# Testing Adlam --> Latin transformations

# Nasalized with nyondal. Remove the nyondal in Latin output.
𞤐𞥋𞤣	Nd
𞤐𞥋𞤁	ND
𞤲𞥋𞤣	nd
𞤐𞥋𞤦	Mb
𞤐𞥋𞤄	MB
𞤲𞥋𞤦	mb
𞤐𞥋𞤔	NJ
𞤐𞥋𞤶	Nj
𞤲𞥋𞤶	nj
𞤐𞥋𞤘	NG
𞤐𞥋𞤺	Ng
𞤲𞥋𞤺	ng

# Nasalized initial
𞤐𞤣	Nd
𞤐𞤁	ND
𞤲𞤣	nd
𞤐𞤦	Mb
𞤐𞤄	MB
𞤲𞤦	mb
𞤐𞤔	NJ
𞤐𞤶	Nj
𞤲𞤶	nj
𞤐𞤘	NG
𞤐𞤺	Ng
𞤲𞤺	ng

# Start of a word
𞤐𞤁 𞤐𞤁	ND ND
𞤲𞤣 𞤲𞤣	nd nd
𞤐𞤦 𞤐𞤦	Mb Mb
𞤐𞤄 𞤐𞤄	MB MB
𞤲𞤦 𞤲𞤦	mb mb
𞤐𞤔 𞤐𞤔	NJ NJ
𞤐𞤶 𞤐𞤶	Nj Nj
𞤲𞤶 𞤲𞤶	nj nj
𞤐𞤘 𞤐𞤘	NG NG
𞤐𞤺 𞤐𞤺	Ng Ng
𞤲𞤺 𞤲𞤺	ng ng

# Non-initial nazalizations with consonant before.
𞤁𞤐𞤁	DND
𞤁𞤲𞤣	Dnd
𞤣𞤲𞤣	dnd
𞤄𞤐𞤄	BMB
𞤄𞤲𞤦	Bmb
𞤦𞤲𞤦	bmb
𞤔𞤐𞤔	JNJ
𞤔𞤲𞤶	Jnj
𞤶𞤲𞤶	jnj
𞤘𞤐𞤘	GNG
𞤘𞤲𞤺	Gng
𞤺𞤲𞤺	gng

# Non-initial nazalizations with long vowel before.
𞤀𞥄𞤐𞤘	AANG
𞤀𞥄𞤲𞤺	Aang
𞤢𞥄𞤲𞤺	aang
𞤋𞥅𞤐𞤘	IING
𞤋𞥅𞤲𞤺	Iing
𞤭𞥅𞤲𞤺	iing
𞤀𞥄𞤐𞤔	AANJ
𞤀𞥄𞤲𞤶	Aanj
𞤢𞥄𞤲𞤶	aanj
𞤀𞥄𞤐𞤄	AAMB
𞤀𞥄𞤲𞤦	Aamb
𞤢𞥄𞤲𞤦	aamb
𞤀𞥄𞤐𞤁	AAND
𞤀𞥄𞤲𞤣	Aand
𞤢𞥄𞤲𞤣	aand

# A bit of punctuation
؟	?
⸮	?

# Tests sorted by Adlam string
# Upper case source should produce upper case results, except
# where the upper case Adlam letter becomes two or more Latin letters.
# When followed by lower case alif 𞤢, such cases should produce
# mixed case results.
𞤀	A
𞤀𞤀	A’A
𞤀𞤀𞤁𞤂𞤃	A’ADLM
𞤀𞤀𞤢	A’aa
𞤀𞤢	A’a
𞤀𞤢𞤣𞤤𞤥	A’adlm
𞤀𞥄	AA
𞤀𞥄𞤢	Aaa
𞤀𞥄𞤢𞤣𞤤𞤥	Aaadlm
𞤀𞥈	Ạ
𞤀𞥉	ẠẠ
𞤀𞥉𞤢	Ạạa
𞤀𞥉𞤢𞤣𞤤𞤥	Ạạadlm
𞤁	D
𞤁𞤀𞤁𞤂𞤃	DADLM
𞤁𞤁	DD
𞤁𞤢𞤣𞤤𞤥	Dadlm
𞤁𞥆	DD
𞤁𞥆𞤢	Dda
𞤁𞥆𞤢𞤣𞤤𞤥	Ddadlm
𞤁𞥇	D’
𞤁𞥈	Ḍ
𞤁𞥈𞤢𞤣𞤤𞤥	Ḍadlm
𞤁𞥉	ḌḌ
𞤁𞥉𞤢	Ḍḍa
𞤂	L
𞤂𞤀𞤁𞤂𞤃	LADLM
𞤂𞤂	LL
𞤂𞤢𞤣𞤤𞤥	Ladlm
𞤂𞥆	LL
𞤂𞥆𞤢	Lla
𞤂𞥆𞤢𞤣𞤤𞤥	Lladlm
𞤃	M
𞤃𞤀𞤁𞤂𞤃	MADLM
𞤃𞤃	MM
𞤃𞤢𞤣𞤤𞤥	Madlm
𞤃𞥆	MM
𞤃𞥆𞤢	Mma
𞤃𞥆𞤢𞤣𞤤𞤥	Mmadlm
𞤄	B
𞤄𞤀𞤁𞤂𞤃	BADLM
𞤄𞤄	BB
𞤄𞤢𞤣𞤤𞤥	Badlm
𞤄𞥆	BB
𞤄𞥆𞤢	Bba
𞤄𞥆𞤢𞤣𞤤𞤥	Bbadlm
𞤅	S
𞤅𞤀𞤁𞤂𞤃	SADLM
𞤅𞤅	SS
𞤅𞤢𞤣𞤤𞤥	Sadlm
𞤅𞥆	SS
𞤅𞥆𞤢	Ssa
𞤅𞥆𞤢𞤣𞤤𞤥	Ssadlm
𞤅𞥈	Ṣ
𞤅𞥈𞤢𞤣𞤤𞤥	Ṣadlm
𞤅𞥈𞥆	TTH
𞤅𞥈𞥆𞤢	Ttha
𞤅𞥉	ṢṢ
𞤅𞥉𞤢	Ṣṣa
𞤅𞥊	TH
𞤅𞥊𞤢	Tha
𞤆	P
𞤆𞤀𞤁𞤂𞤃	PADLM
𞤆𞤆	PP
𞤆𞤢𞤣𞤤𞤥	Padlm
𞤆𞥆	PP
𞤆𞥆𞤢	Ppa
𞤆𞥆𞤢𞤣𞤤𞤥	Ppadlm
𞤇	Ɓ
𞤇𞤀𞤁𞤂𞤃	ƁADLM
𞤇𞤇	ƁƁ
𞤇𞤢𞤣𞤤𞤥	Ɓadlm
𞤇𞥆	ƁƁ
𞤇𞥆𞤢	Ɓɓa
𞤇𞥆𞤢𞤣𞤤𞤥	Ɓɓadlm
𞤈	R
𞤈𞤀𞤁𞤂𞤃	RADLM
𞤈𞤈	RR
𞤈𞤢𞤣𞤤𞤥	Radlm
𞤈𞥆	RR
𞤈𞥆𞤢	Rra
𞤈𞥆𞤢𞤣𞤤𞤥	Rradlm
𞤈𞥇	R’
𞤉	E
𞤉𞤀𞤁𞤂𞤃	EADLM
𞤉𞤉	E’E
𞤉𞤉𞤀	E’EA
𞤉𞤉𞤢	E’ea
𞤉𞤢𞤣𞤤𞤥	Eadlm
𞤉𞤫	E’e
𞤉𞥅	EE
𞤉𞥅𞤢	Eea
𞤉𞥅𞤢𞤣𞤤𞤥	Eeadlm
𞤉𞥊𞥅	ƐƐ
𞤉𞥊𞥅𞤢	Ɛɛa
𞤉𞥊	Ɛ
𞤊	F
𞤊𞤀𞤁𞤂𞤃	FADLM
𞤊𞤊	FF
𞤊𞤢𞤣𞤤𞤥	Fadlm
𞤊𞥆	FF
𞤊𞥆𞤢	Ffa
𞤋	I
𞤋𞤀𞤁𞤂𞤃	IADLM
𞤋𞤋	I’I
𞤋𞤋𞤢	I’ia
𞤋𞤢𞤣𞤤𞤥	Iadlm
𞤋𞤭	I’i
𞤋𞥅	II
𞤋𞥅𞤢	Iia
𞤋𞥅𞤢𞤣𞤤𞤥	Iiadlm
𞤋𞥆	CC
𞤋𞥆𞤢	Cca
𞤌	O
𞤌𞤀𞤁𞤂𞤃	OADLM
𞤌𞤌	O’O
𞤌𞤌𞤢	O’oa
𞤌𞤢𞤣𞤤𞤥	Oadlm
𞤌𞤮	O’o
𞤌𞥅	OO
𞤌𞥅𞤢	Ooa
𞤌𞥅𞤢𞤣𞤤𞤥	Ooadlm
𞤌𞥊𞥅	ƆƆ
𞤌𞥊𞥅𞤢	Ɔɔa
𞤌𞥊	Ɔ
𞤍	Ɗ
𞤍𞤀𞤁𞤂𞤃	ƊADLM
𞤍𞤍	ƊƊ
𞤍𞤢𞤣𞤤𞤥	Ɗadlm
𞤍𞥆	ƊƊ
𞤍𞥆𞤢	Ɗɗa
𞤍𞥆𞤢𞤣𞤤𞤥	Ɗɗadlm
𞤎	Ƴ
𞤎𞤀𞤁𞤂𞤃	ƳADLM
𞤎𞤎	ƳƳ
𞤎𞤢𞤣𞤤𞤥	Ƴadlm
𞤎𞥆	ƳƳ
𞤎𞥆𞤢	Ƴƴa
𞤎𞥆𞤢𞤣𞤤𞤥	Ƴƴadlm
𞤏	W
𞤏𞤀𞤁𞤂𞤃	WADLM
𞤏𞤏	WW
𞤏𞤢𞤣𞤤𞤥	Wadlm
𞤏𞥆	WW
𞤏𞥆𞤢	Wwa
𞤏𞥆𞤢𞤣𞤤𞤥	Wwadlm
𞤐	N
𞤐𞤀𞤁𞤂𞤃	NADLM
𞤐𞤁𞤢	Nda
𞤐𞤶𞤢	Nja
𞤐𞤘𞤢	Nga
𞤐𞤢𞤣𞤤𞤥	Nadlm
𞤐𞤣	Nd
𞤐𞤦	Mb
𞤐𞤶	Nj
𞤐𞤺	Ng
𞤐𞥆	NN
𞤐𞥆𞤢	Nna
𞤐𞥆𞤢𞤣𞤤𞤥	Nnadlm
𞤐𞥋𞤦𞤢	Mba
𞤑	K
𞤑𞤀𞤁𞤂𞤃	KADLM
𞤑𞤑	KK
𞤑𞤢𞤣𞤤𞤥	Kadlm
𞤑𞥆	KK
𞤑𞥆𞤀𞤁𞤂𞤃	KKADLM
𞤑𞥆𞤢	Kka
𞤑𞥆𞤢𞤣𞤤𞤥	Kkadlm
𞤒	Y
𞤒𞤀𞤁𞤂𞤃	YADLM
𞤒𞤒	YY
𞤒𞤢𞤣𞤤𞤥	Yadlm
𞤒𞥆	YY
𞤒𞥆𞤢	Yya
𞤒𞥆𞤢𞤣𞤤𞤥	Yyadlm
𞤓	U
𞤓𞤀𞤁𞤂𞤃	UADLM
𞤓𞤓	U’U
𞤓𞤓𞤢	U’ua
𞤓𞤢𞤣𞤤𞤥	Uadlm
𞤓𞤵	U’u
𞤓𞥅	UU
𞤓𞥅𞤢	Uua
𞤓𞥅𞤢𞤣𞤤𞤥	Uuadlm
𞤔	J
𞤔𞤀𞤁𞤂𞤃	JADLM
𞤔𞤔	JJ
𞤔𞤢𞤣𞤤𞤥	Jadlm
𞤔𞥆	JJ
𞤔𞥆𞤢	Jja
𞤔𞥆𞤢𞤣𞤤𞤥	Jjadlm
𞤔𞥆𞥆	ẒẒ
𞤔𞥆𞥆𞤢	Ẓẓa
𞤔𞥈	J̣
𞤔𞥈𞤢𞤣𞤤𞤥	J̣adlm
𞤔𞥉	J̣J̣
𞤔𞥉𞤢	J̣j̣̣a
𞤔𞥊	Ẓ
𞤔𞥊	Ẓ
𞤕	C
𞤕𞤀𞤁𞤂𞤃	CADLM
𞤕𞤕	CC
𞤕𞤢𞤣𞤤𞤥	Cadlm
𞤖	H
𞤖𞤀𞤁𞤂𞤃	HADLM
𞤖𞤖	HH
𞤖𞤢𞤣𞤤𞤥	Hadlm
𞤖𞥆	HH
𞤖𞥆𞤢	Hha
𞤖𞥆𞤢𞤣𞤤𞤥	Hhadlm
𞤖𞥈	Ḥ
𞤖𞥈𞤢𞤣𞤤𞤥	Ḥadlm
𞤖𞥉	ḤḤ
𞤖𞥉𞤢	Ḥḥa
𞤗	Q
𞤗𞤀𞤁𞤂𞤃	QADLM
𞤗𞤗	QQ
𞤗𞤢𞤣𞤤𞤥	Qadlm
𞤗𞥆	QQ
𞤗𞥆𞤢	Qqa
𞤗𞥆𞤢𞤣𞤤𞤥	Qqadlm
𞤘	G
𞤘𞤀𞤁𞤂𞤃	GADLM
𞤘𞤘	GG
𞤘𞤢𞤣𞤤𞤥	Gadlm
𞤘𞥆	GG
𞤘𞥆𞤢	Gga
𞤘𞥆𞤢𞤣𞤤𞤥	Ggadlm
𞤘𞥈	G̣
𞤘𞥈𞤢𞤣𞤤𞤥	G̣adlm
𞤘𞥉	G̣G̣
𞤘𞥉𞤢	G̣g̣a
𞤙	Ñ
𞤙𞤀𞤁𞤂𞤃	ÑADLM
𞤙𞤙	ÑÑ
𞤙𞤢𞤣𞤤𞤥	Ñadlm
𞤙𞥆	ÑÑ
𞤙𞥆𞤢	Ñña
𞤙𞥆𞤢𞤣𞤤𞤥	Ññadlm
𞤚	T
𞤚𞤀𞤁𞤂𞤃	TADLM
𞤚𞤚	TT
𞤚𞤢𞤣𞤤𞤥	Tadlm
𞤚𞥆	TT
𞤚𞥆𞤢	Tta
𞤚𞥆𞤢𞤣𞤤𞤥	Ttadlm
𞤚𞥈	Ṭ
𞤚𞥈𞤢𞤣𞤤𞤥	Ṭadlm
𞤚𞥉	ṬṬ
𞤚𞥉𞤢	Ṭṭa
𞤛	Ŋ
𞤛𞤀𞤁𞤂𞤃	ŊADLM
𞤛𞤛	ŊŊ
𞤛𞤢𞤣𞤤𞤥	Ŋadlm
𞤛𞥆	ŊŊ
𞤛𞥆𞤢	Ŋŋa
𞤛𞥆𞤢𞤣𞤤𞤥	Ŋŋadlm
𞤜	V
𞤜𞤀𞤁𞤂𞤃	VADLM
𞤜𞤜	VV
𞤜𞤢𞤣𞤤𞤥	Vadlm
𞤜𞥆	VV
𞤜𞥆𞤢	Vva
𞤜𞥆𞤢𞤣𞤤𞤥	Vvadlm
𞤝	KH
𞤝𞤀𞤁𞤂𞤃	KHADLM
𞤝𞤝	KHKH
𞤝𞤢	Kha
𞤝𞤢𞤣𞤤𞤥	Khadlm
𞤝𞥆	KKH
𞤝𞥆𞤢	Kkha
𞤝𞥆𞤢𞤣𞤤𞤥	Kkhadlm
𞤞	GB
𞤞𞤀𞤁𞤂𞤃	GBADLM
𞤞𞤞	GBGB
𞤞𞤢	Gba
𞤞𞤢𞤣𞤤𞤥	Gbadlm
𞤞𞥆	GGB
𞤞𞥆𞤢	Ggba
𞤞𞥆𞤢𞤣𞤤𞤥	Ggbadlm
𞤟	Z
𞤟𞤀𞤁𞤂𞤃	ZADLM
𞤟𞤟	ZZ
𞤟𞤢𞤣𞤤𞤥	Zadlm
𞤟𞥆	ZZ
𞤟𞥆𞤢	Zza
𞤟𞥆𞤢𞤣𞤤𞤥	Zzadlm
𞤠	KP
𞤠𞤀𞤁𞤂𞤃	KPADLM
𞤠𞤠	KPKP
𞤠𞤢	KPa
𞤠𞤢𞤣𞤤𞤥	KPadlm
𞤠𞥆	KKP
𞤠𞥆𞤢	Kkpa
𞤠𞥆𞤢𞤣𞤤𞤥	Kkpadlm
𞤡	SH
𞤡𞤀𞤁𞤂𞤃	SHADLM
𞤡𞤡	SHSH
𞤡𞤢	SHa
𞤡𞤢𞤣𞤤𞤥	SHadlm
𞤡𞥆	SSH
𞤡𞥆𞤢	Ssha
𞤡𞥆𞤢𞤣𞤤𞤥	Sshadlm

# Start of lower case Adlam strings
𞤢	a
𞤢𞤢	a’a
𞤢𞥄	aa
𞤢𞥈	ạ
𞤢𞥉	ạạ
𞤣	d
𞤣𞤣	dd
𞤣𞥆	dd
𞤣𞥇	d’
𞤣𞥈	ḍ
𞤣𞥉	ḍḍ
𞤤	l
𞤤𞤤	ll
𞤤𞥆	ll
𞤥	m
𞤥𞤥	mm
𞤥𞥆	mm
𞤦	b
𞤦𞤦	bb
𞤦𞥆	bb
𞤧	s
𞤧𞤧	ss
𞤧𞥆	ss
𞤧𞥈	ṣ
𞤧𞥈𞥆	tth
𞤧𞥉	ṣṣ
𞤨	p
𞤨𞤨	pp
𞤨𞥆	pp
𞤩	ɓ
𞤩𞤩	ɓɓ
𞤩𞥆	ɓɓ
𞤪	r
𞤪𞤪	rr
𞤪𞥆	rr
𞤪𞥇	r’
𞤫	e
𞤫𞤢𞤣𞤤𞤥	eadlm
𞤫𞤫	e’e
𞤫𞥅	ee
𞤫𞥊𞥅	ɛɛ
𞤫𞥊	ɛ
𞤬	f
𞤬𞤬	ff
𞤬𞥆	ff
𞤭	i
𞤭𞤭	i’i
𞤭𞥅	ii
𞤭𞥆	cc
𞤮	o
𞤮𞤮	o’o
𞤮𞥅	oo
𞤮𞥊𞥅	ɔɔ
𞤮𞥊	ɔ
𞤯	ɗ
𞤯𞥆	ɗɗ
𞤰	ƴ
𞤰𞤰	ƴƴ
𞤰𞥆	ƴƴ
𞤱	w
𞤱𞤱	ww
𞤱𞥆	ww
𞤲	n
𞤲𞤲	nn
𞤲𞤺	ng
𞤲𞥆	nn
𞤳	k
𞤳𞤳	kk
𞤳𞥆	kk
𞤴	y
𞤴𞤴	yy
𞤴𞥆	yy
𞤵	u
𞤵𞤵	u’u
𞤵𞥅	uu
𞤶	j
𞤶𞤶	jj
𞤶𞥆	jj
𞤶𞥆𞥆	ẓẓ
𞤶𞥈	j̣
𞤶𞥉	j̣j̣
𞤶𞥊	ẓ
𞤷	c
𞤷𞤷	cc
𞤸	h
𞤸𞤸	hh
𞤸𞥆	hh
𞤸𞥈	ḥ
𞤸𞥉	ḥḥ
𞤹	q
𞤹𞤹	qq
𞤹𞥆	qq
𞤺	g
𞤺𞤺	gg
𞤺𞥆	gg
𞤺𞥈	g̣
𞤺𞥉	g̣g̣
𞤻	ñ
𞤻𞤻	ññ
𞤻𞥆	ññ
𞤼	t
𞤼𞤼	tt
𞤼𞥆	tt
𞤼𞥈	ṭ
𞤼𞥉	ṭṭ
𞤽	ŋ
𞤽𞤽	ŋŋ
𞤽𞥆	ŋŋ
𞤾	v
𞤾𞤾	vv
𞤾𞥆	vv
𞤿	kh
𞤿𞤿	khkh
𞤿𞥆	kkh
𞥀	gb
𞥀𞥀	gbgb
𞥀𞥆	ggb
𞥁	z
𞥁𞥁	zz
𞥁𞥆	zz
𞥂	kp
𞥂𞥂	kpkp
𞥂𞥆	kkp
𞥃	sh
𞥃𞥃	shsh
𞥃𞥆	ssh

# Adlam digits
𞥐	0
𞥑	1
𞥒	2
𞥓	3
𞥔	4
𞥕	5
𞥖	6
𞥗	7
𞥘	8
𞥙	9
𞥞	¡
𞥟	¿

# Days of the week and months of the year
𞤀𞤤𞤼𞤭𞤲𞤫	Altine
𞤅𞤢𞤤𞤢𞤧𞤢	Salasa
𞤀𞤤𞤢𞤪𞤦𞤢	Alarba
𞤀𞤤𞤢𞤥𞤭𞤧𞤫	Alamise
𞤔𞤵𞤥𞤩𞤢𞤪𞤫	Jumɓare
𞤀𞤧𞤢𞤱𞤫	Asawe
𞤀𞤤𞤢𞤼	Alat
𞤟𞤢𞥄𞤲𞤾𞤭𞤴𞤫	Zaanviye
𞤊𞤫𞤾𞤭𞥅𞤪𞤭𞤴𞤫	Feviiriye
𞤃𞤢𞥄𞤪𞤧	Maars
𞤀𞤾𞤭𞤪𞤭𞤤𞤢𞤳𞤵	Avirilaku
𞤊𞤮𞥅𞤼𞤭	Footi
𞤟𞤱𞤫𞤲𞥋𞤺	Zweng
𞤟𞤱𞤭𞤴𞤫	Zwiye
𞤓𞤼	Ut
𞤅𞤫𞤨𞤼𞤢𞤲𞥋𞤦𞤫𞤪	Septamber
𞤌𞤳𞤼𞤮𞤦𞤫𞤪	Oktober
𞤐𞤮𞤾𞤢𞤲𞥋𞤦𞤫𞤪	Novamber
𞤁𞤫𞤧𞤢𞤲𞥋𞤦𞤫𞤪	Desamber
# Some continents
𞤀𞤬𞤪𞤭𞤳	Afrik
𞤀𞤧𞤭𞥅	Asii
𞤌𞤪𞤮𞤨	Orop
𞤌𞤧𞤼𞤢𞤪𞤢𞤤𞤭	Ostarali
𞤀𞤲𞤼𞤢𞤪𞤼𞤭𞤳	Antartik
𞤀𞤥𞤫𞤪𞤭𞤳 𞤊𞤵𞤯𞤲𞤢𞥄𞤲𞤺𞤫	Amerik Fuɗnaange
𞤀𞤥𞤫𞤪𞤭𞤳 𞤏𞤮𞤪𞤺𞤮	Amerik Worgo
# Transport
𞤮𞤼𞤮	oto
𞤦𞤢𞤧𞤳𞤵𞤪	baskur
𞤳𞤢𞤥𞤭𞤴𞤮𞤲𞥋𞤺	kamiyong
𞤚𞤢𞤳𞤧𞤭	Taksi
𞤶𞤭𞤪𞤳𞤭	jirki
𞤤𞤢𞥄𞤲𞤢 𞤲𞤣𞤭𞤱𞤮𞥅𞤱𞤢	laana ndiwoowa
𞤫𞤤𞤭𞤳𞤮𞤨𞤼𞤫𞥅𞤪	elikopteer
𞤲𞤫𞤤𞤣𞤵𞤺𞤮	neldugo
𞤳𞤮𞤲𞥋𞤦𞤫𞥅𞤱𞤢𞤤	kombeewal
𞤤𞤢𞥄𞤲𞤢 𞤲𞤣𞤭𞤱𞤮𞥅𞤱𞤢	laana ndiwoowa
# Languages and terms about people and writing
𞤆𞤵𞤤𞤢𞥄𞤪	Pulaar
𞤒𞤭𞤥𞤩𞤫 𞤊𞤵𞤤𞤩𞤫	Yimɓe Fulɓe
𞤄𞤭𞤲𞤣𞤮𞤤 𞤀𞤣𞤤𞤢𞤥	Binndol Adlam
𞤄𞤭𞤲𞤣𞤭 𞤀𞤪𞤢𞤦	Binndi Arab
𞤄𞤭𞤲𞤣𞤮𞤤 𞤤𞤢𞤼𞤭𞤲	Binndol latin
𞤋𞤲𞥋𞤺𞤤𞤭𞤧𞤭𞤢	Inglisia
𞤊𞤢𞤪𞤢𞤴𞤧𞤫	Farayse
𞤀𞤪𞤢𞤦	Arab
𞤖𞤢𞤱𞤧𞤢	Hawsa
𞤉𞤧𞤨𞤢𞤲𞤭𞤧	Espanis
𞤍𞤫𞤥𞤲𞤺𞤢𞤤 𞤃𞤫𞤲𞥋𞤣𞤫	Ɗemngal Mende
𞤅𞤭𞤲𞤵𞤱𞤢𞥄 𞤫𞤲	Sinuwaa en
𞤖𞤭𞤲𞥋𞤣𞤭	Hindi
𞤅𞤵𞤱𞤢𞤸𞤭𞤤𞤭	Suwahili
# Geographic features
𞤘𞤫𞥅𞤷 𞤀𞤼𞤤𞤢𞤲𞤼𞤭𞤳	Geec Atlantik
𞤘𞤫𞥅𞤷 𞤋𞤲𞥋𞤣𞤭𞤴𞤢	Geec Indiya
𞤘𞤫𞥅𞤷 𞤀𞤪𞤳𞤼𞤭𞤳	Geec Arktik
𞤘𞤫𞥅𞤷 𞤆𞤢𞤧𞤭𞤬𞤭𞤳	Geec Pasifik
𞤂𞤢𞤳𞤫 𞤕𞤢𞥄𞤣	Lake Caad
𞤃𞤢𞥄𞤴𞤮 𞤑𞤮𞤲𞤺𞤮	Maayo Konngo
𞤃𞤢𞥄𞤴𞤮 𞤀𞤥𞤢𞥁𞤮𞤲𞤭𞤫	Maayo Amazonie
𞤔𞤫𞥅𞤪𞤫𞥅𞤲𞤣𞤫 𞤅𞤢𞤸𞤢𞤪𞤢𞥄	Jeereende Saharaa
𞤃𞤢𞥄𞤴𞤮 𞤐𞤭𞥅𞤤	Maayo Niil
# Some cities
𞤑𞤮𞤲𞤢𞤳𞤪𞤭	Konakri
𞤑𞤢𞤴𞤸𞤢𞤴𞤯𞤭	Kayhayɗi
𞤐𞤢𞤴𞤪𞤮𞥅𞤦𞤭	Nayroobi
𞤁𞤫𞤤𞤭	Deli
𞤆𞤢𞤪𞤭	Pari
𞤂𞤮𞤲𞥋𞤣𞤪𞤫𞤧	Londres
𞤆𞤫𞤳𞤭𞤲	Pekin
𞤚𞤮𞤳𞤭𞤴𞤮𞥅	Tokiyoo
𞤄𞤵𞤱𞤫𞤲𞤮𞤧 𞤀𞤴𞤪𞤫𞤧	Buwenos Ayres
𞤅𞤭𞤣𞤲𞤫𞤴                             	Sidney                             
# Regions of the world
𞤀𞤬𞤺𞤢𞤲𞤭𞤧𞤼𞤢𞥄𞤲	Afganistaan
𞤀𞤤𞤦𞤢𞥄𞤲𞤭	Albaani
𞤀𞤤𞤧𞤫𞤪𞤭	Alseri
𞤅𞤢𞤥𞤮𞤢 𞤀𞤥𞤫𞤪𞤭𞤳𞤲𞤢𞥄𞤶𞤮	Samoa Ameriknaajo
𞤀𞤲𞥋𞤣𞤮𞤪𞤢𞥄𞤶𞤭	Andoraaji
𞤀𞤲𞥋𞤺𞤢𞤤𞤼𞤫𞥅𞤪	Angalteer
𞤀𞤲𞤼𞤭𞤺𞤵 𞤫 𞤄𞤢𞤪𞤦𞤵𞤣𞤢	Antigu e Barbuda
𞤀𞤪𞤶𞤢𞤲𞤼𞤭𞥅𞤲	Arjantiin
𞤂𞤫𞤴𞤣𞤭 𞤀𞤪𞤥𞤫𞤲𞤭	Leydi Armeni
𞤂𞤫𞤴𞤣𞤭 𞤀𞤪𞤵𞤦𞤢	Leydi Aruba
𞤌𞤧𞤼𞤢𞤪𞤢𞤤𞤭	Ostarali
𞤌𞤼𞤭𞤪𞤭𞤧	Otiris
𞤀𞥁𞤫𞤪𞤦𞤢𞤭𞤶𞤢𞥄𞤲	Azerbaijaan
𞤂𞤫𞤴𞤣𞤭 𞤄𞤢𞤸𞤢𞤥𞤢𞤧	Leydi Bahamas
𞤄𞤢𞤸𞤪𞤫𞤴𞤲	Bahreyn
𞤄𞤢𞤲𞤺𞤢𞤤𞤼𞤫𞥅𞤪	Banngalteer
𞤄𞤢𞤪𞤦𞤢𞤣𞤮𞤧	Barbados
𞤄𞤭𞤫𞤤𞤮𞤪𞤵𞤧𞥆𞤭	Bielorussi
𞤄𞤫𞤤𞤧𞤭𞤳	Belsik
𞤄𞤫𞤤𞤭𞥅𞤧	Beliis
𞤄𞤫𞤲𞤫𞤽	Beneŋ
𞤄𞤫𞤪𞤥𞤵𞤣𞤢	Bermuda
𞤄𞤵𞤼𞤢𞥄𞤲	Butaan
𞤄𞤮𞤤𞤭𞤱𞤭	Boliwi
𞤄𞤮𞤧𞤲𞤭 𞤫 𞤖𞤫𞤪𞤧𞤫𞤺𞤮𞤾𞤭𞤲𞤢	Bosni e Hersegovina
𞤄𞤮𞤧𞤼𞤱𞤢𞤲𞤢	Bostwana
𞤄𞤫𞤪𞤫𞤧𞤭𞥅𞤤	Beresiil
𞤄𞤵𞤪𞤵𞤲𞤫𞤴	Buruney
𞤂𞤫𞤴𞤣𞤭 𞤄𞤵𞤤𞤺𞤢𞤪𞤭	Leydi Bulgari
𞤄𞤵𞤪𞤳𞤭𞤲𞤢𞥄	Burkinaa
𞤑𞤮 𞤄𞤵𞤪𞤵𞤲𞥋𞤣𞤭	Ko Burundi
𞤑𞤢𞤦𞤮 𞤜𞤫𞤪𞤣𞤫 (𞤑𞤢𞤨 𞤜𞤫𞤪𞤣𞤫)	Kabo Verde (Kap Verde)
𞤑𞤢𞤲𞤦𞤮𞤶𞤫	Kammboje
𞤑𞤢𞤥𞤫𞤪𞤵𞥅𞤲	Kameruun
𞤑𞤢𞤲𞤢𞤣𞤢𞥄	Kanadaa
𞤁𞤵𞥅𞤲𞤣𞤫 𞤑𞤢𞤴𞤥𞤢𞤲	Duunde Kayman
𞤐𞤣𞤫𞤲𞤣𞤢𞥄𞤲𞤣𞤭 𞤀𞤬𞤪𞤭𞤳 𞤸𞤢𞤳𞥆𞤵𞤲𞥋𞤣𞤫𞥅𞤶𞤮	Ndenndaandi Afrik hakkundeejo
𞤕𞤢𞥄𞤣	Caad
𞤅𞤭𞥅𞤤𞤭	Siili
𞤅𞤭𞥅𞤲	Siin
𞤑𞤮𞤤𞤮𞤲𞤦𞤭	Kolommbi
𞤂𞤫𞤴𞤣𞤭 𞤑𞤮𞤥𞤮𞥅𞤪	Leydi Komoor
𞤐𞤣𞤫𞤲𞤣𞤢𞥄𞤲𞤣𞤭 𞤑𞤮𞤲𞤺𞤮 𞤁𞤫𞤥𞤮𞤳𞤢𞤪𞤢𞥄𞤧𞤭	Ndenndaandi Konngo Demokaraasi
𞤐𞤣𞤫𞤲𞤣𞤢𞥄𞤲𞤣𞤭 𞤑𞤮𞤲𞤺𞤮	Ndenndaandi Konngo
𞤑𞤮𞤧𞤼𞤢 𞤈𞤭𞤳𞤢	Kosta Rika
𞤑𞤮𞤣𞥆𞤵𞤱𞤢𞥄𞤪	Kodduwaar
𞤑𞤮𞤪𞤮𞤱𞤢𞤧𞤭	Korowasi
𞤑𞤵𞤦𞤢𞥄	Kubaa
𞤑𞤵𞤪𞤢𞤧𞤢𞤮	Kurasao
𞤅𞤭𞤨𞤪𞤵𞤧	Siprus
𞤂𞤫𞤴𞤣𞤭 𞤕𞤫𞤳𞤮𞤧𞤤𞤮𞤱𞤢𞤳𞤭	Leydi Cekoslowaki
𞤁𞤢𞤲𞤫𞤥𞤢𞤪𞤳	Danemark
𞤔𞤭𞤦𞤵𞥅𞤼𞤭	Jibuuti
𞤁𞤮𞤥𞤭𞤲𞤭𞤳	Dominik
𞤂𞤫𞤴𞤣𞤭 𞤁𞤮𞤥𞤭𞤲𞤭𞤳	Leydi Dominik
𞤚𞤭𞤥𞤮𞤪 𞤊𞤵𞤯𞤲𞤢𞥄𞤲𞤺𞤫 (𞤚𞤭𞤥𞤮𞤪 𞤊𞤵𞤯𞤲𞤢𞥄𞤲𞤺𞤫)	Timor Fuɗnaange (Timor Fuɗnaange)
𞤉𞤳𞤵𞤱𞤢𞤼𞤮𞤪	Ekuwator
𞤃𞤭𞤧𞤪𞤢	Misra
𞤅𞤢𞤤𞤾𞤢𞤣𞤮𞥅𞤪	Salvadoor
𞤘𞤭𞤲𞤫 𞤉𞤳𞤵𞤱𞤢𞤼𞤮𞥅𞤪	Gine Ekuwatoor
𞤉𞤪𞤭𞤼𞤪𞤫𞥅	Eritree
𞤉𞤧𞤼𞤮𞤲𞤭	Estoni
𞤉𞤧𞤱𞤢𞤼𞤭𞤲𞤭 (𞤅𞤱𞤢𞥄𞤧𞤭𞤤𞤢𞤲𞥋𞤣)	Eswatini (Swaasiland)
𞤉𞤷𞤮𞤨𞥆𞤭	Ecoppi
𞤁𞤵𞥅𞤲𞤣𞤫𞥅𞤶𞤭 𞤊𞤢𞤪𞤮	Duundeeji Faro
𞤊𞤭𞥅𞤶𞤭	Fiiji
𞤊𞤭𞤲𞤤𞤢𞤲𞥋𞤣𞤫	Finlande
𞤊𞤢𞤪𞤢𞤴𞤧𞤫	Farayse
𞤘𞤭𞤲𞤫 𞤊𞤢𞤪𞤢𞤴𞤧𞤫	Gine Farayse
𞤆𞤮𞤤𞤭𞤲𞤫𞥅𞤧𞤭 𞤊𞤢𞤪𞤢𞤴𞤧𞤫	Polineesi Farayse
𞤘𞤢𞤦𞤮𞤲	Gabon
𞤂𞤫𞤴𞤣𞤭 𞤘𞤢𞤲𞤦𞤭	Leydi Gammbi
𞤂𞤫𞤴𞤣𞤭 𞤘𞤢𞥁𞤢	Leydi Gaza
𞤔𞤮𞥅𞤪𞤶𞤭	Joorji
𞤀𞤤𞤥𞤢𞥄𞤻	Almaañ
𞤘𞤢𞤲𞤢𞥄	Ganaa
𞤘𞤫𞤪𞤫𞤧	Geres
𞤘𞤭𞤪𞤭𞥅𞤲𞤤𞤢𞤲𞤣𞤫	Giriinlannde
𞤘𞤪𞤫𞤲𞤢𞤣𞤢	Grenada
𞤘𞤵𞤢𞤣𞤢𞤤𞤵𞤨𞤵	Guadalupu
𞤘𞤵𞤢𞤥	Guam
𞤘𞤵𞤱𞤢𞤼𞤫𞤥𞤢𞤤𞤢	Guwatemala
𞤘𞤫𞤪𞤧𞤭	Gersi
𞤘𞤭𞤲𞤫	Gine
𞤘𞤭𞤲𞤫 𞤄𞤭𞤧𞤢𞥄𞤱𞤮	Gine Bisaawo
𞤘𞤵𞤴𞤢𞤲𞤢	Guyana
𞤖𞤢𞤴𞤭𞤼𞤭	Hayiti
𞤖𞤮𞤲𞥋𞤣𞤵𞤪𞤢𞤧	Honduras
𞤖𞤮𞤲𞥋𞤺 𞤑𞤮𞤲𞥋𞤺	Hong Kong
𞤋𞤧𞤤𞤢𞤲𞥋𞤣𞤫	Islande
𞤋𞤲𞥋𞤣𞤭𞤴𞤢	Indiya
𞤋𞤲𞥋𞤣𞤮𞤲𞤫𞥅𞤧𞤭	Indoneesi
𞤋𞤪𞤢𞥄𞤲	Iraan
𞤋𞤪𞤢𞤳	Irak
𞤋𞤪𞤤𞤢𞤲𞤣𞤢	Irlannda
𞤁𞤵𞥅𞤲𞤣𞤫 𞤃𞤢𞤲	Duunde Man
𞤋𞤧𞤪𞤢𞥄𞤴𞤭𞥅𞤤	Israayiil
𞤋𞤼𞤢𞤤𞤭	Itali
𞤔𞤢𞤥𞤢𞤴𞤳𞤢	Jamayka
𞤔𞤢𞤨𞤮𞤲	Japon
𞤔𞤫𞤪𞤧𞤫𞤴	Jersey
𞤓𞤪𞤣𞤵𞤲	Urdun
𞤑𞤢𞤧𞤢𞤳𞤧𞤼𞤢𞥄𞤲	Kasakstaan
𞤑𞤫𞤻𞤭𞤴𞤢	Keñiya
𞤑𞤭𞤪𞤭𞤦𞤢𞥄𞤼𞤭	Kiribaati
𞤑𞤮𞤪𞤫𞥅 𞤱𞤮𞤪𞤺𞤮	Koree worgo
𞤑𞤮𞤪𞤫𞥅 𞤱𞤮𞤪𞤺𞤮,	Koree worgo,
𞤑𞤮𞤧𞤮𞤾𞤮	Kosovo
𞤑𞤵𞤱𞤮𞤴𞤼	Kuwoyt
𞤑𞤭𞤪𞤺𞤭𞤧𞤭𞤧𞤼𞤢𞥄𞤲	Kirgisistaan
𞤂𞤢𞤮𞤧	Laos
𞤤𞤫𞤴𞤣𞤭 𞤂𞤫𞤼𞤮𞤲𞤭	leydi Letoni
𞤂𞤫𞤴𞤣𞤭 𞤂𞤭𞤦𞤢𞤲	Leydi Liban
𞤂𞤫𞤧𞤮𞤼𞤮	Lesoto
𞤂𞤭𞤦𞤫𞤪𞤭𞤴𞤢𞥄	Liberiyaa
𞤂𞤭𞤦𞤭	Libi
𞤂𞤭𞤳𞤼𞤫𞤲𞤧𞤭𞥅𞤲	Liktensiin
𞤂𞤭𞤼𞤵𞤱𞤢𞥄𞤲𞤭	Lituwaani
𞤂𞤫𞤴𞤣𞤭 𞤂𞤵𞤳𞤧𞤫𞤲𞥋𞤦𞤵𞤪𞤺	Leydi Luksemburg
𞤃𞤢𞤳𞤢𞤮	Makao
𞤃𞤢𞤣𞤢𞤺𞤢𞤧𞤳𞤢𞥄𞤪	Madagaskaar
𞤃𞤢𞤤𞤢𞤱𞤭	Malawi
𞤃𞤢𞤤𞤫𞤧𞤭	Malesi
𞤃𞤢𞤤𞤣𞤭𞥅𞤬 𞤫𞤲	Maldiif en
𞤃𞤢𞥄𞤤𞤭	Maali
𞤃𞤢𞤤𞤼𞤢	Malta
𞤁𞤵𞥅𞤲𞤣𞤫 𞤃𞤢𞤪𞥃𞤢𞤤𞥆	Duunde Marshall
𞤃𞤢𞤪𞤼𞤭𞤲𞤭𞤳	Martinik
𞤂𞤫𞤴𞤣𞤭 𞤃𞤮𞤪𞤭𞤼𞤢𞤲𞤭	Leydi Moritani
𞤃𞤮𞤪𞤭𞤼𞤢𞤲𞤭	Moritani
𞤃𞤢𞤴𞤮𞤼𞤫	Mayote
𞤃𞤫𞤳𞤧𞤭𞤳	Meksik
𞤃𞤭𞤳𞤪𞤮𞤲𞤫𞥅𞤧𞤭	Mikroneesi
𞤃𞤮𞤤𞤣𞤢𞤾𞤭	Moldavi
𞤃𞤮𞤲𞤢𞤳𞤮	Monako
𞤃𞤮𞤲𞥋𞤺𞤮𞤤𞤭	Mongoli
𞤃𞤮𞤲𞤼𞤫𞤲𞤫𞤺𞤪𞤮	Montenegro
𞤃𞤢𞤪𞤵𞤳	Maruk
𞤃𞤮𞤧𞤢𞤲𞤦𞤭𞤳	Mosammbik
𞤃𞤭𞤴𞤢𞤲𞤥𞤢𞥄𞤪 (𞤄𞤭𞤪𞤥𞤢𞥄𞤲𞤭)	Miyanmaar (Birmaani)
𞤐𞤢𞤥𞤭𞤦𞤭	Namibi
𞤐𞤢𞥄𞤪𞤵	Naaru
𞤐𞤫𞤨𞤢𞤤	Nepal
𞤆𞤢𞤴𞤧-𞤄𞤢𞤧	Pays-Bas
𞤑𞤢𞤤𞤫𞤣𞤮𞤲𞤭 𞤳𞤫𞤧𞤮	Kaledoni keso
𞤂𞤫𞤴𞤣𞤭 𞤐𞤵𞤱𞤫𞤤 𞤅𞤫𞤤𞤢𞤲𞤣𞤫	Leydi Nuwel Selannde
𞤐𞤭𞤳𞤢𞤪𞤢𞤺𞤵𞤱𞤢𞥄	Nikaraguwaa
𞤐𞤭𞥅𞤧𞤫𞥅𞤪	Niiseer
𞤐𞤢𞥄𞤶𞤫𞥅𞤪𞤭𞤴𞤢	Naajeeriya
𞤃𞤢𞤧𞤫𞤣𞤵𞤱𞤢𞥄𞤲 𞤱𞤮𞤪𞤺𞤮	Maseduwaan worgo
𞤁𞤵𞥅𞤲𞤣𞤫 𞤃𞤢𞤪𞤭𞤢𞤲𞤢 𞤊𞤵𞤯𞤲𞤢𞥄𞤲𞤺𞤫	Duunde Mariana Fuɗnaange
𞤐𞤮𞤪𞤱𞤫𞥅𞤧	Norwees
𞤌𞤥𞤢𞤲	Oman
𞤆𞤢𞤳𞤭𞤧𞤼𞤢𞥄𞤲	Pakistaan
𞤆𞤢𞤤𞤢𞤵	Palau
𞤆𞤢𞤲𞤢𞤥𞤢	Panama
𞤆𞤢𞤨𞤮𞤵𞤢𞤧𞤭𞤫-𞤐𞤮𞤵𞤾𞤫𞤤𞥆𞤫-𞤘𞤭𞤲𞤫𞥅	Papouasie-Nouvelle-Ginee
𞤆𞤢𞤪𞤢𞤺𞤵𞤱𞤢𞥄𞤴	Paraguwaay
𞤆𞤫𞤪𞤵	Peru
𞤊𞤭𞤤𞤭𞤨𞤭𞥅𞤲	Filipiin
𞤆𞤮𞤤𞤮𞤻	Poloñ
𞤆𞤮𞤪𞤼𞤭𞤺𞤢𞥄𞤤	Portigaal
𞤆𞤮𞤪𞤼𞤮 𞤈𞤭𞤳𞤮	Porto Riko
𞤑𞤢𞤼𞤢𞥄𞤪	Kataar
𞤑𞤢𞤱𞤪𞤢𞤤	Kawral
𞤈𞤵𞤥𞤢𞥄𞤲𞤭	Rumaani
𞤈𞤭𞥅𞤧𞤭	Riisi
𞤈𞤵𞤱𞤢𞤲𞤣𞤢	Ruwannda
𞤅𞤢𞤭𞤲𞤼 𞤑𞤭𞤼𞤧 𞤫 𞤐𞤫𞤾𞤭𞤧	Saint Kits e Nevis
𞤂𞤵𞤧𞤭𞤴𞤢 𞤅𞤫𞤲𞤺𞤮	Lusiya Senngo
𞤅𞤢𞤲 𞤜𞤭𞤷𞤫𞤲𞤼 𞤫 𞤘𞤪𞤫𞤲𞤢𞤣𞤭𞤲	San Vicent e Grenadin
𞤅𞤢𞤥𞤮𞤢	Samoa
𞤅𞤢𞤲 𞤃𞤢𞤪𞤭𞤲𞤮	San Marino
𞤅𞤢𞤮 𞤚𞤮𞤥𞤫 𞤫 𞤆𞤪𞤭𞤲𞤷𞤭𞤨𞤫	Sao Tome e Principe
𞤂𞤫𞤴𞤣𞤭 𞤅𞤢𞤱𞤣𞤭𞤼	Leydi Sawdit
𞤅𞤫𞤲𞤫𞤺𞤢𞥄𞤤	Senegaal
𞤅𞤫𞤪𞤦𞤭	Serbi
𞤅𞤫𞤲𞤫𞤺𞤢𞥄𞤤	Senegaal
𞤅𞤭𞤴𞤫𞤪𞤢𞥄 𞤂𞤫𞤴𞤮𞥅𞤲	Siyeraa Leyoon
𞤅𞤭𞤲𞥋𞤺𞤢𞤨𞤵𞥅𞤪	Singapuur
𞤅𞤭𞤲𞤼 𞤃𞤢𞥄𞤪𞤼𞤫𞤲	Sint Maarten
𞤅𞤤𞤮𞤱𞤢𞤳𞤭	Slowaki
𞤅𞤤𞤮𞤾𞤫𞤲𞤭	Sloveni
𞤁𞤵𞥅𞤲𞤣𞤫𞥅𞤪𞤫 𞤅𞤵𞤤𞤫𞤴𞤥𞤢𞥄𞤲𞤭	Duundeere Suleymaani
𞤅𞤮𞤥𞤢𞤤𞤭	Somali
𞤀𞤬𞤪𞤭𞤳 𞤱𞤮𞤪𞤺𞤮	Afrik worgo
𞤉𞤧𞤨𞤢𞥄𞤻	Espaañ
𞤅𞤭𞤪𞤭 𞤂𞤢𞤲𞤳𞤢	Siri Lanka
𞤅𞤵𞤣𞤢𞥄𞤲	Sudaan
𞤅𞤵𞤣𞤢𞥄𞤲 𞤱𞤮𞤪𞤺𞤮	Sudaan worgo
𞤅𞤵𞤪𞤭𞤲𞤢𞥄𞤥	Surinaam
𞤅𞤵𞤱𞤫𞤣	Suwed
𞤅𞤭𞤱𞤭𞤧	Siwis
𞤅𞤭𞥅𞤪𞤭	Siiri
𞤚𞤢𞤴𞤱𞤢𞥄𞤲	Taywaan
𞤚𞤢𞤶𞤭𞤳𞤭𞤧𞤼𞤢𞥄𞤲	Tajikistaan
𞤚𞤢𞤲𞤧𞤢𞤲𞤭	Tansani
𞤚𞤢𞤴𞤤𞤢𞤲𞥋𞤣𞤫	Taylande
𞤚𞤮𞤺𞤮	Togo
𞤚𞤮𞤲𞥋𞤺𞤢	Tonga
𞤚𞤪𞤭𞤲𞤭𞤣𞤢𞤣 𞤫 𞤚𞤮𞤦𞤢𞤺𞤮	Trinidad e Tobago
𞤚𞤵𞥅𞤲𞤵𞤧	Tuunus
𞤆𞤢𞤵𞤤𞤢	Paula
𞤚𞤵𞤪𞤳𞤥𞤫𞤲𞤭𞤧𞤼𞤢𞥄𞤲	Turkmenistaan
𞤚𞤵𞤱𞤢𞥄𞤤𞤵	Tuwaalu
𞤓𞤺𞤢𞤲𞤣𞤢𞥄	Uganndaa
𞤓𞤳𞤪𞤢𞤲𞤭	Ukrani
𞤉𞤥𞤭𞤪𞤢𞥄𞤶𞤭 𞤀𞤪𞤢𞤦 𞤁𞤫𞤲𞤼𞤵𞤯𞤭	Emiraaji Arab Dentuɗi
𞤂𞤫𞤴𞤣𞤭 𞤄𞤭𞤪𞤭𞤼𞤢𞥄𞤲	Leydi Biritaan
𞤂𞤫𞤴𞤯𞤫𞥅𞤤𞤫 𞤣𞤫𞤲𞤼𞤵𞤯𞤫 𞤀𞤥𞤫𞤪𞤭𞤳	Leyɗeele dentuɗe Amerik
𞤁𞤵𞥅𞤲𞤣𞤫𞥅𞤪𞤫 𞤜𞤭𞤪𞤺𞤭𞤲 𞤀𞤥𞤫𞤪𞤭𞤳	Duundeere Virgin Amerik
𞤓𞤪𞤵𞤺𞤵𞤱𞤢𞥄𞤴	Uruguwaay
𞤓𞤧𞤦𞤫𞤳𞤭𞤧𞤼𞤢𞥄𞤲	Usbekistaan
𞤜𞤢𞤲𞤵𞤢𞤼𞤵	Vanuatu
𞤏𞤵𞤪𞤮 𞤜𞤢𞤼𞤭𞤳𞤢𞤲	Wuro Vatikan
𞤏𞤫𞤲𞤫𞤧𞤵𞤫𞤤𞤢	Wenesuela
𞤏𞤭𞤴𞤫𞤼𞤲𞤢𞥄𞤥	Wiyetnaam
𞤕𞤭𞤧𞤶𞤮𞤪𞤣𞤢𞤲𞤭𞤫	Cisjordanie
𞤒𞤫𞤥𞤫𞤲	Yemen
𞤅𞤢𞤲𞤦𞤭	Sammbi
𞤅𞤭𞤲𞤦𞤢𞥄𞤦𞤵𞤱𞤫𞥅	Simmbaabuwee

# Some longer test cases
𞤁𞤢𞥄𞤪𞤼𞤮𞤤 𞤀𞤬𞤪𞤭𞤳 𞤫 𞤼𞤫𞥅𞤥𞤭𞤲𞤢𞤲𞤣𞤫 𞥒𞥐𞤧𞤭𞥅𞤪𞤫 𞤭𞤲𞤢 𞤧𞤢𞤯𞤼𞤭	Daartol Afrik e teeminannde 20siire ina saɗti
𞤌 𞤢𞤣𞤢𞤼 𞤼𞤢𞤲 𞤮𞤥𞤮 𞤢𞤣𞥆𞤢.	O adat tan omo adda.
'𞤍𞤵𞤥 𞤳𞤮 𞤳𞤮𞤲𞤺𞤮𞤤 𞤶𞤢𞤪𞥆𞤭𞤦𞤮𞤪𞤺𞤮𞤤 𞤫 𞤯𞤫𞤥𞤲𞤺𞤢𞤤 𞤊𞤵𞤤𞤬𞤵𞤤𞤣𞤫!'	'Ɗum ko konngol jarriborgol e ɗemngal Fulfulde!'
'𞤃𞤭𞤯𞤮 𞤶𞤮𞤺𞤭𞥅 𞤥𞤭𞤻𞤭𞤪𞤢𞥄𞤩𞤫 𞤼𞤢𞤼𞤮 𞤱𞤮𞤪𞤩𞤫 𞤫 𞤥𞤭𞤻𞤭𞤪𞤢𞥄𞤩𞤫 𞤪𞤫𞤱𞤩𞤫 𞤯𞤭𞤯𞤮. 𞤉𞤲𞤫𞤲 𞤬𞤮𞤬 𞤫𞤯𞤫𞤲 𞤲𞤺𞤵𞥅𞤪𞤭 𞤫 𞤱𞤵𞤪𞤮 𞤱𞤮𞥅𞤼𞤮, 𞤳𞤮 𞤭𞤲𞤢 𞤱𞤮𞤲𞤢 𞤱𞤢𞤳𞤼𞤵𞥅𞤶𞤭 𞤯𞤭𞤯𞤭 𞤫 𞤱𞤵𞤪𞤮 𞤥𞤫𞤲 𞤢𞤣𞤢𞤲𞤺𞤮.'	'Miɗo jogii miñiraaɓe tato worɓe e miñiraaɓe rewɓe ɗiɗo. Enen fof eɗen nguuri e wuro wooto, ko ina wona waktuuji ɗiɗi e wuro men adanngo.'
