ሀብታምነት	ሀብታምነ፟ት
ሀቻምና	ሀቻ፟ምና
ሀች	ሀች፟
ሁለ	ሁለ፟
ሁለመና	ሁለ፟መና
ሁለተ	ሁለተ፟
ሁለቴ	ሁለቴ፟
ሁለት	ሁለት፟
ሁሉ	ሁሉ፟
ሁሉም	ሁሉ፟ም
ሁሌ	ሁሌ፟
ሁል	ሁል፟
ሁልጊዜ	ሁል፟ጊዜ
ሁነኛ	ሁነኛ፟
ሁከተኛ	ሁከተኛ፟
ሂስና	ሂስና፟
ሃያኛ	ሃያኛ፟
ሃይማኖተኛ	ሃይማኖተኛ፟
ህላዌ	ህላ፟ዌ
ህልውና	ህል፟ውና
ህክምና	ህክ፟ምና፟
ሆሳዕና	ሆሳ፟ዕና
ሆነለት	ሆነለ፟ት
ሆነበት	ሆነበ፟ት
ሆኖም	ሆኖም፟
ሆጃ	ሆጃ፟
ለመለመ	ለመለ፟መ
ለመሰሰ	ለመሰ፟ሰ
ለመነ	ለመ፟ነ
ለመዘገ	ለመዘ፟ገ
ለመደ	ለመ፟ደ
ለመጠ	ለመ፟ጠ
ለመጥ	ለመ፟ጥ፟
ለማ	ለማ፟
ለማመደ	ለማመ፟ደ
ለማኝ	ለማ፟ኝ
ለማኝነት	ለማ፟ኝነ፟ት
ለማዳ	ለማ፟ዳ
ለማዳነት	ለማ፟ዳነ፟ት
ለማጣ	ለማ፟ጣ
ለምነት	ለምነ፟ት
ለሰለሰ	ለሰለ፟ሰ
ለሰሰ	ለሰ፟ሰ
ለሰነ	ለሰ፟ነ
ለሱ	ለሱ፟
ለሳኝ	ለሳ፟ኝ
ለስ	ለስ፟
ለስላሳ	ለስላሳ፟
ለስላሳነት	ለስላሳ፟ነ፟ት
ለሸለሸ	ለሸለ፟ሸ
ለቀለቀ	ለቀለ፟ቀ
ለቀመ	ለቀ፟መ
ለቀም	ለቀም፟
ለቀስተኛ	ለቀ፟ስተኛ፟
ለቀቀ	ለቀ፟ቀ
ለቀቅ	ለቀ፟ቅ
ለቃቀመ	ለቃቀ፟መ
ለቅለቅ	ለቅለቅ፟
ለቅላቂ	ለቅላ፟ቂ
ለበለበ	ለበለ፟በ
ለበሰ	ለበሰ፟
ለበቀ	ለበ፟ቀ
ለበበ	ለበ፟በ
ለበደ	ለበ፟ደ
ለበጠ	ለበ፟ጠ
ለባቃ	ለባ፟ቃ፟
ለባበሰ	ለባበ፟ሰ
ለብ	ለብ፟
ለብታ	ለብ፟ታ
ለብቻ	ለብ፟ቻ፟
ለተመ	ለተ፟መ
ለካ	ለካ፟
ለኮሰ	ለኮ፟ሰ
ለኮፈ	ለኮ፟ፈ
ለወሰ	ለወሰ፟
ለወጠ	ለወ፟ጠ
ለዋሳ	ለዋ፟ሳ፟
ለዘበ	ለዘ፟በ
ለዘብተኛ	ለዘ፟ብተኛ፟
ለዛ	ለዛ፟
ለዛው	ለዛ፟ው
ለየ	ለየ፟
ለየብቻ	ለየ፟ብቻ፟
ለያየ	ለያየ፟
ለይስሙላ	ለይስሙላ፟
ለጅ	ለጅ፟
ለገመ	ለገ፟መ
ለገሰ	ለገ፟ሰ
ለጋ	ለጋ፟
ለጋስ	ለጋ፟ስ
ለጋስነት	ለጋ፟ስነ፟ት
ለግላጋ	ለግላጋ፟
ለጎን	ለጎን፟
ለጎደ	ለጎ፟ደ
ለጐመ	ለጐ፟መ
ለጠለጠ	ለጠለ፟ጠ
ለጫካ	ለጫካ፟
ለፈለፈ	ለፈለ፟ፈ
ለፈፈ	ለፈ፟ፈ
ለፋ	ለፋ፟
ሊቅነት	ሊቅነ፟ት
ላላ	ላላ፟
ላምባ	ላምባ፟
ላሸ	ላሸ፟
ላሸቀ	ላሸ፟ቀ
ላቂያ	ላቂ፟ያ
ላቅ	ላቅ፟
ላቆጠ	ላቆ፟ጠ
ላከከ	ላከ፟ከ
ላይኛ	ላይኛ፟
ላጲስ	ላጲ፟ስ
ሌብነት	ሌብነ፟ት
ሌጣነት	ሌጣነ፟ት
ልመና	ልመ፟ና
ልማደኛ	ልማደኛ፟
ልምምድ	ልምም፟ድ
ልምጥ	ልም፟ጥ፟
ልምጭ	ልም፟ጭ
ልሳነ	ልሳ፟ነ
ልሳን	ልሳ፟ን
ልስላሴ	ልስላ፟ሴ፟
ልስን	ልስ፟ን
ልቃሚ	ልቃ፟ሚ
ልቃቂ	ልቃ፟ቂ
ልቃቂት	ልቃ፟ቂት
ልቅ	ልቅ፟
ልቅም	ልቅ፟ም
ልቅቅ	ልቅቅ፟
ልቅነት	ልቅ፟ነ፟ት
ልበ	ልበ፟
ልቡ	ልቡ፟
ልቡና	ልቡ፟ና
ልባም	ልባ፟ም
ልባሽ	ልባ፟ሽ
ልባዊ	ልባ፟ዊ
ልብ	ልብ፟
ልብስ	ልብ፟ስ
ልብቅ	ልብ፟ቅ
ልብዳት	ልብ፟ዳት
ልብድ	ልብ፟ድ
ልብጥ	ልብ፟ጥ
ልኩን	ልኩ፟ን
ልክ	ልክ፟
ልዋጭ	ልዋ፟ጭ
ልውውጥ	ልውው፟ጥ
ልዕልና	ልዕልና፟
ልዝብ	ልዝ፟ብ
ልዩ	ልዩ፟
ልዩነት	ልዩ፟ነ፟ት
ልጃገረድነት	ልጃገረድነ፟ት
ልጅነት	ልጅነ፟ት
ልጉም	ልጉ፟ም
ልግመኛ	ልግመኛ፟
ልግስና	ልግ፟ስና፟
ልጥፋት	ል፟ጥ፟ፋት
ልጨኛ	ልጨ፟ኛ፟
ልፈፋ	ልፈ፟ፋ
ልፊያ	ልፊ፟ያ
ልፋጫም	ልፋ፟ጫም
ልፋጭ	ልፋ፟ጭ
ሎሌነት	ሎሌነ፟ት
ሎቲ	ሎቲ፟
ሐማል	ሐማ፟ል
ሐማልነት	ሐማ፟ልነ፟ት
ሐሜተኛ	ሐሜተኛ፟
ሐሜት	ሐሜ፟ት
ሐሰተኛ	ሐሰ፟ተኛ፟
ሐሰት	ሐሰ፟ት
ሐሳብ	ሐሳ፟ብ
ሐሳዌ	ሐሳ፟ዌ
ሐቀኛ	ሐቀ፟ኛ፟
ሐቀኛነት	ሐቀ፟ኛ፟ነ፟ት
ሐቅ	ሐቅ፟
ሐተተኛ	ሐተተኛ፟
ሐች	ሐች፟
ሐካይ	ሐካ፟ይ
ሐኬተኛ	ሐኬተኛ፟
ሐኬተኝነት	ሐኬተኝ፟ነ፟ት
ሐዋላ	ሐዋ፟ላ
ሐዋርያነት	ሐዋርያነ፟ት
ሐዘንተኛ	ሐዘንተኛ፟
ሐዲስ	ሐዲ፟ስ
ሑር	ሑር፟
ሑርነት	ሑር፟ነ፟ት
ሕመምተኛ	ሕመምተ፟ኛ
ሕቅ	ሕቅ፟
ሕቅታ	ሕቅ፟ታ
ሕክምና	ሕክ፟ምና፟
ሕያውነት	ሕያውነ፟ት
ሕገ	ሕገ፟
ሕጋዊ	ሕጋ፟ዊ
ሕጋዊነት	ሕጋ፟ዊነ፟ት
ሕግ	ሕግ፟
ሕጓ	ሕጓ፟
ሕፃንነት	ሕፃን፟ነ፟ት
መሀንዲስነት	መሀንዲስነ፟ት
መሀከለኛ	መሀከ፟ለኛ፟
መሀከል	መሀከ፟ል
መሃይም	መሃይ፟ም
መሃይምነት	መሃይ፟ምነ፟ት
መለለ	መለ፟ለ
መለማመጃ	መለ፟ማመጃ
መለሰ	መለ፟ሰ
መለቃለቂያ	መለ፟ቃለቂያ
መለኮትነት	መለኮትነ፟ት
መለወጫ	መለ፟ወጫ፟
መለዮ	መለ፟ዮ፟
መለጠ	መለ፟ጠ
መላ	መላ፟
መላሽ	መላ፟ሽ
መላክተኛ	መላክተኛ፟
መላጣነት	መላጣነ፟ት
መልመጃ	መል፟መጃ
መልሶ	መል፟ሶ
መልቲነት	መልቲነ፟ት
መልእክተኛ	መልእክተኛ፟
መልከኛ	መልከኛ፟
መሐለቅ	መሐለ፟ቅ
መሐላ	መሐላ፟
መመሪያ	መመ፟ሪያ
መመነኛ	መመነ፟ኛ
መመዘኛ	መመዘ፟ኛ
መመዝገቢያ	መመ፟ዝገቢያ
መመጻደቅ	መመ፟ጻደቅ
መማለጃ	መማ፟ለጃ
መምህርነት	መምህርነ፟ት
መሠሪ	መሠሪ፟
መሠሪነት	መሠሪ፟ነ፟ት
መሠዊያ	መሠዊ፟ያ
መሠውር	መሠው፟ር
መሣሪያ	መሣ፟ሪያ
መሥዋዕትነት	መሥዋዕትነ፟ት
መረመረ	መረመ፟ረ
መረማመጃ	መረ፟ማመጃ
መረረ	መረ፟ረ
መረረው	መረ፟ረው
መረቀ	መረ፟ቀ
መረቀዘ	መረቀ፟ዘ
መረባ	መረባ፟
መረተ	መረ፟ተ
መረነ	መረ፟ነ
መረዋ	መረዋ፟
መረዘ	መረ፟ዘ
መረጃ	መረ፟ጃ
መረገ	መረ፟ገ
መረገጫ	መረ፟ገጫ
መረጋገጫ	መረ፟ጋገጫ
መረጠ	መረ፟ጠ
መሪነት	መሪነ፟ት
መራ	መራ፟
መራራነት	መራ፟ራነት
መራር	መራ፟ር
መራርነት	መራ፟ርነ፟ት
መራቂ	መራ፟ቂ
መራቢያ	መራ፟ቢያ
መራዥ	መራ፟ዥ
መራገጫ	መራ፟ገጫ
መራጭነት	መራጭነ፟ት
መር	መር፟
መርከበኛ	መርከበኛ፟
መርዘኛ	መርዘኛ፟
መሰለ	መሰ፟ለ
መሰብሰቢያ	መሰ፟ብሰቢያ
መሰነ	መሰ፟ነ
መሰናዘሪያ	መሰ፟ናዘሪያ
መሰናዶ	መሰ፟ናዶ
መሰከረ	መሰከ፟ረ፟
መሰከነ	መሰከ፟ነ
መሰኪያ	መሰኪ፟ያ
መሰደጃ	መሰ፟ደጃ
መሰገ	መሰ፟ገ
መሰጠ	መሰ፟ጠ
መሳ	መሳ፟
መሳለሚያ	መሳ፟ለሚያ
መሳለቂያ	መሳ፟ለቂያ
መሳጭ	መሳ፟ጭ
መሳፍቻ	መሳ፟ፍቻ፟
መስቀልኛ	መስቀልኛ፟
መስቀልያ	መስቀልያ፟
መስተአምር	መስተአም፟ር
መስካሪነት	መስካሪነ፟ት
መስኮብኛ	መስኮብኛ፟
መስፈሪያ	መስ፟ፈሪያ
መሸ	መሸ፟
መሸለቻ	መሸለ፟ቻ
መሸሸጊያ	መሸ፟ሸጊያ
መሸቀጫ	መሸቀ፟ጫ
መሸበቢያ	መሸበ፟ቢያ
መሸተ	መሸ፟ተ
መሸተኛ	መሸተኛ፟
መሸኛ	መሸኛ፟
መሸገ	መሸ፟ገ
መሸጋሸጊያ	መሸ፟ጋሸጊያ
መሸፈቻ	መሸፈ፟ቻ
መሸፈኛ	መሸፈ፟ኛ
መሻገሪያ	መሻ፟ገሪያ
መቀለጃ	መቀለ፟ጃ
መቀመጫ	መቀ፟መጫ
መቀቀያ	መቀቀ፟ያ
መቀነት	መቀነ፟ት
መቀነቻ	መቀነ፟ቻ
መቀየሻ	መቀየ፟ሻ
መቀጣጫ	መቀ፟ጣጫ
መቀጫ	መቀ፟ጫ
መቀጮ	መቀ፟ጮ
መቃጠሪያ	መቃ፟ጠሪያ
መቆያ	መቆያ፟
መቆጣጠሪያ	መቆ፟ጣጠሪያ
መቆፈሪያ	መቆፈ፟ሪያ
መቋቋሚያ	መቋ፟ቋሚያ
መቍጠሪያ	መቍ፟ጠሪያ
መበለት	መበለ፟ት
መበላት	መበ፟ላት
መበየጃ	መበየ፟ጃ
መበያ	መበ፟ያ
መበደሪያ	መበ፟ደሪያ
መተላለፊያ	መተ፟ላለፊያ
መተማመኛ	መተ፟ማመኛ
መተረ	መተ፟ረ
መተረቻ	መተረ፟ቻ
መተረክያ	መተረ፟ክያ
መተተኛ	መተተኛ፟
መተኛ	መተኛ፟
መተከዣ	መተከ፟ዣ
መተከያ	መተ፟ከያ
መተዳደሪያ	መተ፟ዳደሪያ
መታ	መ፟ታ
መታመኛ	መታ፟መኛ
መታሠሪያ	መታ፟ሠሪያ
መታረቂያ	መታ፟ረቂያ
መታሰቢያ	መታ፟ሰቢያ
መታሻ	መታ፟ሻ
መታተረ	መታተ፟ረ
መታታ	መታታ፟
መታወቂያ	መታ፟ወቂያ
መታጠቂያ	መታ፟ጠቂያ
መታጠቢያ	መታ፟ጠቢያ
መታጠፊያ	መታ፟ጠፊያ
መታጫ	መታ፟ጫ
መትረየስ	መትረየ፟ስ
መቶኛ	መቶኛ፟
መቼም	መቼ፟ም
መቼውንም	መቼ፟ውንም
መነመነ	መነመ፟ነ
መነሣት	መነ፟ሣት
መነሻ	መነ፟ሻ
መነሾ	መነ፟ሾ
መነቀረ	መነቀ፟ረ
መነቃቀረ	መነቃቀ፟ረ
መነተፈ	መነተ፟ፈ
መነቸከ	መነቸ፟ከ
መነነ	መነ፟ነ
መነኰሰ	መነኰ፟ሰ
መነዘረ	መነዘ፟ረ
መነዛዘረ	መነዛዘ፟ረ
መነገገ	መነገ፟ገ
መነጥር	መነጥ፟ር
መነጽር	መነጽ፟ር
መና	መና፟
መናኛ	መናኛ፟
መናኝ	መና፟ኝ
መናገሻ	መና፟ገሻ
መናፈሻ	መና፟ፈሻ
መንማና	መንማና፟
መንቃራ	መንቃራ፟
መንቻካ	መንቻካ፟
መንደረኛ	መንደረኛ፟
መንደርተኛ	መንደርተኛ፟
መንገደኛ	መንገደኛ፟
መንጠቆ	መንጠቆ፟
መንጫራ	መንጫራ፟
መንጫቃ	መንጫ፟ቃ፟
መንፈሳዊነት	መንፈሳዊነ፟ት
መኖ	መኖ፟
መኝታ	መኝ፟ታ
መከለሻ	መከለ፟ሻ
መከላከያ	መከ፟ላከያ
መከማቻ	መከ፟ማቻ
መከረ	መከ፟ረ
መከረኛ	መከረ፟ኛ
መከተ	መከ፟ተ
መከነ	መከ፟ነ
መከናነቢያ	መከ፟ናነቢያ
መከዳ	መከ፟ዳ፟
መከፈኛ	መከፈ፟ኛ
መካች	መካ፟ች
መካን	መካ፟ን
መካንነት	መካ፟ንነ፟ት
መካከለኛ	መካከ፟ለኛ፟
መካከል	መካከ፟ል
መካከረ	መካከ፟ረ
መኰንን	መኰን፟ን
መወሰኛ	መወሰ፟ኛ፟
መዋጮ	መዋ፟ጮ
መዐተኛ	መዐተኛ፟
መዘመዘ	መዘመ፟ዘ
መዘምራን	መዘም፟ራን
መዘምር	መዘም፟ር
መዘበረ	መዘበ፟ረ
መዘባበቻ	መዘ፟ባበቻ
መዘነ	መዘ፟ነ
መዘክር	መዘክ፟ር
መዘውር	መዘው፟ር
መዘዘኛ	መዘዘኛ፟
መዘገበ	መዘገ፟በ
መዛኝ	መዛ፟ኝ፟
መደለዣ	መደለ፟ዣ
መደለያ	መደ፟ለያ
መደመደ	መደመ፟ደ
መደረቢያ	መደረ፟ቢያ
መደቆሻ	መደቆ፟ሻ
መደበ	መደ፟በ
መደበኛ	መደበኛ፟
መደብ	መደ፟ብ
መደብር	መደብ፟ር
መደደ	መደደ፟
መደገፊያ	መደ፟ገፊያ
መድሃኒተኛ	መድሃኒተኛ፟
መድጎሚያ	መድጎ፟ሚያ
መድፈኛ	መድፈኛ፟
መጀመሪያ	መጀመ፟ሪያ
መገለ	መገ፟ለ
መገመገ	መገመ፟ገ
መገበ	መገ፟በ
መገነዣ	መገነ፟ዣ
መገጣጠሚያ	መገ፟ጣጠሚያ
መጋረጃ	መጋ፟ረጃ
መጋቢ	መጋ፟ቢ
መጋቢት	መጋ፟ቢት
መጋዞ	መጋ፟ዞ
መጋዣ	መጋዣ፟
መጎናጠፊያ	መጎ፟ናጠፊያ
መጎናጸፊ	መጎ፟ናጸፊ
መጓጓዣ	መጓ፟ጓዣ
መጠመጠ	መጠመ፟ጠ
መጠነኛ	መጠነኛ፟
መጠወተ	መጠወ፟ተ
መጠይቅ	መጠይ፟ቅ
መጥቼ	መጥቼ፟
መጨመጨ	መጨመ፟ጨ
መጫኛ	መጫኛ፟
መጸወተ	መጸወ፟ተ
መፈተኛ	መፈተ፟ኛ
መፈናፈኛ	መፈ፟ናፈኛ
መፈክር	መፈክ፟ር
ሙሀቻ	ሙሀቻ፟
ሙላጭ	ሙላ፟ጭ
ሙልል	ሙልል፟
ሙረዳ	ሙረ፟ዳ
ሙሽሪት	ሙሽሪ፟ት
ሙሽራ	ሙሽ፟ራ
ሙትቻ	ሙትቻ፟
ሙከራ	ሙከ፟ራ
ሙክት	ሙክ፟ት
ሙክክ	ሙክክ፟
ሙዋለጠ	ሙዋለ፟ጠ
ሙዋሙዋ	ሙዋሙ፟ዋ
ሙዋርተኛ	ሙዋርተኛ፟
ሙዋሸሸ	ሙዋሸ፟ሸ
ሙዋጠጠ	ሙዋጠ፟ጠ
ሙዚቀኛ	ሙዚቀኛ፟
ሙዝዝ	ሙዝዝ፟
ሙያሌ	ሙያ፟ሌ
ሙያተኛ	ሙያተኛ፟
ሙዳ	ሙዳ፟
ሙጃ	ሙጃ፟
ሙጃማ	ሙጃ፟ማ፟
ሙጅር	ሙጅ፟ር
ሙግት	ሙግ፟ት
ሙግግ	ሙግግ፟
ሙጥኝ	ሙጥ፟ኝ፟
ሚሊዮን	ሚሊ፟ዮን
ሚዳቋ	ሚዳቋ፟
ማለለ	ማለ፟ለ
ማለቢያ	ማለቢ፟ያ
ማለደ	ማለ፟ደ
ማለገ	ማለ፟ገ
ማላ	ማላ፟
ማላጋነት	ማላጋነ፟ት
ማሕሌተኛ	ማሕሌተኛ፟
ማመላለሻ	ማመ፟ላለሻ
ማመሻ	ማመ፟ሻ
ማሚቴ	ማሚ፟ቴ
ማሚቶ	ማሚ፟ቶ
ማማሰያ	ማማ፟ሰያ
ማምረቻና	ማምረቻና፟
ማሞ	ማሞ፟
ማሞኛ	ማሞኛ፟
ማሟያ	ማሟ፟ያ
ማረረ	ማረ፟ረ
ማረከ	ማረ፟ከ
ማረገኛ	ማረገኛ፟
ማራቢያ	ማራ፟ቢያ
ማራገቢያ	ማራ፟ገቢያ
ማሰሻ	ማሰ፟ሻ
ማሰፊያ	ማሰ፟ፊያ
ማሳመኛ	ማሳመ፟ኛ
ማሳተሚያ	ማሳተ፟ሚያ
ማስረጃ	ማስረጃ፟
ማስቀመጫ	ማስቀመ፟ጫ
ማስወረድ	ማስወረ፟ድ
ማስጠሎ	ማስጠሎ፟
ማሸጊያ	ማሸ፟ጊያ
ማሻሻያ	ማሻ፟ሻያ
ማሽላ	ማሽላ፟
ማሾለቂያ	ማሾለ፟ቂያ
ማቀቀ	ማቀ፟ቀ
ማቋረጫ	ማቋ፟ረጫ
ማተሚያ	ማተ፟ሚያ
ማኅበረተኛ	ማኅበረተኛ፟
ማኅበርተኛ	ማኅበርተኛ፟
ማኅበርተኝነት	ማኅበርተኝ፟ነ፟ት
ማነቃቂያ	ማነ፟ቃቂያ
ማናበቢያ	ማና፟በቢያ
ማን	ማን፟
ማንም	ማንም፟
ማንኛውም	ማን፟ኛ፟ውም
ማእድ	ማእድ፟
ማከፋፈያ	ማከ፟ፋፈያ
ማካፈል	ማካ፟ፈል
ማክሰኞ	ማክሰኞ፟
ማዋሐጃ	ማዋ፟ሐጃ
ማዕረገኛ	ማዕረገኛ፟
ማዕድ	ማዕድ፟
ማዕድን	ማዕድ፟ን
ማይክሮስኮፕ	ማይክሮስኮፕ፟
ማደያ	ማደ፟ያ
ማዳመጫ	ማዳ፟መጫ
ማድጋ	ማድጋ፟
ማገረ	ማገ፟ረ
ማገደ	ማገ፟ደ
ማገጃ	ማገ፟ጃ
ማገጠ	ማገ፟ጠ
ማጋጣነት	ማጋጣነ፟ት
ማጋጭነት	ማጋጭነ፟ት
ማግሰኞ	ማግሰኞ፟
ማፈኛ	ማፈ፟ኛ
ሜዳማ	ሜዳማ፟
ምላሰኛ	ምላሰኛ፟
ምላሰኝነት	ምላሰኝ፟ነ፟ት
ምላሽ	ምላ፟ሽ
ምልስ	ምል፟ስ
ምልክት	ምልክ፟ት
ምረቃ	ምረ፟ቃ
ምረት	ምረ፟ት
ምሩቅ	ምሩ፟ቅ
ምሪት	ምሪ፟ት
ምራጭ	ምራ፟ጭ
ምሬት	ምሬ፟ት
ምር	ምር፟
ምርምር	ምርም፟ር
ምርር	ምርር፟
ምርቃት	ምር፟ቃት
ምርኮኛ	ምርኮኛ፟
ምርጊት	ምርጊት፟
ምሰሶ	ምሰሶ፟
ምሳሌ	ምሳ፟ሌ
ምሳር	ምሳ፟ር
ምስ	ምስ፟
ምስሪት	ምስ፟ሪት
ምስራች	ምስራች፟
ምስኪንነት	ምስኪንነ፟ት
ምስክር	ምስክ፟ር
ምስግ	ምስ፟ግ
ምስጢረኛ	ምስጢረኛ፟
ምስፍና	ምስፍና፟
ምሽት	ምሽ፟ት
ምሽግ	ምሽ፟ግ
ምቀኛ	ምቀ፟ኛ፟
ምቀኝነት	ምቀ፟ኝ፟ነ፟ት
ምትክ	ምትክ፟
ምቹ	ምቹ፟
ምቹነት	ምቹ፟ነ፟ት
ምች	ምች፟
ምቾት	ምቾ፟ት
ምነና	ምነ፟ና
ምናኔ	ምና፟ኔ
ምንም	ምንም፟
ምንኛ	ምንኛ፟
ምንኩስና	ምንኩስና፟
ምንደኛ	ምንደኛ፟
ምንጅላት	ምንጅላ፟ት
ምንጠራ	ምንጠ፟ራ
ምኞት	ምኞ፟ት
ምክትል	ምክት፟ል
ምደባ	ምደ፟ባ
ምድጃ	ምድጃ፟
ምጥዋተኛ	ምጥዋተኛ፟
ሞለለ	ሞለ፟ለ
ሞለሞለ	ሞለሞ፟ለ
ሞለጨ	ሞለ፟ጨ
ሞለፈጠ	ሞለፈ፟ጠ
ሞላ	ሞላ፟
ሞላላ	ሞላላ፟
ሞላላነት	ሞላላ፟ነ፟ት
ሞላጫ	ሞላ፟ጫ፟
ሞልሟላ	ሞልሟ፟ላ፟
ሞልቃቃ	ሞልቃቃ፟
ሞረሞረ	ሞረሞ፟ረ
ሞረደ	ሞረ፟ደ
ሞረድ	ሞረ፟ድ
ሞሸለቀ	ሞሸለ፟ቀ
ሞሸረ	ሞሸ፟ረ
ሞሽላቃ	ሞሽላቃ፟
ሞቀሞቀ	ሞቀሞ፟ቀ
ሞቀኝ	ሞቀኝ፟
ሞቃት	ሞቃ፟ት
ሞቅሟቃ	ሞቅሟቃ፟
ሞነተፈ	ሞነተ፟ፈ
ሞከረ	ሞከ፟ረ
ሞከተ	ሞከ፟ተ
ሞከከ	ሞከ፟ከ
ሞካሪ	ሞካ፟ሪ
ሞካች	ሞካ፟ች
ሞዘዘ	ሞዘ፟ዘ
ሞዛዛነት	ሞዛዛነ፟ት
ሞያተኛ	ሞያተኛ፟
ሞጀረ	ሞጀ፟ረ
ሞገተ	ሞገ፟ተ
ሞገደኛ	ሞገደ፟ኛ፟
ሞገገ	ሞገ፟ገ
ሞጋች	ሞጋ፟ች
ሞጨለፈ	ሞጨለ፟ፈ
ሞጨሞጨ	ሞጨሞ፟ጨ
ሟለጠ	ሟለ፟ጠ
ሟሟ	ሟሟ፟
ሟሸሸ	ሟሸ፟ሸ
ሟከከ	ሟከ፟ከ
ሟጠጠ	ሟጠ፟ጠ
ሠለሰ	ሠለ፟ሰ
ሠለጠ	ሠለ፟ጠ
ሠላጤ	ሠላ፟ጤ
ሠመረ	ሠመ፟ረ
ሠረሠረ	ሠረሠ፟ረ
ሠረገ	ሠረ፟ገ
ሠራ	ሠራ፟
ሠራተኛ	ሠራ፟ተኛ፟
ሠራው	ሠራ፟ው
ሠራጊ	ሠራ፟ጊ
ሠቀሠቀ	ሠቀሠ፟ቀ
ሠቀቀ	ሠቀ፟ቀ
ሠናይ	ሠና፟ይ
ሠወረ	ሠወ፟ረ
ሠወርዋራ	ሠወርዋራ፟
ሠዊ	ሠዊ፟
ሠዋ	ሠዋ፟
ሠዋራ	ሠዋ፟ራ፟
ሠዓሊነት	ሠዓሊነ፟ት
ሠየመ	ሠየ፟መ
ሠያሚ	ሠያ፟ሚ
ሠገረ	ሠገ፟ረ
ሠጋ	ሠጋ፟
ሠጋር	ሠጋ፟ር
ሣሣ	ሣሣ፟
ሣርማ	ሣርማ፟
ሥሉስ	ሥሉ፟ስ
ሥሉጥ	ሥሉ፟ጥ
ሥላሴ	ሥላ፟ሴ
ሥልጣኔ	ሥል፟ጣ፟ኔ
ሥሡ	ሥሡ፟
ሥሥት	ሥሥ፟ት
ሥሥነት	ሥሥነ፟ት
ሥርቻ	ሥርቻ፟
ሥቅቅ	ሥቅቅ፟
ሥያሜ	ሥያ፟ሜ
ሦስተኛ	ሦስተኛ፟
ረመጠ	ረመ፟ጠ
ረሰረሰ	ረሰረ፟ሰ
ረሳ	ረሳ፟
ረቀቀ	ረቀ፟ቀ
ረቂቅነት	ረቂቅነ፟ት
ረበረበ	ረበረ፟በ
ረበሸ	ረበ፟ሸ
ረበበ	ረበ፟በ
ረባ	ረባ፟
ረባዳ	ረባ፟ዳ፟
ረብሸኛ	ረብሸኛ፟
ረታ	ረታ፟
ረኅብተኛ	ረኅብተኛ፟
ረከሰ	ረከ፟ሰ
ረካ	ረካ፟
ረኸጥነት	ረኸጥነ፟ት
ረዘመ	ረዘ፟መ
ረዘረዘ	ረዘረ፟ዘ
ረዘቀ	ረዘ፟ቀ
ረዥም	ረዥ፟ም
ረዳ	ረዳ፟
ረዳት	ረዳ፟ት
ረጅም	ረጅ፟ም
ረገመ	ረገ፟መ
ረገበ	ረገ፟በ
ረገብ	ረገብ፟
ረገጠ	ረገ፟ጠ
ረገፈ	ረገ፟ፈ
ረጋ	ረጋ፟
ረጋገጠ	ረጋገ፟ጠ
ረፈረፈ	ረፈረ፟ፈ
ረፈደ	ረፈ፟ደ
ረፋድ	ረፋ፟ድ
ሩሩ	ሩሩ፟
ሩስኛ	ሩስኛ፟
ራራ	ራራ፟
ራብተኛ	ራብተኛ፟
ርሚጦ	ርሚ፟ጦ
ርቀት	ርቀ፟ት
ርችት	ርች፟ት
ርካሽ	ርካ፟ሽ
ርክክብ	ርክክ፟ብ
ርዝራዥ	ርዝራ፟ዥ
ርጋጭ	ርጋ፟ጭ
ርጋፊ	ርጋ፟ፊ
ሮሮ	ሮሮ፟
ሰለለ	ሰለ፟ለ
ሰለመ	ሰለ፟መ
ሰለሰለ	ሰለሰ፟ለ
ሰለቀ	ሰለ፟ቀ
ሰለቀጠ	ሰለቀ፟ጠ
ሰለበ	ሰለ፟በ
ሰለተ	ሰለ፟ተ
ሰለቸ	ሰለቸ፟
ሰላ	ሰላ፟
ሰላላ	ሰላ፟ላ
ሰላማዊነት	ሰላማዊነ፟ት
ሰላች	ሰላ፟ች
ሰላይ	ሰላ፟ይ
ሰልካካ	ሰልካካ፟
ሰልፈኛ	ሰልፈኛ፟
ሰመመ	ሰመ፟መ
ሰመጠ	ሰመ፟ጠ
ሰማ	ሰማ፟
ሰማዕትነት	ሰማዕትነ፟ት
ሰምና	ሰምና፟
ሰሞንኛ	ሰሞንኛ፟
ሰረረ	ሰረ፟ረ
ሰረሰረ	ሰረሰ፟ረ
ሰረቀ	ሰረ፟ቀ
ሰረዘ	ሰረ፟ዘ
ሰረገላ	ሰረገላ፟
ሰረጎደ	ሰረጎ፟ደ
ሰራረዘ	ሰራረ፟ዘ
ሰሰነ	ሰሰ፟ነ
ሰቀለ	ሰቀ፟ለ
ሰቀቀ	ሰቀ፟ቀ
ሰቀቀኝ	ሰቀ፟ቀኝ፟
ሰቀዘ	ሰቀ፟ዘ
ሰቅ	ሰቅ፟
ሰበረ	ሰበ፟ረ
ሰበሰበ	ሰበሰ፟በ
ሰበቀ	ሰበ፟ቀ
ሰበበኛ	ሰበበኛ፟
ሰበከ	ሰበ፟ከ
ሰባ	ሰባ፟
ሰባሰበ	ሰባሰ፟በ
ሰባበረ	ሰባበ፟ረ
ሰባተኛ	ሰባተ፟ኛ፟
ሰባት	ሰባት፟
ሰባኛ	ሰባኛ፟
ሰብሳባ	ሰብሳባ፟
ሰተረ	ሰተ፟ረ
ሰተት	ሰተት፟
ሰታራ	ሰታ፟ራ
ሰነቀ	ሰነ፟ቀ
ሰነቀረ	ሰነቀ፟ረ
ሰነበተ	ሰነበ፟ተ
ሰነበጠ	ሰነበ፟ጠ
ሰነኘ	ሰነኘ፟
ሰነከለ	ሰነከ፟ለ
ሰነዘረ	ሰነዘ፟ረ
ሰነገ	ሰነ፟ገ
ሰነፈ	ሰነ፟ፈ
ሰነፈጠ	ሰነፈ፟ጠ
ሰኔና	ሰኔና፟
ሰንከሎ	ሰንከሎ፟
ሰንካላ	ሰንካላ፟
ሰኞ	ሰኞ፟
ሰከረ	ሰከ፟ረ
ሰከሰከ	ሰከሰ፟ከ
ሰከነ	ሰከ፟ነ
ሰካ	ሰካ፟
ሰካራም	ሰካ፟ራም
ሰውነቱ	ሰውነ፟ቱ
ሰውነቱን	ሰውነ፟ቱን
ሰውነት	ሰውነ፟ት
ሰውየው	ሰውየ፟ው
ሰውየውን	ሰውየ፟ውን
ሰውዬ	ሰውዬ፟
ሰየመ	ሰየ፟መ
ሰየፈ	ሰየ፟ፈ
ሰያፊ	ሰያ፟ፊ
ሰያፍ	ሰያ፟ፍ
ሰይፈኛ	ሰይፈኛ፟
ሰደበ	ሰደ፟በ
ሰደደ	ሰደ፟ደ
ሰገሰገ	ሰገሰ፟ገ
ሰገነት	ሰገነ፟ት
ሰገደ	ሰገ፟ደ
ሰገገ	ሰገ፟ገ
ሰጉዳት	ሰጉ፟ዳ፟ት
ሰጐደ	ሰጐ፟ደ
ሰጓዳ	ሰጓዳ፟
ሰጠ	ሰጠ፟
ሰጠመ	ሰጠ፟መ
ሰፈረ	ሰፈ፟ረ
ሰፈረተኛ	ሰፈረተኛ፟
ሰፈርተኛ	ሰፈርተኛ፟
ሰፈነ	ሰፈ፟ነ
ሰፈፈ	ሰፈ፟ፈ
ሰፊ	ሰ፟ፊ
ሰፊው	ሰፊ፟ው
ሰፋ	ሰፋ፟
ሰፍሳፋ	ሰፍሳፋ፟
ሱረት	ሱረ፟ት
ሱሪ	ሱሪ፟
ሱሰኛ	ሱሰኛ፟
ሱካር	ሱካ፟ር
ሱፋጭ	ሱፋ፟ጭ
ሲል	ሲል፟
ሲቀድ	ሲቀድ፟
ሳሌ	ሳሌ፟
ሳሎን	ሳሎ፟ን
ሳማ	ሳማ፟
ሳምንታዊ	ሳም፟ንታዊ
ሳምንት	ሳም፟ንት
ሳቂታ	ሳቂ፟ታ፟
ሳቅ	ሳቅ፟
ሳቢያ	ሳቢ፟ያ
ሳንባማ	ሳንባማ፟
ሳይንሰኛ	ሳይንሰኛ፟
ሳዱላ	ሳዱላ፟
ሴረኛ	ሴረኛ፟
ሴሰነ	ሴሰ፟ነ
ሴሰኛ	ሴሰኛ፟
ሴሰኛነት	ሴሰኛ፟ነ፟ት
ሴሰኝነት	ሴሰኝ፟ነ፟ት
ሴተኛ	ሴተኛ፟
ሴትነት	ሴትነ፟ት
ስለላ	ስለ፟ላ
ስለሱ	ስለሱ፟
ስለዚህ	ስለዚ፟ህ
ስለዚያ	ስለዚ፟ያ
ስሌት	ስሌ፟ት
ስልም	ስል፟ም
ስልምልም	ስልምልም፟
ስልሳኛ	ስልሳኛ፟
ስልቅ	ስል፟ቅ
ስልቻ	ስል፟ቻ፟
ስልከኛ	ስልከኛ፟
ስመኛ	ስመኛ፟
ስሜት	ስሜ፟ት
ስምም	ስምም፟
ስምምነት	ስምምነ፟ት
ስምንተኛ	ስምንተኛ፟
ስምንት	ስም፟ንት
ስሞተኛ	ስሞተኛ፟
ስረዛ	ስረ፟ዛ
ስሪያ	ስሪ፟ያ
ስርቅ	ስር፟ቅ
ስርቅታ	ስር፟ቅታ
ስርዝ	ስር፟ዝ
ስቅላት	ስቅ፟ላት
ስቅቅ	ስቅ፟ቅ
ስባሪ	ስባ፟ሪ
ስብራት	ስብ፟ራት
ስብስብ	ስብስብ፟
ስተተኛ	ስተተኛ፟
ስትር	ስት፟ር
ስንባጭ	ስንባ፟ጭ
ስንተኛ	ስንተኛ፟
ስንኝ	ስንኝ፟
ስንግ	ስን፟ግ
ስንጣሪ	ስን፟ጣ፟ሪ
ስንፍና	ስንፍና፟
ስኳር	ስኳ፟ር
ስውር	ስው፟ር
ስያሜ	ስያ፟ሜ
ስደተኛ	ስደ፟ተኛ፟
ስደት	ስደ፟ት
ስድ	ስድ፟
ስድሳኛ	ስድሳኛ፟
ስድስተኛ	ስድ፟ስተኛ፟
ስድስት	ስድ፟ስት
ስጋጃ	ስጋጃ፟
ስግስግ	ስግስግ፟
ስፋፊ	ስፋ፟ፊ
ስፍስፍ	ስፍስፍ፟
ስፖርተኛ	ስፖርተኛ፟
ሶመሶመ	ሶመሶ፟መ፟
ሶምሶማ	ሶምሶ፟ማ
ሸለለ	ሸለ፟ለ
ሸለመ	ሸለ፟መ
ሸለሸለ	ሸለሸ፟ለ
ሸለቀቀ	ሸለቀ፟ቀ
ሸለብ	ሸለ፟ብ፟
ሸለተ	ሸለ፟ተ
ሸለገ	ሸለ፟ገ
ሸላለመ	ሸላለ፟መ
ሸላሚ	ሸላ፟ሚ
ሸላች	ሸላ፟ች
ሸላይ	ሸላ፟ይ
ሸመቀ	ሸመ፟ቀ
ሸመቀቀ	ሸመቀ፟ቀ
ሸመተ	ሸመ፟ተ
ሸመታ	ሸመ፟ታ
ሸመደደ	ሸመደ፟ደ
ሸመድማዳ	ሸመድማዳ፟
ሸመገለ	ሸመገ፟ለ
ሸማቂ	ሸማ፟ቂ
ሸማች	ሸማ፟ች
ሸማኔ	ሸማ፟ኔ
ሸሜኔ	ሸሜ፟ኔ
ሸምቀቆ	ሸምቀቆ፟
ሸምቃቃ	ሸምቃቃ፟
ሸምበቆ	ሸምበቆ፟
ሸረሞጠ	ሸረሞ፟ጠ
ሸረሸረ	ሸረሸ፟ረ
ሸረኛ	ሸረ፟ኛ
ሸረኝነት	ሸረኝ፟ነ፟ት
ሸረከተ	ሸረከ፟ተ
ሸረካከተ	ሸረካከ፟ተ
ሸረደደ	ሸረደ፟ደ
ሸረፈ	ሸረ፟ፈ
ሸራረፈ	ሸራረ፟ፈ
ሸር	ሸር፟
ሸሻጊ	ሸሻ፟ጊ
ሸቀለ	ሸቀ፟ለ
ሸቀሸቀ	ሸቀሸ፟ቀ
ሸቀበ	ሸቀ፟በ
ሸቀጠ	ሸቀ፟ጠ
ሸቃቢ	ሸቃ፟ቢ
ሸቃይ	ሸቃ፟ይ
ሸቃጭ	ሸቃ፟ጭ
ሸበለለ	ሸበለ፟ለ
ሸበሸበ	ሸበሸ፟በ
ሸበበ	ሸበ፟በ
ሸበተ	ሸበ፟ተ
ሸበቶ	ሸበ፟ቶ
ሸብ	ሸብ፟
ሸብራቃ	ሸብራቃ፟
ሸተተ	ሸተ፟ተ
ሸተተው	ሸተ፟ተው
ሸተት	ሸተት፟
ሸተትያ	ሸተትያ፟
ሸነሸነ	ሸነሸ፟ነ
ሸነቀረ	ሸነ፟ቀ፟ረ
ሸነቀጠ	ሸነቀ፟ጠ
ሸነቆረ	ሸነቆ፟ረ
ሸነቆጠ	ሸነቆ፟ጠ
ሸነተረ	ሸነተ፟ረ
ሸነታተረ	ሸነታተ፟ረ
ሸነከፈ	ሸነከ፟ፈ
ሸነደረ	ሸነደ፟ረ
ሸነገለ	ሸነገ፟ለ
ሸነጠ	ሸነ፟ጠ
ሸና	ሸና፟
ሸንበቆ	ሸንበቆ፟
ሸንተረርማ	ሸንተረርማ፟
ሸንከሎ	ሸንከሎ፟
ሸንካፋ	ሸንካ፟ፋ
ሸንዳራ	ሸንዳራ፟
ሸኘ	ሸኘ፟
ሸኚ	ሸኚ፟
ሸከሸከ	ሸከሸ፟ከ
ሸከፈ	ሸከ፟ፈ
ሸካፋ	ሸካ፟ፋ
ሸኮተ	ሸኮ፟ተ
ሸውራራ	ሸውራ፟ራ
ሸውሻዋ	ሸውሻዋ፟
ሸየኛ	ሸየኛ፟
ሸጐረ	ሸጐ፟ረ
ሸጐጠ	ሸጐ፟ጠ
ሸጠኝ	ሸጠኝ፟
ሸፈተ	ሸፈ፟ተ
ሸፈነ	ሸፈ፟ነ
ሸፈጠ	ሸፈ፟ጠ
ሸፈፈ	ሸፈ፟ፈ
ሸፋጭ	ሸፋ፟ጭ
ሸፋፈነ	ሸፋፈ፟ነ
ሸፍጠኛ	ሸፍጠኛ፟
ሹሩባ	ሹሩ፟ባ፟
ሹራብ	ሹራ፟ብ
ሹርቤ	ሹርቤ፟
ሹካ	ሹካ፟
ሹክ	ሹክ፟
ሹክክ	ሹክክ፟
ሺህኛ	ሺህኛ፟
ሻምበል	ሻምበል፟
ሻቀለ	ሻቀ፟ለ
ሻንቅላ	ሻንቅላ፟
ሻኛ	ሻኛ፟
ሻከረ	ሻከ፟ረ
ሻከር	ሻከር፟
ሻገተ	ሻገ፟ተ
ሻግያ	ሻግያ፟
ሻፈደ	ሻፈ፟ደ
ሽለላ	ሽለ፟ላ
ሽልማት	ሽል፟ማት
ሽልም	ሽል፟ም
ሽልት	ሽል፟ት
ሽልግ	ሽል፟ግ
ሽልጦ	ሽል፟ጦ
ሽመቃ	ሽመ፟ቃ
ሽሚያ	ሽሚ፟ያ
ሽማግሌ	ሽማግሌ፟
ሽምብራ	ሽምብራ፟
ሽምግልና	ሽምግል፟ና
ሽር	ሽር፟
ሽርሙጥና	ሽርሙጥና፟
ሽርሽር	ሽር፟ሽር፟
ሽርክና	ሽርክና፟
ሽርጥ	ሽር፟ጥ
ሽርፋት	ሽር፟ፋት
ሽሽት	ሽሽ፟ት
ሽሽግ	ሽሽ፟ግ
ሽቀላ	ሽቀ፟ላ
ሽቀባ	ሽቀ፟ባ
ሽቅብ	ሽቅ፟ብ
ሽብልቅ	ሽብል፟ቅ
ሽብር	ሽብ፟ር
ሽቱ	ሽቱ፟
ሽታ	ሽታ፟
ሽታው	ሽታ፟ው
ሽቶ	ሽቶ፟
ሽንፍላ	ሽንፍላ፟
ሽክ	ሽክ፟
ሽክና	ሽክ፟ና
ሽክፍ	ሽክ፟ፍ
ሽኮኮ	ሽኮኮ፟
ሽው	ሽው፟
ሽውታ	ሽው፟ታ
ሽያጭ	ሽያ፟ጭ
ሽጉር	ሽጉ፟ር
ሽጉጥ	ሽጉ፟ጥ፟
ሽፋች	ሽፋ፟ች
ሽፍ	ሽፍ፟
ሽፍታ	ሽፍ፟ታ
ሽፍትነት	ሽፍትነ፟ት
ሽፍን	ሽፍ፟ን
ሾለከ	ሾለ፟ከ፟
ሾላካ	ሾላ፟ካ
ሾከከ	ሾከ፟ከ
ሾጥ	ሾጥ፟
ቀለለ	ቀለ፟ለ
ቀለል	ቀለል፟
ቀለመ	ቀለ፟መ
ቀለሰ	ቀለ፟ሰ
ቀለበ	ቀለ፟በ
ቀለበሰ	ቀለበ፟ሰ
ቀለብ	ቀለ፟ብ
ቀለብላባ	ቀለብላ፟ባ
ቀለብተኛ	ቀለ፟ብተኛ፟
ቀለደ	ቀለ፟ደ
ቀለጠ	ቀለ፟ጠ
ቀላ	ቀላ፟
ቀላለሰ	ቀላለ፟ሰ
ቀላለደ	ቀላለ፟ደ
ቀላል	ቀላ፟ል
ቀላመደ	ቀላመ፟ደ
ቀላማጅነት	ቀላማጅ፟ነ፟ት
ቀላቢ	ቀላ፟ቢ
ቀላወጠ	ቀላወ፟ጠ
ቀላጅ	ቀላ፟ጅ
ቀልማዳ	ቀልማዳ፟
ቀልቃላ	ቀልቃላ፟
ቀልደኛ	ቀልደኛ፟
ቀልጠፍ	ቀልጠፍ፟
ቀልጣፋ	ቀልጣፋ፟
ቀመለ	ቀመ፟ለ
ቀመመ	ቀመ፟መ
ቀመሰ	ቀመ፟ሰ
ቀመስ	ቀመ፟ስ
ቀመቀመ	ቀመቀ፟መ
ቀማ	ቀማ፟
ቀማመሰ	ቀማመ፟ሰ
ቀማሚ	ቀማ፟ሚ
ቀማኛ	ቀማ፟ኛ፟
ቀሠረ	ቀሠ፟ረ
ቀሠፈ	ቀሠ፟ፈ
ቀረ	ቀረ፟
ቀረረ	ቀረ፟ረ
ቀረሽ	ቀረ፟ሽ
ቀረቀረ	ቀረቀ፟ረ
ቀረቀበ	ቀረቀ፟በ
ቀረበ	ቀረ፟በ
ቀረና	ቀረና፟
ቀረደደ	ቀረደ፟ደ
ቀረጠ	ቀረ፟ጠ
ቀረጸ	ቀረ፟ጸ
ቀረፈ	ቀረ፟ፈ
ቀራረመ	ቀራረ፟መ
ቀራረፈ	ቀራረ፟ፈ
ቀር	ቀር፟
ቀርፋፋ	ቀርፋፋ፟
ቀሰመ	ቀሰ፟መ
ቀሰረ	ቀሰ፟ረ
ቀሰሰ	ቀሰ፟ሰ
ቀሰስተኛ	ቀሰስተኛ፟
ቀሰስተኛነት	ቀሰስተኛ፟ነ፟ት
ቀሰቀሰ	ቀሰቀ፟ሰ
ቀሰተ	ቀሰ፟ተ
ቀሳሰመ	ቀሳሰ፟መ
ቀሳፈተ	ቀሳፈ፟ተ
ቀስ	ቀስ፟
ቀስተኛ	ቀስተኛ፟
ቀስታ	ቀስ፟ታ
ቀቀለ	ቀቀ፟ለ
ቀቃይ	ቀቃ፟ይ
ቀበሌኛ	ቀበሌኛ፟
ቀበቀበ	ቀበቀ፟በ
ቀበተተ	ቀበተ፟ተ
ቀበቶ	ቀበቶ፟
ቀበኛ	ቀበኛ፟
ቀበዝባዛ	ቀበዝባዛ፟
ቀበጠ	ቀበ፟ጠ
ቀባ	ቀባ፟
ቀባባ	ቀባባ፟
ቀባጀረ	ቀባጀ፟ረ
ቀብራራ	ቀብራራ፟
ቀብቃባ	ቀብቃባ፟
ቀተረ	ቀተ፟ረ
ቀነሰ	ቀነ፟ሰ
ቀነቀነ	ቀነቀ፟ነ
ቀነበረ	ቀነበ፟ረ
ቀነተ	ቀነ፟ተ
ቀነዘረ	ቀነዘ፟ረ
ቀነደበ	ቀነደ፟በ
ቀነፈ	ቀነ፟ፈ
ቀና	ቀና፟
ቀናተኛ	ቀና፟ተኛ፟
ቀናነሰ	ቀናነ፟ሰ
ቀን	ቀን፟
ቀንደኛ	ቀንደኛ፟
ቀኖና	ቀኖ፟ና
ቀኛዝማች	ቀኛ፟ዝማች
ቀኝ	ቀኝ፟
ቀውላላ	ቀውላላ፟
ቀዘቀዘ	ቀዘቀ፟ዘ
ቀዘቀዘው	ቀዘቀ፟ዘው
ቀዘነ	ቀዘ፟ነ
ቀዘዘ	ቀዘ፟ዘ
ቀዘፈ	ቀዘ፟ፈ
ቀዝቃዛ	ቀዝቃዛ፟
ቀዥቃዣ	ቀዥቃዣ፟
ቀየሠ	ቀየ፟ሠ
ቀየረ	ቀየ፟ረ
ቀየደ	ቀየ፟ደ
ቀየጠ	ቀየ፟ጠ
ቀያሽ	ቀያ፟ሽ
ቀያቴ	ቀያ፟ቴ
ቀያየረ	ቀያየ፟ረ
ቀያየጠ	ቀያየ፟ጠ
ቀይ	ቀይ፟
ቀደመ	ቀደ፟መ
ቀደምትነት	ቀደ፟ምትነ፟ት
ቀደሰ	ቀደ፟ሰ
ቀደደ	ቀደ፟ደ
ቀዳሚነት	ቀዳሚነ፟ት
ቀዳሽ	ቀዳ፟ሽ
ቀዶ	ቀዶ፟
ቀጠቀጠ	ቀጠቀ፟ጠ
ቀጣፊነት	ቀጣፊነ፟ት
ቀጨቀጨ	ቀጨቀ፟ጨ
ቀፈረረ	ቀፈረ፟ረ
ቀፈቀፈ	ቀፈቀ፟ፈ
ቀፈደደ	ቀፈደ፟ደ
ቀፈፈ	ቀፈ፟ፈ
ቀፍራራ	ቀፍራ፟ራ
ቁለላ	ቁለ፟ላ
ቁሌት	ቁሌ፟ት
ቁልም	ቁልም፟
ቁልፍ	ቁል፟ፍ፟
ቁማርተኛ	ቁማርተኛ፟
ቁማጭ	ቁማ፟ጭ
ቁምጥ	ቁም፟ጥ፟
ቁምጥና	ቁምጥና፟
ቁራሽ	ቁራ፟ሽ
ቁራኛ	ቁራኛ፟
ቁራጭ	ቁራ፟ጭ
ቁር	ቁር፟
ቁርጥምጥም	ቁርጥምጥም፟
ቁስለኛ	ቁስለኛ፟
ቁቅ	ቁቅ፟
ቁና	ቁና፟
ቁንን	ቁን፟ን
ቁንጅና	ቁንጅና፟
ቁጥር	ቁጥ፟ር
ቁፈራ	ቁፈ፟ራ
ቁፋሪ	ቁፋ፟ሪ
ቁፋሮ	ቁፋ፟ሮ
ቁፍር	ቁፍ፟ር
ቂመኛ	ቂመኛ፟
ቂጥኝ	ቂጥኝ፟
ቃልቻ	ቃል፟ቻ፟
ቃረመ	ቃረ፟መ
ቃሬ	ቃሬ፟
ቃበዘ	ቃበ፟ዘ
ቃተተ	ቃተ፟ተ
ቃኘ	ቃኘ፟
ቃዠ	ቃዠ፟
ቄንጠኛ	ቄንጠኛ፟
ቅሌተኛ	ቅሌ፟ተኛ፟
ቅሌታም	ቅሌ፟ታም
ቅሌት	ቅሌ፟ት
ቅልሽስሽ	ቅልሽስሽ፟
ቅልቅል	ቅልቅ፟ል
ቅልብ	ቅል፟ብ
ቅልጥ	ቅል፟ጥ፟
ቅልጥፍና	ቅልጥፍና፟
ቅልጥፍጥፍ	ቅልጥፍ፟ጥፍ
ቅመማ	ቅመ፟ማ
ቅሚያ	ቅሚ፟ያ
ቅምምጦሽ	ቅምም፟ጦሽ
ቅምብቻ	ቅምብቻ፟
ቅምጥ	ቅም፟ጥ
ቅሥር	ቅሥ፟ር
ቅሪላ	ቅሪላ፟
ቅሪት	ቅሪ፟ት
ቅራሪ	ቅራ፟ሪ
ቅራፊ	ቅራ፟ፊ
ቅሬታ	ቅሬ፟ታ
ቅር	ቅር፟
ቅርጥፍ	ቅርጥፍ፟
ቅርፊት	ቅርፊት፟
ቅርፍፍ	ቅርፍፍ፟
ቅስት	ቅስ፟ት
ቅስና	ቅስ፟ና፟
ቅቅል	ቅቅ፟ል
ቅበላ	ቅበ፟ላ
ቅባቅዱስ	ቅባቅዱ፟ስ
ቅብብል	ቅብብ፟ል
ቅብብሎሽ	ቅብብ፟ሎሽ
ቅነሳ	ቅነ፟ሳ
ቅናሽ	ቅና፟ሽ
ቅንብር	ቅንብ፟ር
ቅንነት	ቅንነ፟ት
ቅንዝረኛ	ቅንዝረኛ፟
ቅንዲላ	ቅንዲላ፟
ቅንፍ	ቅን፟ፍ
ቅኝ	ቅኝ፟
ቅኝት	ቅኝ፟ት
ቅዝቃዜ	ቅዝቃ፟ዜ
ቅዝዝ	ቅዝ፟ዝ
ቅዥቅዥ	ቅዥቅዥ፟
ቅየሣ	ቅየ፟ሣ
ቅያሜ	ቅያ፟ሜ
ቅያሪ	ቅያ፟ሪ
ቅይድ	ቅይ፟ድ
ቅይጥ	ቅይ፟ጥ
ቅዱሳን	ቅዱ፟ሳን
ቅዱስ	ቅዱ፟ስ
ቅዱስነት	ቅዱ፟ስነ፟ት
ቅዳሴ	ቅዳ፟ሴ
ቅዳጅ	ቅዳ፟ጅ
ቅድ	ቅድ፟
ቅድም	ቅድ፟ም
ቅድሳት	ቅድ፟ሳት
ቅድስተ	ቅድ፟ስተ
ቅድስት	ቅድ፟ስት
ቅድስና	ቅድ፟ስና
ቅጅ	ቅጅ፟
ቅጠልያ	ቅጠልያ፟
ቅጥረኛ	ቅጥረኛ፟
ቅጥቃጤ	ቅጥቃ፟ጤ
ቅፍር	ቅፍር፟
ቅፍርር	ቅፍርር፟
ቆለለ	ቆለ፟ለ
ቆለመመ	ቆለመ፟መ
ቆለኛ	ቆለ፟ኛ፟
ቆላ	ቆላ፟
ቆሌ	ቆሌ፟
ቆልማማ	ቆልማማ፟
ቆልቋላ	ቆልቋላ፟
ቆመጠ	ቆመ፟ጠ
ቆም	ቆም፟
ቆራረሰ	ቆራረ፟ሰ
ቆራጥ	ቆራ፟ጥ
ቆርቆሮ	ቆርቆሮ፟
ቆርጦኝ	ቆርጦኝ፟
ቆሸሸ	ቆሸ፟ሸ
ቆሽማዳ	ቆሽማዳ፟
ቆነጀ	ቆነጀ፟
ቆነጣጠረ	ቆነጣ፟ጠ፟ረ
ቆየ	ቆየ፟
ቆይታ	ቆይ፟ታ
ቆጠቆጠ	ቆጠቆ፟ጠ
ቆጶስ	ቆጶ፟ስ
ቆፈረ	ቆፈ፟ረ
ቆፈነነ	ቆፈነ፟ነ
ቆፋሪ	ቆፋ፟ሪ
ቆፋፈረ	ቆፋፈ፟ረ
ቈለመመ	ቈለመ፟መ
ቈለቈለ	ቈለቈ፟ለ
ቈለፈ	ቈለ፟ፈ
ቈላለፈ	ቈላለ፟ፈ
ቈላፋ	ቈላ፟ፋ፟
ቈላፍ	ቈላ፟ፍ
ቈረመደ	ቈረመ፟ደ
ቈረሰ	ቈረ፟ሰ
ቈረቈረ	ቈረቈ፟ረ
ቈረቈሰ	ቈረቈ፟ሰ
ቈረበ	ቈረ፟በ
ቈረጠ	ቈረ፟ጠ
ቈረፈደ	ቈረፈ፟ደ
ቈራ	ቈራ፟
ቈራረጠ	ቈራረ፟ጠ
ቈራጥ	ቈራ፟ጥ
ቈርማዳ	ቈርማዳ፟
ቈርቈዘ	ቈርቈ፟ዘ
ቈርቋዛ	ቈርቋ፟ዛ
ቈርፋዳ	ቈርፋዳ፟
ቈሰለ	ቈሰ፟ለ
ቈሰቈሰ	ቈሰቈ፟ሰ
ቈነሰ	ቈነ፟ሰ
ቈነነ	ቈነ፟ነ
ቈነደደ	ቈነደ፟ደ
ቈነጐለ	ቈነጐ፟ለ
ቈንቋና	ቈንቋና፟
ቋመጠ	ቋመ፟ጠ
ቋቅ	ቋቅ፟
ቋቅታ	ቋቅ፟ታ፟
ቋቍቻ	ቋቍ፟ቻ፟
ቋያ	ቋያ፟
ቋጥኝ	ቋጥ፟ኝ፟
ቍልጭ	ቍል፟ጭ፟
ቍራጭ	ቍራ፟ጭ
ቍርጥ	ቍር፟ጥ
ቍስለ	ቍስለ፟
በለቀጠ	በለቀ፟ጠ
በለተ	በለ፟ተ
በለኝ	በለኝ፟
በለዘ	በለ፟ዘ
በለገ	በለ፟ገ
በለጠ	በለ፟ጠ
በሉጥ	በሉ፟ጥ
በሊታ	በሊ፟ታ
በላ	በላ፟
በሌለበት	በሌለ፟በት
በል	በል፟
በመጀመሪያው	በመጀመ፟ሪያው
በሞላ	በሞላ፟
በረሃማ	በረሃማ፟
በረረ	በረ፟ረ
በረቀ	በረ፟ቀ
በረቀሰ	በረቀ፟ሰ
በረቃቀሰ	በረቃቀ፟ሰ
በረበረ	በረበ፟ረ
በረታ	በረታ፟
በረኛ	በረ፟ኛ፟
በረከተ	በረከ፟ተ
በረኸኛ	በረኸኛ፟
በረዘ	በረ፟ዘ
በረደ	በረ፟ደ
በረደኝ	በረ፟ደኝ፟
በረገደ	በረገ፟ደ
በረገገ	በረገ፟ገ
በረጋገደ	በረጋገ፟ደ
በራ	በራ፟
በራረዘ	በራረ፟ዘ
በራዥ	በራ፟ዥ
በራድ	በራ፟ድ
በራፍ	በራ፟ፍ
በር	በር፟
በርበሬ	በርበሬ፟
በርካታ	በርካታ፟
በርዳማ	በርዳማ፟
በርጩማ	በርጩማ፟
በሰለ	በሰ፟ለ
በሰበሰ	በሰበ፟ሰ
በሰፊው	በሰፊ፟ው
በሳ	በሳ፟
በሳል	በሳ፟ል
በስባሳ	በስባሳ፟
በሶ	በሶ፟
በሸቀ	በሸ፟ቀ
በሸቀጠ	በሸቀ፟ጠ
በሽተኛ	በሽ፟ተኛ፟
በሽታ	በሽ፟ታ
በቀለ	በቀ፟ለ
በቀለኛ	በቀለኛ፟
በቀል	በቀ፟ል
በቀስ	በቀስ፟
በቀስታ	በቀስ፟ታ
በቀተ	በቀ፟ተ
በቀደም	በቀደ፟ም
በቃ	በቃ፟
በቃኝ	በቃ፟ኝ
በቅበቃ	በቅበቃ፟
በቆሎ	በቆ፟ሎ፟
በቈልት	በቈ፟ልት
በቡጢ	በቡጢ፟
በተለይ	በተለይ፟
በተረፈ	በተረ፟ፈ
በተነ	በተ፟ነ
በተጨማሪ	በተጨማ፟ሪ
በታተነ	በታተ፟ነ
በትር	በት፟ር
በነነ	በነ፟ነ
በአጋጣሚ	በአጋጣ፟ሚ
በከለ	በከ፟ለ
በከተ	በከ፟ተ
በኩል	በኩ፟ል
በካይ	በካ፟ይ
በወዘ	በወ፟ዘ
በዘበዘ	በዘበ፟ዘ
በዚህ	በዚ፟ህ
በዚህም	በዚህም፟
በዚያ	በዚ፟ያ
በዛ	በዛ፟
በየሰዓቱ	በየ፟ሰዓቱ
በየቀኑ	በየ፟ቀኑ
በየተራ	በየ፟ተራ
በየነ	በየ፟ነ
በየወቅቱ	በየ፟ወቅቱ
በየዓመቱ	በየ፟ዓመቱ
በየደ	በየ፟ደ
በየጊዜው	በየ፟ጊዜው
በየግል	በየ፟ግል፟
በየፊናው	በየ፟ፊናው
በያለበት	በያ፟ለ፟በ፟ት
በያኝ	በያ፟ኝ፟
በያጅ	በያ፟ጅ
በደለ	በደ፟ለ
በደለኛ	በደለኛ፟
በደል	በደ፟ል
በደዊ	በደዊ፟
በዱላ	በዱላ፟
በዳ	በዳ፟
በዳይ	በዳ፟ይ
በድጋሚ	በድጋ፟ሚ
በጀ	በጀ፟
በጅምር	በጅም፟ር
በገነ	በገ፟ነ
በገዛ	በገዛ፟
በግላጭ	በግላ፟ጭ
በግል	በግል፟
በግምት	በግም፟ት
በግድ	በግድ፟
በጐ	በጐ፟
በጐነት	በጐ፟ነ፟ት
በጠቅላላ	በጠቅላላ፟
በጠቅላላው	በጠቅላላ፟ው
በጠበጠ	በጠበ፟ጠ
በጡጫ	በጡጫ፟
በጥሞና	በጥሞ፟ና
በጥያቄ	በጥያ፟ቄ
በጥፊ	በጥፊ፟
በጭራሽ	በጭራ፟ሽ
በጭካኔ	በጭካ፟ኔ
በጭፍን	በጭፍ፟ን
ቡላ	ቡላ፟
ቡልቅ	ቡል፟ቅ፟
ቡልቅታ	ቡል፟ቅታ
ቡረቃ	ቡረ፟ቃ
ቡራቡሬ	ቡራ፟ቡሬ፟
ቡራኬ	ቡራ፟ኬ
ቡሬ	ቡሬ፟
ቡሬማ	ቡሬ፟ማ፟
ቡቃያ	ቡቃያ፟
ቡቡ	ቡቡ፟
ቡትርፍ	ቡትርፍ፟
ቡችላ	ቡች፟ላ፟
ቡና	ቡና፟
ቡናማ	ቡና፟ማ፟
ቡናኝ	ቡና፟ኝ
ቡን	ቡን፟
ቡንኝ	ቡን፟ኝ፟
ቡዳነት	ቡዳነ፟ት
ቡድስ	ቡድ፟ስ
ቡድነት	ቡድነ፟ት
ቡግ	ቡግ፟
ቡፍ	ቡፍ፟
ቢሆንም	ቢሆንም፟
ቢላዋ	ቢላ፟ዋ
ቢላዎ	ቢላ፟ዎ
ቢል	ቢል፟
ቢልቢላ	ቢልቢላ፟
ቢራቢሮ	ቢራ፟ቢሮ፟
ቢዘገይም	ቢዘገይ፟ም
ባለሥልጣኖች	ባለሥልጣኖች፟
ባለሳምንት	ባለሳም፟ንት
ባለስድስት	ባለስድ፟ስት
ባለብር	ባለብር፟
ባለእጅ	ባለእጅ፟
ባለጅ	ባለጅ፟
ባለገ	ባለ፟ገ
ባለጉዳይ	ባለጉዳ፟ይ
ባለጌነት	ባለጌነ፟ት
ባለጠጋ	ባለጠጋ፟
ባለጥግ	ባለጥግ፟
ባለፀጋ	ባለፀጋ፟
ባላ	ባላ፟
ባላባት	ባላባ፟ት
ባላባትነት	ባላባ፟ትነ፟ት
ባላንጣነት	ባላንጣነ፟ት
ባልትና	ባልትና፟
ባልና	ባልና፟
ባልንጀርነት	ባልንጀርነ፟ት
ባልጩት	ባልጩት፟
ባረቀ	ባረ፟ቀ
ባረከ	ባረ፟ከ
ባርማሽላ	ባርማሽላ፟
ባርነት	ባርነ፟ት
ባሻ	ባሻ፟
ባባ	ባባ፟
ባነነ	ባነ፟ነ
ባንድነት	ባንድነ፟ት
ባኞ	ባኞ፟
ባከነ	ባከ፟ነ
ባዘቀ	ባዘ፟ቀ
ባዘተ	ባዘ፟ተ
ቤተኛ	ቤተኛ፟
ቤዛ	ቤዛ፟
ብላታ	ብላታ፟
ብላቴና	ብላቴ፟ና
ብላቴን	ብላቴ፟ን
ብላጊ	ብላ፟ጊ
ብልሃተኛ	ብልሃተኛ፟
ብልሹ	ብልሹ፟
ብልት	ብል፟ት
ብልኮ	ብል፟ኮ፟
ብልዝ	ብል፟ዝ፟
ብልግ	ብል፟ግ፟
ብልግና	ብልግና፟
ብልጥግና	ብልጥግ፟ና፟
ብልጫ	ብል፟ጫ
ብልጭ	ብል፟ጭ
ብልጭታ	ብል፟ጭታ
ብልፅግና	ብልፅግ፟ና፟
ብሎት	ብሎ፟ት
ብሔረተኛ	ብሔረተኛ፟
ብሕትውና	ብሕትውና፟
ብረድስት	ብረድ፟ስት
ብራ	ብራ፟
ብራቢሮ	ብራቢሮ፟
ብራና	ብራና፟
ብራኳ	ብራኳ፟
ብር	ብር፟
ብርሌ	ብርሌ፟
ብርቅስቅስ	ብርቅስቅ፟ስ
ብርኩማ	ብርኩማ፟
ብርካቴ	ብርካ፟ቴ
ብርግድ	ብርግድ፟
ብርጭቆ	ብርጭቆ፟
ብስባሽ	ብስባ፟ሽ
ብስጭትጭት	ብስጭትጭ፟ት
ብቁነት	ብቁ፟ነ፟ት
ብቅ	ብቅ፟
ብቡ	ብቡ፟
ብብት	ብብ፟ት
ብትቶ	ብትቶ፟
ብትቷም	ብትቷ፟ም
ብትን	ብት፟ን
ብቸኛ	ብቸ፟ኛ፟
ብቸኝነት	ብቸ፟ኝ፟ነ፟ት
ብቻ	ብቻ፟
ብናኝ	ብና፟ኝ፟
ብኩርና	ብኩርና፟
ብኩንነት	ብኩንነ፟ት
ብካች	ብካ፟ች
ብክል	ብክ፟ል
ብክት	ብክ፟ት
ብው	ብው፟
ብየዳ	ብየ፟ዳ፟
ብያኔ	ብያ፟ኔ
ብዬ	ብዬ፟
ብይ	ብይ፟
ብይን	ብይ፟ን
ብይድ	ብይ፟ድ
ብድር	ብድ፟ር
ብድግ	ብድግ፟
ብጥብጥ	ብጥብ፟ጥ
ቦሎቄ	ቦሎ፟ቄ
ቦረቀ	ቦረ፟ቀ
ቦረቦረ	ቦረቦ፟ረ
ቦራቂ	ቦራ፟ቂ
ቦርቃቃ	ቦርቃቃ፟
ቦቃማ	ቦቃማ፟
ቦተረፈ	ቦተረ፟ፈ
ቦታ	ቦታ፟
ቦነነ	ቦነ፟ነ
ቦከቦከ	ቦከቦ፟ከ
ቦካ	ቦካ፟
ቦዘነ	ቦዘ፟ነ
ቦዘንተኛ	ቦዘንተኛ፟
ቦደሰ	ቦደ፟ሰ
ቦግ	ቦግ፟
ቦግታ	ቦግ፟ታ
ቦጨቅ	ቦጨ፟ቅ
ቦጫጨረ	ቦጫ፟ጨረ
ቦጭ	ቦጭ፟
ቧገተ	ቧገ፟ተ
ተለመ	ተለ፟መ
ተለመለመ	ተለመለ፟መ
ተለመሰሰ	ተለመሰ፟ሰ
ተለመነ	ተለመ፟ነ
ተለመዘገ	ተለመዘ፟ገ
ተለመደ	ተለመ፟ደ
ተለመጠ	ተለመ፟ጠ
ተለማመነ	ተለማመ፟ነ
ተለማመደ	ተለማመ፟ደ
ተለማመጠ	ተለማመ፟ጠ
ተለማኝ	ተለማ፟ኝ
ተለማጅ	ተለማ፟ጅ
ተለማጭ	ተለማ፟ጭ
ተለሰነ	ተለሰ፟ነ
ተለሳለሰ	ተለሳለ፟ሰ
ተለቀ	ተለ፟ቀ
ተለቀለቀ	ተለቀለ፟ቀ
ተለቀመ	ተለቀ፟መ
ተለቀቀ	ተለ፟ቀ፟ቀ
ተለቃለቀ	ተለቃለ፟ቀ
ተለበለበ	ተለበለ፟በ
ተለበቀ	ተለበ፟ቀ
ተለበበ	ተለበ፟በ
ተለበደ	ተለበ፟ደ
ተለበጠ	ተለበ፟ጠ
ተለባቂ	ተለባ፟ቂ
ተለባበሰ	ተለባበ፟ሰ
ተለተለ	ተለተ፟ለ
ተለተመ	ተለተ፟መ
ተለወጠ	ተለወ፟ጠ
ተለዋወጠ	ተለዋወ፟ጠ
ተለዋጭ	ተለዋ፟ጭ
ተለየ	ተለየ፟
ተለያየ	ተለያየ፟
ተለጠለጠ	ተለጠለ፟ጠ
ተለፈፈ	ተለፈ፟ፈ
ተለፋለፈ	ተለፋለ፟ፈ
ተለፋላፊ	ተለፋላ፟ፊ
ተላ	ተላ፟
ተላለቀ	ተላለ፟ቀ
ተላለፈ	ተላለ፟ፈ
ተላላኪነት	ተላላኪነ፟ት
ተላላፊ	ተላላ፟ፊ
ተላመደ	ተላመ፟ደ
ተላመጠ	ተላመ፟ጠ
ተላቀሰ	ተላቀ፟ሰ
ተላቀቀ	ተላቀ፟ቀ
ተላከከ	ተላከ፟ከ
ተላወሰ	ተላወሰ፟
ተላፋ	ተላፋ፟
ተልከስከሰ	ተልከስከ፟ሰ
ተልከፈከፈ	ተልከፈከ፟ፈ
ተልካሳ	ተልካሳ፟
ተልፈሰፈሰ	ተልፈሰፈ፟ሰ
ተመለሰ	ተመለ፟ሰ
ተመለከ	ተመለ፟ከ
ተመለከተ	ተመለከ፟ተ
ተመለጠ	ተመለ፟ጠ
ተመላለሰ	ተመላለ፟ሰ
ተመላለጠ	ተመላለ፟ጠ
ተመላሽ	ተመላ፟ሽ
ተመላኪ	ተመላ፟ኪ
ተመመ	ተመ፟መ
ተመሠረተ	ተመሠ፟ረተ
ተመሠጠ	ተመ፟ሠ፟ጠ
ተመሥጦ	ተመሥ፟ጦ
ተመረመረ	ተመረመ፟ረ
ተመረረ	ተመረ፟ረ
ተመረቀ	ተመረ፟ቀ
ተመረኰዘ	ተመረኰ፟ዘ
ተመረዘ	ተመረ፟ዘ
ተመረገ	ተመረ፟ገ
ተመረጠ	ተመረ፟ጠ
ተመራ	ተመራ፟
ተመራመረ	ተመራመ፟ረ
ተመራቂ	ተመራ፟ቂ
ተመራጭ	ተመራ፟ጭ
ተመራጭነት	ተመራ፟ጭነ፟ት
ተመሰለ	ተመሰ፟ለ
ተመሰቃቀለ	ተመሰቃቀ፟ለ
ተመሰከረ	ተመሰከ፟ረ
ተመሰገነ	ተመሰገ፟ነ
ተመሰጠ	ተመሰ፟ጠ
ተመሳቀለ	ተመሳቀ፟ለ
ተመሳከረ	ተመሳከ፟ረ
ተመተመ	ተመተ፟መ
ተመተረ	ተመተ፟ረ
ተመታ	ተመታ፟
ተመቸ	ተመቸ፟
ተመቻቸ	ተመቻቸ፟
ተመነ	ተመ፟ነ
ተመነቃቀረ	ተመነቃቀ፟ረ
ተመነተፈ	ተመነተ፟ፈ
ተመነዘረ	ተመነዘ፟ረ
ተመናቀረ	ተመናቀ፟ረ
ተመኘ	ተመኘ፟
ተመከረ	ተመከ፟ረ
ተመከተ	ተመከ፟ተ
ተመካ	ተመካ፟
ተመካከረ	ተመካከ፟ረ
ተመዘመዘ	ተመዘመ፟ዘ
ተመዘበረ	ተመዘበ፟ረ
ተመዘነ	ተመዘ፟ነ
ተመዘዘ	ተመዘ፟ዘ
ተመዘገበ	ተመዘገ፟በ
ተመዛዘነ	ተመዛዘ፟ነ
ተመደበ	ተመደ፟በ
ተመገበ	ተመገ፟በ
ተመጋቢ	ተመጋ፟ቢ፟
ተመጠወተ	ተመጠወ፟ተ
ተመጻደቀ	ተመጻደ፟ቀ
ተማለደ	ተማለ፟ደ
ተማመነ	ተማመ፟ነ
ተማማ	ተማማ፟
ተማረረ	ተማረ፟ረ
ተማረከ	ተማረ፟ከ
ተማረዘ	ተማረ፟ዘ
ተማራ	ተማራ፟
ተማሰለ	ተማሰ፟ለ
ተማታ	ተማታ፟
ተማከረ	ተማከ፟ረ
ተማዘዘ	ተማዘ፟ዘ
ተማገረ	ተማገ፟ረ
ተማገደ	ተማገ፟ደ
ተምቦጫቦጨ	ተምቦጫቦ፟ጨ
ተምታታ	ተምታታ፟
ተምነሸነሸ	ተምነሸነ፟ሸ
ተምዘአዘገ	ተምዘአዘ፟ገ
ተምዘገዘገ	ተምዘገዘ፟ገ
ተሞለጨ	ተሞለ፟ጨ
ተሞላ	ተሞላ፟
ተሞላቀቀ	ተሞላቀ፟ቀ
ተሞላፈጠ	ተሞላፈ፟ጠ
ተሞረደ	ተሞረ፟ደ
ተሞሸለቀ	ተሞሸለ፟ቀ
ተሞሸረ	ተሞሸ፟ረ
ተሞከረ	ተሞከ፟ረ
ተሞከተ	ተሞከ፟ተ
ተሞካከረ	ተሞካከ፟ረ
ተሞክሮ	ተሞክ፟ሮ
ተሞጀረ	ተሞጀ፟ረ
ተሞገሰ	ተሞገ፟ሰ
ተሞጋሽ	ተሞጋ፟ሽ
ተሞጋገሰ	ተሞጋገ፟ሰ
ተሞጨለፈ	ተሞጨለ፟ፈ
ተሟላ	ተሟላ፟
ተሟሸ	ተሟሸ፟
ተሟከረ	ተሟከ፟ረ
ተሟገተ	ተሟገ፟ተ
ተሟጋች	ተሟጋ፟ች
ተሠረሠረ	ተሠረሠ፟ረ
ተሠረገ	ተሠረ፟ገ
ተሠቀሠቀ	ተሠቀሠ፟ቀ
ተሠወረ	ተሠወ፟ረ
ተሠዋሪ	ተሠዋ፟ሪ
ተሠየመ	ተሠየ፟መ
ተሣሠረ	ተሣሠ፟ረ
ተረማመደ	ተረማመ፟ደ
ተረሳ	ተረሳ፟
ተረሳሳ	ተረሳሳ፟
ተረበ	ተረ፟በ
ተረበረበ	ተረበረ፟በ
ተረበኛ	ተረበኛ፟
ተረባረበ	ተረባረ፟በ
ተረተ	ተረ፟ተ
ተረተረ	ተረተ፟ረ
ተረታ	ተረታ፟
ተረኛ	ተረኛ፟
ተረከበ	ተረከ፟በ
ተረከከ	ተረከ፟ከ
ተረካቢ	ተረካ፟ቢ
ተረካከበ	ተረካከ፟በ
ተረኰሰ	ተረኰ፟ሰ
ተረዳ	ተረዳ፟
ተረዳዳ	ተረዳዳ፟
ተረገመ	ተረገ፟መ
ተረገረገ	ተረገረ፟ገ
ተረገዘ	ተረገ፟ዘ
ተረገጠ	ተረገ፟ጠ
ተረጋጋ	ተረጋጋ፟
ተረጐመ	ተረጐ፟መ
ተረፈ	ተረ፟ፈ
ተራመደ	ተራመ፟ደ
ተራረመ	ተራረ፟መ
ተራረደ	ተራረ፟ደ
ተራራማ	ተራራማ፟
ተራቀቀ	ተራቀ፟ቀ
ተራቢ	ተራ፟ቢ
ተራባ	ተራባ፟
ተራች	ተራ፟ች
ተራኪ	ተራ፟ኪ
ተራኰተ	ተራኰ፟ተ
ተራገመ	ተራገ፟መ
ተራገጠ	ተራገ፟ጠ
ተራገፈ	ተራገ፟ፈ
ተርመሰመሰ	ተርመሰመ፟ሰ
ተርመጠመጠ	ተርመጠመ፟ጠ
ተርበተበተ	ተርበተበ፟ተ
ተርበደበደ	ተርበደበ፟ደ
ተርከፈከፈ	ተርከፈከ፟ፈ
ተርካካ	ተርካካ፟
ተርገበገበ	ተርገበገ፟በ
ተሰለለ	ተሰለ፟ለ
ተሰለቀ	ተሰለ፟ቀ
ተሰለበ	ተሰለ፟በ
ተሰለቸ	ተሰለቸ፟
ተሰለቻቸ	ተሰለቻቸ፟
ተሰለፈ	ተሰለ፟ፈ
ተሰላቸ	ተሰላቸ፟
ተሰላፊ	ተሰላ፟ፊ
ተሰሚነት	ተሰሚነ፟ት
ተሰማ	ተሰማ፟
ተሰማማ	ተሰማማ፟
ተሰረረ	ተሰረ፟ረ
ተሰረሰረ	ተሰረሰ፟ረ
ተሰረቀ	ተሰረ፟ቀ
ተሰረነቀ	ተሰረነ፟ቀ
ተሰረዘ	ተሰረ፟ዘ
ተሰረጐደ	ተሰረጐ፟ደ፟
ተሰራረቀ	ተሰራረ፟ቀ
ተሰቀለ	ተሰቀ፟ለ
ተሰቀቀ	ተሰቀ፟ቀ
ተሰቃየ	ተሰቃየ፟
ተሰቃይ	ተሰቃ፟ይ
ተሰበረ	ተሰበ፟ረ
ተሰበሰበ	ተሰበሰ፟በ
ተሰበከ	ተሰበ፟ከ
ተሰባሪ	ተሰባ፟ሪ
ተሰባበረ	ተሰባበ፟ረ
ተሰተረ	ተሰተ፟ረ
ተሰነቀ	ተሰነ፟ቀ
ተሰነቀረ	ተሰነቀ፟ረ
ተሰነቀረብኝ	ተሰነቀ፟ረብኝ፟
ተሰነባበተ	ተሰነባበ፟ተ
ተሰነከለ	ተሰነከ፟ለ
ተሰነዳዳ	ተሰነዳዳ፟
ተሰነገ	ተሰነ፟ገ
ተሰናበተ	ተሰናበ፟ተ
ተሰናከለ	ተሰናከ፟ለ
ተሰናዘረ	ተሰናዘ፟ረ
ተሰናዳ	ተሰናዳ፟
ተሰኘ	ተሰኘ፟
ተሰካ	ተሰካ፟
ተሰወጠ	ተሰወ፟ጠ
ተሰየፈ	ተሰየ፟ፈ
ተሰደበ	ተሰደ፟በ
ተሰደደ	ተሰደ፟ደ
ተሰዳደበ	ተሰዳደ፟በ
ተሰገሰገ	ተሰገሰ፟ገ
ተሳለመ	ተሳለ፟መ
ተሳለቀ	ተሳለ፟ቀ
ተሳረረ	ተሳ፟ረ፟ረ
ተሳረቀ	ተሳረ፟ቀ
ተሳሰበ	ተሳሰ፟በ
ተሳቀቀ	ተሳቀ፟ቀ
ተሳበበ	ተሳበ፟በ
ተሳተፈ	ተሳተ፟ፈ
ተሳከረ	ተሳከ፟ረ
ተሳካ	ተሳካ፟
ተሳደበ	ተሳደ፟በ
ተሳደደ	ተሳደ፟ደ
ተስለመለመ	ተስለመለ፟መ
ተስለከለከ	ተስለከለ፟ከ
ተስማማ	ተስማማ፟
ተስገበገበ	ተስገበገ፟በ
ተስፋፋ	ተስፋፋ፟
ተሸለመ	ተሸለ፟መ
ተሸለቀቀ	ተሸለቀ፟ቀ
ተሸለተ	ተሸለ፟ተ
ተሸላለመ	ተሸላለ፟መ
ተሸላሚ	ተሸላ፟ሚ
ተሸመቀቀ	ተሸመቀ፟ቀ
ተሸመተ	ተሸመ፟ተ
ተሸማቀቀ	ተሸማቀ፟ቀ
ተሸረሸረ	ተሸረሸ፟ረ
ተሸረከተ	ተሸረከ፟ተ
ተሸረካከተ	ተሸረካከ፟ተ
ተሸረፈ	ተሸረ፟ፈ
ተሸራረፈ	ተሸራረ፟ፈ
ተሸራፊ	ተሸራ፟ፊ
ተሸሸገ	ተሸሸ፟ገ
ተሸቀበ	ተሸቀ፟በ
ተሸበረ	ተሸበ፟ረ
ተሸበበ	ተሸበ፟በ
ተሸነሸነ	ተሸነሸ፟ነ
ተሸነተረ	ተሸነተ፟ረ
ተሸናነፈ	ተሸናነ፟ፈ
ተሸናፊ	ተሸና፟ፊ
ተሸኘ	ተሸኘ፟
ተሸከመ	ተሸከ፟መ
ተሸከሸከ	ተሸከሸ፟ከ
ተሸካሚ	ተሸካ፟ሚ
ተሸካከመ	ተሸካከ፟መ
ተሸጋሸገ	ተሸ፟ጋሸ፟ገ
ተሸጋገረ	ተሸጋገ፟ረ
ተሸጐረ	ተሸጐ፟ረ
ተሸጐጠ	ተሸጐ፟ጠ
ተሸፈነ	ተሸፈ፟ነ
ተሸፋፈነ	ተሸፋፈ፟ነ
ተሹለከለከ	ተሹለከለ፟ከ
ተሻማ	ተሻማ፟
ተሻረከ	ተሻረ፟ከ
ተሻሸ	ተሻሸ፟
ተሻኰተ	ተሻኰ፟ተ
ተሻገረ	ተሻገ፟ረ
ተሽመደመደ	ተሽመደመ፟ደ
ተሽቀዳደመ	ተሽቀዳደ፟መ
ተሽቆጠቆጠ	ተሽቆጠቆ፟ጠ
ተሽበለበለ	ተሽበለበ፟ለ
ተሽከረከረ	ተሽከረከ፟ረ
ተሽኮረመመ	ተሽኮረመ፟መ
ተቀለሰ	ተቀለ፟ሰ
ተቀለበ	ተቀለ፟በ
ተቀለበሰ	ተቀለበ፟ሰ
ተቀላ	ተቀላ፟
ተቀላለደ	ተቀላለ፟ደ
ተቀላቀለ	ተቀላቀ፟ለ
ተቀላቢ	ተቀላ፟ቢ
ተቀመለ	ተቀመ፟ለ
ተቀመመ	ተቀመ፟መ
ተቀመሰ	ተቀመ፟ሰ
ተቀመጠ	ተቀመ፟ጠ
ተቀማ	ተቀማ፟
ተቀማጭ	ተቀማ፟ጭ
ተቀረቀረ	ተቀረቀ፟ረ
ተቀረቀበ	ተቀረቀ፟በ
ተቀረደደ	ተቀረደ፟ደ
ተቀረጠ	ተቀረ፟ጠ
ተቀረጸ	ተቀረ፟ጸ
ተቀረፈ	ተቀረ፟ፈ
ተቀራረፈ	ተቀራረ፟ፈ
ተቀሰመ	ተቀሰ፟መ
ተቀሰረ	ተቀሰ፟ረ
ተቀሰቀሰ	ተቀሰቀ፟ሰ
ተቀሰተ	ተቀሰ፟ተ
ተቀቀለ	ተቀቀ፟ለ
ተቀበለ	ተቀበ፟ለ
ተቀበረ	ተቀበ፟ረ
ተቀበቀበ	ተቀበቀ፟በ
ተቀበተተ	ተቀበተ፟ተ
ተቀባ	ተቀባ፟
ተቀባበለ	ተቀባበ፟ለ
ተቀባይ	ተቀባ፟ይ
ተቀተረ	ተቀተ፟ረ
ተቀነሰ	ተቀነ፟ሰ
ተቀነባበረ	ተቀ፟ነባበ፟ረ
ተቀነፈ	ተቀነ፟ፈ
ተቀናሽ	ተቀና፟ሽ
ተቀናቀነ	ተቀናቀ፟ነ
ተቀናቃኝ	ተቀናቃኝ፟
ተቀናበረ	ተቀናበ፟ረ
ተቀናነሰ	ተቀናነ፟ሰ
ተቀናና	ተቀና፟ና
ተቀኘ	ተቀኘ፟
ተቀዘፈ	ተቀዘ፟ፈ
ተቀዛቀዘ	ተቀዛቀ፟ዘ
ተቀየመ	ተቀየ፟መ
ተቀየሠ	ተቀየ፟ሠ
ተቀየረ	ተቀየ፟ረ
ተቀየደ	ተቀየ፟ደ
ተቀየጠ	ተቀየ፟ጠ
ተቀደመ	ተቀደ፟መ
ተቀደሰ	ተቀደ፟ሰ
ተቀደደ	ተቀደ፟ደ
ተቀዳ	ተቀዳ፟
ተቀዳሚ	ተቀዳ፟ሚ
ተቀዳደመ	ተቀዳደ፟መ
ተቀዳደደ	ተቀዳደ፟ደ
ተቀዳጀ	ተቀዳጀ፟
ተቀጠቀጠ	ተቀጠቀ፟ጠ
ተቀፈረረ	ተቀፈረ፟ረ
ተቀፈቀፈ	ተቀፈቀ፟ፈ
ተቀፈደደ	ተቀፈደ፟ደ
ተቀፈፈ	ተቀፈ፟ፈ
ተቁለጨለጨ	ተቁለጨለ፟ጨ፟
ተቁነጠነጠ	ተቁነጠነ፟ጠ
ተቃለለ	ተቃለ፟ለ
ተቃለደ	ተቃለ፟ደ
ተቃመሰ	ተቃመ፟ሰ
ተቃማ	ተቃማ፟
ተቃረመ	ተቃረ፟መ
ተቃረበ	ተቃረ፟በ
ተቃረነ	ተቃረ፟ነ
ተቃቀፈ	ተቃቀ፟ፈ
ተቃባ	ተቃባ፟
ተቃና	ተቃና፟
ተቃኘ	ተቃኘ፟
ተቃወመ	ተቃወ፟መ
ተቃወሰ	ተቃወ፟ሰ
ተቅለሰለሰ	ተቅለሰለ፟ሰ
ተቅለበለበ	ተቅለበለ፟በ
ተቅለጠለጠ	ተቅለጠለ፟ጠ
ተቅበዘበዘ	ተቅበዘበ፟ዘ
ተቅነዘነዘ	ተቅነዘነ፟ዘ
ተቆለለ	ተቆለ፟ለ
ተቆላ	ተቆላ፟
ተቆረሰ	ተቆረ፟ሰ
ተቆረቆረ	ተቆረቆ፟ረ
ተቆረጠ	ተቆረ፟ጠ
ተቆራረሰ	ተቆራረ፟ሰ
ተቆራኘ	ተቆራኘ፟
ተቆፈረ	ተቆፈ፟ረ
ተቈለመመ	ተቈለመ፟መ
ተቈለፈ	ተቈለ፟ፈ
ተቈረቈረ	ተቈረቈ፟ረ
ተቈረጠ	ተቈረ፟ጠ
ተቈራ	ተቈራ፟
ተቈራመደ	ተቈራመ፟ደ
ተቈራረጠ	ተቈራረ፟ጠ
ተቈራቈሰ	ተቈራቈ፟ሰ
ተቈራጭ	ተቈራ፟ጭ
ተቈሰቈሰ	ተቈሰቈ፟ሰ
ተቈነነ	ተቈነ፟ነ
ተቈነደደ	ተቈነደ፟ደ
ተቈናኝ	ተቈና፟ኝ፟
ተቋለፈ	ተቋለ፟ፈ
ተቋላ	ተቋላ፟
ተቋረጠ	ተቋረ፟ጠ
ተቋራጭ	ተቋራ፟ጭ
ተበለቀጠ	ተበለቀ፟ጠ
ተበለጠ	ተበለ፟ጠ
ተበላ	ተበላ፟
ተበላለጠ	ተበላለ፟ጠ
ተበላሸ	ተበላሸ፟
ተበላቀጠ	ተበላቀ፟ጠ
ተበረቀሰ	ተበረቀ፟ሰ
ተበረቃቀሰ	ተበረቃቀ፟ሰ
ተበረበረ	ተበረበ፟ረ
ተበረዘ	ተበረ፟ዘ
ተበረጋገደ	ተበረጋገ፟ደ
ተበራከተ	ተበራከ፟ተ
ተበሳ	ተበሳ፟
ተበሳሳ	ተበሳሳ፟
ተበሳበሰ	ተበሳበ፟ሰ
ተበሻቀጠ	ተበሻቀ፟ጠ
ተበቀለ	ተበቀ፟ለ
ተበቃይ	ተበቃ፟ይ
ተበተበ	ተበተ፟በ
ተበታተነ	ተበታተ፟ነ
ተበከለ	ተበከ፟ለ
ተበካከለ	ተበካከ፟ለ
ተበዘበዘ	ተበዘበ፟ዘ
ተበየነ	ተበየ፟ነ
ተበየደ	ተበየ፟ደ
ተበያጅ	ተበያ፟ጅ
ተበደለ	ተበደ፟ለ
ተበደረ	ተበደ፟ረ
ተበዳ	ተበዳ፟
ተበዳሪ	ተበዳ፟ሪ
ተበዳይ	ተበዳ፟ይ
ተበዳደረ	ተበዳደ፟ረ
ተበጀ	ተበጀ፟
ተበጃጀ	ተበጃጀ፟
ተበገረ	ተበገ፟ረ
ተበጠበጠ	ተበጠበ፟ጠ
ተበጣበጠ	ተበጣበ፟ጠ
ተባ	ተባ፟
ተባላ	ተባላ፟
ተባረረ	ተባረ፟ረ
ተባረከ	ተባረ፟ከ
ተባረደ	ተባረ፟ደ
ተባሸቀ	ተባሸ፟ቀ
ተባቃ	ተባቃ፟
ተባበረ	ተባበ፟ረ
ተባዛ	ተባዛ፟
ተብለጠለጠ	ተብለጠለ፟ጠ
ተብለጨለጨ	ተብለጨለ፟ጨ
ተብላላ	ተብላላ፟
ተብረቀረቀ	ተብረቀረ፟ቀ
ተብረከረከ	ተብረከረ፟ከ
ተብራራ	ተብራራ፟
ተብሰለሰለ	ተብሰለሰ፟ለ
ተብታባ	ተብታባ፟
ተብከነከነ	ተብከነከ፟ነ
ተቦረቦረ	ተቦረቦ፟ረ
ተቦተረፈ	ተቦተረ፟ፈ
ተቦካ	ተቦካ፟
ተቦደሰ	ተቦደ፟ሰ
ተቧደነ	ተቧደ፟ነ
ተተለተለ	ተተለተ፟ለ
ተተመተመ	ተተመተ፟መ
ተተመነ	ተተመ፟ነ
ተተረማመሰ	ተተረማመ፟ሰ
ተተረተረ	ተተረተ፟ረ
ተተረከ	ተተረ፟ከ
ተተረከከ	ተተረከ፟ከ
ተተረኰሰ	ተተረኰ፟ሰ
ተተረጐመ	ተተረጐ፟መ
ተተራመሰ	ተተራመ፟ሰ
ተተበተበ	ተተበተ፟በ
ተተቸ	ተተቸ፟
ተተነተነ	ተተነተ፟ነ
ተተናኮለ	ተተናኮ፟ለ
ተተከለ	ተተከ፟ለ
ተተካ	ተተካ፟
ተተካይ	ተተካ፟ይ
ተተኰሰ	ተተኰ፟ሰ
ተታለለ	ተታለ፟ለ
ተታኰሰ	ተታኰ፟ሰ
ተታፋ	ተታፋ፟
ተትረፈረፈ	ተትረፈረ፟ፈ
ተቸ	ተቸ፟
ተቸለሰ	ተቸለ፟ሰ
ተቸበቸበ	ተቸበቸ፟በ
ተቸነከረ	ተቸነከ፟ረ
ተቸከለ	ተቸከ፟ለ
ተቸገረ	ተቸገ፟ረ
ተቸፈቸፈ	ተቸፈቸ፟ፈ
ተቸፈገ	ተቸፈ፟ገ
ተቺ	ተቺ፟
ተቻኰለ	ተቻኰ፟ለ
ተነሣ	ተነሣ፟
ተነሣሣ	ተነሣ፟ሣ፟
ተነሰነሰ	ተነሰነ፟ሰ
ተነሳ	ተነ፟ሳ
ተነቀለ	ተነቀ፟ለ
ተነቀሰ	ተነቀ፟ሰ
ተነቀነቀ	ተነቀነ፟ቀ
ተነቀፈ	ተነቀ፟ፈ
ተነቃቀፈ	ተነቃቀ፟ፈ
ተነቃቃ	ተነቃቃ፟
ተነቃነቀ	ተነቃነ፟ቀ
ተነበበ	ተነበ፟በ
ተነበየ	ተነበ፟የ
ተነባበረ	ተነባበ፟ረ
ተነባቢ	ተነባ፟ቢ
ተነተነ	ተነተ፟ነ
ተነተገ	ተነተ፟ገ
ተነታረከ	ተነታረ፟ከ
ተነነ	ተነ፟ነ
ተነከረ	ተነከ፟ረ
ተነከሰ	ተነከ፟ሰ
ተነካ	ተነካ፟
ተነካከሰ	ተነካከ፟ሰ
ተነካካ	ተነካካ፟
ተነኰሰ	ተነኰ፟ሰ
ተነኰተ	ተነኰ፟ተ
ተነዘነዘ	ተነዘነ፟ዘ
ተነዛ	ተነዛ፟
ተነዛነዘ	ተነዛነ፟ዘ
ተነደፈ	ተነደ፟ፈ
ተነዳ	ተነዳ፟
ተነዳደፈ	ተነዳደ፟ፈ
ተነገተ	ተነገ፟ተ
ተነጋገረ	ተነጋገ፟ረ
ተነጋገደ	ተነጋገ፟ደ
ተነጐረ	ተነጐ፟ረ
ተነጫነጨ	ተነጫነ፟ጨ
ተነፈሰ	ተነፈ፟ሰ
ተነፈገ	ተነፈ፟ገ
ተነፋ	ተነፋ፟
ተነፋረቀ	ተነፋረ፟ቀ
ተነፋነፈ	ተነፋነ፟ፈ
ተነፋፈሰ	ተነፋፈ፟ሰ
ተነፋፈቀ	ተነፋፈ፟ቀ
ተነፋፈገ	ተነፋፈ፟ገ
ተነፋፋ	ተነፋፋ፟
ተናበበ	ተናበ፟በ
ተናባቢ	ተናባ፟ቢ
ተናነቀ	ተናነ፟ቀ
ተናነቀው	ተናነ፟ቀው
ተናኘ	ተናኘ፟
ተናከሰ	ተናከ፟ሰ
ተናዘዘ	ተናዘ፟ዘ
ተናደደ	ተናደ፟ደ
ተናገሠ	ተናገ፟ሠ
ተናገረ	ተናገ፟ረ
ተናጋ	ተናጋ፟
ተናፈሰ	ተናፈ፟ሰ
ተናፈቀ	ተናፈ፟ቀ
ተናፈጠ	ተናፈ፟ጠ
ተናፋ	ተናፋ፟
ተን	ተን፟
ተንሠቀሠቀ	ተንሠቀሠ፟ቀ
ተንሰቀሰቀ	ተንሰቀሰ፟ቀ
ተንሰፈሰፈ	ተንሰፈሰ፟ፈ
ተንሳፈፈ	ተንሳፈ፟ፈ
ተንሶለሶለ	ተንሶለሶ፟ለ
ተንሸረሸረ	ተንሸረሸ፟ረ
ተንሸራተተ	ተንሸራተ፟ተ
ተንሸዋረረ	ተንሸዋረ፟ረ
ተንሻተተ	ተንሻተ፟ተ
ተንቀለቀለ	ተንቀለቀ፟ለ
ተንቀረበበ	ተንቀረበ፟በ
ተንቀረፈፈ	ተንቀረፈ፟ፈ፟
ተንቀሳቀሰ	ተንቀሳቀ፟ሰ
ተንቀበቀበ	ተንቀበቀ፟በ
ተንቀበደደ	ተንቀበደ፟ደ
ተንቀባረረ	ተንቀባረ፟ረ
ተንቀባደደ	ተንቀባደ፟ደ
ተንቀዋለለ	ተንቀዋለ፟ለ
ተንቀዠቀዠ	ተንቀዠቀ፟ዠ
ተንቀጠቀጠ	ተንቀጠቀ፟ጠ
ተንቀፈደደ	ተንቀፈደ፟ደ
ተንበለበለ	ተንበለበ፟ለ
ተንበረከከ	ተንበረከ፟ከ
ተንበሸበሸ	ተንበሸ፟በ፟ሸ
ተንቦለቦለ	ተንቦለቦ፟ለ
ተንቦረቀቀ	ተንቦረቀ፟ቀ
ተንቦራቀቀ	ተንቦራቀ፟ቀ
ተንቦገቦገ	ተንቦገቦ፟ገ
ተንቦጨቦጨ	ተንቦጨቦ፟ጨ
ተንቦጫበጨ	ተንቦጫበ፟ጨ
ተንቦጫቦጨ	ተንቦጫቦ፟ጨ
ተንተረከከ	ተንተረከ፟ከ
ተንተባተበ	ተንተባተ፟በ
ተንተከተከ	ተንተከተ፟ከ
ተንቶሰቶሰ	ተንቶሰቶ፟ሰ
ተንቻቻ	ተንቻቻ፟
ተንከላወሰ	ተንከላወ፟ሰ
ተንከረፈፈ	ተንከረፈ፟ፈ
ተንከራተተ	ተንከራተ፟ተ
ተንከባለለ	ተንከባለ፟ለ
ተንከባከበ	ተንከባከ፟በ
ተንከተከተ	ተንከተከ፟ተ
ተንከታከተ	ተንከታከ፟ተ
ተንከዋተተ	ተንከዋተ፟ተ
ተንከፈረረ	ተንከፈረ፟ረ
ተንኮለኛ	ተንኮለኛ፟
ተንኳኳ	ተንኳኳ፟
ተንኳፈፈ	ተንኳፈ፟ፈ
ተንዘረፈጠ	ተንዘረፈ፟ጠ
ተንዘረፈፈ	ተንዘረፈ፟ፈ
ተንዘራፈጠ	ተንዘራፈ፟ጠ
ተንዘፈዘፈ	ተንዘፈ፟ዘፈ
ተንዛዛ	ተንዛዛ፟
ተንዠረገገ	ተንዠረገ፟ገ
ተንዠቀዠቀ	ተንዠቀዠ፟ቀ
ተንዠባረረ	ተንዠባረ፟ረ
ተንዣበበ	ተንዣበ፟በ
ተንደላቀቀ	ተንደላቀ፟ቀ
ተንደረበበ	ተንደረበ፟በ
ተንደረከከ	ተንደረከ፟ከ
ተንደረደረ	ተንደረደ፟ረ
ተንደቀደቀ	ተንደቀደ፟ቀ
ተንደበደበ	ተንደበደ፟በ
ተንደባለለ	ተንደባለ፟ለ
ተንደባደበ	ተንደባደ፟በ
ተንደከደ	ተንደከ፟ደ
ተንደፋደፈ	ተንደፋደ፟ፈ
ተንዶለዶለ	ተንዶለዶ፟ለ
ተንጀላጀለ	ተንጀላጀ፟ለ
ተንጀረገገ	ተንጀረገ፟ገ
ተንገላታ	ተንገላታ፟
ተንገላወደ	ተንገላወ፟ደ
ተንገላጀጀ	ተንገላጀ፟ጀ
ተንገረገበ	ተንገረገ፟በ
ተንገሸገሸ	ተንገሸገ፟ሸ
ተንገበገበ	ተንገበገ፟በ
ተንገዋለለ	ተንገዋለ፟ለ
ተንገደገደ	ተንገደገ፟ደ
ተንገዳገደ	ተንገዳገ፟ደ
ተንገጫገጨ	ተንገጫገ፟ጨ
ተንገፈገፈ	ተንገፈገ፟ፈ
ተንጋለለ	ተንጋለ፟ለ
ተንጋደደ	ተንጋደ፟ደ
ተንጋጋ	ተንጋጋ፟
ተንጎራደደ	ተንጎራደ፟ደ
ተንጐራደደ	ተንጐራደ፟ደ
ተንጓለለ	ተንጓለ፟ለ
ተንጓደደ	ተንጓደ፟ደ
ተንጠረበበ	ተንጠረበ፟በ
ተንጠረዘዘ	ተንጠረዘ፟ዘ
ተንጠራራ	ተንጠራ፟ራ
ተንጠራወዘ	ተንጠራወ፟ዘ
ተንጣለለ	ተንጣለ፟ለ
ተንጸባረቀ	ተንጸባረ፟ቀ
ተንፈላሰሰ	ተንፈላሰ፟ሰ
ተንፈራገጠ	ተንፈራገ፟ጠ
ተንፈራፈረ	ተንፈራፈ፟ረ
ተንፈስ	ተንፈስ፟
ተንፈቀፈቀ	ተንፈቀፈ፟ቀ
ተንፋነፈ	ተንፋነ፟ፈ
ተንፏቀቀ	ተንፏቀ፟ቀ
ተንፏፏ	ተንፏፏ፟
ተኛ	ተኛ፟
ተኛት	ተኛ፟ት
ተኝቶ	ተኝ፟ቶ
ተኝቷል	ተኝ፟ቷል
ተአምረኛ	ተአም፟ረኛ፟
ተአምራታዊ	ተአም፟ራታዊ
ተአምር	ተአም፟ር
ተከለ	ተከ፟ለ
ተከለለ	ተከለ፟ለ
ተከለሰ	ተከለ፟ሰ
ተከለበሰ	ተከለበ፟ሰ
ተከለከለ	ተከለከ፟ለ
ተከላከለ	ተከላከ፟ለ
ተከመቻቸ	ተከመቻቸ፟
ተከመከመ	ተከመከ፟መ
ተከማቸ	ተከማ፟ቸ
ተከሠተ	ተከሠ፟ተ
ተከረበተ	ተከረበ፟ተ
ተከረተፈ	ተከረተ፟ፈ
ተከረከመ	ተከረከ፟መ
ተከራከረ	ተከራከ፟ረ
ተከራየ	ተከራየ፟
ተከሰሰ	ተከሰ፟ሰ
ተከሰከሰ	ተከሰከ፟ሰ
ተከሳሽ	ተከሳ፟ሽ
ተከሳከሰ	ተከሳከ፟ሰ
ተከበረ	ተከበ፟ረ
ተከበበ	ተከበ፟በ
ተከባበረ	ተከባበ፟ረ
ተከተለ	ተከተ፟ለ
ተከተለበ	ተከተለ፟በ
ተከተል	ተከተ፟ል
ተከተረ	ተከተ፟ረ
ተከተበ	ተከተ፟በ
ተከተተ	ተከተ፟ተ
ተከተከ	ተከተ፟ከ
ተከተከተ	ተከተከ፟ተ
ተከተፈ	ተከተ፟ፈ
ተከታተለ	ተከታተ፟ለ
ተከታከተ	ተከታከ፟ተ
ተከታይ	ተከታ፟ይ
ተከነ	ተከ፟ነ
ተከናነበ	ተከናነ፟በ
ተከናወነ	ተከናወ፟ነ
ተከካ	ተከካ፟
ተከዘ	ተከ፟ዘ
ተከደነ	ተከደ፟ነ
ተከፈለ	ተከፈ፟ለ
ተከፈተ	ተከፈ፟ተ
ተከፈነ	ተከፈ፟ነ
ተከፈከፈ	ተከፈከ፟ፈ
ተከፈፈ	ተከፈ፟ፈ
ተከፋ	ተከፋ፟
ተከፋች	ተከፋ፟ች
ተከፋይ	ተከፋ፟ይ
ተከፋፈለ	ተከፋፈ፟ለ
ተከፋፈተ	ተከፋፈ፟ተ
ተኩረፈረፈ	ተኩረፈረ፟ፈ
ተኩራራ	ተኩራራ፟
ተኩስ	ተኩ፟ስ
ተኩነሰነሰ	ተኩነሰነ፟ሰ
ተካ	ተካ፟
ተካለለ	ተካለ፟ለ
ተካለሰ	ተካለ፟ሰ
ተካረረ	ተካረ፟ረ
ተካሰሰ	ተካሰ፟ሰ
ተካበደ	ተካበ፟ደ
ተካከለ	ተካ፟ከ፟ለ
ተካዥ	ተካ፟ዥ
ተካፈለ	ተካፈ፟ለ
ተካፈተ	ተካፈ፟ተ
ተክለፈለፈ	ተክለፈለ፟ፈ
ተክበሰበሰ	ተክበሰበ፟ሰ
ተኮላሸ	ተኮላሸ፟
ተኮማተረ	ተኮማተ፟ረ
ተኮረተመ	ተኮረተ፟መ
ተኮረጀ	ተኮረ፟ጀ
ተኮረፈ	ተኮረ፟ፈ
ተኮራመተ	ተኮራመ፟ተ
ተኮራፊ	ተኮራ፟ፊ
ተኮሳተረ	ተኮሳተ፟ረ
ተኮተኮተ	ተኮተኮ፟ተ
ተኮፈሰ	ተኮፈ፟ሰ
ተኮፋሽ	ተኮፋ፟ሽ
ተኰላተፈ	ተኰላተ፟ፈ
ተኰረተመ	ተኰረተ፟መ
ተኰረታተመ	ተኰረታተ፟መ
ተኰሰ	ተኰ፟ሰ
ተኰሳተረ	ተኰሳተ፟ረ
ተኰነነ	ተኰነ፟ነ
ተኳረፈ	ተኳረ፟ፈ
ተኳሽ	ተኳ፟ሽ
ተኳሽነት	ተኳሽነ፟ት
ተኳኰሰ	ተኳኰ፟ሰ
ተወለደ	ተወለ፟ደ
ተወለጋገደ	ተወለጋገ፟ደ
ተወላመመ	ተወላመ፟መ
ተወላከፈ	ተወላከ፟ፈ
ተወላጅ	ተወላ፟ጅ
ተወላገደ	ተወላገ፟ደ
ተወረረ	ተወረ፟ረ
ተወረሰ	ተወረ፟ሰ
ተወረወረ	ተወረወ፟ረ
ተወረደ	ተወረ፟ደ
ተወራ	ተወራ፟
ተወራረሰ	ተወራረ፟ሰ
ተወራረደ	ተወራረ፟ደ
ተወራሽ	ተወራ፟ሽ
ተወራወረ	ተወራወ፟ረ
ተወራጅ	ተወራ፟ጅ
ተወሰነ	ተወሰ፟ነ
ተወሰወሰ	ተወሰወ፟ሰ
ተወሰደ	ተወሰ፟ደ
ተወሳ	ተወሳ፟
ተወቀሰ	ተወቀ፟ሰ
ተወቀጠ	ተወቀ፟ጠ
ተወቃ	ተወቃ፟
ተወቃቀሰ	ተወቃቀ፟ሰ
ተወተፈ	ተወተ፟ፈ
ተወነባበደ	ተወነባበ፟ደ
ተወነጃጀለ	ተወነጃጀ፟ለ
ተወናበደ	ተወናበ፟ደ
ተወናፈለ	ተወናፈ፟ለ
ተወንጀለ	ተወንጀ፟ለ
ተወከለ	ተወከ፟ለ
ተወካይ	ተወካ፟ይ
ተወዘፈ	ተወዘ፟ፈ
ተወዛወዘ	ተወዛወ፟ዘ
ተወደደ	ተወደ፟ደ
ተወዳደረ	ተወዳደ፟ረ
ተወዳጀ	ተወዳጀ፟
ተወዳጅ	ተወዳ፟ጅ
ተወገረ	ተወገ፟ረ
ተወገደ	ተወገ፟ደ
ተወጋ	ተወጋ፟
ተወጫመደ	ተወጫመ፟ደ
ተዋለደ	ተዋለ፟ደ
ተዋልቀ	ተዋል፟ቀ
ተዋረደ	ተዋረ፟ደ
ተዋሰነ	ተዋሰ፟ነ
ተዋቀረ	ተዋቀ፟ረ
ተዋቀሰ	ተዋቀ፟ሰ
ተዋከበ	ተዋከ፟በ
ተዋወቀ	ተዋወ፟ቀ
ተዋደቀ	ተዋደ፟ቀ
ተዋደደ	ተዋደ፟ደ
ተዋጋ	ተዋጋ፟
ተውለበለበ	ተውለበለ፟በ
ተውረገረገ	ተውረገረ፟ገ
ተውተረተረ	ተውተረተ፟ረ
ተውተበተበ	ተውተበተ፟በ
ተውተፈተፈ	ተውተፈተ፟ፈ
ተዘለለ	ተዘለ፟ለ
ተዘለቀ	ተዘለ፟ቀ
ተዘመዘመ	ተዘመዘ፟መ
ተዘረረ	ተዘረ፟ረ
ተዘረነቀ	ተዘረ፟ነቀ
ተዘረከተ	ተዘረከ፟ተ
ተዘረካከተ	ተዘረካከ፟ተ
ተዘረዘረ	ተዘረዘ፟ረ
ተዘረገፈ	ተዘረገ፟ፈ
ተዘረጋ	ተዘረጋ፟
ተዘረፈ	ተዘረ፟ፈ
ተዘረፈጠ	ተዘረፈ፟ጠ
ተዘራ	ተዘራ፟
ተዘራረፈ	ተዘራረ፟ፈ
ተዘቀዘቀ	ተዘቀዘ፟ቀ
ተዘበራረቀ	ተዘበራረ፟ቀ
ተዘባረቀ	ተዘባረ፟ቀ
ተዘባበተ	ተዘባበ፟ተ
ተዘባነነ	ተዘባነ፟ነ
ተዘነቀ	ተዘነ፟ቀ
ተዘነተረ	ተዘነተ፟ረ
ተዘነጋ	ተዘነጋ፟
ተዘነጋጋ	ተዘነጋጋ፟
ተዘናከተ	ተዘናከ፟ተ
ተዘናጋ	ተዘናጋ፟
ተዘናፈለ	ተዘናፈ፟ለ
ተዘከረ	ተዘከ፟ረ
ተዘከዘከ	ተዘከዘ፟ከ
ተዘካሪ	ተዘካ፟ሪ
ተዘወተረ	ተዘወተ፟ረ
ተዘዋወረ	ተዘዋወ፟ረ
ተዘያየረ	ተዘያየ፟ረ
ተዘገረረ	ተዘገረ፟ረ
ተዘገጃጀ	ተዘገጃጀ፟
ተዘጋ	ተዘ፟ጋ፟
ተዘጋጀ	ተዘጋጀ፟
ተዘፈቀ	ተዘፈ፟ቀ
ተዘፈዘፈ	ተዘፈዘ፟ፈ
ተዛለለ	ተዛለ፟ለ
ተዛለፈ	ተዛለ፟ፈ
ተዛመተ	ተዛመ፟ተ
ተዛመደ	ተዛመ፟ደ
ተዛባ	ተዛ፟ባ፟
ተዛነቀ	ተዛነ፟ቀ
ተዛነፈ	ተዛነ፟ፈ
ተዛና	ተዛና፟
ተዛናና	ተዛናና፟
ተዛወረ	ተዛወ፟ረ
ተዛዘበ	ተዛዘ፟በ
ተዛዘነ	ተዛዘ፟ነ
ተዛፈቀ	ተዛፈ፟ቀ
ተዝለገለገ	ተዝለገለ፟ገ
ተዝለፈለፈ	ተዝለፈለ፟ፈ
ተዝረበረበ	ተዝረበረ፟በ
ተዝረከረከ	ተዝረከረ፟ከ
ተዝረጠረጠ	ተዝረጠረ፟ጠ
ተዝረፈረፈ	ተዝረፈረ፟ፈ
ተዝናና	ተዝናና፟
ተዝጎረጎረ	ተዝጎረጎ፟ረ
ተዝጐረጐረ	ተዝጐረጐ፟ረ
ተዠለጠ	ተዠለ፟ጠ
ተዥጎረገረ	ተዥጎረገ፟ረ
ተዥጎደጎደ	ተዥጎደጎ፟ደ
ተያየ	ተያየ፟
ተደለለ	ተደለ፟ለ
ተደለቀ	ተደ፟ለ፟ቀ
ተደለደለ	ተደለደ፟ለ
ተደላደለ	ተደላደ፟ለ
ተደመመ	ተደመ፟መ
ተደመረ	ተደመ፟ረ
ተደመሰሰ	ተደመሰ፟ሰ
ተደመደመ	ተደመደ፟መ
ተደመጠ	ተደመ፟ጠ
ተደማመጠ	ተደማመ፟ጠ
ተደማሪ	ተደማ፟ሪ
ተደማጭ	ተደማ፟ጭ
ተደረሰ	ተደረ፟ሰ
ተደረሰመ	ተደረሰ፟መ
ተደረበ	ተደረ፟በ
ተደረተ	ተደረ፟ተ
ተደረደረ	ተደረደ፟ረ
ተደረገ	ተደረ፟ገ
ተደረገመ	ተደረገ፟መ
ተደራረበ	ተደራረ፟በ
ተደራረገ	ተደራረ፟ገ
ተደራቢ	ተደራ፟ቢ
ተደራደረ	ተደራደ፟ረ
ተደራጀ	ተደራጀ፟
ተደራጊ	ተደራ፟ጊ
ተደሰተ	ተደሰ፟ተ
ተደሳች	ተደሳ፟ች
ተደቀነ	ተደቀ፟ነ
ተደቆሰ	ተደቆ፟ሰ
ተደበለለ	ተደበለ፟ለ
ተደበለቀ	ተደበለ፟ቀ
ተደበላለቀ	ተደበላለ፟ቀ
ተደበቀ	ተደበ፟ቀ
ተደበደበ	ተደበደ፟በ
ተደባለቀ	ተደባለ፟ቀ
ተደባበቀ	ተደባበ፟ቀ
ተደባደበ	ተደባደ፟በ
ተደነቀ	ተደነ፟ቀ
ተደነቀረ	ተደነቀ፟ረ
ተደነቀረብኝ	ተደነቀ፟ረብኝ፟
ተደናቀፈ	ተደናቀ፟ፈ
ተደናቂ	ተደና፟ቂ
ተደናበረ	ተደናበ፟ረ
ተደናበዘ	ተደናበ፟ዘ
ተደናገረ	ተደና፟ገ፟ረ
ተደናገጠ	ተደናገ፟ጠ
ተደከመ	ተደከ፟መ
ተደወለ	ተደወ፟ለ
ተደገመ	ተደገ፟መ
ተደገሰ	ተደገ፟ሰ
ተደገነ	ተደገ፟ነ
ተደገፈ	ተደገ፟ፈ
ተደጋገመ	ተደጋገ፟መ
ተደጋገፈ	ተደጋገ፟ፈ
ተደጎመ	ተደጎ፟መ
ተደፈረ	ተደፈ፟ረ
ተደፈቀ	ተደፈ፟ቀ
ተደፈነ	ተደፈ፟ነ
ተደፋ	ተደፋ፟
ተደፋፈረ	ተደፋፈ፟ረ
ተዳመረ	ተዳመ፟ረ
ተዳመጠ	ተዳመ፟ጠ
ተዳረሰ	ተዳረ፟ሰ
ተዳረቀ	ተዳረ፟ቀ
ተዳረገ	ተዳረ፟ገ
ተዳራ	ተዳራ፟
ተዳቀለ	ተዳቀ፟ለ
ተዳቀቀ	ተዳቀ፟ቀ
ተዳበለ	ተዳበ፟ለ
ተዳነቀ	ተዳነ፟ቀ
ተዳኘ	ተዳኘ፟
ተዳከመ	ተዳከ፟መ
ተዳደረ	ተዳደ፟ረ
ተዳፈረ	ተዳፈ፟ረ
ተዳፈቀ	ተዳፈ፟ቀ
ተዳፈነ	ተዳፈ፟ነ
ተዳፋ	ተዳፋ፟
ተድረቀረቀ	ተድረቀረ፟ቀ
ተድበለበለ	ተድበለበ፟ለ
ተድበሰበሰ	ተድበሰበ፟ሰ
ተድቦለቦለ	ተድቦለቦ፟ለ
ተድፈነፈነ	ተድፈነፈ፟ነ
ተጀመረ	ተጀመ፟ረ
ተጀነነ	ተጀነ፟ነ
ተገለለ	ተገለ፟ለ
ተገለማመጠ	ተገለማመ፟ጠ
ተገለበጠ	ተገለበ፟ጠ
ተገለባበጠ	ተገለባበ፟ጠ
ተገለጠ	ተገለ፟ጠ
ተገለፈፈ	ተገለፈ፟ፈ
ተገላመጠ	ተገላመ፟ጠ
ተገላበጠ	ተገላበ፟ጠ
ተገላገለ	ተገላገ፟ለ
ተገመሰ	ተገመ፟ሰ
ተገመተ	ተገመ፟ተ
ተገመደለ	ተገመደ፟ለ
ተገመገመ	ተገመገ፟መ
ተገረመ	ተገረ፟መ
ተገረዘ	ተገረ፟ዘ
ተገረፈ	ተገረ፟ፈ
ተገራ	ተገራ፟
ተገሰሰ	ተገሰ፟ሰ
ተገሸለጠ	ተገሸለ፟ጠ
ተገሸረ	ተገሸ፟ረ
ተገበያየ	ተገበያየ፟
ተገቢ	ተገቢ፟
ተገባደደ	ተገባደ፟ደ
ተገታ	ተገታ፟
ተገታተረ	ተገታተ፟ረ
ተገነዘበ	ተገነዘ፟በ
ተገነጣጠለ	ተገነጣጠ፟ለ
ተገናኘ	ተገናኘ፟
ተገናዘበ	ተገናዘ፟በ
ተገኘ	ተገኘ፟
ተገዘተ	ተገዘ፟ተ
ተገዛ	ተገዛ፟
ተገዛዛ	ተገዛ፟ዛ፟
ተገደለ	ተገደ፟ለ
ተገደደ	ተገደ፟ደ
ተገፈፈ	ተገፈ፟ፈ
ተገፋ	ተገፋ፟
ተገፋተረ	ተገፋተ፟ረ
ተገፋፋ	ተገፋፋ፟
ተጉመጠመጠ	ተጉመጠመ፟ጠ
ተጉረበረበ	ተጉረበረ፟በ
ተጋ	ተጋ፟
ተጋለጠ	ተጋለ፟ጠ
ተጋመሰ	ተጋመ፟ሰ
ተጋማ	ተጋማ፟
ተጋረደ	ተጋረ፟ደ
ተጋረጠ	ተጋረ፟ጠ
ተጋራ	ተጋራ፟
ተጋበዘ	ተጋበ፟ዘ
ተጋባ	ተጋባ፟
ተጋተረ	ተጋተ፟ረ
ተጋነነ	ተጋነ፟ነ
ተጋዘ	ተጋዘ፟
ተጋዛ	ተጋዛ፟
ተጋደለ	ተጋደ፟ለ
ተጋገረ	ተጋገ፟ረ
ተጋገዘ	ተጋገ፟ዘ
ተጋፈጠ	ተጋፈ፟ጠ
ተጋፋ	ተጋፋ፟
ተግ	ተግ፟
ተግማማ	ተግማማ፟
ተግባባ	ተግባባ፟
ተግተለተለ	ተግተለተ፟ለ
ተግተረተረ	ተግተረተ፟ረ
ተግደረደረ	ተግደረደ፟ረ
ተግፈለፈለ	ተግፈለፈ፟ለ
ተጎማለለ	ተጎማለ፟ለ
ተጎማዘዘ	ተጎማዘ፟ዘ
ተጎራበተ	ተጎራበ፟ተ
ተጎዳ	ተጎዳ፟
ተጎዳኘ	ተጎዳኘ፟
ተጐለተ	ተጐለ፟ተ
ተጐላመመ	ተጐላመ፟መ
ተጐላደፈ	ተጐላደ፟ፈ
ተጐሳቈለ	ተጐሳቈ፟ለ
ተጐተተ	ተጐተ፟ተ
ተጐታች	ተጐታ፟ች
ተጐነጐነ	ተጐነጐ፟ነ
ተጐናዘለ	ተጐናዘ፟ለ
ተጓተተ	ተጓተ፟ተ
ተጓደለ	ተጓደ፟ለ
ተጓደደ	ተጓደ፟ደ
ተጕመጠመጠ	ተጕመጠመ፟ጠ
ተጠለለ	ተጠለ፟ለ
ተጠለፈ	ተጠለ፟ፈ
ተጠላ	ተጠላ፟
ተጠላላፊ	ተጠላላ፟ፊ
ተጠመቀ	ተጠመ፟ቀ
ተጠመዘዘ	ተጠመዘ፟ዘ
ተጠመደ	ተጠመ፟ደ
ተጠማ	ተጠማ፟
ተጠማዘዘ	ተጠማዘ፟ዘ
ተጠረመሰ	ተጠረመ፟ሰ
ተጠረቃቀመ	ተጠረቃቀ፟መ
ተጠራ	ተጠራ፟
ተጠራቀመ	ተጠራቀ፟መ
ተጠቀመ	ተጠቀ፟መ
ተጠቃ	ተጠቃ፟
ተጠቃለለ	ተጠቃለ፟ለ
ተጠቃሚ	ተጠቃ፟ሚ
ተጠቃሽ	ተጠቃ፟ሽ
ተጠቃቀሰ	ተጠቃቀ፟ሰ
ተጠቆመ	ተጠቆ፟መ
ተጠበቀ	ተጠበ፟ቀ
ተጠበበ	ተጠበ፟በ
ተጠባበቀ	ተጠባበ፟ቀ
ተጠነቀቀ	ተጠነቀ፟ቀ
ተጠና	ተጠና፟
ተጠናቀቀ	ተጠናቀ፟ቀ
ተጠናቆለ	ተጠናቆ፟ለ
ተጠናበሰ	ተጠናበ፟ሰ
ተጠናከረ	ተጠናከ፟ረ
ተጠናወተ	ተጠናወ፟ተ
ተጠየቀ	ተጠየ፟ቀ
ተጠየቅ	ተጠየ፟ቅ
ተጠየፈ	ተጠየ፟ፈ
ተጠያቂ	ተጠያ፟ቂ
ተጠያየቀ	ተጠያየ፟ቀ
ተጠያፊ	ተጠያ፟ፊ
ተጠጋ	ተጠጋ፟
ተጠጋገነ	ተጠጋገ፟ነ
ተጠጋጋ	ተጠጋጋ፟
ተጠፋፋ	ተጠፋፋ፟
ተጣላ	ተጣ፟ላ
ተጣመመ	ተጣመ፟መ
ተጣመረ	ተጣመ፟ረ
ተጣመደ	ተጣመ፟ደ
ተጣረረ	ተጣረ፟ረ
ተጣራ	ተጣራ፟
ተጣበቀ	ተጣበ፟ቀ
ተጣበበ	ተጣበ፟በ
ተጣባ	ተጣባ፟
ተጣደፈ	ተጣደ፟ፈ
ተጣዳ	ተጣዳ፟
ተጣፋ	ተጣፋ፟
ተጥለቀለቀ	ተጥለቀለ፟ቀ
ተጥመለመለ	ተጥመለመ፟ለ
ተጥመሰመሰ	ተጥመሰመ፟ሰ
ተጥመዘመዘ	ተጥመዘመ፟ዘ
ተጥናና	ተጥናና፟
ተጧጧፈ	ተጧጧ፟ፈ
ተጨለጠ	ተጨለ፟ጠ
ተጨመላለቀ	ተጨመላለ፟ቀ
ተጨመረ	ተጨ፟መ፟ረ
ተጨመቀ	ተጨመ፟ቀ
ተጨመታተረ	ተጨመታተ፟ረ
ተጨማለቀ	ተጨማለ፟ቀ
ተጨማሪ	ተጨማ፟ሪ
ተጨማተረ	ተጨማተ፟ረ
ተጨማደደ	ተጨማደ፟ደ
ተጨረሰ	ተጨ፟ረ፟ሰ
ተጨራመመ	ተጨራመ፟መ
ተጨራመተ	ተጨራመ፟ተ
ተጨራመደ	ተጨራመ፟ደ
ተጨቆነ	ተጨቆ፟ነ
ተጨቋኝ	ተጨቋ፟ኝ
ተጨበተ	ተጨበ፟ተ
ተጨበጨበለት	ተጨበጨ፟በለ፟ት
ተጨባበጠ	ተጨባበ፟ጠ
ተጨባበጡ	ተጨባበ፟ጡ
ተጨባጭ	ተጨባ፟ጭ
ተጨነቀ	ተጨነ፟ቀ
ተጨናነቀ	ተጨናነ፟ቀ
ተጨናገፈ	ተጨናገ፟ፈ
ተጨናጎለ	ተጨናጎ፟ለ
ተጨካከነ	ተጨካከ፟ነ
ተጨዋወተ	ተጨዋወ፟ተ
ተጨፈለቀ	ተጨፈለ፟ቀ
ተጨፋጨፈ	ተጨፋጨ፟ፈ፟
ተጨፋፈቀ	ተጨፋፈ፟ቀ
ተጫማ	ተጫማ፟
ተጫረሰ	ተጫ፟ረ፟ሰ
ተጫወተ	ተጫወ፟ተ
ተጫወተበት	ተጫወ፟ተበ፟ት
ተጫፈረ	ተጫፈ፟ረ
ተጭበረበረ	ተጭበረበ፟ረ
ተጸለየ	ተጸለ፟የ
ተጸናወተ	ተጸናወ፟ተ
ተጸየፈ	ተጸየ፟ፈ
ተጸዳዳ	ተጸዳዳ፟
ተጻረረ	ተጻረ፟ረ
ተጽናና	ተጽናና፟
ተፀነሰ	ተፀነ፟ሰ
ተፈለቀቀ	ተፈለቀ፟ቀ
ተፈለገ	ተፈለ፟ገ
ተፈለጠ	ተፈለ፟ጠ
ተፈለፈለ	ተፈለፈ፟ለ
ተፈላ	ተፈላ፟
ተፈላለገ	ተፈላለ፟ገ
ተፈላሰፈ	ተፈላሰ፟ፈ
ተፈላጊ	ተፈላ፟ጊ
ተፈላጭ	ተፈላ፟ጭ
ተፈረመ	ተፈረ፟መ
ተፈረከሰ	ተፈረከ፟ሰ
ተፈረደ	ተፈረ፟ደ
ተፈረፈረ	ተፈረፈ፟ረ
ተፈራ	ተፈራ፟
ተፈራረመ	ተፈራረ፟መ
ተፈራራ	ተፈራራ፟
ተፈቃቀረ	ተፈቃቀ፟ረ
ተፈቃቀደ	ተፈቃቀ፟ደ
ተፈተለ	ተፈተ፟ለ
ተፈተለከ	ተፈተለ፟ከ
ተፈተሸ	ተፈተ፟ሸ
ተፈተነ	ተፈተ፟ነ
ተፈተገ	ተፈተ፟ገ
ተፈታ	ተፈታ፟
ተፈታተሸ	ተፈታተ፟ሸ
ተፈታተነ	ተፈታ፟ተነ
ተፈታኝ	ተፈታ፟ኝ
ተፈነቀለ	ተፈነቀ፟ለ
ተፈነቸረ	ተፈነቸ፟ረ
ተፈነከተ	ተፈነከ፟ተ
ተፈነገለ	ተፈነገ፟ለ
ተፈናቀለ	ተፈናቀ፟ለ
ተፈናከተ	ተፈናከ፟ተ
ተፈናፈነ	ተፈናፈ፟ነ
ተፈወሰ	ተፈወ፟ሰ
ተፈጀ	ተፈጀ፟
ተፈገፈገ	ተፈገፈ፟ገ
ተፈጋፈገ	ተፈጋፈ፟ገ
ተፋ	ተፋ፟
ተፋለመ	ተፋለ፟መ
ተፋለሰ	ተፋለ፟ሰ
ተፋረሰ	ተፋረ፟ሰ
ተፋረደ	ተፋረ፟ደ
ተፋሰሰ	ተፋሰ፟ሰ
ተፋቀረ	ተፋቀ፟ረ
ተፋተገ	ተፋተ፟ገ
ተፋታ	ተፋታ፟
ተፋዘዘ	ተፋዘ፟ዘ
ተፋጀ	ተፋጀ፟
ተፋፈነ	ተፋፈ፟ነ
ተፋፈገ	ተፋፈ፟ገ
ተፌ	ተፌ፟
ተፍ	ተፍ፟
ተፍለቀለቀ	ተፍለቀለ፟ቀ
ተፍለከለከ	ተፍለከለ፟ከ
ተፍረቀረቀ	ተፍረቀረ፟ቀ
ተፍረከረከ	ተፍረከረ፟ከ
ተፍረጠረጠ	ተፍረጠረ፟ጠ
ተፍታታ	ተፍታታ፟
ተፎካከረ	ተፎካከ፟ረ
ቱር	ቱር፟
ቱስ	ቱስ፟
ቱሽ	ቱሽ፟
ቱባ	ቱባ፟
ቱቦ	ቱቦ፟
ቱታ	ቱታ፟
ቱግ	ቱግ፟
ቱፋሕ	ቱፋ፟ሕ
ታለበ	ታለ፟በ
ታለፈ	ታለ፟ፈ
ታላቅ	ታላ፟ቅ
ታመመ	ታመ፟መ
ታመሰ	ታመ፟ሰ
ታመቀ	ታመ፟ቀ
ታመነ	ታመ፟ነ
ታማ	ታማ፟
ታማኝ	ታማ፟ኝ
ታምረኛ	ታም፟ረኛ፟
ታምራታዊ	ታም፟ራታዊ
ታምር	ታም፟ር
ታሠሠ	ታሠ፟ሠ
ታሠረ	ታሠ፟ረ
ታረመ	ታረ፟መ
ታረሰ	ታረ፟ሰ
ታረቀ	ታረ፟ቀ
ታረዘ	ታረ፟ዘ
ታረደ	ታረ፟ደ
ታሪከኛ	ታሪከኛ፟
ታሰበ	ታሰ፟በ
ታስቦ	ታስ፟ቦ
ታሸ	ታሸ፟
ታሸመ	ታሸ፟መ
ታሸገ	ታሸ፟ገ
ታቀደ	ታቀ፟ደ
ታቀፈ	ታቀ፟ፈ
ታበለ	ታበ፟ለ
ታበየ	ታበ፟የ
ታተመ	ታተ፟መ
ታተረ	ታተ፟ረ
ታተተ	ታተ፟ተ
ታታ	ታታ፟
ታነቀ	ታነ፟ቀ
ታነጠ	ታነ፟ጠ
ታናሽ	ታና፟ሽ
ታንከኛ	ታንከኛ፟
ታኘከ	ታኘ፟ከ
ታከለ	ታከ፟ለ
ታከመ	ታከ፟መ
ታከተ	ታከ፟ተ
ታከከ	ታከ፟ከ
ታካሚ	ታካ፟ሚ
ታወረ	ታወ፟ረ
ታወሰው	ታወ፟ሰው
ታወቀ	ታወ፟ቀ
ታወከ	ታወ፟ከ
ታዘለ	ታዘ፟ለ
ታዘበ	ታዘ፟በ
ታዘዘ	ታዘ፟ዘ
ታዛቢ	ታዛ፟ቢ
ታዛዥ	ታዛ፟ዥ
ታየ	ታየ፟
ታደለ	ታደ፟ለ
ታደመ	ታደ፟መ
ታደገ	ታደ፟ገ
ታዲያሳ	ታዲያሳ፟
ታዲያስ	ታዲያስ፟
ታዳጊ	ታዳ፟ጊ
ታጀለ	ታጀ፟ለ
ታጀበ	ታጀ፟በ
ታገለ	ታገ፟ለ
ታገሠ	ታገ፟ሠ
ታገደ	ታገ፟ደ
ታጋሽ	ታጋ፟ሽ
ታጐረ	ታጐ፟ረ
ታፈረ	ታፈ፟ረ
ታፈነ	ታፈ፟ነ
ታፈገ	ታፈ፟ገ
ታፋሪ	ታፋ፟ሪ
ቴሌስኮፕ	ቴሌስኮፕ፟
ቴፕ	ቴፕ፟
ትሉግሉግ	ትሉግሉግ፟
ትላንትና	ትላንትና፟
ትልቅ	ትል፟ቅ
ትልቅነት	ትል፟ቅነ፟ት
ትሕትና	ትሕትና፟
ትምቡሽ	ትምቡሽ፟
ትምትም	ትምትም፟
ትምክህተኛ	ትምክህተኛ፟
ትራፊ	ትራ፟ፊ
ትር	ትር፟
ትርምስ	ትርም፟ስ
ትርታ	ትር፟ታ
ትርክክ	ትርክክ፟
ትርኳሽ	ትርኳ፟ሽ
ትሻለህ	ትሻለ፟ህ
ትቢተኛ	ትቢተኛ፟
ትቢያ	ትቢ፟ያ
ትብብር	ትብብ፟ር
ትብትብ	ትብትብ፟
ትችት	ትች፟ት
ትናንትና	ትናንትና፟
ትናጋ	ትና፟ጋ
ትንሽ	ትን፟ሽ
ትንቢተኛ	ትንቢተኛ፟
ትንኝ	ትንኝ፟
ትንፋሽ	ትንፋ፟ሽ
ትእቢተኛ	ትእቢተኛ፟
ትእግሥተኛ	ትእግሥተኛ፟
ትከሻ	ትከሻ፟
ትከሻማ	ትከሻ፟ማ፟
ትከሻም	ትከሻ፟ም
ትኩሳት	ትኩ፟ሳት
ትኩስ	ትኩ፟ስ
ትካዜ	ትካ፟ዜ
ትክ	ትክ፟
ትክለኛ	ትክለኛ፟
ትክል	ትክ፟ል
ትክት	ትክ፟ት
ትክዝ	ትክ፟ዝ፟
ትውልድ	ትውልድ፟
ትዕይንት	ትዕይ፟ንት
ትዝ	ትዝ፟
ትዝብት	ትዝ፟ብት
ትዝታ	ትዝ፟ታ
ትይዩ	ትይዩ፟
ትግሥተኛ	ትግሥተኛ፟
ትግርኛ	ትግርኛ፟
ትግያ	ትግያ፟
ትጥቅና	ትጥቅና፟
ቶስቷሳ	ቶስቷሳ፟
ቸለል	ቸለል፟
ቸለሰ	ቸለ፟ሰ
ቸል	ቸል፟
ቸልተኛ	ቸል፟ተኛ፟
ቸልታ	ቸል፟ታ
ቸረቸመ	ቸረቸ፟መ
ቸረቸረ	ቸረቸ፟ረ
ቸርቻማ	ቸርቻማ፟
ቸርነት	ቸርነ፟ት
ቸሰሰ	ቸሰ፟ሰ
ቸበቸበ	ቸበቸ፟በ
ቸብቸቦ	ቸብቸቦ፟
ቸነከረ	ቸነከ፟ረ
ቸከለ	ቸከ፟ለ
ቸኰለ	ቸኰ፟ለ
ቸኳይ	ቸኳ፟ይ
ቸገረ	ቸገ፟ረ
ቸፈቸፈ	ቸፈቸ፟ፈ
ቸፈገ	ቸፈ፟ገ
ቸፍግ	ቸፍ፟ግ፟
ችላ	ችላ፟
ችስ	ችስ፟
ችቦ	ችቦ፟
ችኩል	ችኩ፟ል
ችክ	ችክ፟
ችክል	ችክ፟ል፟
ችኮ	ችኮ፟
ችኰላ	ችኰ፟ላ
ችግረኛ	ችግ፟ረኛ፟
ችግር	ችግ፟ር
ችግኝ	ችግ፟ኝ
ችፍ	ችፍ፟
ችፍርግ	ችፍርግ፟
ችፍቻፊ	ችፍቻ፟ፊ
ችፍግ	ችፍ፟ግ
ኅሊና	ኅሊ፟ና
ኅብረተሰብአዊነት	ኅብረተሰብአዊነ፟ት
ኅያል	ኅያ፟ል
ኅይለኛ	ኅይለኛ፟
ኅይለኝነት	ኅይለኝ፟ነ፟ት
ኅዳግ	ኅዳ፟ግ
ኅጢአተኛ	ኅጢአተኛ፟
ኅጢአተኝነት	ኅጢአተኝ፟ነ፟ት
ኋለኛ	ኋለኛ፟
ነሣ	ነሣ፟
ነረተ	ነረ፟ተ
ነሰረ	ነሰ፟ረ
ነሰነሰ	ነሰነ፟ሰ
ነሳነሰ	ነሳነ፟ሰ
ነሸጠ	ነሸ፟ጠ
ነቀለ	ነቀ፟ለ
ነቀሰ	ነቀ፟ሰ
ነቀዘ	ነቀ፟ዘ
ነቃ	ነቃ፟
ነቃቀለ	ነቃቀ፟ለ
ነቃቀዘ	ነቃቀ፟ዘ
ነቃቀፈ	ነቃቀ፟ፈ
ነቃቃ	ነቃቃ፟
ነቈጠ	ነቈ፟ጠ
ነበረ	ነበ፟ረ
ነበር	ነበ፟ር
ነበበ	ነበ፟በ
ነበዘ	ነበ፟ዘ
ነቢይ	ነቢይ፟
ነባር	ነባ፟ር
ነብርማ	ነብርማ፟
ነቦጨ	ነቦ፟ጨ፟
ነተረከ	ነተረ፟ከ
ነተበ	ነተ፟በ
ነኁላላ	ነኁላላ፟
ነኈለለ	ነኈለ፟ለ
ነኝ	ነኝ፟
ነከረ	ነከ፟ረ
ነከሰ	ነከ፟ሰ
ነከስ	ነከስ፟
ነከተ	ነከ፟ተ
ነካ	ነካ፟
ነካከሰ	ነካከ፟ሰ
ነካካ	ነካካ፟
ነክ	ነክ፟
ነኰተ	ነኰ፟ተ
ነውረኛ	ነውረኛ፟
ነዘረ	ነዘ፟ረ
ነዘነዘ	ነዘነ፟ዘ
ነዛ	ነዛ፟
ነዝናዛ	ነዝናዛ፟
ነደለ	ነደ፟ለ
ነደደ	ነደ፟ደ
ነደፈ	ነደ፟ፈ
ነዳ	ነዳ፟
ነዳደለ	ነዳደ፟ለ
ነዳደፈ	ነዳደ፟ፈ
ነገሠ	ነገ፟ሠ
ነገረ	ነገ፟ረ
ነገረኛ	ነገረኛ፟
ነገረኝ	ነገ፟ረኝ፟
ነገረው	ነገ፟ረው
ነገደ	ነገ፟ደ
ነጋ	ነጋ፟
ነጋዴ	ነጋ፟ዴ
ነጋድራስ	ነጋ፟ድራስ
ነጋገረ	ነጋገ፟ረ
ነጋገደ	ነጋገ፟ደ
ነጋጋ	ነጋጋ፟
ነጐረ	ነጐ፟ረ
ነጻነት	ነጻነ፟ት
ነፈለለ	ነፈለ፟ለ
ነፈረ	ነፈ፟ረ
ነፈረቀ	ነፈረ፟ቀ
ነፈሰ	ነፈ፟ሰ
ነፈሰበት	ነፈ፟ሰበ፟ት
ነፈነፈ	ነፈነ፟ፈ
ነፈገ	ነፈ፟ገ
ነፊ	ነፊ፟
ነፋ	ነፋ፟
ነፋሻ	ነፋ፟ሻ፟
ነፋፈሰ	ነፋፈ፟ሰ
ነፋፋ	ነፋፋ፟
ነፍላላ	ነፍላላ፟
ነፍራቃ	ነፍራቃ፟
ነፍናፋ	ነፍናፋ፟
ነፍጠኛ	ነፍጠኛ፟
ናሙና	ናሙ፟ና
ናቸው	ናቸ፟ው
ናችሁ	ናች፟ሁ
ናኘ	ናኘ፟
ናወዘ	ናወ፟ዘ
ናዋዥ	ናዋ፟ዥ
ናፈቀ	ናፈ፟ቀ
ንስሐ	ንስ፟ሐ
ንቃሽ	ንቃ፟ሽ
ንቃይ	ንቃ፟ይ
ንቅል	ንቅ፟ል
ንቅሳታም	ንቅ፟ሳታም
ንቅሳት	ንቅ፟ሳት
ንቅናቄ	ንቅና፟ቄ
ንብብር	ንብብ፟ር
ንብዝ	ንብ፟ዝ
ንብዝብዝ	ንብዝብዝ፟
ንትርክ	ንትር፟ክ
ንክሳት	ንክ፟ሳት
ንክስ	ንክ፟ስ
ንክኪት	ንክኪ፟ት
ንክክ	ንክክ፟
ንኳቸ	ንኳ፟ቸ
ንዝራት	ንዝ፟ራት
ንዴተኛ	ንዴተኛ፟
ንዴታም	ንዴ፟ታም
ንዴት	ንዴ፟ት
ንገዳ	ንገ፟ዳ
ንግር	ንግ፟ር
ንግርተኛ	ንግ፟ርተኛ፟
ንግርት	ንግ፟ርት
ንግግር	ንግግ፟ር
ንጹሕነት	ንጹሕነ፟ት
ንጽሕና	ንጽሕና፟
ንፊት	ንፊ፟ት
ንፋሽ	ንፋ፟ሽ
አሁኑኑ	አሁኑ፟ኑ
አሁንም	አሁንም፟
አሁንስ	አሁንስ፟
አህያ	አህያ፟
አለ	አለ፟
አለሁ	አለ፟ሁ
አለለ	አለ፟ለ
አለል	አለል፟
አለሎ	አለሎ፟
አለመ	አለ፟መ
አለመለመ	አለመለ፟መ
አለመደ	አለመ፟ደ
አለመጠ	አለመ፟ጠ
አለማ	አለማ፟
አለማለም	አለ፟ማለ፟ም
አለማመነ	አለ፟ማመ፟ነ
አለማመደ	አለ፟ማመ፟ደ
አለሳለስ	አለ፟ሳለስ
አለቀ	አለ፟ቀ
አለቀለቀ	አለቀለ፟ቀ
አለቀመ	አለቀ፟መ
አለቀሰ	አለቀ፟ሰ
አለቃለቀ	አለ፟ቃለ፟ቀ
አለቃቀሰ	አለቃቀ፟ሰ
አለቅነት	አለቅነ፟ት
አለበ	አለ፟በ
አለበለዚያ	አለበለ፟ዚ፟ያ
አለበሰ	አለ፟በ፟ሰ
አለበት	አለ፟በት
አለባበሰ	አለባበ፟ሰ
አለብኝ	አለ፟ብ፟ኝ፟
አለኝታ	አለ፟ኝ፟ታ
አለከለከ	አለከለ፟ከ
አለው	አለ፟ው
አለዘበ	አለዘ፟በ
አለያየ	አለ፟ያ፟የ
አለጎመ	አለጎ፟መ
አለጐመ	አለጐ፟መ
አለጠ	አለ፟ጠ
አለጠለጠ	አለጠለ፟ጠ
አለፈ	አለ፟ፈ
አለፈበት	አለ፟ፈበ፟ት
አለፋ	አለፋ፟
አለፋጨቀ	አለ፟ፋጨ፟ቀ
አላላ	አላላ፟
አላላም	አላ፟ላም
አላላከ	አላ፟ላከ
አላመነ	አላ፟መ፟ነ
አላመደ	አላ፟መደ
አላመጠ	አላ፟መ፟ጠ
አላሚ	አላ፟ሚ
አላማኝ	አላ፟ማኝ
አላሰነ	አላ፟ሰ፟ነ
አላሸ	አላሸ፟
አላሸቀ	አላሸ፟ቀ
አላቀመ	አላ፟ቀ፟መ
አላቀሰ	አላ፟ቀ፟ሰ
አላቀቀ	አላ፟ቀ፟ቀ
አላቃሽ	አላ፟ቃሽ
አላቆጠ	አላቆ፟ጠ
አላጋ	አላ፟ጋ፟
አላጋጭ	አላ፟ጋጭ
አላፊነት	አላፊነ፟ት
አልቃሻ	አልቃሻ፟
አልባሌ	አልባ፟ሌ
አልባነት	አልባነ፟ት
አልከሰከሰ	አልከሰከ፟ሰ
አልኮሰኮሰ	አልኮሰኮ፟ሰ
አልገባኝም	አልገባ፟ኝ፟ም
አልጐመጐመ	አልጐመጐ፟መ
አልጨረሰም	አልጨረ፟ሰም
አልጫ	አል፟ጫ፟
አልፈሰፈሰ	አልፈሰፈ፟ሰ
አሎሎ	አሎሎ፟
አመለመለ	አመለመ፟ለ
አመለኛ	አመለኛ፟
አመለከ	አመለ፟ከ
አመለከተ	አመለከ፟ተ
አመለጠ	አመለ፟ጠ
አመለጠው	አመለ፟ጠው
አመላለስ	አመ፟ላለ፟ስ
አመላላሽ	አመ፟ላላ፟ሽ
አመመ	አመ፟መ
አመሠራረት	አመ፟ሠራረት
አመረረ	አመረ፟ረ
አመረቀዘ	አመረቀ፟ዘ
አመረተ	አመረ፟ተ
አመራ	አመራ፟
አመራመረ	አመ፟ራመ፟ረ
አመራመር	አመ፟ራመር
አመራማሪ	አመ፟ራማሪ
አመራር	አመ፟ራር
አመሰ	አመ፟ሰ
አመሰቃቀለ	አመ፟ሰቃቀ፟ለ
አመሰቃቃይ	አመ፟ሰቃቃይ
አመሰኳ	አመሰኳ፟
አመሰገነ	አመሰገ፟ነ
አመሰጋገነ	አመሰጋገ፟ነ
አመሳሰል	አመ፟ሳሰል
አመሳቀለ	አመ፟ሳቀ፟ለ
አመሳከረ	አመ፟ሳከ፟ረ
አመሳካሪ	አመ፟ሳካሪ
አመሸ	አመ፟ሸ፟
አመሸህ	አመሸ፟ህ
አመቀ	አመ፟ቀ
አመቸ	አመቸ፟
አመቺ	አመቺ፟
አመቻቸ	አመ፟ቻቸ፟
አመነ	አመ፟ነ
አመነመነ	አመነመ፟ነ
አመነቃቀረ	አመ፟ነቃቀ፟ረ
አመነታ	አመነታ፟
አመነታታ	አመነታታ፟
አመነቸከ	አመነቸ፟ከ
አመነኰሰ	አመነኰ፟ሰ
አመነዘረ	አመነዘ፟ረ
አመነጫጨቀ	አመ፟ነጫጨ፟ቀ፟
አመናቀረ	አመ፟ናቀ፟ረ
አመናጨቀ	አመ፟ናጨ፟ቀ
አመከነ	አመከ፟ነ
አመካኘ	አመ፟ካኘ
አመዘነ	አመዘ፟ነ
አመዛዘነ	አመ፟ዛዘ፟ነ
አመዛዛኝ	አመ፟ዛዛኝ
አመገ	አመ፟ገ
አመገለ	አመ፟ገ፟ለ
አመጋገብ	አመ፟ጋገብ
አመጣጠነ	አመ፟ጣጠ፟ነ
አመጻደቀ	አመ፟ጻደ፟ቀ
አማ	አማ፟
አማለደ	አማ፟ለደ
አማላጅ	አማ፟ላጅ
አማላጅነት	አማ፟ላጅነ፟ት
አማመመ	አማመ፟መ
አማረረ	አማ፟ረ፟ረ
አማረዘ	አማ፟ረ፟ዘ
አማረገ	አማ፟ረ፟ገ
አማረጠ	አማ፟ረ፟ጠ
አማሪኛው	አማሪኛ፟ው
አማራሪ	አማ፟ራሪ
አማራጭ	አማ፟ራጭ
አማርኛ	አማርኛ፟
አማሰለ	አማ፟ሰ፟ለ
አማሸ	አማ፟ሸ፟
አማሺ	አማ፟ሺ
አማሽ	አማ፟ሽ
አማተበ	አማ፟ተ፟በ
አማታ	አማ፟ታ
አማች	አማ፟ች
አማከረ	አማከ፟ረ
አማካሪ	አማ፟ካሪ
አማካኝ	አማ፟ካኝ
አማገረ	አማ፟ገ፟ረ
አማገጠ	አማገ፟ጠ
አማጣ	አማ፟ጣ
አማጭ	አማ፟ጭ
አሜተኛ	አሜተኛ፟
አምሳኛ	አምሳኛ፟
አምሳያ	አምሳያ፟
አምስተኛ	አም፟ስተኛ፟
አምስት	አም፟ስት
አምበል	አምበል፟
አምቡላ	አምቡላ፟
አምባረቀ	አምባረ፟ቀ
አምባሻ	አምባሻ፟
አምባጋሮኛ	አምባጋሮኛ፟
አምቦልክ	አምቦልክ፟
አምቦረቀቀ	አምቦረቀ፟ቀ
አምቦጨቦጨ	አምቦጨቦ፟ጨ
አምቧቧ	አምቧቧ፟
አምታታ	አምታታ፟
አምነሸነሸ	አምነሸነ፟ሸ
አምዘገዘገ	አምዘገዘ፟ገ
አሞለጨ	አሞለ፟ጨ
አሞላ	አሞላ፟
አሞላላ	አሞ፟ላላ፟
አሞላቀቀ	አሞላቀ፟ቀ
አሞቀሞቀ	አሞቀሞ፟ቀ
አሞኘ	አሞኘ፟
አሞካከረ	አሞ፟ካከ፟ረ
አሞገሰ	አሞገ፟ሰ
አሞጋሽ	አሞጋ፟ሽ
አሞጋገሰ	አሞጋገ፟ሰ
አሞጠሞጠ	አሞጠሞ፟ጠ
አሟላ	አሟ፟ላ፟
አሟሟቀ	አሟ፟ሟቀ
አሟሟቂ	አሟ፟ሟቂ
አሟረተ	አሟረ፟ተ
አሟሸ	አሟሸ፟
አሟከረ	አሟ፟ከ፟ረ
አሟገተ	አሟ፟ገ፟ተ
አሟጋች	አሟ፟ጋች
አሠለሰ	አሠለ፟ሰ
አሠልጣኝ	አሠልጣኝ፟
አሠመረ	አሠመ፟ረ
አሠማመረ	አሠማመ፟ረ
አሠሠ	አሠ፟ሠ
አሠረ	አሠ፟ረ
አሠዋ	አሠ፟ዋ፟
አሠየመ	አሠየ፟መ
አሠገረ	አሠገ፟ረ
አሠጋ	አሠጋ፟
አሠጋገር	አሠ፟ጋገር
አሣሣ	አሣሣ፟
አሣረኛ	አሣረኛ፟
አረመ	አረ፟መ
አረመኔነት	አረመኔነ፟ት
አረሰ	አረ፟ሰ
አረሳሳ	አረሳሳ፟
አረቀ	አረ፟ቀ
አረቀቀ	አረቀ፟ቀ
አረበደ	አረ፟በ፟ደ
አረባ	አረባ፟
አረባጅ	አረባ፟ጅ
አረከሰ	አረከ፟ሰ
አረካ	አረካ፟
አረካከበ	አረ፟ካከ፟በ
አረካካቢ	አረ፟ካካቢ
አረዘመ	አረዘ፟መ
አረደ	አረ፟ደ
አረዳ	አረዳ፟
አረጀ	አረጀ፟
አረገረገ	አረገረ፟ገ
አረገበ	አረገ፟በ
አረገዘ	አረገ፟ዘ
አረገደ	አረገ፟ደ
አረገፈ	አረገ፟ፈ
አረጋ	አረጋ፟
አረጋገጠ	አረ፟ጋገ፟ጠ
አረጋገፈ	አረ፟ጋገ፟ፈ
አረጋጋ	አረ፟ጋጋ፟
አረጠ	አረ፟ጠ
አረጠረጠ	አረጠረ፟ጠ
አረፈደ	አረፈ፟ደ
አረፋፈደ	አረፋ፟ፈደ
አራ	አራ፟
አራመደ	አራ፟መ፟ደ
አራሙቻ	አራ፟ሙቻ፟
አራሚ	አራ፟ሚ
አራረሰ	አራረ፟ሰ
አራራ	አራራ፟
አራራቀ	አራ፟ራቀ
አራቈተ	አራ፟ቈተ
አራባ	አራ፟ባ
አራተኛ	አራተ፟ኛ፟
አራት	አራት፟
አራገበ	አራ፟ገ፟በ
አራገፈ	አራ፟ገ፟ፈ
አራጋፊ	አራ፟ጋ፟ፊ
አርመጠመጠ	አርመጠመ፟ጠ
አርበተበተ	አርበተበ፟ተ
አርበኛ	አርበኛ፟
አርበኛነት	አርበኛ፟ነት
አርበኝነት	አርበኝ፟ነ፟ት
አርበደበደ	አርበደበ፟ደ
አርባኛ	አርባኛ፟
አርነት	አርነ፟ት
አርአያነት	አርአያነ፟ት
አርከፈከፈ	አርከፈከ፟ፈ
አርገበገበ	አርገበገ፟በ
አርጩሜ	አርጩሜ፟
አሯሯጠ	አሯ፟ሯጠ
አሰለለ	አሰ፟ለ፟ለ
አሰለመ	አሰለ፟መ
አሰለሰለ	አሰለሰ፟ለ
አሰለበ	አሰ፟ለበ
አሰለቸ	አሰለቸ፟
አሰለፈ	አሰለ፟ፈ
አሰላ	አሰላ፟
አሰላሰለ	አሰ፟ላሰ፟ለ
አሰላይ	አሰ፟ላ፟ይ
አሰላፊ	አሰ፟ላ፟ፊ
አሰማ	አሰ፟ማ፟
አሰረ	አሰ፟ረ
አሰረቀ	አሰ፟ረቀ
አሰረዘ	አሰ፟ረ፟ዘ
አሰራጨ	አሰ፟ራጨ
አሰሰ	አሰ፟ሰ
አሰሳ	አሰ፟ሳ
አሰቀለ	አሰ፟ቀ፟ለ
አሰቀቀ	አሰ፟ቀ፟ቀ
አሰቃቂ	አሰ፟ቃ፟ቂ
አሰቃየ	አሰ፟ቃየ፟
አሰበ	አሰ፟በ
አሰበረ	አሰ፟በ፟ረ
አሰበከ	አሰበ፟ከ
አሰበጣጠረ	አሰ፟በጣጠ፟ረ
አሰባ	አሰባ፟
አሰባሰበ	አሰ፟ባሰ፟በ
አሰባጠረ	አሰ፟ባጠ፟ረ
አሰት	አሰ፟ት
አሰነቀ	አሰ፟ነ፟ቀ
አሰነበተ	አሰነበ፟ተ
አሰነካከለ	አሰ፟ነካከ፟ለ
አሰነዳዳ	አሰ፟ነዳዳ፟
አሰነጠቀ	አሰ፟ነጠ፟ቀ
አሰነፈ	አሰነ፟ፈ
አሰናበተ	አሰ፟ናበ፟ተ
አሰናከለ	አሰ፟ናከ፟ለ
አሰናካይ	አሰ፟ናካይ
አሰናዳ	አሰ፟ናዳ፟
አሰናጅ	አሰ፟ናጅ
አሰኘ	አሰ፟ኘ፟
አሰኘው	አሰ፟ኘ፟ው
አሰከረ	አሰከ፟ረ
አሰከነ	አሰከ፟ነ
አሰካ	አሰ፟ካ፟
አሰየፈ	አሰ፟የ፟ፈ
አሰደበ	አሰ፟ደ፟በ
አሰዳቢ	አሰዳ፟ቢ
አሰገደ	አሰ፟ገደ፟
አሰገገ	አሰገ፟ገ
አሰጠ	አሰ፟ጠ፟
አሰፈረ	አሰ፟ፈ፟ረ
አሰፈሰፈ	አሰፈሰ፟ፈ
አሰፈፈ	አሰፈ፟ፈ
አሰፋ	አሰ፟ፋ፟
አሳለ	አሳ፟ለ
አሳለበ	አሳለ፟በ
አሳለፈ	አሳለ፟ፈ
አሳመ	አሳ፟መ
አሳመመ	አሳመ፟መ
አሳመሰ	አሳመ፟ሰ
አሳመቀ	አሳመ፟ቀ
አሳመነ	አሳመ፟ነ
አሳማኝ	አሳማ፟ኝ
አሳሠረ	አሳሠ፟ረ
አሳረመ	አሳረ፟መ
አሳረረ	አሳ፟ረ፟ረ
አሳረሰ	አሳረ፟ሰ
አሳረደ	አሳረ፟ደ
አሳረፈ	አሳረ፟ፈ
አሳራ	አሳራ፟
አሳራሪ	አሳ፟ራሪ
አሳራሽ	አሳራ፟ሽ
አሳሰበ	አሳሰ፟በ
አሳሳመ	አሳ፟ሳመ
አሳሳቀ	አሳ፟ሳቀ
አሳሳበ	አሳ፟ሳበ
አሳሳቢ	አሳሳ፟ቢ
አሳሳተ	አሳ፟ሳተ
አሳሳች	አሳ፟ሳች
አሳሸ	አሳሸ፟
አሳሸገ	አሳሸ፟ገ
አሳቀ	አሳ፟ቀ
አሳቀለ	አሳ፟ቀ፟ለ
አሳቀቀ	አሳ፟ቀ፟ቀ
አሳቀደ	አሳቀ፟ደ
አሳቀፈ	አሳቀ፟ፈ
አሳበ	አሳ፟በ
አሳበረ	አሳ፟በ፟ረ
አሳበቀ	አሳ፟በ፟ቀ
አሳበበ	አሳ፟በ፟በ
አሳበደ	አሳበ፟ደ
አሳበጠ	አሳበ፟ጠ
አሳቢ	አሳ፟ቢ
አሳባሪ	አሳ፟ባሪ
አሳባቂ	አሳ፟ባቂ
አሳብ	አሳ፟ብ
አሳተ	አሳ፟ተ
አሳተመ	አሳተ፟መ
አሳተፈ	አሳ፟ተ፟ፈ
አሳታሚ	አሳታ፟ሚ
አሳቻ	አሳ፟ቻ፟
አሳች	አሳ፟ች
አሳነሰ	አሳነ፟ሰ
አሳነቀ	አሳነ፟ቀ
አሳነጠ	አሳነ፟ጠ
አሳነፈ	አሳ፟ነ፟ፈ
አሳከለ	አሳከ፟ለ
አሳከመ	አሳከ፟መ
አሳከረ	አሳ፟ከ፟ረ
አሳከተ	አሳከ፟ተ
አሳከከ	አሳከ፟ከ
አሳካ	አሳ፟ካ፟
አሳካሚ	አሳካ፟ሚ
አሳወቀ	አሳወ፟ቀ
አሳዘነ	አሳዘ፟ነ
አሳዘዘ	አሳዘ፟ዘ
አሳዛኝ	አሳዛ፟ኝ፟
አሳየ	አሳየ፟
አሳደለ	አሳደ፟ለ
አሳደደ	አሳ፟ደ፟ደ
አሳደገ	አሳደ፟ገ
አሳደፈ	አሳደ፟ፈ
አሳዳጅ	አሳ፟ዳጅ
አሳዳጊ	አሳዳ፟ጊ
አሳጀለ	አሳጀ፟ለ
አሳጀበ	አሳጀ፟በ
አሳገደ	አሳገ፟ደ
አሳጣ	አሳ፟ጣ፟
አሳጪ	አሳ፟ጪ
አሳፈረ	አሳ፟ፈ፟ረ
አሳፈሰ	አሳፈ፟ሰ
አሳፈነ	አሳፈ፟ነ
አሳፋሪ	አሳ፟ፋሪ
አስለመነ	አስለመ፟ነ
አስለመደ	አስለመ፟ደ
አስለማ	አስለማ፟
አስለማጅ	አስለማ፟ጅ
አስለሰነ	አስለሰ፟ነ
አስለቀለቀ	አስለቀለ፟ቀ
አስለቀመ	አስለቀ፟መ
አስለቀሰ	አስለቀ፟ሰ
አስለቀቀ	አስለቀ፟ቀ
አስለቃሽ	አስለቃ፟ሽ
አስለበለበ	አስለበለ፟በ
አስለበሰ	አስለበ፟ሰ
አስለበበ	አስለበ፟በ
አስለበደ	አስለበ፟ደ
አስለበጠ	አስለበ፟ጠ
አስለጎመ	አስለጎ፟መ
አስለፈለፈ	አስለፈለ፟ፈ
አስለፈፈ	አስለፈ፟ፈ
አስለፋ	አስለፋ፟
አስመለሰ	አስመለ፟ሰ
አስመለከተ	አስመለከ፟ተ
አስመለጠ	አስመለ፟ጠ
አስመሠረተ	አስመሠ፟ረተ
አስመረመረ	አስመረመ፟ረ
አስመረረ	አስመረ፟ረ
አስመረቀ	አስመረ፟ቀ
አስመረዘ	አስመረ፟ዘ
አስመረገ	አስመረ፟ገ
አስመረጠ	አስመረ፟ጠ
አስመራ	አስመራ፟
አስመሰለ	አስመሰ፟ለ
አስመሰከረ	አስመሰከ፟ረ
አስመሰገነ	አስመሰገ፟ነ
አስመሳይ	አስመሳ፟ይ
አስመሸ	አስመሸ፟
አስመሸገ	አስመሸ፟ገ
አስመተረ	አስመተ፟ረ
አስመታ	አስመታ፟
አስመነታ	አስመነታ፟
አስመነነ	አስመነ፟ነ
አስመነኰሰ	አስመነኰ፟ሰ
አስመነዘረ	አስመነዘ፟ረ
አስመኘ	አስመኘ፟
አስመከረ	አስመከ፟ረ
አስመዘነ	አስመዘ፟ነ
አስመዘዘ	አስመዘ፟ዘ
አስመዘገበ	አስመዘገ፟በ
አስመደበ	አስመደ፟በ
አስመገበ	አስመገ፟በ
አስመጠወተ	አስመጠወ፟ተ
አስማማ	አስማማ፟
አስማተኛ	አስማተኛ፟
አስማገረ	አስማገ፟ረ
አስሞላ	አስሞላ፟
አስሞረደ	አስሞረ፟ደ
አስሞከተ	አስሞከ፟ተ
አስሞገተ	አስሞገ፟ተ
አስሞጨለፈ	አስሞጨለ፟ፈ
አስረረ	አስ፟ረ፟ረ
አስረሳ	አስረሳ፟
አስረቀቀ	አስረቀ፟ቀ
አስረበረበ	አስረበረ፟በ
አስረከበ	አስረከ፟በ
አስረካቢ	አስረካ፟ቢ
አስረዳ	አስረዳ፟
አስረጀ	አስረጀ፟
አስረገመ	አስረገ፟መ
አስረገዘ	አስረገ፟ዘ
አስረገጠ	አስረገ፟ጠ
አስረገፈ	አስረገ፟ፈ
አስረፈደ	አስረፈ፟ደ
አስቀለሰ	አስቀለ፟ሰ
አስቀለበሰ	አስቀለበ፟ሰ
አስቀለጠ	አስቀለ፟ጠ
አስቀመለ	አስቀመ፟ለ
አስቀመመ	አስቀመ፟መ
አስቀመሰ	አስቀመ፟ሰ
አስቀመቀመ	አስቀመቀ፟መ
አስቀመጠ	አስቀመ፟ጠ
አስቀማ	አስቀማ፟
አስቀሠፈ	አስቀሠ፟ፈ
አስቀረ	አስቀረ፟
አስቀረደደ	አስቀረደ፟ደ
አስቀረጠ	አስቀረ፟ጠ
አስቀረጸ	አስቀረ፟ጸ
አስቀረፈ	አስቀረ፟ፈ
አስቀሰተ	አስቀሰ፟ተ
አስቀሳፈተ	አስቀሳፈ፟ተ
አስቀቀለ	አስቀቀ፟ለ
አስቀበለ	አስቀበ፟ለ
አስቀበረ	አስቀበ፟ረ
አስቀበቀበ	አስቀበቀ፟በ
አስቀባ	አስቀባ፟
አስቀነሰ	አስቀነ፟ሰ
አስቀና	አስቀና፟
አስቀዘነ	አስቀዘ፟ነ
አስቀዘፈ	አስቀዘ፟ፈ
አስቀየመ	አስቀየ፟መ
አስቀየሠ	አስቀየ፟ሠ
አስቀየደ	አስቀየ፟ደ
አስቀየጠ	አስቀየ፟ጠ
አስቀያሚ	አስቀያ፟ሚ
አስቀደመ	አስቀደ፟መ
አስቀደሰ	አስቀደ፟ሰ
አስቀደደ	አስቀደ፟ደ
አስቀዳ	አስቀዳ፟
አስቀዳሽ	አስቀዳ፟ሽ
አስቀድሞ	አስቀድ፟ሞ
አስቀጠቀጠ	አስቀጠቀ፟ጠ
አስቀፈቀፈ	አስቀፈቀ፟ፈ
አስቀፈደደ	አስቀፈደ፟ደ
አስቂኝ	አስ፟ቂኝ፟
አስቃረመ	አስቃረ፟መ
አስቆለለ	አስቆለ፟ለ
አስቆለፈ	አስቆለ፟ፈ
አስቆላ	አስቆላ፟
አስቆረሰ	አስቆረ፟ሰ
አስቆየ	አስቆየ፟
አስቆፈረ	አስቆፈ፟ረ
አስቈለመመ	አስቈለመ፟መ
አስቈረቈረ	አስቈረቈ፟ረ
አስቈረበ	አስቈረ፟በ
አስቈረጠ	አስቈረ፟ጠ
አስቈራ	አስቈራ፟
አስበላ	አስበላ፟
አስበረቀሰ	አስበረቀ፟ሰ
አስበረበረ	አስበረበ፟ረ
አስበረዘ	አስበረ፟ዘ
አስበረደ	አስበረ፟ደ
አስበረገገ	አስበረገ፟ገ
አስበራ	አስበራ፟
አስበሰለ	አስበሰ፟ለ
አስበተነ	አስበተ፟ነ
አስበከለ	አስበከ፟ለ
አስበዘበዘ	አስበዘበ፟ዘ
አስበየነ	አስበየ፟ነ
አስበየደ	አስበየ፟ደ
አስበደለ	አስበደ፟ለ
አስበዳ	አስበዳ፟
አስበጂ	አስበጂ፟
አስበጠበጠ	አስበጠበ፟ጠ
አስባረከ	አስባረ፟ከ
አስተለተለ	አስተለተ፟ለ
አስተላለቀ	አስተላለ፟ቀ
አስተላለፈ	አስተላለ፟ፈ
አስተመተመ	አስተመተ፟መ
አስተማመነ	አስተማመ፟ነ
አስተማረ	አስተማ፟ረ
አስተሣሠረ	አስተሣሠ፟ረ
አስተረተረ	አስተረተ፟ረ
አስተረጐመ	አስተረጐ፟መ
አስተራረሰ	አስተራረ፟ሰ
አስተሳሰበ	አስተሳሰ፟በ
አስተሻሸ	አስተሻሸ፟
አስተባበለ	አስተባበ፟ለ
አስተባበረ	አስተባበ፟ረ
አስተቸ	አስተቸ፟
አስተነተነ	አስተነተ፟ነ
አስተነፈሰ	አስተነፈ፟ሰ
አስተናበረ	አስተናበ፟ረ
አስተናገደ	አስተናገ፟ደ
አስተኛ	አስተ፟ኛ
አስተከዘ	አስተከ፟ዘ
አስተካከለ	አስተካከ፟ለ
አስተኰሰ	አስተኰ፟ሰ
አስተዋወቀ	አስተዋወ፟ቀ
አስተዛዘበ	አስተዛዘ፟በ
አስተያየ	አስተያየ፟
አስተዳደረ	አስተዳደ፟ረ
አስተጋባ	አስተጋባ፟
አስተፋ	አስተፋ፟
አስታረቀ	አስታረ፟ቀ
አስታቀፈ	አስታቀ፟ፈ
አስታከከ	አስታከ፟ከ
አስታወሰ	አስታወ፟ሰ
አስታወቀ	አስታወ፟ቀ
አስታገሠ	አስታገ፟ሠ
አስታጐለ	አስታጐ፟ለ
አስቸረቸረ	አስቸ፟ረቸ፟ረ
አስቸነከረ	አስቸነከ፟ረ
አስቸከለ	አስቸከ፟ለ
አስቸኰለ	አስቸኰ፟ለ
አስቸኳይ	አስቸኳ፟ይ
አስቸገረ	አስቸገ፟ረ
አስቸጋሪ	አስቸጋ፟ሪ
አስነሣ	አስነ፟ሣ
አስነረተ	አስነረ፟ተ
አስነሰነሰ	አስነሰነ፟ሰ
አስነሺ	አስነሺ፟
አስነቀለ	አስነቀ፟ለ
አስነቀሰ	አስነቀ፟ሰ
አስነቀፈ	አስነቀ፟ፈ
አስነቃፊ	አስነቃ፟ፊ
አስነበበ	አስነበ፟በ
አስነከረ	አስነከ፟ረ
አስነከሰ	አስነከ፟ሰ
አስነካ	አስነካ፟
አስነወረ	አስነወ፟ረ
አስነዋሪ	አስነዋ፟ሪ
አስነደለ	አስነደ፟ለ
አስነደፈ	አስነደ፟ፈ
አስነዳ	አስነዳ፟
አስነገረ	አስነገ፟ረ
አስነገተ	አስነገ፟ተ
አስነገደ	አስነገ፟ደ
አስነጋ	አስነጋ፟
አስነጐረ	አስነጐ፟ረ
አስነፈሰ	አስነፈ፟ሰ
አስነፋ	አስነፋ፟
አስከለለ	አስከለ፟ለ
አስከለበሰ	አስከለበ፟ሰ
አስከለከለ	አስከለከ፟ለ
አስከመረ	አስከመ፟ረ
አስከረተፈ	አስከረተ፟ፈ
አስከረከመ	አስከረከ፟መ
አስከሰለ	አስከሰ፟ለ
አስከሰሰ	አስከሰ፟ሰ
አስከሰከሰ	አስከሰከ፟ሰ
አስከበረ	አስከበ፟ረ
አስከበበ	አስከበ፟በ
አስከባሪ	አስከባ፟ሪ
አስከተለ	አስከተ፟ለ
አስከተረ	አስከተ፟ረ
አስከተበ	አስከተ፟በ
አስከተተ	አስከተ፟ተ
አስከተከተ	አስከተከ፟ተ
አስከነዳ	አስከነ፟ዳ
አስከደነ	አስከደ፟ነ
አስከዳ	አስከዳ፟
አስከፈለ	አስከፈ፟ለ
አስከፈነ	አስከፈ፟ነ
አስከፈከፈ	አስከፈከ፟ፈ
አስከፈፈ	አስከፈ፟ፈ
አስከፊ	አስከፊ፟
አስከፋ	አስከፋ፟
አስካካ	አስካካ፟
አስኮላሸ	አስኮላሸ፟
አስኮረጀ	አስኮረ፟ጀ
አስኮረፈ	አስኮረ፟ፈ
አስኮበለለ	አስኮበለ፟ለ
አስኮተኮተ	አስኮተኮ፟ተ
አስኰነነ	አስኰነ፟ነ
አስኰናኝ	አስኰና፟ኝ
አስወለቀ	አስወለ፟ቀ
አስወለደ	አስወለ፟ደ
አስወረረ	አስወረ፟ረ
አስወረወረ	አስወረወ፟ረ
አስወረደ	አስወረ፟ደ
አስወራ	አስወራ፟
አስወሰነ	አስወሰ፟ነ
አስወሰደ	አስወሰ፟ደ
አስወቀረ	አስወቀ፟ረ
አስወቀጠ	አስወቀ፟ጠ
አስወቃ	አስወቃ፟
አስወተፈ	አስወተ፟ፈ
አስወነጀለ	አስወነጀ፟ለ
አስወደደ	አስወደ፟ደ
አስወገረ	አስወገ፟ረ
አስወገደ	አስወገ፟ደ
አስወጋ	አስወጋ፟
አስዋኘ	አስዋኘ፟
አስደለደለ	አስደለደ፟ለ
አስደመረ	አስደመ፟ረ
አስደመሰሰ	አስደመሰ፟ሰ
አስደረተ	አስደረ፟ተ
አስደረደረ	አስደረደ፟ረ
አስደረገ	አስደረ፟ገ
አስደራጊ	አስደራ፟ጊ
አስደሰተ	አስደሰ፟ተ
አስደሳች	አስደሳ፟ች
አስደቀቀ	አስደቀ፟ቀ
አስደበለቀ	አስደበለ፟ቀ
አስደበቀ	አስደበ፟ቀ
አስደባለቀ	አስደባለ፟ቀ
አስደነሰ	አስደነ፟ሰ
አስደነቀ	አስደነ፟ቀ
አስደነበረ	አስደነበ፟ረ
አስደነገጠ	አስደነገ፟ጠ
አስደናቂ	አስደና፟ቂ
አስደወለ	አስደወ፟ለ
አስደገመ	አስደገ፟መ
አስደገሰ	አስደገ፟ሰ
አስደገደገ	አስደገደ፟ገ
አስደፈረ	አስደፈ፟ረ
አስደፈቀ	አስደፈ፟ቀ
አስደፈነ	አስደፈ፟ነ
አስደፈጠ	አስደፈ፟ጠ
አስጀመረ	አስጀመ፟ረ
አስገለበጠ	አስገለበ፟ጠ
አስገመሰ	አስገመ፟ሰ
አስገመተ	አስገመ፟ተ
አስገመገመ	አስገመገ፟መ
አስገረመ	አስገረ፟መ
አስገረዘ	አስገረ፟ዘ
አስገራ	አስገራ፟
አስገራሚ	አስገራ፟ሚ
አስገባ	አስገባ፟
አስገነዘበ	አስገነዘ፟በ
አስገኘ	አስገኘ፟
አስገዘተ	አስገዘ፟ተ
አስገደለ	አስገደ፟ለ
አስገደደ	አስገደ፟ደ
አስገደፈ	አስገደ፟ፈ
አስጎመጀ	አስጎመጀ፟
አስጐበኘ	አስጐበኘ፟
አስጐነበሰ	አስጐነበ፟ሰ
አስጠለለ	አስጠለ፟ለ
አስጠላ	አስጠላ፟
አስጠመደ	አስጠመ፟ደ
አስጠማ	አስጠማ፟
አስጠራ	አስጠራ፟
አስጠቃ	አስጠቃ፟
አስጠነቀቀ	አስጠነቀ፟ቀ
አስጠና	አስጠና፟
አስጠኚ	አስጠኚ፟
አስጠየፈ	አስጠየ፟ፈ
አስጠያፊ	አስጠያ፟ፊ
አስጠይ	አስጠይ፟
አስጠገነ	አስጠገ፟ነ
አስጠጋ	አስጠጋ፟
አስጨመረ	አስጨመ፟ረ
አስጨመቀ	አስጨመ፟ቀ
አስጨበጨበ	አስጨበጨ፟በ
አስጨነቀ	አስጨነ፟ቀ
አስጨናቂ	አስጨና፟ቂ
አስጨፈለቀ	አስጨፈለ፟ቀ
አስጨፈረ	አስጨፈ፟ረ
አስጸየፈ	አስጸ፟የ፟ፈ
አስጸያፊ	አስጸ፟ያ፟ፊ
አስፈለገ	አስፈለ፟ገ
አስፈለገኝ	አስፈለ፟ገኝ፟
አስፈለፈለ	አስፈለፈ፟ለ
አስፈላ	አስፈላ፟
አስፈረመ	አስፈረ፟መ
አስፈረደ	አስፈ፟ረደ
አስፈሪ	አስፈሪ፟
አስፈራ	አስፈራ፟
አስፈራራ	አስፈራራ፟
አስፈሳ	አስፈሳ፟
አስፈሳው	አስፈሳ፟ው
አስፈቀደ	አስፈቀ፟ደ
አስፈተሸ	አስፈተ፟ሸ
አስፈተነ	አስፈተ፟ነ
አስፈተገ	አስፈተ፟ገ
አስፈታ	አስፈታ፟
አስፈጀ	አስፈጀ፟
አስፋፋ	አስፋፋ፟
አሶመሰመ	አሶመሰ፟መ
አሸ	አሸ፟
አሸለለ	አሸ፟ለ፟ለ
አሸለመ	አሸለ፟መ
አሸለቀቀ	አሸ፟ለቀ፟ቀ
አሸለበ	አሸለ፟በ
አሸለተ	አሸ፟ለ፟ተ
አሸመ	አሸ፟መ
አሸመተ	አሸመ፟ተ
አሸመገለ	አሸመገ፟ለ
አሸመጠጠ	አሸ፟መጠ፟ጠ
አሸረሞጠ	አሸረሞ፟ጠ
አሸረጠ	አሸረ፟ጠ
አሸረፈ	አሸረ፟ፈ
አሸሸ	አሸ፟ሸ
አሸሸገ	አሸ፟ሸ፟ገ
አሸቀለ	አሸ፟ቀ፟ለ
አሸቀበ	አሸቀ፟በ
አሸበረ	አሸ፟በ፟ረ
አሸበረቀ	አሸበረ፟ቀ
አሸበሸበ	አሸበሸ፟በ
አሸበበ	አሸ፟በ፟በ
አሸበተ	አሸበ፟ተ
አሸባሪ	አሸ፟ባ፟ሪ
አሸተተ	አሸተ፟ተ
አሸነሸነ	አሸ፟ነሸ፟ነ
አሸነፈ	አሸ፟ነ፟ፈ
አሸና	አሸ፟ና፟
አሸናፊ	አሸ፟ና፟ፊ
አሸኘ	አሸ፟ኘ፟
አሸኛኘት	አሸ፟ኛኘት
አሸከመ	አሸ፟ከ፟መ
አሸካሸከ	አሸ፟ካሸ፟ከ
አሸዋማ	አሸዋማ፟
አሸዋነት	አሸዋነ፟ት
አሸገ	አሸ፟ገ
አሸጋሸገ	አሸ፟ጋሸ፟ገ
አሸጋገረ	አሸ፟ጋገ፟ረ
አሸጠ	አሸ፟ጠ
አሸፈተ	አሸፈ፟ተ
አሸፈነ	አሸ፟ፈ፟ነ
አሻለ	አሻ፟ለ
አሻማ	አሻ፟ማ፟
አሻረ	አሻ፟ረ
አሻረከ	አሻ፟ረ፟ከ
አሻሸ	አሻሸ፟
አሻሻለ	አሻ፟ሻለ
አሻሻጠ	አሻ፟ሻጠ
አሻሻጭ	አሻ፟ሻጭ
አሻቀበ	አሻቀ፟በ
አሻንጉሊት	አሻንጉሊ፟ት
አሻከረ	አሻከ፟ረ
አሻገረ	አሻገ፟ረ
አሻገተ	አሻገ፟ተ
አሻፈረኝ	አሻፈ፟ረኝ
አሻፈደ	አሻፈ፟ደ
አሽሙረኛ	አሽሙረኛ፟
አሽሟጣጭነት	አሽሟጣጭነ፟ት
አሽቀዳደመ	አሽቀዳደ፟መ
አሽቆጠቆጠ	አሽቆጠቆ፟ጠ
አሽበለበለ	አሽበለበ፟ለ
አሽታ	አሽ፟ታ
አሽከረከረ	አሽከረከ፟ረ
አሽከርነት	አሽከርነ፟ት
አሽካካ	አሽካ፟ካ
አሽኮረመመ	አሽኮረመ፟መ
አሾለቀ	አሾለ፟ቀ
አሾለከ	አሾለ፟ከ
አሾላቂ	አሾላ፟ቂ
አሾመ	አሾ፟መ
አሾከሾከ	አሾከሾ፟ከ
አቀለለ	አቀለ፟ለ
አቀለመ	አቀለ፟መ
አቀለጠ	አቀለ፟ጠ
አቀላ	አቀላ፟
አቀላል	አቀ፟ላል
አቀላቀለ	አቀ፟ላቀ፟ለ
አቀላጠፈ	አቀ፟ላጠ፟ፈ
አቀመሰ	አቀመ፟ሰ
አቀማመጥ	አቀ፟ማመጥ
አቀማጠለ	አቀ፟ማጠ፟ለ
አቀረረ	አቀረ፟ረ
አቀረቀረ	አቀረቀ፟ረ
አቀረበ	አቀረ፟በ
አቀረና	አቀረና፟
አቀረጣጠፈ	አቀ፟ረጣጠ፟ፈ
አቀራረበ	አቀ፟ራረ፟በ
አቀሰሰ	አቀሰ፟ሰ
አቀበለ	አቀበ፟ለ
አቀበጠ	አቀበ፟ጠ
አቀባበለ	አቀ፟ባበ፟ለ
አቀባበረ	አቀ፟ባበ፟ረ
አቀባባይ	አቀ፟ባባይ
አቀባይ	አቀባ፟ይ
አቀነቀነ	አቀነቀ፟ነ
አቀነበጠ	አቀነበ፟ጠ
አቀነባበረ	አቀ፟ነባበ፟ረ
አቀነባባሪ	አቀ፟ነባባ፟ሪ
አቀና	አቀና፟
አቀናበረ	አቀ፟ናበ፟ረ
አቀናበር	አቀ፟ናበ፟ር
አቀናባሪ	አቀ፟ናባሪ
አቀናነሰ	አቀ፟ናነ፟ሰ
አቀዘቀዘ	አቀዘቀ፟ዘ
አቀዛቀዘ	አቀ፟ዛቀዘ
አቀያየረ	አቀ፟ያየ፟ረ
አቀያየደ	አቀያየ፟ደ
አቀያየጠ	አቀ፟ያየ፟ጠ
አቀዳጀ	አቀዳጀ፟
አቀጣጠረ	አቀ፟ጣጠረ
አቀጣጠነ	አቀ፟ጣጠነ
አቀፈ	አቀ፟ፈ
አቀፍ	አቀ፟ፍ
አቁለጨለጨ	አቁለጨለ፟ጨ
አቁላላ	አቁላላ፟
አቁነጠነጠ	አቁነጠነ፟ጠ
አቃለለ	አቃ፟ለ፟ለ
አቃመሰ	አቃመ፟ሰ
አቃረበ	አቃ፟ረበ
አቃራመ	አቃ፟ራ፟መ
አቃሰተ	አቃሰ፟ተ
አቃበረ	አቃ፟በ፟ረ
አቃባ	አቃ፟ባ፟
አቃነሰ	አቃ፟ነ፟ሰ
አቃና	አቃ፟ና፟
አቃወሰ	አቃወ፟ሰ
አቃዋሽ	አቃ፟ዋሽ
አቃዠ	አቃዠ፟
አቃጠለ	አቃ፟ጠ፟ለ
አቃጠረ	አቃ፟ጠረ
አቃጠፈ	አቃ፟ጠ፟ፈ
አቃጣሪ	አቃ፟ጣሪ
አቅለሸለሸ	አቅለሸለ፟ሸ
አቅለበለበ	አቅለበለ፟በ
አቅማማ	አቅማማ፟
አቅራቢያ	አቅራቢ፟ያ
አቅበዘበዘ	አቅበዘበ፟ዘ
አቅነዘነዘ	አቅነዘነ፟ዘ
አቅጣጫ	አቅጣጫ፟
አቆለቆለ	አቆለቆ፟ለ
አቆላለፈ	አቆ፟ላለ፟ፈ
አቆላመጠ	አቆ፟ላመ፟ጠ
አቆራኘ	አቆ፟ራኘ፟
አቆሸሸ	አቆሸ፟ሸ
አቆነጀ	አቆነጀ፟
አቆየ	አቆየ፟
አቆጠቆጠ	አቆጠቆ፟ጠ
አቈለቈለ	አቈለቈ፟ለ
አቈላለፈ	አቈላለ፟ፈ
አቈረቈዘ	አቈረቈ፟ዘ
አቈረበ	አቈረ፟በ
አቈረፈደ	አቈረፈ፟ደ
አቈራመደ	አቈ፟ራመ፟ደ
አቈራረጠ	አቈ፟ራረ፟ጠ
አቈሰለ	አቈሰ፟ለ
አቈሳሰለ	አቈሳሰ፟ለ
አቈነሰ	አቈነ፟ሰ
አቈጣጠረ	አቈ፟ጣጠ፟ረ
አቋለፈ	አቋ፟ለ፟ፈ
አቋመጠ	አቋመ፟ጠ
አቋረጠ	አቋ፟ረ፟ጠ
አቋራጭ	አቋ፟ራጭ
አቋቋመ	አቋ፟ቋመ
አቋቋሚ	አቋ፟ቋሚ
አቋቋም	አቋ፟ቋም
አቋፈረ	አቋ፟ፈ፟ረ
አበለ	አበ፟ለ
አበለዘ	አበለ፟ዘ
አበለጠ	አበለ፟ጠ
አበላ	አበላ፟
አበላለጠ	አበላለ፟ጠ
አበላሸ	አበላሸ፟
አበል	አበል፟
አበረ	አበ፟ረ
አበረረ	አበረ፟ረ
አበረታ	አበረታ፟
አበረከተ	አበረከ፟ተ
አበረደ	አበረ፟ደ
አበረገገ	አበረገ፟ገ
አበራ	አበራ፟
አበራከተ	አበ፟ራከ፟ተ
አበራየ	አበራየ፟
አበር	አበ፟ር
አበሰ	አበ፟ሰ
አበሰለ	አበሰ፟ለ
አበሰረ	አበሰ፟ረ
አበሰበሰ	አበሰበ፟ሰ
አበሳጨ	አበ፟ሳጨ፟
አበሸቀ	አበሸ፟ቀ
አበሸቀጠ	አበ፟ሸቀ፟ጠ
አበሻቀጠ	አበ፟ሻቀ፟ጠ
አበቀለ	አበቀ፟ለ
አበቃ	አበቃ፟
አበቃቃ	አበ፟ቃቃ፟
አበበ	አበ፟በ
አበባማ	አበባማ፟
አበታተነ	አበ፟ታተ፟ነ
አበከተ	አበከ፟ተ
አበካከነ	አበካከ፟ነ
አበዛ	አበዛ፟
አበደረ	አበደ፟ረ
አበዳሪ	አበዳ፟ሪ
አበጀ	አበጀ፟
አበጃጀ	አበጃጀ፟
አበገነ	አበገ፟ነ
አበጠ	አበ፟ጠ
አበጣበጠ	አበ፟ጣበ፟ጠ
አበጣባጭ	አበ፟ጣባጭ
አባ	አባ፟
አባለገ	አባለ፟ገ
አባለጠ	አባለ፟ጠ
አባላ	አባላ፟
አባልነት	አባልነ፟ት
አባረረ	አባ፟ረ፟ረ
አባረቀ	አባረ፟ቀ
አባራ	አባራ፟
አባራሪ	አባ፟ራሪ
አባቃ	አባቃ፟
አባበለ	አባበ፟ለ
አባበጠ	አባበ፟ጠ
አባባ	አባ፟ባ፟
አባባለ	አባ፟ባለ
አባባል	አባ፟ባል
አባባሰ	አባ፟ባሰ
አባቴ	አባ፟ቴ
አባት	አባ፟ት
አባነነ	አባነ፟ነ
አባከነ	አባከ፟ነ
አባካኝ	አባካኝ፟
አባወራ	አባ፟ወራ፟
አባዛ	አባዛ፟
አባዥ	አባ፟ዥ
አባዬ	አባ፟ዬ
አባይ	አባ፟ይ
አባይነት	አባይነ፟ት
አባዳ	አባ፟ዳ
አባጨጓሬ	አባ፟ጨጓ፟ሬ፟
አብላላ	አብላ፟ላ
አብረቀረቀ	አብረቀረ፟ቀ
አብረከረከ	አብረከረ፟ከ
አብራራ	አብራራ፟
አብሰለሰለ	አብሰለሰ፟ለ
አብቃቃ	አብቃቃ፟
አብነት	አብነ፟ት
አብዛኛው	አብዛኛ፟ው
አብዛኛውን	አብዛኛ፟ውን
አቦ	አቦ፟
አቦነነ	አቦነ፟ነ
አቦካ	አቦካ፟
አቦዘነ	አቦዘ፟ነ
አቧለተ	አቧለ፟ተ
አቧራማ	አቧራ፟ማ
አቧደነ	አቧ፟ደ፟ነ
አተላ	አተላ፟
አተመ	አተ፟መ
አተመተመ	አተመተ፟መ
አተረማመሰ	አተ፟ረማመ፟ሰ
አተረፈ	አተረ፟ፈ
አተራመሰ	አተ፟ራመ፟ሰ
አተራማሽ	አተ፟ራማሽ
አተራረፈ	አተራረ፟ፈ
አተራተረ	አተ፟ራተ፟ረ
አተበ	አተ፟በ
አተተ	አተ፟ተ
አተኛኘት	አተ፟ኛኘት
አተኛኝ	አተ፟ኛኝ
አተከነ	አተከ፟ነ
አተኮረ	አተኮ፟ረ
አተኰሰ	አተኰ፟ሰ
አታለለ	አታ፟ለለ
አታላይ	አታ፟ላይ
አታሚ	አታ፟ሚ
አታቢ	አታ፟ቢ
አታች	አታ፟ች
አታከለ	አታ፟ከ፟ለ
አታከተ	አታከ፟ተ
አታገለ	አታ፟ገ፟ለ
አታጋይ	አታ፟ጋይ
አትራ	አት፟ራ
አትክልተኛ	አትክልተ፟ኛ
አትጠራጠር	አት፟ጠ፟ራጠር
አቶሰቶሰ	አቶሰቶ፟ሰ
አቶፈቶፈ	አቶፈቶ፟ፈ
አቸነፈ	አቸ፟ነ፟ፈ
አቻ	አቻ፟
አቻምና	አቻ፟ምና
አቻቻለ	አቻ፟ቻለ
አቻኳይ	አቻ፟ኳይ
አነሣ	አነሣ፟
አነሣሣ	አነ፟ሣሣ፟
አነሣሽ	አነ፟ሣሽ
አነሰ	አነ፟ሰ
አነሰረ	አነሰ፟ረ
አነስተኛ	አነስተኛ፟
አነቀ	አነ፟ቀ
አነቀዘ	አነቀ፟ዘ
አነቀፈ	አነቀ፟ፈ
አነቃ	አነቃ፟
አነቃቂ	አነ፟ቃቂ
አነቃቃ	አነ፟ቃቃ፟
አነቃነቀ	አነ፟ቃነ፟ቀ
አነቃናቂ	አነ፟ቃናቂ
አነቈረ	አነቈ፟ረ
አነበበ	አነበ፟በ
አነበነበ	አነበነ፟በ
አነበዘ	አነበ፟ዘ
አነባ	አነባ፟
አነባበረ	አነ፟ባበ፟ረ
አነባበሮ	አነ፟ባበሮ
አነባበበ	አነባበ፟በ
አነታረከ	አነ፟ታረ፟ከ
አነኈለለ	አነኈለ፟ለ
አነከሰ	አነከ፟ሰ
አነከተ	አነከ፟ተ
አነካከሰ	አነካከ፟ሰ
አነካኪ	አነ፟ካኪ
አነካካ	አነ፟ካካ፟
አነኰረ	አነኰ፟ረ
አነኰተ	አነኰ፟ተ
አነኳኰተ	አነኳኰ፟ተ
አነወረ	አነወ፟ረ
አነዘረ	አነዘ፟ረ
አነደደ	አነደ፟ደ
አነዳድ	አነ፟ዳድ
አነገሠ	አነገ፟ሠ
አነገበ	አነገ፟በ
አነገተ	አነገ፟ተ
አነጋ	አነጋ፟
አነጋገር	አነ፟ጋገር
አነጋጋ	አነጋጋ፟
አነጋጋሪ	አነ፟ጋጋሪ
አነጐረ	አነጐ፟ረ
አነጐተ	አነጐ፟ተ
አነጐድ	አነጐ፟ድ
አነጠ	አነ፟ጠ
አነጠነጠ	አነጠነ፟ጠ
አነጣጠለ	አነ፟ጣጠ፟ለ
አነጣጠረ	አነ፟ጣጠ፟ረ
አነጣጣሪ	አነ፟ጣጣሪ
አነጫነጨ	አነጫነ፟ጨ
አነጻጸረ	አነ፟ጻጸ፟ረ
አነፈረ	አነፈ፟ረ
አነፈረቀ	አነፈረ፟ቀ
አነፈሰ	አነፈ፟ሰ
አነፈነ	አነ፟ፈነ
አነፈነፈ	አነፈነ፟ፈ
አነፋረቀ	አነ፟ፋረ፟ቀ
አነፋፈሰ	አነፋፈ፟ሰ
አናረ	አና፟ረ
አናቀለ	አና፟ቀ፟ለ
አናበበ	አና፟በ፟በ
አናባቢ	አና፟ባቢ
አናከሰ	አና፟ከ፟ሰ
አናኪ	አና፟ኪ
አናካ	አና፟ካ፟
አናዘዘ	አና፟ዘ፟ዘ
አናዛዥ	አና፟ዛዥ
አናደደ	አና፟ደ፟ደ
አናደፈ	አና፟ደ፟ፈ
አናዳ	አና፟ዳ፟
አናዳጅ	አና፟ዳጅ
አናገሠ	አና፟ገ፟ሠ
አናገረ	አና፟ገ፟ረ
አናጊ	አና፟ጊ
አናጋ	አና፟ጋ፟
አናጋሪ	አና፟ጋሪ
አናጋሽ	አና፟ጋሽ
አናጠቀ	አና፟ጠ፟ቀ
አናጠበ	አና፟ጠ፟በ
አናጠፈ	አና፟ጠፈ
አናጢነት	አናጢነ፟ት
አናፈሰ	አና፟ፈ፟ሰ
አናፋ	አናፋ፟
አንሰፈሰፈ	አንሰፈሰ፟ፈ
አንሸረሸረ	አንሸረሸ፟ረ
አንሸዋረረ	አንሸዋረ፟ረ
አንሻተተ	አንሻተ፟ተ
አንሻፈፈ	አንሻፈ፟ፈ
አንሾካሾከ	አንሾካሾከ፟
አንሿከከ	አንሿከ፟ከ
አንሿካኪ	አንሿካ፟ኪ
አንቀለቀለ	አንቀለቀ፟ለ
አንቀላፋ	አንቀላፋ፟
አንቀረበበ	አንቀረበ፟በ
አንቀረፈፈ	አንቀረፈ፟ፈ
አንቀሰቀሰ	አንቀሰቀ፟ሰ
አንቀሳቀሰ	አንቀሳቀ፟ሰ
አንቀባረረ	አንቀባረ፟ረ
አንቀዋለለ	አንቀዋለ፟ለ
አንቀጠቀጠ	አንቀጠቀ፟ጠ
አንቃረረ	አንቃረ፟ረ
አንቆረቆረ	አንቆረቆ፟ረ
አንቋሸሸ	አንቋሸ፟ሸ
አንበለበለ	አንበለበ፟ለ
አንበረከከ	አንበረከ፟ከ
አንበሳ	አንበሳ፟
አንበሸበሸ	አንበሸበ፟ሸ
አንቦራቀቀ	አንቦራቀ፟ቀ
አንቦገቦገ	አንቦገቦ፟ገ
አንቦጨቦጨ	አንቦጨ፟ቦ፟ጨ
አንቦጫቦጨ	አንቦጫ፟ቦ፟ጨ
አንተላከሰ	አንተላከ፟ሰ
አንተረከከ	አንተረከ፟ከ
አንተከተከ	አንተከተ፟ከ
አንተገተገ	አንተገተ፟ገ
አንቺዬ	አንቺዬ፟
አንከረፈፈ	አንከረፈ፟ፈ
አንከራተተ	አንከራተ፟ተ
አንከበከበ	አንከበከ፟በ
አንከባለለ	አንከባለ፟ለ
አንከባከበ	አንከባከ፟በ
አንከተከተ	አንከተከ፟ተ
አንከታከተ	አንከታከ፟ተ
አንከፈረረ	አንከፈረ፟ረ
አንካላ	አንካላ፟
አንካሳ	አንካሳ፟
አንካሴ	አንካሴ፟
አንኳሰሰ	አንኳሰ፟ሰ
አንኳኳ	አንኳኳ፟
አንዘላዘለ	አንዘላዘ፟ለ
አንዘረፈጠ	አንዘረፈ፟ጠ
አንዘረፈፈ	አንዘረፈ፟ፈ
አንዘፈዘፈ	አንዘፈዘ፟ፈ
አንዛረጠ	አንዛረ፟ጠ
አንዛዛ	አንዛዛ፟
አንዠቀዘቀ	አንዠቀዘ፟ቀ
አንዠቀዠቀ	አንዠቀዠ፟ቀ
አንዣበበ	አንዣበ፟በ
አንዣባቢ	አንዣባ፟ቢ
አንደላቀቀ	አንደላቀ፟ቀ
አንደረበበ	አንደረበ፟በ
አንደቀደቀ	አንደቀደ፟ቀ
አንደበደበ	አንደበደ፟በ
አንደባለለ	አንደባለ፟ለ
አንደኛ	አንደኛ፟
አንደፋደፈ	አንደፋደ፟ፈ
አንዳች	አንዳች፟
አንድም	አንድም፟
አንድነት	አንድነ፟ት
አንጀረገገ	አንጀረገ፟ገ
አንጀተ	አንጀ፟ተ
አንገላታ	አንገላታ፟
አንገረገበ	አንገረገ፟በ
አንገራገረ	አንገራገ፟ረ
አንገሸገሸ	አንገሸገ፟ሸ
አንገበገበ	አንገበገ፟በ
አንገዋለለ	አንገዋለ፟ለ
አንገደገደ	አንገደገ፟ደ
አንገዳገደ	አንገዳገ፟ደ
አንገጫገጨ	አንገጫገ፟ጨ
አንገፈገፈ	አንገፈገ፟ፈ
አንጋለለ	አንጋለ፟ለ
አንጋሬ	አንጋሬ፟
አንጋደደ	አንጋደ፟ደ
አንጋጋ	አንጋጋ፟
አንጋፋ	አንጋፋ፟
አንግዋለለ	አንግዋለ፟ለ
አንጐራደደ	አንጐራደ፟ደ
አንጐራጐረ	አንጐራጐ፟ረ
አንጐደጐደ	አንጐደጐ፟ደ
አንጓለለ	አንጓለ፟ለ
አንጕራጐረ	አንጕራጐ፟ረ
አንጠራራ	አንጠራ፟ራ
አንጠራራኝ	አንጠራራኝ፟
አንጠራወዘ	አንጠራወ፟ዘ
አንጥረኛ	አንጥረኛ፟
አንጨረፈፈ	አንጨረፈ፟ፈ
አንጸባረቀ	አንጸባረ፟ቀ
አንፈራገጠ	አንፈራገ፟ጠ
አንፈራፈረ	አንፈራፈ፟ረ
አንፈቀፈቀ	አንፈቀፈ፟ቀ
አንፏቀቀ	አንፏቀ፟ቀ
አንፏቃቂ	አንፏቃ፟ቂ
አኘከ	አኘ፟ከ
አኢሉባቦር	አኢሉባ፟ቦር
አከለ	አከ፟ለ
አከላከለ	አከ፟ላከ፟ለ
አከል	አከ፟ል
አከመ	አከ፟መ
አከመቻቸ	አከመቻቸ፟
አከማቸ	አከ፟ማቸ፟
አከረመ	አከረ፟መ
አከረረ	አከረ፟ረ
አከረፋ	አከረፋ፟
አከራካሪ	አከ፟ራካሪ
አከራየ	አከ፟ራየ፟
አከሰለ	አከሰ፟ለ
አከሰመ	አከሰ፟መ
አከሰረ	አከሰ፟ረ
አከሰከሰ	አከሰከ፟ሰ
አከሳ	አከሳ፟
አከበረ	አከበ፟ረ
አከበደ	አከበ፟ደ
አከባበረ	አከባበ፟ረ
አከባበር	አከ፟ባበር
አከተ	አከ፟ተ
አከተመ	አከተ፟መ
አከታተለ	አከ፟ታተ፟ለ
አከነነ	አከነ፟ነ
አከነፈ	አከነ፟ፈ
አከናነበ	አከ፟ናነ፟በ
አከናወ	አከ፟ና፟ወ
አከናወነ	አከ፟ናወ፟ነ
አከከ	አከ፟ከ
አከድዬ	አከ፟ድዬ፟
አከፈለ	አከፈ፟ለ
አከፋ	አከፋ፟
አከፋፈለ	አከ፟ፋፈ፟ለ
አከፋፋይ	አከ፟ፋፋይ
አካለለ	አካ፟ለለ
አካለሰ	አካ፟ለ፟ሰ
አካመረ	አካ፟መ፟ረ
አካሚ	አካ፟ሚ
አካሰሰ	አካ፟ሰ፟ሰ
አካበበ	አካ፟በ፟በ
አካበተ	አካበ፟ተ
አካባቢ	አካ፟ባቢ
አካተተ	አካ፟ተ፟ተ
አካቴ	አካ፟ቴ
አካከከ	አካከ፟ከ
አካካሰ	አካ፟ካሰ
አካደነ	አካ፟ደ፟ነ
አካፈለ	አካ፟ፈ፟ለ
አካፋ	አካፋ፟
አካፋይ	አካ፟ፋይ
አክ	አክ፟
አክለፈለፈ	አክለፈለ፟ፈ
አክታ	አክ፟ታ
አኮላሸ	አኮ፟ላሸ፟
አኮመታተረ	አኮ፟መታተ፟ረ
አኮማተረ	አኮ፟ማተ፟ረ
አኮረፈ	አኮረ፟ፈ
አኮራ	አኮራ፟
አኮራመተ	አኮ፟ራመ፟ተ
አኮሰመነ	አኮሰመ፟ነ
አኮበለለ	አኮበለ፟ለ
አኰረተ	አኰረ፟ተ
አኰሰሰ	አኰሰ፟ሰ
አኰበኰበ	አኰበኰ፟በ
አኰቴት	አኰ፟ቴት
አኳሁዋን	አኳ፟ሁዋን
አኳሰሰ	አኳሰ፟ሰ
አወለቀ	አወለ፟ቀ
አወለወለ	አወለወ፟ለ
አወለጋገደ	አወ፟ለጋገ፟ደ
አወላለቀ	አወላለ፟ቀ
አወላመመ	አወ፟ላመ፟መ
አወላከፈ	አወ፟ላከ፟ፈ
አወላካፊ	አወ፟ላካፊ
አወላወለ	አወ፟ላወ፟ለ
አወላገደ	አወ፟ላገ፟ደ
አወረሰ	አወረ፟ሰ
አወረዛ	አወረዛ፟
አወረደ	አወረ፟ደ
አወራ	አወራ፟
አወራረሰ	አወራረ፟ሰ
አወራረደ	አወራረ፟ደ
አወራጨ	አወ፟ራጨ
አወሰለተ	አወሰለ፟ተ
አወሳ	አወሳ፟
አወበቀ	አወበ፟ቀ
አወናበደ	አወ፟ናበ፟ደ
አወናባጅ	አወ፟ናባ፟ጅ
አወናከረ	አወ፟ናከ፟ረ
አወናፈለ	አወ፟ናፈ፟ለ
አወከ	አወ፟ከ
አወካ	አወካ፟
አወዛወዘ	አወ፟ዛወ፟ዘ
አወደለ	አወደ፟ለ
አወደመ	አወደ፟መ
አወደሰ	አወደ፟ሰ
አወዳደረ	አወ፟ዳደ፟ረ
አወዳዳሪ	አወ፟ዳዳሪ
አወጋ	አወጋ፟
አወጣ	አወጣ፟
አወጣጣ	አወ፟ጣጣ፟
አወፈረ	አወፈ፟ረ
አዋለደ	አዋ፟ለ፟ደ
አዋላጅ	አዋ፟ላጅ
አዋልደጌሻ	አዋልደጌሻ፟
አዋሐደ	አዋ፟ሐደ
አዋረደ	አዋ፟ረ፟ደ
አዋራ	አዋ፟ራ
አዋሰነ	አዋ፟ሰ፟ነ
አዋሰደ	አዋ፟ሰ፟ደ
አዋሳኝ	አዋ፟ሳኝ
አዋሸከ	አዋ፟ሸ፟ከ
አዋቀጠ	አዋ፟ቀ፟ጠ
አዋቃ	አዋ፟ቃ፟
አዋኪ	አዋ፟ኪ
አዋዋለ	አዋ፟ዋለ
አዋዋይ	አዋ፟ዋይ
አዋዛ	አዋ፟ዛ፟
አዋየ	አዋ፟የ
አዋደደ	አዋ፟ደ፟ደ
አዋጊ	አዋ፟ጊ
አዋጋ	አዋ፟ጋ፟
አዋጠረ	አዋ፟ጠ፟ረ
አዋጣ	አዋ፟ጣ፟
አዋጪ	አዋ፟ጪ
አውለበለበ	አውለበለ፟በ
አውላላ	አውላላ፟
አውራጃ	አውራ፟ጃ
አውሬነት	አውሬነ፟ት
አውሮፓ	አውሮፓ፟
አውሮፕላን	አውሮፕ፟ላን
አውተረተረ	አውተረተ፟ረ
አውተፈተፈ	አውተፈተ፟ፈ
አውታታ	አውታታ፟
አውደለደለ	አውደለደ፟ለ
አውድማ	አውድማ፟
አውጫጭኝ	አውጫጭ፟ኝ፟
አዘለ	አዘ፟ለ
አዘለለ	አዘ፟ለለ
አዘለቀ	አዘለ፟ቀ
አዘለፈ	አዘ፟ለ፟ፈ
አዘመመ	አዘመ፟መ
አዘመረ	አዘመ፟ረ
አዘመተ	አዘመ፟ተ
አዘረዘረ	አዘ፟ረዘ፟ረ
አዘረገፈ	አዘ፟ረገ፟ፈ
አዘረጋ	አዘ፟ረጋ
አዘረጋጋ	አዘ፟ረጋጋ፟
አዘረጠ	አዘረ፟ጠ
አዘረጠጠ	አዘ፟ረጠጠ
አዘረፈ	አዘ፟ረ፟ፈ
አዘራ	አዘ፟ራ
አዘቀዘቀ	አዘቀዘ፟ቀ
አዘቀጠ	አዘቀ፟ጠ
አዘበራረቀ	አዘ፟በራረ፟ቀ
አዘባረቀ	አዘ፟ባረ፟ቀ
አዘባነነ	አዘ፟ባነ፟ነ
አዘነ	አዘ፟ነ
አዘነበ	አዘነ፟በ
አዘነበለ	አዘነበ፟ለ
አዘነጋ	አዘነጋ፟
አዘነጠለ	አዘ፟ነጠ፟ለ
አዘናከተ	አዘ፟ናከ፟ተ
አዘናጋ	አዘ፟ናጋ፟
አዘንተኛ	አዘንተኛ፟
አዘከረ	አዘከ፟ረ
አዘከዘከ	አዘ፟ከዘ፟ከ
አዘወረ	አዘ፟ወ፟ረ
አዘወተረ	አዘወተ፟ረ
አዘዘ	አዘ፟ዘ
አዘገመ	አዘገ፟መ
አዘገነ	አዘ፟ገ፟ነ
አዘገየ	አዘገየ፟
አዘገጀ	አዘ፟ገጀ፟
አዘጋ	አዘ፟ጋ፟
አዘጋጀ	አዘ፟ጋጀ፟
አዘጋገመ	አዘጋገ፟መ
አዘጠዘጠ	አዘጠዘ፟ጠ
አዘፈቀ	አዘፈ፟ቀ
አዘፈነ	አዘ፟ፈ፟ነ
አዛለቀ	አዛ፟ለ፟ቀ
አዛመተ	አዛ፟መ፟ተ
አዛመደ	አዛ፟መ፟ደ
አዛማች	አዛ፟ማች
አዛማጅ	አዛ፟ማጅ
አዛቀ	አዛ፟ቀ
አዛባ	አዛ፟ባ፟
አዛነፈ	አዛ፟ነ፟ፈ
አዛወረ	አዛ፟ወ፟ረ
አዛዘነ	አዛዘ፟ነ
አዛዥ	አዛ፟ዥ
አዛጋ	አዛ፟ጋ፟
አዛፈነ	አዛ፟ፈ፟ነ
አዝለገለገ	አዝለገለ፟ገ
አዝማሚያ	አዝማሚ፟ያ
አዝረበረበ	አዝረበ፟ረ፟በ
አዝረከረከ	አዝረከረ፟ከ
አዝረጠረጠ	አዝረጠረ፟ጠ
አዝረፈረፈ	አዝረፈረ፟ፈ
አዝናና	አዝናና፟
አዝጎረጎረ	አዝጎረጎረ፟
አዞ	አዞ፟
አዠ	አዠ፟
አዠለጠ	አዠ፟ለ፟ጠ
አዥጎረጎረ	አዥጎረጎ፟ረ
አዥጎደጎደ	አዥጎደጎ፟ደ
አዥጐረጐረ	አዥጐረጐ፟ረ
አየ	አየ፟
አየለ	አየ፟ለ
አየር	አየ፟ር
አየው	አየ፟ው
አያ	አያ፟
አያሌ	አያ፟ሌ
አያያ	አያ፟ያ፟
አያያዘ	አያ፟ያዘ
አያያዝ	አያ፟ያዝ
አይልም	አይልም፟
አይቀርም	አይቀርም፟
አይደለም	አይደለ፟ም
አይገባኝም	አይገባኝ፟ም
አይጥማ	አይጥማ፟
አደለ	አደ፟ለ
አደለበ	አደለ፟በ
አደላ	አደላ፟
አደላደለ	አደ፟ላደ፟ለ
አደላዳይ	አደ፟ላዳይ
አደመ	አደ፟መ
አደመቀ	አደመ፟ቀ
አደመጠ	አደመ፟ጠ
አደማ	አደማ፟
አደረ	አደ፟ረ
አደረሰ	አደረ፟ሰ
አደረገ	አደ፟ረ፟ገ
አደረገው	አደረ፟ገው
አደራ	አደራ፟
አደራረግ	አደ፟ራረግ
አደራደረ	አደ፟ራደ፟ረ
አደራጀ	አደራጀ፟
አደራጅ	አደ፟ራጅ
አደር	አደ፟ር
አደርክ	አደ፟ርክ
አደሰ	አደ፟ሰ
አደሸደሸ	አደሸደ፟ሸ
አደቀቀ	አደቀ፟ቀ
አደበ	አደ፟በ
አደበነ	አደበ፟ነ
አደበዘዘ	አደበዘ፟ዘ
አደባ	አደ፟ባ
አደባለቀ	አደባለ፟ቀ
አደባባይ	አደ፟ባባይ
አደባየ	አደባየ፟
አደብ	አደ፟ብ
አደነ	አደ፟ነ
አደነቀ	አደነ፟ቀ
አደነቆረ	አደነቆ፟ረ
አደነዘ	አደነ፟ዘ
አደነዘዘ	አደነዘ፟ዘ
አደነጋገረ	አደ፟ነጋገ፟ረ
አደናቀፈ	አደ፟ናቀ፟ፈ
አደናበረ	አደ፟ናበ፟ረ
አደናባሪ	አደ፟ናባሪ
አደናገረ	አደ፟ናገ፟ረ
አደናገጠ	አደ፟ናገ፟ጠ
አደናጋሪ	አደ፟ናጋሪ
አደን	አደ፟ን
አደንጓሬ	አደንጓሬ፟
አደከመ	አደከ፟መ
አደኸየ	አደኸየ፟
አደዘደዘ	አደዘደ፟ዘ
አደደበ	አደደ፟በ
አደገ	አደ፟ገ
አደገኛ	አደገኛ፟
አደገደ	አደገ፟ደ
አደግ	አደ፟ግ
አደፈ	አደ፟ፈ
አደፈረሰ	አደ፟ፈረሰ
አደፈጠ	አደፈ፟ጠ
አደፋፈረ	አደ፟ፋፈ፟ረ
አዱኛ	አዱ፟ኛ፟
አዲስ	አዲ፟ስ
አዳለጠ	አዳለ፟ጠ
አዳላ	አዳ፟ላ፟
አዳመረ	አዳ፟መ፟ረ
አዳመቀ	አዳ፟መ፟ቀ
አዳመጠ	አዳ፟መ፟ጠ
አዳሚ	አዳ፟ሚ
አዳማቂ	አዳ፟ማ፟ቂ
አዳም	አዳ፟ም
አዳምና	አዳ፟ምና፟
አዳረሰ	አዳ፟ረ፟ሰ
አዳራሽ	አዳ፟ራሽ
አዳሽ	አዳ፟ሽ
አዳቀለ	አዳ፟ቀ፟ለ
አዳቀቀ	አዳ፟ቀ፟ቀ
አዳበለ	አዳ፟በ፟ለ
አዳበረ	አዳበ፟ረ
አዳባይ	አዳ፟ባይ
አዳነቀ	አዳነ፟ቀ
አዳኝ	አዳ፟ኝ
አዳከመ	አዳ፟ከ፟መ
አዳወረ	አዳወ፟ረ
አዳይ	አዳ፟ይ
አዳደለ	አዳደ፟ለ
አዳደሰ	አዳደ፟ሰ
አዳገተ	አዳገ፟ተ
አዳፈነ	አዳፈ፟ነ
አዳፋ	አዳ፟ፋ፟
አዳፍኔ	አዳ፟ፍኔ
አድሎኛ	አድሎኛ፟
አድመኛ	አድመኛ፟
አድረገ	አድረ፟ገ
አድራሻ	አድራሻ፟
አድበለበለ	አድበለበ፟ለ
አድበሰበሰ	አድበሰበ፟ሰ
አድቦለቦለ	አድቦለቦ፟ለ
አድፈነፈነ	አድፈነፈ፟ነ
አድፋፋ	አድፋፋ፟
አዶ	አዶ፟
አዶለዶመ	አዶለዶ፟መ
አጀለ	አጀ፟ለ
አጀበ	አጀ፟በ
አጃ	አጃ፟
አጃቢ	አጃ፟ቢ
አጃጃለ	አጃ፟ጃለ
አጃገነ	አጃ፟ገነ
አጅሬ	አጅ፟ሬ
አገለለ	አገለ፟ለ
አገለሞተ	አገለሞ፟ተ
አገለደመ	አገለደ፟መ
አገለገለ	አገለ፟ገለ
አገላበጠ	አገ፟ላበ፟ጠ
አገመ	አገ፟መ
አገማ	አገማ፟
አገሣ	አገሣ፟
አገረሸ	አገረሸ፟
አገረሸበት	አገረሸ፟በ፟ት
አገሸሸ	አገሸ፟ሸ
አገባ	አገባ፟
አገባብ	አገ፟ባብ
አገባት	አገባ፟ት
አገባደደ	አገ፟ባደ፟ደ
አገተ	አገ፟ተ
አገነፋ	አገነፋ፟
አገናኘ	አገናኘ፟
አገናኝ	አገ፟ናኝ፟
አገናዘበ	አገ፟ናዘበ
አገናዛቢ	አገ፟ናዛቢ
አገኘ	አገኘ፟
አገዘ	አገ፟ዘ
አገዝ	አገ፟ዝ
አገደ	አገ፟ደ
አገደመ	አገደ፟መ
አገደፈ	አገደ፟ፈ
አገድ	አገ፟ድ
አገገመ	አገገ፟መ
አገጋሚ	አገጋ፟ሚ
አገጫጨ	አገ፟ጫጨ፟
አጋለጠ	አጋ፟ለ፟ጠ
አጋመሰ	አጋ፟መ፟ሰ
አጋሚ	አጋ፟ሚ
አጋማሽ	አጋ፟ማሽ
አጋሪ	አጋ፟ሪ
አጋራ	አጋ፟ራ
አጋር	አጋ፟ር
አጋሰሰ	አጋሰ፟ሰ
አጋሰስ	አጋሰ፟ስ
አጋበሰ	አጋበ፟ሰ
አጋባ	አጋ፟ባ፟
አጋተረ	አጋ፟ተ፟ረ
አጋነነ	አጋ፟ነ፟ነ
አጋኖ	አጋ፟ኖ፟
አጋዛ	አጋ፟ዛ፟
አጋዥ	አጋ፟ዥ
አጋየ	አጋየ፟
አጋደለ	አጋደ፟ለ
አጋደመ	አጋ፟ደ፟መ
አጋደደ	አጋ፟ደ፟ደ
አጋጅ	አጋ፟ጅ
አጋጋለ	አጋ፟ጋለ
አጋጋመ	አጋ፟ጋመ
አጋጠመ	አጋ፟ጠ፟መ
አጋጣሚ	አጋ፟ጣሚ
አጋጨ	አጋ፟ጨ
አጋፈረ	አጋ፟ፈረ
አጋፈጠ	አጋ፟ፈ፟ጠ
አጋፋሪ	አጋ፟ፋሪ
አግበሰበሰ	አግበሰበ፟ሰ
አግተለተለ	አግተለተ፟ለ
አግዶኝ	አግዶ፟ኝ፟
አግጣጫ	አግጣጫ፟
አግፈለፈለ	አግፈለፈ፟ለ
አጎላመሰ	አጎላመ፟ሰ
አጎላማሽ	አጎ፟ላማሽ
አጎመዘዘ	አጎመዘ፟ዘ
አጎረሰ	አጎረ፟ሰ
አጎራበተ	አጎ፟ራበ፟ተ
አጎት	አጎ፟ት
አጎናጠፈ	አጎ፟ናጠ፟ፈ
አጎደለ	አጎደ፟ለ
አጎፈረ	አጎፈ፟ረ
አጐላ	አጐላ፟
አጐረ	አጐ፟ረ
አጐረና	አጐረና፟
አጐራ	አጐራ፟
አጐሳቈለ	አጐሳቈ፟ለ
አጐበደደ	አጐበደ፟ደ
አጐበጐበ	አጐበጐ፟በ
አጐበጠ	አጐበ፟ጠ
አጐተነ	አጐተ፟ነ
አጐነቈለ	አጐነቈ፟ለ
አጐነበሰ	አጐነበ፟ሰ
አጐደጐደ	አጐደጐ፟ደ
አጓመጠ	አጓመ፟ጠ
አጓራ	አጓራ፟
አጓት	አጓ፟ት
አጓደደ	አጓ፟ደ፟ደ
አጓጐለ	አጓጐ፟ለ
አጓጓዘ	አጓ፟ጓዘ
አጕመተመተ	አጕመተመ፟ተ
አጕረመረመ	አጕረመረ፟መ
አጕረጠረጠ	አጕረጠረ፟ጠ
አጕተመተመ	አጕተመተ፟መ
አጠለለ	አጠለ፟ለ
አጠለቀ	አጠለ፟ቀ
አጠለቀው	አጠለ፟ቀው
አጠመቀ	አጠመ፟ቀ
አጠማ	አጠማ፟
አጠረሰ	አጠረ፟ሰ
አጠረኝ	አጠ፟ረኝ፟
አጠራ	አጠራ፟
አጠራቀመ	አጠ፟ራቀ፟መ
አጠቀሰ	አጠቀ፟ሰ
አጠቃ	አጠቃ፟
አጠቃለለ	አጠ፟ቃለ፟ለ
አጠቆረ	አጠቆ፟ረ
አጠበቀ	አጠበ፟ቀ
አጠበበ	አጠበ፟በ
አጠባ	አጠባ፟
አጠነባ	አጠነባ፟
አጠነነ	አጠነ፟ነ
አጠነከረ	አጠነከ፟ረ
አጠነፈፈ	አጠነፈ፟ፈ
አጠና	አጠና፟
አጠናቀረ	አጠ፟ናቀ፟ረ
አጠናቀቀ	አጠ፟ናቀ፟ቀ
አጠናከረ	አጠ፟ናከ፟ረ
አጠናጋ	አጠናጋ፟
አጠየቀ	አጠየ፟ቀ
አጠያየፈ	አጠ፟ያየ፟ፈ
አጠገበ	አጠገ፟በ
አጠጋጋ	አጠ፟ጋጋ፟
አጠፈፈ	አጠፈ፟ፈ
አጠፋ	አጠፋ፟
አጣላ	አጣ፟ላ
አጣመመ	አጣመ፟መ
አጣመረ	አጣመ፟ረ
አጣመደ	አጣመ፟ደ
አጣራ	አጣ፟ራ
አጣቀሰ	አጣ፟ቀ፟ሰ
አጣበቀ	አጣ፟በ፟ቀ
አጣበበ	አጣ፟በ፟በ
አጣብቂኝ	አጣ፟ብቂኝ፟
አጣየቀ	አጣ፟የ፟ቀ
አጣደፈ	አጣ፟ደ፟ፈ
አጣገበ	አጣ፟ገ፟በ
አጣፈረ	አጣ፟ፈ፟ረ
አጣፈጠ	አጣፈ፟ጠ
አጣፋ	አጣ፟ፋ፟
አጥለቀለቀ	አጥለቀለ፟ቀ
አጥላላ	አጥላላ፟
አጥመለመለ	አጥመለመ፟ለ
አጥመዘመዘ	አጥመዘመ፟ዘ
አጥበረበረ	አጥበረበ፟ረ
አጥናና	አጥናና፟
አጥወለወለ	አጥወለወ፟ለ
አጥፊና	አጥፊና፟
አጨለመ	አጨለ፟መ
አጨለገ	አጨለ፟ገ
አጨማለቀ	አጨ፟ማለ፟ቀ
አጨማተረ	አጨ፟ማተ፟ረ
አጨማደደ	አጨ፟ማደ፟ደ
አጨራመመ	አጨ፟ራመ፟መ
አጨራመደ	አጨ፟ራመ፟ደ
አጨቀየ	አጨቀየ፟
አጨባበጠ	አጨ፟ባበ፟ጠ
አጨነቆረ	አጨነቆ፟ረ
አጨነጎለ	አጨ፟ነጎ፟ለ
አጨናገፈ	አጨ፟ናገ፟ፈ
አጫረሰ	አጫ፟ረ፟ሰ
አጫረተ	አጫ፟ረ፟ተ
አጫወተ	አጫ፟ወ፟ተ
አጭበረበረ	አጭበረበ፟ረ
አጸለየ	አጸ፟ለ፟የ
አጸና	አጸና፟
አጸየፈ	አጸ፟የ፟ፈ
አጸያፊ	አጸ፟ያ፟ፊ
አጸደቀ	አጸደ፟ቀ
አጸዳ	አጸዳ፟
አጽናና	አጽናና፟
አፈለሰ	አፈለ፟ሰ
አፈለቀ	አፈለ፟ቀ
አፈላ	አፈላ፟
አፈረ	አፈ፟ረ
አፈረጠ	አፈረ፟ጠ
አፈረጠው	አፈረ፟ጠው
አፈራ	አፈራ፟
አፈራረሰ	አፈራረ፟ሰ
አፈሰ	አፈ፟ሰ
አፈሰሰ	አፈ፟ሰ፟ሰ
አፈቀረ	አፈ፟ቀ፟ረ
አፈተለከ	አፈተለ፟ከ
አፈታበት	አፈታ፟በ፟ት
አፈታተነ	አፈ፟ታተ፟ነ
አፈነ	አፈ፟ነ
አፈነደደ	አፈነደ፟ደ
አፈነዳ	አፈነዳ፟
አፈነገጠ	አፈነገ፟ጠ
አፈነፈነ	አፈነፈ፟ነ
አፈናቀለ	አፈ፟ናቀ፟ለ
አፈናጠረ	አፈ፟ናጠ፟ረ
አፈናጠጠ	አፈ፟ናጠ፟ጠ
አፈኛ	አፈኛ፟
አፈከፈ	አፈከ፟ፈ
አፈካ	አፈካ፟
አፈዘዘ	አፈዘ፟ዘ
አፈገ	አፈ፟ገ
አፈገመ	አፈገ፟መ
አፈገፈገ	አፈገፈ፟ገ
አፈፈ	አፈ፟ፈ
አፈፍ	አፈፍ፟
አፋለመ	አፋ፟ለ፟መ
አፋለሰ	አፋ፟ለ፟ሰ
አፋለገ	አፋ፟ለ፟ገ
አፋረደ	አፋ፟ረደ
አፋራም	አፋ፟ራም
አፋር	አፋ፟ር
አፋሰሰ	አፋ፟ሰ፟ሰ
አፋሸገ	አፋሸ፟ገ
አፋቀረ	አፋ፟ቀ፟ረ
አፋተለ	አፋ፟ተ፟ለ
አፋተገ	አፋ፟ተ፟ገ
አፋታ	አፋ፟ታ
አፋኝ	አፋ፟ኝ
አፋዘዘ	አፋ፟ዘ፟ዘ
አፋደሰ	አፋደ፟ሰ
አፋጀ	አፋ፟ጀ፟
አፋጠነ	አፋ፟ጠ፟ነ
አፋጠጠ	አፋ፟ጠ፟ጠ
አፋጣኝ	አፋ፟ጣኝ
አፋጨ	አፋ፟ጨ፟
አፋፋመ	አፋ፟ፋመ
አፍለቀለቀ	አፍለቀለ፟ቀ
አፍለኛ	አፍለኛ፟
አፍታታ	አፍታታ፟
አፍንጫማ	አፍንጫማ፟
አፍኖ	አፍ፟ኖ
አፎካከረ	አፎ፟ካከ፟ረ
አፓርትማ	አፓ፟ርትማ
ኢትዮጲያ	ኢትዮጲ፟ያ
ኢትዮጲያዊ	ኢትዮጲ፟ያዊ
ኢትዮጵያዊት	ኢትዮጵ፟ያዊት
ኢየሩሳሌም	ኢየ፟ሩሳሌም
ኢየሱሳዊ	ኢየ፟ሱሳዊ
ኢየሱስ	ኢየ፟ሱስ
ኢዮቤልዩ	ኢዮ፟ቤልዩ
ኢጣልያኛ	ኢጣልያኛ፟
ኤክዌተር	ኤክ፟ዌተር
እላቂ	እላ፟ቂ
እልም	እል፟ም
እልቂት	እልቂት፟
እልቅ	እልቅ፟
እልቅት	እል፟ቅት
እልቅና	እልቅና፟
እልባት	እል፟ባት
እልከኛ	እል፟ከኛ፟
እልክ	እል፟ክ
እልፊት	እልፊት፟
እልፍኝ	እልፍኝ፟
እመ	እመ፟
እመምተኛ	እመምተኛ፟
እመር	እመ፟ር
እመቤታችን	እመ፟ቤታች፟ን
እመቤት	እመ፟ቤት
እመት	እመ፟ት
እመጫት	እመ፟ጫት
እማሆይ	እማ፟ሆይ
እሜቴ	እሜ፟ቴ
እምር	እም፟ር
እምስ	እም፟ስ
እምቢልተኛ	እምቢልተኛ፟
እምቢተኛ	እምቢተኛ፟
እምብዛም	እምብዛም፟
እምቦሳ	እምቦሳ፟
እምዬ	እም፟ዬ
እሥረኛ	እሥረኛ፟
እሥራት	እሥ፟ራት
እሥር	እሥ፟ር
እረኛ	እረ፟ኛ፟
እረኝነት	እረ፟ኝ፟ነ፟ት
እራሪ	እራ፟ሪ
እራሽ	እራ፟ሽ
እርማት	እር፟ማት
እርምጃ	እርምጃ፟
እርይ	እር፟ይ
እርጅና	እርጅና፟
እርግዝና	እርግዝና፟
እርግጠኛ	እርግጠኛ፟
እርግፍ	እርግፍ፟
እሮምታ	እሮ፟ምታ
እሰይ	እሰ፟ይ
እሳ	እሳ፟
እሳት	እሳ፟ት
እሳትና	እሳትና፟
እሳቸው	እሳ፟ቸ፟ው
እስልምና	እስልምና፟
እስከነ	እስከነ፟
እስከናካቴው	እስከና፟ካ፟ቴው
እስከዚህ	እስከዚ፟ህ
እስከዚያ	እስከዚ፟ያ
እስፓንኛ	እስፓንኛ፟
እሸትነት	እሸትነ፟ት
እሹሩሩ	እሹ፟ሩሩ
እሺ	እሺ፟
እሽ	እሽ፟
እሽም	እሽ፟ም
እሽሩሩ	እሽ፟ሩሩ
እሽቅድድም	እሽቅድድ፟ም
እሽግ	እሽ፟ግ
እቀጭታ	እቀ፟ጭ፟ታ
እቅፍ	እቅ፟ፍ
እበት	እበ፟ት
እቡይ	እቡ፟ይ
እባካችሁ	እባካ፟ች፟ሁ
እባክህ	እባክ፟ህ
እባክሽ	እባክ፟ሽ
እባክዎን	እባክ፟ዎን
እባጭ	እባ፟ጭ
እብሪተኛ	እብሪተኛ፟
እብስ	እብ፟ስ፟
እቴዋ	እቴዋ፟
እትማማች	እትማ፟ማች
እትማማችነት	እትማ፟ማችነ፟ት
እትም	እት፟ም
እትዬ	እትዬ፟
እትፍ	እት፟ፍ
እትፍታ	እት፟ፍታ
እችግር	እችግ፟ር
እነ	እነ፟
እነሆ	እነ፟ሆ
እነማን	እነ፟ማን፟
እነኋት	እነ፟ኋት
እነኛ	እነ፟ኛ፟
እነዚያ	እነ፟ዚ፟ያ
እና	እና፟
እናት	እና፟ት
እናትነት	እና፟ትነ፟ት
እናትና	እና፟ትና፟
እንስሳነት	እንስሳነ፟ት
እንስትነት	እንስትነ፟ት
እንቃቅላ	እንቃቅላ፟
እንቅስቃሴ	እንቅስ፟ቃ፟ሴ
እንቅጥቃጤ	እንቅጥቃ፟ጤ
እንቆቅልሽ	እንቆቅል፟ሽ
እንቆቆ	እንቆቆ፟
እንብርክ	እንብርክ፟
እንትና	እንትና፟
እንትፍ	እንትፍ፟
እንቺ	እንቺ፟
እንክርት	እንክር፟ት
እንክብል	እንክብል፟
እንክብካቤ	እንክብካ፟ቤ
እንኮኮ	እንኮኮ፟
እንደልብ	እንደልብ፟
እንደገና	እንደገ፟ና
እንዲሁም	እንዲሁም፟
እንጃለት	እንጃለ፟ት
እንጃልህ	እንጃል፟ህ
እንጃልሽ	እንጃል፟ሽ
እንጃልኝ	እንጃል፟ኝ፟
እንጃባቱ	እንጃባ፟ቱ
እንጆሪ	እንጆሪ፟
እንግሊዘኛ	እንግሊዘኛ፟
እንግልት	እንግልት፟
እንግዲማ	እንግዲማ፟
እንግዲያስ	እንግዲያስ፟
እንጐቻ	እንጐቻ፟
እንጕርጕሮ	እንጕርጕ፟ሮ
እንፍሌ	እንፍሌ፟
እኛ	እኛ፟
እኝኝ	እኝ፟ኝ፟
እኩለ	እኩ፟ለ
እኩሌታ	እኩ፟ሌታ
እኩል	እኩ፟ል
እኩያ	እኩ፟ያ፟
እክላም	እክ፟ላም
እክል	እክ፟ል
እኮ	እኮ፟
እውልኛ	እውል፟ኛ፟
እውነተኛ	እውነተኛ፟
እውነተኛነት	እውነተኛ፟ነ፟ት
እውነትም	እውነትም፟
እዚህ	እዚ፟ህ
እዚያ	እዚ፟ያ
እየመጣ	እየ፟መጣ፟
እየቅሉ	እየ፟ቅሉ
እየተጠና	እየተጠና፟
እያንዳንዱ	እያ፟ንዳንዱ
እያደር	እያ፟ደ፟ር
እደሳ	እደ፟ሳ
እዳሪ	እዳ፟ሪ
እድለ	እድ፟ለ
እድል	እድ፟ል
እድመኛ	እድመኛ፟
እድር	እድ፟ር
እድርተኛ	እድ፟ርተኛ፟
እጀ	እጀ፟
እጀታ	እጀ፟ታ
እጁን	እጁ፟ን
እጄ	እጄ፟
እጅ	እጅ፟
እጅብ	እጅ፟ብ
እጅና	እጅ፟ና
እጅጉን	እጅ፟ጉን
እጅጌ	እጅ፟ጌ
እጅግ	እጅግ፟
እገዛ	እገ፟ዛ
እገዳ	እገ፟ዳ
እግረኛ	እግረኛ፟
እግድ	እግ፟ድ
እጥቤ	እጥ፟ቤ፟
እጭድ	እጭ፟ድ
እፉኝት	እፉኝ፟ት
እፊያ	እፊ፟ያ
እፋሽ	እፋ፟ሽ
እፋፊ	እፋ፟ፊ
እፍ	እፍ፟
እፍኝ	እፍ፟ኝ
እፍግ	እፍ፟ግ
እፍግፍግ	እፍግፍግ፟
እፎይ	እፎ፟ይ
እፎይታ	እፎ፟ይታ
ከሁሉ	ከሁሉ፟
ከለለ	ከለ፟ለ
ከለላ	ከለ፟ላ
ከለሰ	ከለ፟ሰ
ከለበ	ከለ፟በ
ከለበሰ	ከለ፟በ፟ሰ
ከለቻ	ከለ፟ቻ፟
ከለከለ	ከለከ፟ለ
ከለፈ	ከለ፟ፈ
ከለፍላፋ	ከለፍላፋ፟
ከላሽ	ከላ፟ሽ
ከላባ	ከላ፟ባ
ከል	ከል፟
ከመረ	ከመ፟ረ
ከመቼ	ከመቼ፟
ከመቼውም	ከመቼ፟ውም፟
ከመከመ	ከመከ፟መ
ከማሪ	ከማ፟ሪ
ከሞላ	ከሞላ፟
ከሠተ	ከሠ፟ተ
ከሠተለት	ከሠ፟ተለ፟ት
ከሠተበት	ከሠ፟ተበ፟ት
ከረመ	ከረ፟መ
ከረረ	ከረ፟ረ
ከረበተ	ከረበ፟ተ
ከረተፈ	ከረተ፟ፈ
ከረከመ	ከረከ፟መ
ከረከረ	ከረከ፟ረ
ከረደደ	ከረደ፟ደ
ከረፋ	ከረፋ፟
ከርታታ	ከርታታ፟
ከርከሮ	ከርከሮ፟
ከርዳዳ	ከርዳዳ፟
ከርፋፋ	ከርፋ፟ፋ
ከሰለ	ከሰ፟ለ
ከሰልማ	ከሰልማ፟
ከሰመ	ከሰ፟መ
ከሰረ	ከሰ፟ረ
ከሰሰ	ከሰ፟ሰ
ከሰበ	ከሰ፟በ
ከሰከሰ	ከሰከ፟ሰ
ከሲታ	ከሲ፟ታ፟
ከሳ	ከሳ፟
ከሳራ	ከሳ፟ራ
ከሳይ	ከሳ፟ይ
ከሸነ	ከሸ፟ነ
ከሸፈ	ከሸ፟ፈ
ከበረ	ከበ፟ረ
ከበርቴ	ከበ፟ርቴ
ከበሰ	ከበ፟ሰ
ከበበ	ከበ፟በ
ከበተ	ከበ፟ተ
ከበደ	ከበ፟ደ
ከባዳ	ከባ፟ዳ
ከባድ	ከባ፟ድ
ከተለበ	ከተለ፟በ
ከተል	ከተ፟ል፟
ከተመ	ከተ፟መ
ከተረ	ከተ፟ረ
ከተበ	ከተ፟በ
ከተተ	ከተ፟ተ
ከተከተ	ከተከ፟ተ
ከተፈ	ከተ፟ፈ
ከት	ከት፟
ከትቢያ	ከትቢ፟ያ
ከቶ	ከቶ፟
ከቶውንም	ከቶ፟ውንም፟
ከቸረ	ከቸ፟ረ
ከቸቸ	ከቸ፟ቸ
ከቻራ	ከቻራ፟
ከች	ከች፟
ከነበለ	ከነበ፟ለ
ከነቤተሰቡ	ከነ፟ቤተሰቡ
ከነተረ	ከነተ፟ረ
ከነነ	ከነ፟ነ
ከነአካቴው	ከነ፟አካ፟ቴው
ከነከነ	ከነከ፟ነ
ከነዳ	ከነዳ፟
ከነፈ	ከነ፟ፈ
ከንቱነት	ከንቱነ፟ት
ከካ	ከካ፟
ከውታታ	ከውታታ፟
ከውካዋ	ከውካዋ፟
ከዚህ	ከዚ፟ህ
ከዚህም	ከዚ፟ህም
ከዚያ	ከዚ፟ያ
ከደነ	ከደ፟ነ
ከዳ	ከዳ፟
ከዳተኛ	ከዳተኛ፟
ከጀለ	ከጀ፟ለ
ከፈለ	ከፈ፟ለ
ከፈተ	ከፈ፟ተ
ከፈነ	ከፈ፟ነ
ከፈከፈ	ከፈከ፟ፈ
ከፈፈ	ከፈ፟ፈ
ከፋ	ከፋ፟
ከፋኝ	ከፋ፟ኝ
ከፋፈለ	ከፋፈ፟ለ
ከፋፈተ	ከፋፈ፟ተ
ከፍ	ከፍ፟
ከፍራራ	ከፍራ፟ራ
ከፍተኛ	ከፍ፟ተኛ፟
ከፍታ	ከፍ፟ታ
ኩሊነት	ኩሊነ፟ት
ኩልሽት	ኩልሽ፟ት
ኩምትርትር	ኩምትርትር፟
ኩረጃ	ኩረ፟ጃ
ኩራተኛ	ኩራተኛ፟
ኩራዝ	ኩራ፟ዝ
ኩርምት	ኩርምት፟
ኩርምትምት	ኩርምትምት፟
ኩርትም	ኩርትም፟
ኩርትምትም	ኩርትምትም፟
ኩባያ	ኩባ፟ያ፟
ኩብ	ኩብ፟
ኩብኩባ	ኩብኩባ፟
ኩይሳ	ኩይ፟ሳ
ኩፍ	ኩፍ፟
ኩፍኝ	ኩፍ፟ኝ፟
ኪራየተኛ	ኪራየተኛ፟
ካባ	ካባ፟
ካቤላ	ካቤላ፟
ካቦ	ካቦ፟
ካቻምና	ካቻ፟ምና
ካች	ካች፟
ካንዴላ	ካንዴላ፟
ካካ	ካካ፟
ካውያ	ካውያ፟
ካደመ	ካደ፟መ
ካዳሚ	ካዳ፟ሚ
ካፊያ	ካፊ፟ያ
ካፍያ	ካፍ፟ያ
ካፒታሊዝም	ካፒ፟ታሊዝም
ካፖርት	ካፖ፟ርት
ኬላ	ኬላ፟
ክለሳ	ክለ፟ሳ
ክልል	ክል፟ል
ክልስ	ክል፟ስ
ክልብሽ	ክልብሽ፟
ክልብሽታ	ክል፟ብሽታ
ክመራ	ክመ፟ራ
ክምር	ክም፟ር
ክምቹ	ክምቹ፟
ክምችት	ክምች፟ት
ክር	ክር፟
ክርስትና	ክርስትና፟
ክርክም	ክርክ፟ም
ክርክር	ክርክ፟ር
ክርድ	ክርድ፟
ክርፍፍ	ክርፍፍ፟
ክስ	ክስ፟
ክብ	ክብ፟
ክብልል	ክብልል፟
ክብርና	ክብርና፟
ክብብ	ክብብ፟
ክብነት	ክብ፟ነ፟ት
ክት	ክት፟
ክትር	ክት፟ር
ክትባት	ክት፟ባት
ክትትል	ክትት፟ል
ክትካች	ክትካ፟ች
ክችች	ክች፟ች
ክንውን	ክንው፟ን
ክካም	ክካ፟ም
ክክ	ክክ፟
ክው	ክው፟
ክውትት	ክውትት፟
ክጀላ	ክጀ፟ላ
ክፉኛ	ክፉኛ፟
ክፋተኛ	ክፋተኛ፟
ክፋይ	ክፋ፟ይ
ክፍ	ክፍ፟
ክፍት	ክፍ፟ት
ክፍያ	ክፍያ፟
ኮምፓስ	ኮምፓስ፟
ኮረሸመ	ኮረሸ፟መ
ኮረብታማ	ኮረብታማ፟
ኮረጀ	ኮረ፟ጀ
ኮረጠ	ኮረ፟ጠ
ኮራ	ኮራ፟
ኮርማታ	ኮርማታ፟
ኮርቻ	ኮርቻ፟
ኮሰመነ	ኮሰመ፟ነ
ኮስማና	ኮስማና፟
ኮስታራ	ኮስታራ፟
ኮሸሽ	ኮሸሽ፟
ኮበለለ	ኮበለ፟ለ
ኮተኮተ	ኮተኮ፟ተ
ኮቴ	ኮቴ፟
ኮትቻ	ኮትቻ፟
ኮዳ	ኮዳ፟
ኮፈኮፈ	ኮፈኮ፟ፈ
ኰለለ	ኰለ፟ለ
ኰለል	ኰለ፟ል
ኰላ	ኰላ፟
ኰልታፋ	ኰልታፋ፟
ኰልኰሎ	ኰልኰሎ፟
ኰመኰመ	ኰመኰ፟መ
ኰረተመ	ኰረተ፟መ
ኰረታተመ	ኰረታተ፟መ
ኰረኰመ	ኰረኰ፟መ
ኰረኰረ	ኰረኰ፟ረ
ኰረዳ	ኰረዳ፟
ኰረፈ	ኰረ፟ፈ
ኰረፌ	ኰረ፟ፌ
ኰሰሰ	ኰሰ፟ሰ
ኰሰተረ	ኰሰተ፟ረ
ኰሰኰሰ	ኰሰኰ፟ሰ
ኰሳሳ	ኰሳ፟ሳ
ኰሳሳነት	ኰሳሳነ፟ት
ኰስታራ	ኰስታራ፟
ኰስኳሳ	ኰስኳሳ፟
ኰነነ	ኰነ፟ነ
ኰናኝ	ኰና፟ኝ
ኵርፈኛ	ኵርፈኛ፟
ኵርፍተኛ	ኵር፟ፍተኛ፟
ወለል	ወለል፟
ወለም	ወለም፟
ወለቀ	ወለ፟ቀ
ወለወለ	ወለወ፟ለ
ወለደ	ወለ፟ደ
ወለድ	ወለ፟ድ
ወለገደ	ወለገ፟ደ
ወለጋ	ወለ፟ጋ
ወላለቀ	ወላለ፟ቀ
ወላለደ	ወላለ፟ደ
ወላወለ	ወላወ፟ለ
ወላይታ	ወላይታ፟
ወላይትኛ	ወላይትኛ፟
ወላድ	ወላ፟ድ
ወልማማ	ወልማ፟ማ
ወልካፋ	ወልካ፟ፋ
ወልጋዳ	ወልጋዳ፟
ወሎ	ወሎ፟
ወመቴ	ወመ፟ቴ
ወረረ	ወረ፟ረ
ወረርሽኝ	ወረርሽኝ፟
ወረሰ	ወረ፟ሰ
ወረቦ	ወረቦ፟
ወረተኛ	ወረተኛ፟
ወረክራካ	ወረክራካ፟
ወረወረ	ወረወ፟ረ
ወረዛ	ወረዛ፟
ወረደ	ወረ፟ደ
ወረገኑ	ወረ፟ገኑ
ወረፈ	ወረ፟ፈ
ወራረደ	ወራረ፟ደ
ወራዳ	ወራ፟ዳ፟
ወራዳነት	ወራ፟ዳ፟ነ፟ት
ወራፊ	ወራ፟ፊ
ወሬኛ	ወሬኛ፟
ወርቃማ	ወርቃማ፟
ወርድና	ወርድና፟
ወሮበላ	ወሮ፟በላ፟
ወሰለተ	ወሰለ፟ተ
ወሰራ	ወሰራ፟
ወሰነ	ወሰ፟ነ
ወሰን	ወሰ፟ን
ወሰንተኛ	ወሰንተኛ፟
ወሰወሰ	ወሰወ፟ሰ
ወሰደ	ወሰ፟ደ
ወሰደው	ወሰ፟ደው
ወሰድ	ወሰድ፟
ወሳኝ	ወሳ፟ኝ
ወሳፍቻ	ወሳ፟ፍቻ፟
ወስላታ	ወስላታ፟
ወስዋሳ	ወስዋሳ፟
ወሸለ	ወሸ፟ለ
ወሸመ	ወሸ፟መ
ወሸቀ	ወሸ፟ቀ
ወሸከተ	ወሸከ፟ተ
ወሻቃ	ወሻ፟ቃ፟
ወሽመላ	ወሽመላ፟
ወሽካታ	ወሽካታ፟
ወቀረ	ወቀ፟ረ
ወቀሰ	ወቀ፟ሰ
ወቀሳ	ወቀሳ፟
ወቀጠ	ወቀ፟ጠ
ወቃ	ወቃ፟
ወበራ	ወበራ፟
ወበቀ	ወበ፟ቀ
ወባማ	ወባማ፟
ወቦ	ወቦ፟
ወተወተ	ወተወ፟ተ
ወተፈ	ወተ፟ፈ
ወተፍታፋ	ወተፍታፋ፟
ወታደራዊ	ወታ፟ደ፟ራዊ
ወታደር	ወታደ፟ር
ወታደርነት	ወታደ፟ርነ፟ት
ወታፋ	ወታ፟ፋ፟
ወትዋታ	ወትዋ፟ታ
ወነበደ	ወነበ፟ደ
ወነከረ	ወነከ፟ረ
ወነወነ	ወነወ፟ነ
ወነጀለ	ወነጀ፟ለ
ወንድማማችነት	ወንድማ፟ማችነ፟ት
ወንድም	ወንድም፟
ወንድነት	ወንድነ፟ት
ወንጀለኛ	ወንጀለኛ፟
ወከለ	ወከ፟ለ
ወከፍ	ወከ፟ፍ
ወኪል	ወኪ፟ል
ወካይ	ወካ፟ይ
ወዘተ	ወዘ፟ተ
ወዘተ\.	ወዘ፟ተ\.
ወዘወዘ	ወዘወ፟ዘ
ወዘፈ	ወዘ፟ፈ
ወዛ	ወዛ፟
ወዛም	ወዛ፟ም
ወዛደር	ወዛደ፟ር
ወየበ	ወየ፟በ
ወየው	ወየ፟ው
ወያላ	ወያ፟ላ
ወይም	ወይም፟
ወይስ	ወይስ፟
ወይንማ	ወይንማ፟
ወዮ	ወዮ፟
ወዮታ	ወዮ፟ታ
ወደለ	ወደ፟ለ
ወደላ	ወደላ፟
ወደመ	ወደ፟መ
ወደረ	ወደ፟ረ
ወደረኛ	ወደረኛ፟
ወደቀ	ወደ፟ቀ
ወደዚህ	ወደዚ፟ህ
ወደዚያ	ወደዚ፟ያ
ወደደ	ወደ፟ደ
ወደድ	ወደ፟ድ
ወደጎን	ወደጎን፟
ወዲያልኝ	ወዲያል፟ኝ፟
ወዳድ	ወዳ፟ድ
ወዳጅነት	ወዳጅነ፟ት
ወዶ	ወዶ፟
ወገረ	ወገ፟ረ
ወገኛ	ወገኛ፟
ወገግ	ወገግ፟
ወገግታ	ወገ፟ግታ
ወጋ	ወጋ፟
ወጋጋ	ወጋጋ፟
ወጌሻ	ወጌሻ፟
ወጣ	ወጣ፟
ወጣራ	ወጣ፟ራ፟
ወጣትነት	ወጣ፟ትነ፟ት
ወጣች	ወጣች፟
ወጥ	ወጥ፟
ወጭማዳ	ወጭማዳ፟
ወፈረ	ወፈ፟ረ
ወፈር	ወፈር፟
ወፈፈ	ወፈ፟ፈ
ወፈፌ	ወፈፌ፟
ወፈፍተኛ	ወፈፍተኛ፟
ወፋፈረ	ወፋፈ፟ረ
ዋለለ	ዋለ፟ለ
ዋስትና	ዋስትና፟
ዋሸ	ዋሸ፟
ዋሻ	ዋሻ፟
ዋተተ	ዋተ፟ተ
ዋነተኛ	ዋነተኛ፟
ዋነኛ	ዋነ፟ኛ፟
ዋና	ዋና፟
ዋኘ	ዋኘ፟
ዋዠ	ዋዠ፟
ዋጀ	ዋጀ፟
ውሀማ	ውሀማ፟
ውለኛ	ውለኛ፟
ውላቂ	ውላ፟ቂ
ውላጅ	ውላ፟ጅ
ውል	ውል፟
ውልቃት	ውል፟ቃት
ውልቅ	ውል፟ቅ
ውልብ	ውል፟ብ
ውልታ	ውል፟ታ
ውልክፍክፍ	ውልክፍክፍ፟
ውራ	ውራ፟
ውራጅ	ውራ፟ጅ
ውር	ውር፟
ውርር	ውር፟ር
ውርርድ	ውርር፟ድ
ውርንጭላ	ውርንጭላ፟
ውርጅብኝ	ውርጅብ፟ኝ፟
ውሳኔ	ውሳ፟ኔ
ውስልትና	ውስልትና፟
ውሻ	ውሻ፟
ውሻነት	ውሻ፟ነ፟ት
ውሽማ	ውሽማ፟
ውቂያ	ውቂ፟ያ
ውቃጭ	ውቃ፟ጭ
ውቅራት	ውቅ፟ራት
ውትፍ	ውት፟ፍ
ውነተኛ	ውነተኛ፟
ውንብድና	ውንብድና፟
ውንድቢ	ውንድቢ፟
ውከላ	ውከ፟ላ
ውክልና	ውክ፟ልና፟
ውዝዋዜ	ውዝዋ፟ዜ
ውዝፍ	ውዝ፟ፍ
ውይባት	ውይ፟ባት
ውደሳ	ውደ፟ሳ
ውዳሴ	ውዳ፟ሴ
ውዳቂ	ውዳ፟ቂ
ውዴላ	ውዴ፟ላ፟
ውድ	ውድ፟
ውድነት	ውድ፟ነ፟ት
ውድድር	ውድድ፟ር
ውጊያ	ውጊ፟ያ
ውፋሬ	ውፋ፟ሬ
ዐልቅት	ዐልቅ፟ት
ዐመቀ	ዐመ፟ቀ
ዐመጠ	ዐመ፟ጠ
ዐመጠኛ	ዐመጠኛ፟
ዐመፀ	ዐመ፟ፀ
ዐመፀኛ	ዐመፀኛ፟
ዐሥረኛ	ዐሥረኛ፟
ዐሥር	ዐሥ፟ር
ዐረቀ	ዐረ፟ቀ
ዐረበ	ዐረ፟በ
ዐረብኛ	ዐረብኛ፟
ዐረገ	ዐረ፟ገ
ዐረፈ	ዐረ፟ፈ
ዐራቢ	ዐራ፟ቢ
ዐቀደ	ዐቀ፟ደ
ዐቃቢት	ዐቃ፟ቢት
ዐቃቤ	ዐቃ፟ቤ
ዐበደ	ዐበ፟ደ
ዐበድ	ዐበ፟ድ
ዐወቀ	ዐወ፟ቀ
ዐወደ	ዐወ፟ደ
ዐወደኝ	ዐወ፟ደኝ፟
ዐውድማ	ዐውድማ፟
ዐየ	ዐየ፟
ዐይናማ	ዐይናማ፟
ዓለመኛ	ዓለመኛ፟
ዓለማዊነት	ዓለማዊነ፟ት
ዕልል	ዕልል፟
ዕምቅ	ዕም፟ቅ
ዕሴት	ዕሴ፟ት
ዕቀዳ	ዕቀ፟ዳ
ዕቁብ	ዕቁ፟ብ
ዕቃ	ዕቃ፟
ዕቅድ	ዕቅ፟ድ
ዕውር	ዕው፟ር
ዕውቀተኛ	ዕውቀተኛ፟
ዕጮኛ	ዕጮኛ፟
ዘለለ	ዘለ፟ለ
ዘለል	ዘለል፟
ዘለም	ዘለም፟
ዘለሰ	ዘለ፟ሰ
ዘለሰኛ	ዘለሰኛ፟
ዘለቀ	ዘለ፟ቀ
ዘለዘለ	ዘለዘ፟ለ
ዘለግ	ዘለግ፟
ዘለግላጋ	ዘለግላ፟ጋ
ዘለፈ	ዘለ፟ፈ
ዘላበደ	ዘላበ፟ደ
ዘላን	ዘላ፟ን
ዘልዛላ	ዘልዛ፟ላ
ዘልዛልነት	ዘልዛል፟ነ፟ት
ዘመመ	ዘመ፟መ
ዘመረ	ዘመ፟ረ
ዘመተ	ዘመ፟ተ
ዘመዘመ	ዘመዘ፟መ
ዘመዳሞች	ዘመዳሞች፟
ዘማ	ዘማ፟
ዘማዊ	ዘማ፟ዊ
ዘረረ	ዘረ፟ረ
ዘረነቀ	ዘረነ፟ቀ
ዘረኛ	ዘረኛ፟
ዘረከተ	ዘረከ፟ተ
ዘረክራካ	ዘረክራካ፟
ዘረዘረ	ዘረዘ፟ረ
ዘረገፈ	ዘረገ፟ፈ
ዘረጋ	ዘረጋ፟
ዘረፈ	ዘረ፟ፈ
ዘረፍራፋ	ዘረፍራፋ፟
ዘራ	ዘራ፟
ዘራሽ	ዘራ፟ሽ
ዘራፍ	ዘራ፟ፍ
ዘርካታ	ዘርካታ፟
ዘርዛራ	ዘርዛራ፟
ዘርፋፋ	ዘርፋፋ፟
ዘርፍና	ዘርፍና፟
ዘቀዘቀ	ዘቀዘ፟ቀ
ዘቀጠ	ዘቀ፟ጠ
ዘቅዛቃ	ዘቅዛቃ፟
ዘበለለ	ዘበለ፟ለ
ዘበራረቀ	ዘበራረ፟ቀ
ዘበተ	ዘበ፟ተ
ዘበነ	ዘበ፟ነ
ዘበናይነት	ዘበናይነ፟ት
ዘበኛ	ዘበኛ፟
ዘበዘበ	ዘበዘ፟በ
ዘበጠ	ዘበ፟ጠ
ዘባ	ዘባ፟
ዘባረቀ	ዘባረ፟ቀ
ዘብዛባ	ዘብዛባ፟
ዘብጥያ	ዘብጥያ፟
ዘነመ	ዘነ፟መ
ዘነቀ	ዘነ፟ቀ
ዘነቆለ	ዘነቆ፟ለ
ዘነበ	ዘነ፟በ
ዘነተረ	ዘነተ፟ረ
ዘነነ	ዘነ፟ነ
ዘነን	ዘነን፟
ዘነጋ	ዘነጋ፟
ዘነፈ	ዘነ፟ፈ
ዘና	ዘና፟
ዘናጭ	ዘና፟ጭ
ዘንባላ	ዘንባላ፟
ዘንካታ	ዘንካታ፟
ዘንፋላ	ዘንፋላ፟
ዘከረ	ዘከ፟ረ
ዘከዘከ	ዘከዘ፟ከ
ዘኬ	ዘኬ፟
ዘክዛካ	ዘክዛካ፟
ዘወረ	ዘወ፟ረ
ዘወርዋራ	ዘወርዋራ፟
ዘዋራ	ዘዋ፟ራ፟
ዘው	ዘው፟
ዘየረ	ዘየ፟ረ
ዘየነ	ዘየ፟ነ
ዘየደ	ዘየ፟ደ
ዘያጅ	ዘያ፟ጅ
ዘዴኛ	ዘዴኛ፟
ዘገምተኛ	ዘገምተኛ፟
ዘገረረ	ዘገረ፟ረ
ዘገበ	ዘገ፟በ
ዘገነ	ዘገ፟ነ
ዘገነነ	ዘገነ፟ነ
ዘገየ	ዘገየ፟
ዘጋ	ዘጋ፟
ዘግየት	ዘግየት፟
ዘጎርጓራ	ዘጎርጓራ፟
ዘጎነ	ዘጎ፟ነ
ዘጠነኛ	ዘጠነኛ፟
ዘጠኝ	ዘጠኝ፟
ዘፈቀ	ዘፈ፟ቀ
ዘፈነ	ዘፈ፟ነ
ዘፈዘፈ	ዘፈዘ፟ፈ
ዘፍ	ዘፍ፟
ዙጥ	ዙጥ፟
ዚቀኛ	ዚቀኛ፟
ዛተለ	ዛተ፟ለ
ዛቻ	ዛቻ፟
ዛኒጋባ	ዛኒጋባ፟
ዛዘነ	ዛዘ፟ነ
ዛጎልማ	ዛጎልማ፟
ዜመኛ	ዜመኛ፟
ዜንጠኛ	ዜንጠኛ፟
ዝሊያ	ዝሊ፟ያ
ዝላይ	ዝላ፟ይ
ዝልል	ዝል፟ል
ዝልስ	ዝል፟ስ
ዝመራ	ዝመ፟ራ
ዝሙተኛ	ዝሙ፟ተኛ፟
ዝሙት	ዝሙ፟ት
ዝማሬ	ዝማ፟ሬ
ዝም	ዝም፟
ዝምታ	ዝም፟ታ
ዝራጭ	ዝራ፟ጭ
ዝር	ዝር፟
ዝርክርክ	ዝርክርክ፟
ዝርክት	ዝርክ፟ት፟
ዝርዛሪ	ዝርዛ፟ሪ
ዝርዝር	ዝርዝ፟ር
ዝርያ	ዝር፟ያ
ዝርግነት	ዝርግነ፟ት
ዝርግፍ	ዝርግፍ፟
ዝቀታ	ዝቀ፟ታ
ዝቃጭ	ዝቃ፟ጭ
ዝቅ	ዝቅ፟
ዝቅተኛ	ዝቅ፟ተኛ፟
ዝብዝብ	ዝብዝ፟ብ
ዝተታም	ዝተ፟ታም
ዝተት	ዝተ፟ት
ዝነኛ	ዝነ፟ኛ፟
ዝነጣ	ዝነ፟ጣ
ዝና	ዝና፟
ዝናር	ዝና፟ር
ዝናቢስ	ዝና፟ቢስ
ዝንባሌ	ዝንባ፟ሌ
ዝንጅብል	ዝንጅብል፟
ዝንፋት	ዝን፟ፋት
ዝክዝክ	ዝክዝክ፟
ዝውውር	ዝውው፟ር
ዝየራ	ዝየ፟ራ
ዝየና	ዝየ፟ና
ዝየዳ	ዝየ፟ዳ
ዝይ	ዝይ፟
ዝግ	ዝግ፟
ዝግተኛ	ዝግ፟ተኛ፟
ዝግታ	ዝግ፟ታ
ዝግጁ	ዝግጁ፟
ዝግጅት	ዝግጅ፟ት
ዠለጠ	ዠለ፟ጠ
ዠረር	ዠረር፟
ዠረገገ	ዠረገ፟ገ
ዠርጋዳ	ዠርጋዳ፟
ዠርጋጋ	ዠርጋጋ፟
ዠቀዠቀ	ዠቀዠ፟ቀ
ዠበደ	ዠበ፟ደ
ዠበድ	ዠበ፟ድ
ዠብረር	ዠብረር፟
ዠብራራ	ዠብራራ፟
ዥማት	ዥማ፟ት
ዥዋዥዌ	ዥዋ፟ዥዌ፟
ዥው	ዥው፟
ዦፌ	ዦፌ፟
የለለው	የለለ፟ው
የለም	የለ፟ም
የለሽ	የለ፟ሽ
የለኝም	የለ፟ኝ፟ም
የለውም	የለ፟ውም
የሌለ	የሌለ፟
የሌለው	የሌ፟ለ፟ው
የሐሰት	የሐሰ፟ት
የሕግ	የሕግ፟
የመረረ	የመረ፟ረ
የመሸኛ	የመሸኛ፟
የሚመጣው	የሚ፟መጣው
የሚበቃ	የሚ፟በቃ
የሚዘለቅ	የሚዘ፟ለ፟ቅ
የሚያህል	የሚ፟ያህል
የሚያመሰኳ	የሚ፟ያመሰኳ፟
የሚያሰለች	የሚ፟ያሰለች፟
የሚያስቅ	የሚ፟ያስ፟ቅ
የሚያስተኛ	የሚ፟ያስተኛ፟
የሚያከራክር	የሚ፟ያከ፟ራክ፟ር
የሚጠልዝ	የሚ፟ጠል፟ዝ
የማን	የማን፟
የማዘጋጃ	የማዘ፟ጋጃ
የማያከራክር	የማ፟ያከ፟ራክ፟ር
የማያዛልቅ	የማ፟ያዛ፟ል፟ቅ
የማይሆን	የማ፟ይሆን
የማይለወጥ	የማ፟ይለ፟ወ፟ጥ
የማይለው	የማ፟ይለው
የማይል	የማ፟ይል
የማይረባ	የማ፟ይረባ
የማይሻር	የማ፟ይሻ፟ር
የማይቀር	የማ፟ይቀር
የማይበቃ	የማ፟ይበቃ
የማይበገር	የማ፟ይበ፟ገ፟ር
የማይታጠፍ	የማ፟ይታጠ፟ፍ
የማይጠዳው	የማ፟ይጠዳው
የምሩን	የምሩ፟ን
የምር	የምር፟
የምስራች	የምስ፟ራች፟
የረሳው	የረሳ፟ው
የረፋድ	የረፋ፟ድ
የሩጫ	የሩጫ፟
የርሱ	የርሱ፟
የርሳቸው	የርሳቸ፟ው
የሰራ	የሰ፟ራ
የሱ	የሱ፟
የሳቸው	የሳ፟ቸ፟ው
የሸማኔ	የሸማ፟ኔ
የቀረ	የቀረ፟
የቀረች	የቀረ፟ች
የቀረው	የቀረ፟ው
የቆየ	የቆየ፟
የቈላ	የቈላ፟
የበለጠ	የበለ፟ጠ
የበላይነት	የበላይነ፟ት
የበቃ	የበቃ፟
የባሰበት	የባሰበ፟ት
የተለቀቀ	የተለቀ፟ቀ
የተለያየ	የተለያየ፟
የተሟላ	የተሟላ፟
የተሟጠጠ	የተሟጠ፟ጠ
የተቀደሰ	የተቀደ፟ሰ
የተንጠለጠለ	የተንጠለጠ፟ለ
የተወለደ	የተወ፟ለደ
የተወሰነ	የተወሰ፟ነ
የተዛባ	የተዛባ፟
የተጠላ	የተጠላ፟
የተጣላ	የተጣላ፟
የተጣራ	የተጣራ፟
የተጸውዖ	የተጸው፟ዖ
የታማ	የታማ፟
የትም	የትም፟
የትና	የትና፟
የትኛው	የትኛ፟ው
የትየለሌ	የትየ፟ለሌ
የነቃ	የነቃ፟
የነጋዴዎች	የነጋ፟ዴዎች፟
የናት	የና፟ት
የንስሐ	የንስ፟ሐ
የአህያ	የአህያ፟
የአየር	የአየ፟ር
የአጋጣሚ	የአጋጣ፟ሚ
የእጅ	የእጅ፟
የከበረ	የከበ፟ረ
የካቲት	የካ፟ቲት
የክት	የክት፟
የኮቴ	የኮቴ፟
የወረገኑ	የወረ፟ገኑ
የወንድም	የወንድም፟
የዋህ	የዋ፟ህ
የዋህነት	የዋ፟ህነ፟ት
የዝናር	የዝና፟ር
የይ	የይ፟
የደምበኛ	የደምበኛ፟
የደራ	የደራ፟
የደስደስ	የደስደስ፟
የድመት	የድመ፟ት
የገዛ	የገዛ፟
የጉበት	የጉበ፟ት
የጋማ	የጋማ፟
የግሥ	የግሥ፟
የጎልማሶች	የጎልማሶች፟
የጎደለበት	የጎደ፟ለበ፟ት
የጠለቀ	የጠለ፟ቀ
የጠረጴዛ	የጠረጴ፟ዛ
የጥሪ	የጥሪ፟
የጥቅል	የጥቅ፟ል
የጥያቄ	የጥያ፟ቄ
የጫማ	የጫማ፟
የጭቅና	የጭቅ፟ና፟
የፈሰሰ	የፈሰ፟ሰ
የፊታችን	የፊታች፟ን
የፊጥኝ	የፊጥ፟ኝ፟
ያለ	ያለ፟
ያለውድ	ያለውድ፟
ያለግምት	ያለግም፟ት
ያልተሟላ	ያልተሟላ፟
ያልተወሰነ	ያልተወሰ፟ነ
ያልተገራ	ያልተገራ፟
ያልታሰበ	ያልታሰ፟በ
ያመዋል	ያመ፟ዋል
ያም	ያም፟
ያሳማ	ያሳ፟ማ
ያቻትና	ያቻ፟ትና፟
ያች	ያች፟
ያኔ	ያኔ፟
ያን	ያን፟
ያንማ	ያን፟ማ፟
ያንን	ያን፟ን
ያኛው	ያኛ፟ው
ያውና	ያውና፟
ያውኮ	ያውኮ፟
ያዝ	ያዝ፟
ያደረ	ያደ፟ረ
ያገለገለ	ያገለገ፟ለ
ያጎት	ያጎ፟ት
ይህም	ይህም፟
ይህን	ይህን፟
ይህኛው	ይህኛ፟ው
ይሉኝ	ይሉኝ፟
ይሉኝታ	ይሉኝ፟ታ
ይልቁንም	ይልቁንም፟
ይልቁንስ	ይልቁንስ፟
ይልቅስ	ይልቅስ፟
ይስጠን	ይስጠን፟
ይስጣኝ	ይስጣኝ፟
ይስጥልኝ	ይስጥልኝ፟
ይሻላል	ይሻ፟ላል
ይብላኝ	ይብላኝ፟
ይውልህ	ይውል፟ህ
ይግባኝ	ይግባኝ፟
ደለለ	ደለ፟ለ
ደለቀ	ደለ፟ቀ
ደለበ	ደለ፟በ
ደለኸ	ደለ፟ኸ
ደለዘ	ደለ፟ዘ
ደለደለ	ደለደ፟ለ
ደለፈሰ	ደለፈ፟ሰ
ደላ	ደላ፟
ደላላ	ደላ፟ላ
ደላይ	ደላ፟ይ
ደልቃቃ	ደልቃቃ፟
ደልዳላ	ደልዳ፟ላ
ደመመ	ደመ፟መ
ደመረ	ደመ፟ረ
ደመሰሰ	ደመሰ፟ሰ
ደመቀ	ደመ፟ቀ
ደመና	ደመ፟ና
ደመኛ	ደመኛ፟
ደመወዝተኛ	ደመወዝተኛ፟
ደመደመ	ደመደ፟መ
ደማ	ደማ፟
ደማቃ	ደማ፟ቃ
ደማቅ	ደማ፟ቅ
ደም	ደም፟
ደምበኛ	ደምበኛ፟
ደሞ	ደሞ፟
ደረሰ	ደረ፟ሰ
ደረሰለት	ደረ፟ሰለ፟ት
ደረሰመ	ደረሰ፟መ
ደረሰበት	ደረ፟ሰበት
ደረሰኝ	ደረ፟ሰኝ፟
ደረቀ	ደረ፟ቀ
ደረበ	ደረ፟በ
ደረተ	ደረ፟ተ
ደረደረ	ደረደ፟ረ
ደረጀ	ደረጀ፟
ደረገመ	ደረገ፟መ
ደራ	ደራ፟
ደራሲነት	ደራሲነ፟ት
ደርሽ	ደር፟ሽ፟
ደርበብ	ደርበብ፟
ደርባባ	ደርባባ፟
ደርካካ	ደርካካ፟
ደሰመ	ደሰ፟መ
ደሰሰ	ደሰ፟ሰ
ደስ	ደስ፟
ደስተኛ	ደስ፟ተኛ፟
ደስታ	ደስ፟ታ
ደቀ	ደቀ፟
ደቀለ	ደቀ፟ለ
ደቀመዝሙር	ደቀ፟መዝሙር
ደቀቀ	ደቀ፟ቀ
ደቀነ	ደቀ፟ነ
ደቀደቀ	ደቀደ፟ቀ
ደቃ	ደቃ፟
ደቃቃ	ደቃ፟ቃ
ደቃቅ	ደቃ፟ቅ
ደቅደቂት	ደቅደቂ፟ት
ደቆሰ	ደቆ፟ሰ
ደቆስቋሳ	ደቆስቋሳ፟
ደቋቆሰ	ደቋቆ፟ሰ
ደበለለ	ደበለ፟ለ
ደበለቀ	ደበለ፟ቀ
ደበላለቀ	ደበላለ፟ቀ
ደበልባላ	ደበልባላ፟
ደበሰሰ	ደበሰ፟ሰ
ደበስባሳ	ደበስባሳ፟
ደበቀ	ደበ፟ቀ
ደበበ	ደበ፟በ
ደበተ	ደበ፟ተ
ደበነ	ደበ፟ነ
ደበዘዘ	ደበዘ፟ዘ
ደበደበ	ደበደ፟በ
ደባል	ደባ፟ል
ደባቃ	ደባ፟ቃ
ደባበሰ	ደባበ፟ሰ
ደባች	ደባ፟ች
ደብሳሳ	ደብሳሳ፟
ደብዛዛ	ደብዛዛ፟
ደብዳቤ	ደብዳቤ፟
ደቦለቦለ	ደቦለቦ፟ለ
ደቦል	ደቦ፟ል
ደቦልቧላ	ደቦልቧላ፟
ደኅንነት	ደኅንነ፟ት
ደነሰ	ደነ፟ሰ
ደነቀ	ደነ፟ቀ
ደነቀረ	ደነቀ፟ረ
ደነቀፈ	ደነቀ፟ፈ
ደነቆለ	ደነቆ፟ለ
ደነቆረ	ደነቆ፟ረ
ደነበረ	ደነበ፟ረ
ደነበዘ	ደነበ፟ዘ
ደነባ	ደነባ፟
ደነነ	ደነ፟ነ
ደነዘ	ደነ፟ዘ
ደነዘዘ	ደነዘ፟ዘ
ደነደነ	ደነደነ፟
ደነገዘ	ደነገ፟ዘ
ደነገገ	ደነገ፟ገ
ደነገጠ	ደነገ፟ጠ
ደነጎረ	ደነጎ፟ረ
ደነፋ	ደነፋ፟
ደነፋፋ	ደነፋ፟ፋ
ደናማ	ደና፟ማ፟
ደናሽ	ደና፟ሽ
ደን	ደን፟
ደንቃፋ	ደንቃፋ፟
ደንበኛ	ደንበኛ፟
ደንባራ	ደንባራ፟
ደንባዛ	ደንባዛ፟
ደንደሮ	ደንደሮ፟
ደንደሳም	ደንደ፟ሳ፟ም
ደንደስ	ደንደስ፟
ደንዳና	ደንዳና፟
ደንዳኔ	ደንዳኔ፟
ደንገሎ	ደንገሎ፟
ደንጉላ	ደንጉላ፟
ደንጋራ	ደንጋራ፟
ደንጋዛ	ደንጋዛ፟
ደከመ	ደከ፟መ
ደካማ	ደካማ፟
ደኸየ	ደኸየ፟
ደወለ	ደወ፟ለ
ደዋይ	ደዋ፟ይ
ደደረ	ደደ፟ረ
ደደቀ	ደደ፟ቀ
ደደበ	ደደ፟በ
ደደብ	ደደ፟ብ
ደጀ	ደጀ፟
ደጃች	ደጃ፟ች
ደጃፍ	ደጃ፟ፍ
ደጅ	ደጅ፟
ደገመ	ደገ፟መ
ደገሰ	ደገ፟ሰ
ደገነ	ደገ፟ነ
ደገኛ	ደገኛ፟
ደገደገ	ደገደ፟ገ
ደገፈ	ደገ፟ፈ
ደጉሰ	ደጉ፟ሰ
ደጋደግ	ደጋ፟ደግ፟
ደጋፊ	ደጋ፟ፊ
ደግ	ደግ፟
ደግነቱ	ደግ፟ነ፟ቱ
ደግነት	ደግ፟ነ፟ት
ደግዳጋ	ደግዳጋ፟
ደግፍ	ደግ፟ፍ
ደጎመ	ደጎ፟መ
ደጎባ	ደጎ፟ባ
ደፈረ	ደፈ፟ረ
ደፈረሰ	ደፈረ፟ሰ
ደፈቀ	ደፈ፟ቀ
ደፈነ	ደፈ፟ነ
ደፈንፋና	ደፈንፋና፟
ደፈደፈ	ደፈደ፟ፈ
ደፋ	ደፋ፟
ደፋር	ደፋ፟ር
ደፍ	ደፍ፟
ዱለቻ	ዱለ፟ቻ፟
ዱለኛ	ዱለ፟ኛ፟
ዱላ	ዱላ፟
ዱርዬ	ዱርዬ፟
ዱባ	ዱባ፟
ዱቤ	ዱቤ፟
ዱብ	ዱብ፟
ዲካ	ዲካ፟
ዳለቻ	ዳለቻ፟
ዳለጠ	ዳለ፟ጠ
ዳሌ	ዳሌ፟
ዳመነ	ዳመ፟ነ
ዳመና	ዳመ፟ና
ዳመናማ	ዳመና፟ማ፟
ዳመናም	ዳመ፟ናም
ዳመጠ	ዳመ፟ጠ
ዳረገ	ዳረ፟ገ
ዳርቻ	ዳርቻ፟
ዳርና	ዳርና፟
ዳሰሰ	ዳሰ፟ሰ
ዳሸቀ	ዳሸ፟ቀ
ዳበረ	ዳበ፟ረ
ዳበሰ	ዳበ፟ሰ
ዳበሳ	ዳበ፟ሳ
ዳባ	ዳባ፟
ዳቦ	ዳቦ፟
ዳተኛ	ዳተኛ፟
ዳንሰኛ	ዳንሰኛ፟
ዳንግሌ	ዳንግሌ፟
ዳኘ	ዳኘ፟
ዳኛ	ዳኛ፟
ዳኝነት	ዳኝ፟ነ፟ት
ዳከረ	ዳከ፟ረ
ዳክዬ	ዳክ፟ዬ፟
ዳዋ	ዳዋ፟
ዳውላ	ዳውላ፟
ዳግመኛ	ዳግመኛ፟
ድህነት	ድህነ፟ት
ድለላ	ድለ፟ላ
ድል	ድል፟
ድልህ	ድል፟ህ
ድልል	ድል፟ል
ድልኸ	ድል፟ኸ
ድልኽ	ድል፟ኽ
ድልዝ	ድል፟ዝ
ድልድል	ድልድ፟ል
ድሎትኛ	ድሎትኛ፟
ድመራ	ድመ፟ራ
ድመት	ድመ፟ት
ድማሪ	ድማ፟ሪ
ድምር	ድም፟ር
ድምበረተኛ	ድምበረተኛ፟
ድምቡሼ	ድምቡሼ፟
ድሪያ	ድሪ፟ያ
ድራሹ	ድራ፟ሹ
ድርቅ	ድር፟ቅ
ድርቅና	ድርቅና፟
ድርብ	ድር፟ብ
ድርት	ድር፟ት
ድርና	ድርና፟
ድርድር	ድርድ፟ር
ድርጁ	ድርጁ፟
ድርጅት	ድርጅ፟ት
ድርጊት	ድርጊ፟ት
ድርግም	ድርግም፟
ድቁስ	ድቁ፟ስ
ድቅን	ድቅ፟ን፟
ድበቃ	ድበ፟ቃ
ድበብ	ድበብ፟
ድቡሽት	ድቡ፟ሽት
ድባኖ	ድባ፟ኖ
ድብ	ድብ፟
ድብልቅ	ድብል፟ቅ
ድብቅ	ድብ፟ቅ
ድብብቆሽ	ድብብ፟ቆሽ
ድብት	ድብ፟ት
ድብን	ድብ፟ን፟
ድብኝት	ድብኝ፟ት
ድኅነት	ድኅነ፟ት
ድንቁርና	ድንቁርና፟
ድንቄም	ድንቄም፟
ድንቅ	ድን፟ቅ
ድንበረተኛ	ድንበረተኛ፟
ድንበርተኛ	ድንበርተኛ፟
ድንቡሎ	ድንቡሎ፟
ድንች	ድን፟ች፟
ድንክዬ	ድንክዬ፟
ድንገተኛ	ድንገተኛ፟
ድንጋጌ	ድንጋ፟ጌ
ድንጋጤ	ድንጋ፟ጤ
ድንግልና	ድንግል፟ና
ድንግዝግዝ	ድንግዝግዝ፟
ድኝ	ድኝ፟
ድኩላ	ድኩ፟ላ
ድኽነት	ድኽነ፟ት
ድወላ	ድወ፟ላ
ድው	ድው፟
ድውር	ድው፟ር
ድውይ	ድው፟ይ
ድዳም	ድዳ፟ም
ድድ	ድድ፟
ድድር	ድድ፟ር
ድድቅ	ድድ፟ቅ
ድገና	ድገ፟ና
ድጋሚ	ድጋ፟ሚ
ድግስ	ድግ፟ስ
ድግን	ድግ፟ን
ድጎማ	ድጎ፟ማ
ድጕሳት	ድጕ፟ሳት
ዶለተ	ዶለ፟ተ
ዶለዶመ	ዶለዶ፟መ
ዶልዷላ	ዶልዷላ፟
ዶልዷሌ	ዶልዷሌ፟
ዶልዷማ	ዶልዷማ፟
ዶመኛ	ዶመኛ፟
ዶኬ	ዶኬ፟
ዶዮ	ዶዮ፟
ዶፈዶፈ	ዶፈዶ፟ፈ
ዶፍዷፋ	ዶፍዷፋ፟
ጀመረ	ጀመ፟ረ
ጀምሮ	ጀም፟ሮ
ጀረገገ	ጀረገ፟ገ
ጀሶ	ጀሶ፟
ጀበበ	ጀበ፟በ
ጀበደ	ጀበ፟ደ
ጀብደኛ	ጀብደኛ፟
ጀቦነ	ጀቦ፟ነ
ጀገነ	ጀገ፟ነ
ጀግንነት	ጀግንነ፟ት
ጂጌ	ጂጌ፟
ጃኬት	ጃኬ፟ት
ጃዊ	ጃዊ፟
ጃውሳ	ጃው፟ሳ
ጃጀ	ጃጀ፟
ጃፓናዊ	ጃፓ፟ናዊ
ጃፓን	ጃፓ፟ን
ጅላንጅል	ጅላንጅ፟ል
ጅልነት	ጅልነ፟ት
ጅማታም	ጅማ፟ታም
ጅማት	ጅማ፟ት
ጅምር	ጅም፟ር
ጅብ	ጅብ፟
ጅንን	ጅን፟ን
ጅዋጅዌ	ጅዋ፟ጅዌ፟
ጅው	ጅው፟
ጆንያ	ጆንያ፟
ጆፌ	ጆፌ፟
ጆፍጆፌ	ጆፍጆፌ፟
ገሀነመ	ገሀነ፟መ
ገሀነም	ገሀነ፟ም
ገለል	ገለል፟
ገለልተኛ	ገለልተኛ፟
ገለልተኛነት	ገለልተኛ፟ነት
ገለማ	ገለማ፟
ገለሞተ	ገለሞ፟ተ
ገለበ	ገለ፟በ
ገለበጠ	ገለበ፟ጠ
ገለጀጀ	ገለጀ፟ጀ
ገለጠ	ገለ፟ጠ
ገለጸ	ገለ፟ጸ
ገለፈጠ	ገለፈ፟ጠ
ገለፈፈ	ገለፈ፟ፈ
ገላለጠ	ገላለ፟ጠ
ገላመጠ	ገላመ፟ጠ
ገላገለ	ገላገ፟ለ
ገልዋዳ	ገልዋዳ፟
ገመለ	ገመ፟ለ
ገመምተኛ	ገመምተኛ፟
ገመሰ	ገመ፟ሰ
ገመተ	ገመ፟ተ
ገመደ	ገመ፟ደ
ገመደለ	ገመደ፟ለ
ገመገመ	ገመገ፟መ
ገመጠ	ገመ፟ጠ
ገማ	ገማ፟
ገማች	ገማ፟ች
ገምባሌ	ገምባሌ፟
ገሠሠ	ገሠ፟ሠ
ገሠጠ	ገሠ፟ጠ
ገሠጸ	ገሠ፟ጸ
ገረመ	ገረ፟መ
ገረመመ	ገረመ፟መ
ገረረ	ገረ፟ረ
ገረዘ	ገረ፟ዘ
ገረደፈ	ገረደ፟ፈ
ገረጀፈ	ገረጀ፟ፈ
ገረገረ	ገረገ፟ረ
ገረገደ	ገረ፟ገደ
ገረፈ	ገረ፟ፈ
ገራ	ገራ፟
ገራም	ገራ፟ም
ገርበብ	ገርበብ፟
ገርባባ	ገርባባ፟
ገርጃፋ	ገርጃፋ፟
ገርጋራ	ገርጋራ፟
ገሰረ	ገሰ፟ረ
ገሰሰ	ገሰ፟ሰ
ገሰገሰ	ገሰገ፟ሰ
ገሸለጠ	ገሸለ፟ጠ
ገሸረ	ገሸ፟ረ
ገሸሽ	ገሸሽ፟
ገበረ	ገበ፟ረ
ገበየ	ገበየ፟
ገበያተኛ	ገበያተኛ፟
ገቢና	ገቢና፟
ገባ	ገባ፟
ገባር	ገባ፟ር
ገባች	ገባች፟
ገባው	ገባ፟ው
ገብ	ገብ፟
ገብጋባ	ገብጋ፟ባ
ገተረ	ገተ፟ረ
ገተት	ገተ፟ት
ገታ	ገታ፟
ገታራ	ገታ፟ራ
ገትጋታ	ገትጋታ፟
ገቻ	ገቻ፟
ገነባ	ገነባ፟
ገነተረ	ገነተ፟ረ
ገነት	ገነ፟ት
ገነነ	ገነ፟ነ
ገነን	ገነ፟ን
ገነዘ	ገነ፟ዘ
ገነደሰ	ገነደ፟ሰ
ገነገነ	ገነገ፟ነ
ገነፈለ	ገነፈ፟ለ
ገና	ገና፟
ገንባሌ	ገንባሌ፟
ገንታራ	ገንታራ፟
ገዘተ	ገዘ፟ተ
ገዘገዘ	ገዘገ፟ዘ
ገዘፈ	ገዘ፟ፈ
ገዛ	ገዛ፟
ገዝጋዛ	ገዝጋዛ፟
ገደ	ገደ፟
ገደለ	ገደ፟ለ
ገደለው	ገደ፟ለው
ገደላማ	ገደላማ፟
ገደርዳራ	ገደርዳራ፟
ገደበ	ገደ፟በ
ገደገደ	ገደገ፟ደ
ገደፈ	ገደ፟ፈ
ገዳማ	ገዳ፟ማ፟
ገዳም	ገዳ፟ም
ገዳዳ	ገዳ፟ዳ
ገዴ	ገዴ፟
ገድ	ገድ፟
ገድለኛ	ገድለኛ፟
ገድጋዳ	ገድጋዳ፟
ገዶኝ	ገዶ፟ኝ፟
ገገምተኛ	ገገምተኛ፟
ገገረ	ገገ፟ረ
ገጠገጠ	ገጠገ፟ጠ
ገጠጠ	ገጠ፟ጠ
ገጨኸኝ	ገጨ፟ኸኝ፟
ገፈተረ	ገፈተ፟ረ
ገፈገፈ	ገፈገ፟ፈ
ገፈፈ	ገፈ፟ፈ
ገፈፋ	ገፈፋ፟
ገፋ	ገፋ፟
ገፋፋ	ገፋፋ፟
ጉልላት	ጉል፟ላት
ጉልማ	ጉልማ፟
ጉልበተኛ	ጉልበተኛ፟
ጉልተኛ	ጉልተኛ፟
ጉልቻ	ጉል፟ቻ
ጉማጅ	ጉማ፟ጅ
ጉም	ጉም፟
ጉረሮ	ጉረሮ፟
ጉረኖ	ጉረኖ፟
ጉረኛ	ጉረኛ፟
ጉራ	ጉራ፟
ጉራሽ	ጉራ፟ሽ
ጉራቻ	ጉራ፟ቻ፟
ጉራች	ጉራ፟ች፟
ጉራጅ	ጉራ፟ጅ
ጉሬዛማ	ጉሬዛማ፟
ጉርምስና	ጉርምስ፟ና፟
ጉርብርብ	ጉርብርብ፟
ጉርብትና	ጉርብትና፟
ጉሮሮ	ጉሮሮ፟
ጉበት	ጉበ፟ት
ጉበኛ	ጉበኛ፟
ጉብ	ጉብ፟
ጉብታ	ጉብ፟ታ
ጉብዝና	ጉብዝና፟
ጉቦ	ጉቦ፟
ጉቦኛ	ጉቦ፟ኛ፟
ጉተታ	ጉተ፟ታ
ጉትቻ	ጉትቻ፟
ጉትያ	ጉትያ፟
ጉቶ	ጉቶ፟
ጉያ	ጉያ፟
ጉደኛ	ጉደኛ፟
ጉዳተኛ	ጉዳተኛ፟
ጉዳዩ	ጉዳ፟ዩ
ጉዳዬ	ጉዳ፟ዬ
ጉዳይ	ጉዳ፟ይ
ጉድ	ጉድ፟
ጉድለት	ጉድ፟ለት
ጉዶ	ጉዶ፟
ጉጉት	ጉጉ፟ት
ጋለበ	ጋለ፟በ
ጋማ	ጋማ፟
ጋሜ	ጋሜ፟
ጋረደ	ጋረ፟ደ
ጋረጠ	ጋረ፟ጠ
ጋራማ	ጋራማ፟
ጋሬ	ጋሬ፟
ጋሸበ	ጋሸ፟በ
ጋሻ	ጋሻ፟
ጋሼ	ጋሼ፟
ጋሽዬ	ጋሽ፟ዬ
ጋበዘ	ጋበ፟ዘ
ጋብቻ	ጋብቻ፟
ጋንድያ	ጋንድያ፟
ጋየ	ጋየ፟
ጋገረ	ጋገ፟ረ
ጋጋ	ጋጋ፟
ጋጠኝ	ጋጠኝ፟
ጌትነት	ጌትነ፟ት
ጌቶች	ጌቶች፟
ጌጅ	ጌጅ፟
ጌጠኛ	ጌጠኛ፟
ግለሂስ	ግለ፟ሂስ
ግለኛ	ግለ፟ኛ፟
ግላዊ	ግላ፟ዊ
ግላጭ	ግላ፟ጭ
ግል	ግል፟
ግልሙትና	ግልሙትና፟
ግልባጭ	ግል፟ባ፟ጭ
ግልብነት	ግልብነ፟ት
ግልግል	ግልግ፟ል
ግልፋፊ	ግልፋ፟ፊ
ግልፍ	ግል፟ፍ፟
ግልፍተኛ	ግልፍተኛ፟
ግልፍታም	ግል፟ፍታም
ግማሽ	ግማ፟ሽ
ግማደ	ግማ፟ደ
ግማጭ	ግማ፟ጭ
ግም	ግም፟
ግምል	ግም፟ል
ግምበኛ	ግምበኛ፟
ግምት	ግም፟ት
ግሣዊ	ግሣ፟ዊ
ግሣጼ	ግሣ፟ጼ
ግሥ	ግሥ፟
ግሦች	ግሦ፟ች
ግረዛ	ግረ፟ዛ
ግራኝ	ግራኝ፟
ግራዋ	ግራዋ፟
ግር	ግር፟
ግርዛት	ግር፟ዛት
ግርድና	ግርድና፟
ግርድፍ	ግርድ፟ፍ
ግርግር	ግር፟ግር፟
ግርፋት	ግር፟ፋት
ግሳንግስ	ግሳ፟ንግስ
ግስላ	ግስ፟ላ
ግስጋሴ	ግስጋ፟ሴ
ግሽር	ግሽ፟ር
ግቢ	ግቢ፟
ግብርና	ግብርና፟
ግብዝ	ግብ፟ዝ
ግብዝና	ግብዝና፟
ግብዣ	ግብዣ፟
ግትር	ግት፟ር
ግትርትር	ግትርትር፟
ግትቻ	ግትቻ፟
ግንበኛ	ግንበኛ፟
ግንኙነት	ግንኙ፟ነ፟ት
ግንዛቤ	ግንዛ፟ቤ
ግንዲላ	ግንዲላ፟
ግኝት	ግኝ፟ት
ግዝት	ግዝ፟ት
ግዞተኛ	ግዞተኛ፟
ግዥ	ግዥ፟
ግዳይ	ግዳ፟ይ
ግዳጅ	ግዳ፟ጅ
ግዴ	ግዴ፟
ግዴታ	ግዴ፟ታ
ግድ	ግድ፟
ግድብ	ግድ፟ብ
ግድያ	ግድያ፟
ግድግዳ	ግድግዳ፟
ግግ	ግግ፟
ግግር	ግግ፟ር
ግጥም	ግጥ፟ም፟
ግፈኛ	ግፈኛ፟
ግፊት	ግፊ፟ት
ግፊያ	ግፊ፟ያ
ጎለመሰ	ጎለመ፟ሰ
ጎልማሳ	ጎልማሳ፟
ጎመን	ጎመ፟ን
ጎመዘዘ	ጎመዘ፟ዘ
ጎመደ	ጎመ፟ደ
ጎመጀ	ጎመጀ፟
ጎሚስታ	ጎሚ፟ስታ
ጎማ	ጎማ፟
ጎማህ	ጎማ፟ህ
ጎማሬ	ጎማ፟ሬ
ጎምላላ	ጎምላላ፟
ጎምዛዛ	ጎምዛ፟ዛ
ጎረመሰ	ጎረመ፟ሰ
ጎረሰ	ጎረ፟ሰ
ጎረበ	ጎረ፟በ
ጎረደ	ጎረ፟ደ
ጎረደመ	ጎረደ፟መ
ጎራረደ	ጎራረ፟ደ
ጎርደድ	ጎርደድ፟
ጎሸመ	ጎሸ፟መ
ጎሽ	ጎሽ፟
ጎበበ	ጎበ፟በ
ጎበዘ	ጎበ፟ዘ
ጎታች	ጎታ፟ች
ጎን	ጎን፟
ጎንደርኛ	ጎንደርኛ፟
ጎዘጎዘ	ጎዘ፟ጎ፟ዘ
ጎዦ	ጎዦ፟
ጎደለ	ጎደ፟ለ
ጎደል	ጎደ፟ል
ጎዳ	ጎዳ፟
ጎዳኒሳ	ጎዳኒሳ፟
ጎጆ	ጎጆ፟
ጎጆና	ጎጆ፟ና
ጎፈረ	ጎፈ፟ረ
ጎፈር	ጎፈ፟ር
ጎፈነነ	ጎፈነ፟ነ
ጐለተ	ጐለ፟ተ
ጐለጐለ	ጐለጐ፟ለ
ጐላ	ጐላ፟
ጐልማማ	ጐልማማ፟
ጐልዳፋ	ጐልዳፋ፟
ጐመራ	ጐመራ፟
ጐረበጠ	ጐረበ፟ጠ
ጐረበጠኝ	ጐረበ፟ጠኝ፟
ጐረና	ጐረና፟
ጐረጐረ	ጐረጐ፟ረ
ጐረፈ	ጐረ፟ፈ
ጐርናና	ጐርናና፟
ጐርደድ	ጐርደድ፟
ጐርዳዳ	ጐርዳዳ፟
ጐሰመ	ጐሰ፟መ
ጐሰረ	ጐሰ፟ረ
ጐሰቈለ	ጐሰቈ፟ለ
ጐሰጐሰ	ጐሰጐ፟ሰ
ጐስቋላ	ጐስቋላ፟
ጐበኘ	ጐበኘ፟
ጐበጠ	ጐበ፟ጠ
ጐባን	ጐባ፟ን
ጐተተ	ጐተ፟ተ
ጐተጐተ	ጐተጐ፟ተ
ጐነቈለ	ጐነቈ፟ለ
ጐነጐነ	ጐነጐ፟ነ
ጐነጠ	ጐነ፟ጠ
ጐነፈ	ጐነ፟ፈ
ጐንበስ	ጐንበስ፟
ጐንዛላ	ጐንዛላ፟
ጐደሪ	ጐደሪ፟
ጐደጐደ	ጐደጐ፟ደ
ጐድጓዳ	ጐድጓዳ፟
ጐጃሜ	ጐጃ፟ሜ
ጐጃም	ጐጃ፟ም
ጐፈየ	ጐፈየ፟
ጓሮኛ	ጓሮኛ፟
ጓያ	ጓያ፟
ጓደኛ	ጓደኛ፟
ጓደኛሞች	ጓደኛ፟ሞች
ጓደኝነት	ጓደ፟ኝ፟ነ፟ት
ጓድ	ጓድ፟
ጓጐለ	ጓጐ፟ለ
ጓጐረ	ጓጐ፟ረ
ጓጐጠ	ጓጐ፟ጠ
ጓጓ	ጓጓ፟
ጓጓላ	ጓጓ፟ላ
ጕላይ	ጕላ፟ይ
ጕልት	ጕል፟ት
ጕልቻ	ጕልቻ፟
ጕሰማ	ጕሰ፟ማ
ጕስቈላ	ጕስቈላ፟
ጕብኝት	ጕብኝ፟ት
ጕተታ	ጕተ፟ታ
ጕትት	ጕት፟ት
ጕትቻ	ጕትቻ፟
ጕነጣ	ጕነ፟ጣ
ጕዞኛ	ጕዞኛ፟
ጕጕ	ጕጕ፟
ጕፋያ	ጕፋያ፟
ጠለለ	ጠለ፟ለ
ጠለቀ	ጠለ፟ቀ
ጠለዘ	ጠለ፟ዘ
ጠለፈ	ጠለ፟ፈ
ጠላ	ጠላ፟
ጠል	ጠል፟
ጠመመ	ጠመ፟መ
ጠመረረ	ጠመረ፟ረ
ጠመሰሰ	ጠመሰ፟ሰ
ጠመቀ	ጠመ፟ቀ
ጠመዘዘ	ጠመዘ፟ዘ
ጠመዝማዛ	ጠመዝማዛ፟
ጠመደ	ጠመ፟ደ
ጠምባራ	ጠምባራ፟
ጠምዛዛ	ጠምዛዛ፟
ጠምጣማ	ጠምጣማ፟
ጠረመሰ	ጠረመ፟ሰ
ጠረረ	ጠረ፟ረ
ጠረሰ	ጠረ፟ሰ
ጠረቀመ	ጠረቀ፟መ
ጠረበ	ጠረ፟በ
ጠረነቀ	ጠረነ፟ቀ
ጠረዘ	ጠረ፟ዘ
ጠረገ	ጠረ፟ገ
ጠረጴዛ	ጠረጴ፟ዛ
ጠራ	ጠራ፟
ጠርባባ	ጠርባባ፟
ጠርዛዛ	ጠርዛዛ፟
ጠሰቀ	ጠሰ፟ቀ
ጠስቆ	ጠስ፟ቆ
ጠቀለለ	ጠቀለ፟ለ
ጠቀመ	ጠቀ፟መ
ጠቀሰ	ጠቀ፟ሰ
ጠቀስ	ጠቀ፟ስ
ጠቅላላ	ጠቅላ፟ላ
ጠቅላላውን	ጠቅላላ፟ውን
ጠቆረ	ጠቆ፟ረ
ጠበልተኛ	ጠበልተኛ፟
ጠበሰ	ጠበ፟ሰ
ጠበሰቀ	ጠበሰ፟ቀ
ጠበቀ	ጠበ፟ቀ
ጠበበ	ጠበ፟በ
ጠበኛ	ጠበኛ፟
ጠበደለ	ጠበደ፟ለ
ጠባ	ጠባ፟
ጠባቂ	ጠባ፟ቂ
ጠባብ	ጠባ፟ብ
ጠብ	ጠብ፟
ጠብታ	ጠብ፟ታ
ጠቦት	ጠቦ፟ት
ጠነሰሰ	ጠነሰ፟ሰ
ጠነቀቀ	ጠነቀ፟ቀ
ጠነቆለ	ጠነቆ፟ለ
ጠነበዘ	ጠነበ፟ዘ
ጠነባ	ጠነባ፟
ጠነነ	ጠነ፟ነ
ጠነነኝ	ጠነ፟ነኝ፟
ጠነዛ	ጠነዛ፟
ጠነፈፈ	ጠነፈ፟ፈ
ጠና	ጠና፟
ጠኔ	ጠኔ፟
ጠኔያም	ጠኔ፟ያም
ጠንቀኛ	ጠንቀኛ፟
ጠንቃቃ	ጠንቃቃ፟
ጠንባራ	ጠንባራ፟
ጠንባሳ	ጠንባሳ፟
ጠንባዛ	ጠንባዛ፟
ጠንካራ	ጠንካ፟ራ
ጠወለገ	ጠወለ፟ገ
ጠውላጋ	ጠውላጋ፟
ጠየመ	ጠየ፟መ
ጠየቀ	ጠየ፟ቀ
ጠያር	ጠያ፟ር
ጠያቂ	ጠያ፟ቂ
ጠያፍ	ጠያ፟ፍ
ጠይም	ጠይ፟ም
ጠደቀ	ጠደ፟ቀ
ጠዳ	ጠዳ፟
ጠጅ	ጠጅ፟
ጠገበ	ጠገ፟በ
ጠገነ	ጠገ፟ነ
ጠገገ	ጠገ፟ገ
ጠጋ	ጠጋ፟
ጠጋቢስ	ጠጋ፟ቢስ
ጠጋኝ	ጠጋ፟ኝ
ጠጠተ	ጠጠ፟ተ
ጠጠተኝ	ጠጠ፟ተኝ፟
ጠጣ	ጠጣ፟
ጠፈረ	ጠፈ፟ረ
ጠፈረተኛ	ጠፈረተኛ፟
ጠፈጠፈው	ጠፈጠ፟ፈው
ጠፈፈ	ጠፈ፟ፈ
ጠፋ	ጠፋ፟
ጠፍ	ጠፍ፟
ጠፍጣፋ	ጠፍጣፋ፟
ጡሌ	ጡሌ፟
ጡል	ጡል፟
ጡረኛ	ጡረኛ፟
ጡርነት	ጡርነ፟ት
ጡብ	ጡብ፟
ጡንቸኛ	ጡንቸኛ፟
ጡንቻማ	ጡንቻማ፟
ጡጥ	ጡጥ፟
ጢም	ጢም፟
ጢሰኛ	ጢሰኛ፟
ጢቅ	ጢቅ፟
ጢቅታ	ጢቅ፟ታ
ጢን	ጢን፟
ጣሰሰ	ጣሰ፟ሰ
ጣጠኛ	ጣጠኛ፟
ጣፈጠ	ጣፈ፟ጠ
ጣፊያ	ጣፊ፟ያ
ጤነኛ	ጤነኛ፟
ጤናማ	ጤናማ፟
ጤናዳም	ጤናዳ፟ም
ጥለኛ	ጥለኛ፟
ጥላማ	ጥላማ፟
ጥላቻ	ጥላቻ፟
ጥልቅ	ጥል፟ቅ፟
ጥልቆ	ጥል፟ቆ
ጥማድ	ጥማ፟ድ
ጥምልምል	ጥምልምል፟
ጥምር	ጥም፟ር
ጥምዝ	ጥምዝ፟
ጥምጥም	ጥምጥም፟
ጥሞና	ጥሞ፟ና
ጥሩምበኛ	ጥሩምበኛ፟
ጥሪ	ጥሪ፟
ጥራቢ	ጥራ፟ቢ
ጥራጊ	ጥራ፟ጊ
ጥር	ጥር፟
ጥርቃሚ	ጥርቃ፟ሚ
ጥርቃሞ	ጥርቃ፟ሞ
ጥርቅም	ጥርቅ፟ም
ጥርቅምአድርጎ	ጥርቅም፟አድርጎ
ጥርኝ	ጥርኝ፟
ጥስቅ	ጥስ፟ቅ
ጥቁም	ጥቁ፟ም
ጥቃቅን	ጥቃቅ፟ን
ጥቅል	ጥቅ፟ል
ጥበቃ	ጥበ፟ቃ
ጥበበኛ	ጥበበኛ፟
ጥበት	ጥበ፟ት
ጥቢ	ጥቢ፟
ጥብቅ	ጥብ፟ቅ
ጥብቅና	ጥብቅና፟
ጥብቆ	ጥብ፟ቆ
ጥብኛ	ጥብ፟ኛ፟
ጥቦት	ጥቦ፟ት
ጥንቃቄ	ጥንቃ፟ቄ
ጥንካሬ	ጥንካ፟ሬ
ጥንዚዛ	ጥንዚዛ፟
ጥየቃ	ጥየ፟ቃ
ጥዩፍ	ጥዩ፟ፍ
ጥያቄ	ጥያ፟ቄ
ጥይት	ጥይ፟ት
ጥይፍተኛ	ጥይ፟ፍተኛ፟
ጥጃ	ጥጃ፟
ጥገት	ጥገ፟ት
ጥገና	ጥገ፟ና
ጥገኛ	ጥገ፟ኛ፟
ጥገኛነት	ጥገ፟ኛ፟ነ፟ት
ጥጋበኛ	ጥጋበኛ፟
ጥግ	ጥግ፟
ጥግን	ጥግ፟ን
ጥፊ	ጥፊ፟
ጥፋተኛ	ጥፋተኛ፟
ጦልጣሏ	ጦልጣሏ፟
ጦልጧላ	ጦልጧላ፟
ጦመኛ	ጦመኛ፟
ጦረኛ	ጦረኛ፟
ጦርነት	ጦርነ፟ት
ጦሰኛ	ጦሰኛ፟
ጦስኝ	ጦስኝ፟
ጦሽ	ጦሽ፟
ጦቢያ	ጦቢ፟ያ
ጨለመ	ጨለ፟መ
ጨለማ	ጨለ፟ማ
ጨለጠ	ጨለ፟ጠ
ጨለፈ	ጨለ፟ፈ
ጨላጭ	ጨላ፟ጭ
ጨሌ	ጨሌ፟
ጨመለቅ	ጨመለ፟ቅ
ጨመረ	ጨመ፟ረ
ጨመቀ	ጨመ፟ቀ
ጨመተ	ጨመ፟ተ
ጨመደደ	ጨመደ፟ደ
ጨምላቃ	ጨምላቃ፟
ጨምባሳ	ጨምባሳ፟
ጨምታራ	ጨምታራ፟
ጨምዳዳ	ጨምዳዳ፟
ጨረሰ	ጨረ፟ሰ
ጨረታ	ጨረ፟ታ
ጨረገደ	ጨረገ፟ደ
ጨረፈ	ጨረ፟ፈ
ጨርማማ	ጨርማማ፟
ጨርማታ	ጨርማታ፟
ጨርማዳ	ጨርማዳ፟
ጨርሶ	ጨር፟ሶ
ጨርጫሳ	ጨርጫሳ፟
ጨቀየ	ጨቀየ፟
ጨቅላነት	ጨቅላነ፟ት
ጨቅጫቃ	ጨቅጫቃ፟
ጨቆነ	ጨቆ፟ነ
ጨቋኝ	ጨቋ፟ኝ
ጨበጠ	ጨበ፟ጠ
ጨቦደ	ጨቦ፟ደ
ጨነቀ	ጨነ፟ቀ
ጨነገፈ	ጨነገ፟ፈ
ጨንቋራ	ጨንቋራ፟
ጨንባሳ	ጨንባሳ፟
ጨከነ	ጨከ፟ነ
ጨካኝ	ጨካ፟ኝ
ጨዋነት	ጨዋነ፟ት
ጨውናና	ጨውናና፟
ጨገገ	ጨገ፟ገ
ጨጓራ	ጨጓ፟ራ፟
ጨፈለቀ	ጨፈለ፟ቀ
ጨፈረ	ጨፈ፟ረ
ጨፈነ	ጨፈ፟ነ
ጨፈገገ	ጨፈገ፟ገ
ጨፋሪ	ጨፋ፟ሪ
ጨፋና	ጨፋ፟ና
ጨፌ	ጨፌ፟
ጨፍራራ	ጨፍራራ፟
ጨፍጋጋ	ጨፍጋጋ፟
ጩርር	ጩርር፟
ጫማ	ጫማ፟
ጫር	ጫር፟
ጫና	ጫና፟
ጫን	ጫን፟
ጫካ	ጫካ፟
ጫካማ	ጫካማ፟
ጫጩት	ጫጩት፟
ጫፍና	ጫፍና፟
ጭለማ	ጭለ፟ማ
ጭላጭ	ጭላ፟ጭ
ጭልጥ	ጭል፟ጥ፟
ጭልፊት	ጭልፊት፟
ጭማሪ	ጭማ፟ሪ
ጭማቂ	ጭማ፟ቂ
ጭምር	ጭም፟ር
ጭምት	ጭም፟ት
ጭራሹ	ጭራ፟ሹ
ጭራሽ	ጭራ፟ሽ
ጭር	ጭር፟
ጭርታ	ጭር፟ታ
ጭቁን	ጭቁ፟ን
ጭቃማ	ጭቃማ፟
ጭቅቅታም	ጭቅቅ፟ታም
ጭቅቅት	ጭቅቅ፟ት
ጭቅና	ጭቅና፟
ጭቆና	ጭቆ፟ና
ጭባጭ	ጭባ፟ጭ
ጭብጥ	ጭብ፟ጥ
ጭብጦ	ጭብ፟ጦ
ጭቦ	ጭቦ፟
ጭቦኛ	ጭቦ፟ኛ፟
ጭንቅላታም	ጭንቅላ፟ታም
ጭንቅላት	ጭንቅ፟ላት
ጭከና	ጭከ፟ና
ጭካኔ	ጭካ፟ኔ
ጭኮ	ጭኮ፟
ጭው	ጭው፟
ጭውውት	ጭው፟ውት
ጭፈራ	ጭፈ፟ራ
ጭፍን	ጭፍ፟ን
ጮሌ	ጮሌ፟
ጮረረ	ጮረ፟ረ
ጮራ	ጮራ፟
ጮቤ	ጮቤ፟
ጳጳሳት	ጳጳ፟ሳት
ጳጳስ	ጳጳ፟ስ
ጸለየ	ጸለ፟የ
ጸሎተኛ	ጸሎተኛ፟
ጸበረቀ	ጸበረ፟ቀ
ጸነነ	ጸነ፟ነ
ጸና	ጸና፟
ጸያፍ	ጸያ፟ፍ
ጸደቀ	ጸደ፟ቀ
ጸዳ	ጸዳ፟
ጸጋ	ጸጋ፟
ጸጥ	ጸጥ፟
ጸጥተኛ	ጸጥ፟ተኛ፟
ጸጸተ	ጸጸ፟ተ
ጸጸተኛ	ጸጸተኛ፟
ጽላተ	ጽላ፟ተ
ጽላት	ጽላ፟ት
ጽኑነት	ጽኑነ፟ት
ጽዋ	ጽዋ፟
ጽጌረዳ	ጽጌ፟ረዳ
ጾመኛ	ጾመኛ፟
ፀሐያማ	ፀሐያማ፟
ፈለሰ	ፈለ፟ሰ
ፈለሰመ	ፈለሰ፟መ
ፈለሰፈ	ፈለሰ፟ፈ
ፈለቀ	ፈለ፟ቀ
ፈለቀቀ	ፈለቀ፟ቀ
ፈለገ	ፈለ፟ገ
ፈለጠ	ፈለ፟ጠ
ፈለፈለ	ፈለፈ፟ለ
ፈሊጠኛ	ፈሊጠኛ፟
ፈላ	ፈላ፟
ፈላሻ	ፈላ፟ሻ
ፈላጊ	ፈላ፟ጊ
ፈልሳሳ	ፈልሳ፟ሳ
ፈረመ	ፈረ፟መ
ፈረሰ	ፈረ፟ሰ
ፈረሰኛ	ፈረሰኛ፟
ፈረሱላ	ፈረሱላ፟
ፈረንሳይኛ	ፈረንሳይኛ፟
ፈረክራካ	ፈረክራካ፟
ፈረደ	ፈረ፟ደ
ፈረደለት	ፈረ፟ደለት
ፈረደበት	ፈረ፟ደበ፟ት
ፈረጠ	ፈረ፟ጠ
ፈረፈረ	ፈረፈ፟ረ
ፈሪነት	ፈሪነ፟ት
ፈራ	ፈራ፟
ፈራሚ	ፈራ፟ሚ
ፈራረሰ	ፈራረ፟ሰ
ፈርጣማ	ፈርጣማ፟
ፈሰሰ	ፈሰ፟ሰ
ፈሰከ	ፈሰ፟ከ
ፈሰፈሰ	ፈሰፈ፟ሰ
ፈሳ	ፈሳ፟
ፈቀቅ	ፈቀቅ፟
ፈቀደ	ፈቀ፟ደ
ፈቀደው	ፈቀ፟ደው
ፈቀፈቀ	ፈቀፈ፟ቀ
ፈቃደኛ	ፈቃደኛ፟
ፈቃደኛነት	ፈቃደኛ፟ነ፟ት
ፈተለ	ፈተ፟ለ
ፈተሸ	ፈተ፟ሸ
ፈተነ	ፈተ፟ነ
ፈተገ	ፈተ፟ገ
ፈተፈተ	ፈተፈ፟ተ
ፈታ	ፈታ፟
ፈታሽ	ፈታ፟ሽ
ፈታታ	ፈታታ፟
ፈታኝ	ፈታ፟ኝ
ፈት	ፈት፟
ፈትለክ	ፈትለክ፟
ፈነቀለ	ፈነቀ፟ለ
ፈነከተ	ፈነከ፟ተ
ፈነደቀ	ፈነደ፟ቀ
ፈነዳ	ፈነዳ፟
ፈነገለ	ፈነገ፟ለ
ፈንዳዳ	ፈንዳዳ፟
ፈንጋላ	ፈንጋላ፟
ፈንጠዝያ	ፈንጠዝያ፟
ፈንጣራ	ፈንጣራ፟
ፈካ	ፈካ፟
ፈወሰ	ፈወ፟ሰ
ፈዋሽ	ፈዋ፟ሽ
ፈዘዘ	ፈዘ፟ዘ
ፈዛዛ	ፈዛዛ፟
ፈየለ	ፈየ፟ለ
ፈየደ	ፈየ፟ደ
ፈጀ	ፈጀ፟
ፈጅ	ፈጅ፟
ፈገመ	ፈገ፟መ
ፈገገ	ፈገ፟ገ
ፈገፈገ	ፈገፈ፟ገ
ፈግጠው	ፈግ፟ጠው
ፈጠመ	ፈጠ፟መ
ፈጠፈጠ	ፈጠፈ፟ጠ
ፈጸመ	ፈጸ፟መ
ፈጻሚ	ፈጻ፟ሚ
ፉት	ፉት፟
ፉከራ	ፉከ፟ራ
ፉክክር	ፉክክ፟ር
ፉጉሎ	ፉጉሎ፟
ፊር	ፊር፟
ፊተኛው	ፊተኛ፟ው
ፊትና	ፊትና፟
ፊን	ፊን፟
ፊኛ	ፊኛ፟
ፊጥኝ	ፊጥ፟ኝ፟
ፋነነ	ፋነ፟ነ
ፋንድያ	ፋንድ፟ያ
ፋኖ	ፋኖ፟
ፋፋ	ፋፋ፟
ፌዘኛ	ፌዘ፟ኛ፟
ፍለጋ	ፍለ፟ጋ
ፍላጎት	ፍላ፟ጎት
ፍልስፍና	ፍልስፍና፟
ፍልቃቂ	ፍል፟ቃ፟ቂ
ፍሥሐ	ፍሥ፟ሐ
ፍራሽ	ፍራ፟ሽ
ፍራቻ	ፍራቻ፟
ፍሬያማ	ፍሬያማ፟
ፍርምባ	ፍርምባ፟
ፍርስ	ፍር፟ስ
ፍርጥ	ፍር፟ጥ
ፍርፋሪ	ፍርፋ፟ሪ
ፍሳሽ	ፍሳ፟ሽ
ፍስስ	ፍስ፟ስ
ፍስክ	ፍስ፟ክ
ፍቅረኛ	ፍቅረኛ፟
ፍቅፋቂ	ፍቅፋ፟ቂ
ፍተሻ	ፍተ፟ሻ
ፍተጋ	ፍተ፟ጋ
ፍትወተኛ	ፍትወተኛ፟
ፍትግ	ፍት፟ግ
ፍች	ፍች፟
ፍንካች	ፍንካ፟ች
ፍንክች	ፍንክች፟
ፍንድቅ	ፍንድ፟ቅ፟
ፍየል	ፍየ፟ል
ፍዳ	ፍዳ፟
ፍዳውን	ፍዳ፟ውን
ፍጅት	ፍጅ፟ት
ፍግም	ፍግ፟ም፟
ፍግፋጊ	ፍግፋ፟ጊ
ፍጥጥ	ፍጥጥ፟
ፍጹምነት	ፍጹ፟ምነ፟ት
ፎሌ	ፎሌ፟
ፎልፏላ	ፎልፏላ፟
ፎረሸ	ፎረ፟ሸ
ፎቀቅ	ፎቀ፟ቅ
ፎነነ	ፎነ፟ነ
ፎከረ	ፎከ፟ረ
ፎከተ	ፎከ፟ተ
ፎከት	ፎከት፟
ፓኮ	ፓኮ፟
ፓፓዬ	ፓፓ፟ዬ
ፕሮፓጋንዳ	ፕሮፓጋንዳ፟
ፖሊቲከኛ	ፖሊቲከኛ፟
ፖስተኛ	ፖስተኛ፟
