# Country/region/territory names
#
ᎠᏂᏙᎳ	anidola
ᏌᏊ ᎢᏳᎾᎵᏍᏔᏅ ᎡᎳᏈ ᎢᎹᎵᏘᏏ	sakʷu ijunalistanə̃ elakʷi imalitisi
ᎠᏫᎨᏂᏍᏖᏂ	awiɡenisteni
ᎤᏪᏘ ᎠᎴ ᏆᏊᏓ	uweti ale kʷakʷuda
ᎠᏂᎩᎳ	aniɡila
ᎠᎵᏇᏂᏯ	alikʷenija
ᎠᎵᎻᏂᎠ	aliminia
ᎠᏂᎪᎳ	aniɡola
ᏧᏁᏍᏓᎸ	t͡sunesdalə̃
ᎠᏥᏂᏘᏂᎠ	at͡sinitinia
ᎠᎺᎵᎧ ᏌᎼᎠ	amelika samoa
ᎠᏍᏟᏯ	ast͡ɬija
ᎡᎳᏗᏜ	eladid͡la
ᎠᎷᏆ	alukʷa
ᎣᎴᏅᏓ ᏚᎦᏚᏛᎢ	olenə̃da duɡadudə̃i
ᎠᏏᎵᏆᏌᏂ	asilikʷasani
ᏉᏏᏂᎠ ᎠᎴ ᎲᏤᎪᏫ	kʷosinia ale hə̃t͡seɡowi
ᏆᏇᏙᏍ	kʷakʷedos
ᏆᏂᎦᎵᏕᏍ	kʷaniɡalides
ᏇᎵᏥᎥᎻ	kʷelit͡siə̃mi
ᏋᎩᎾ ᏩᏐ	kʷə̃ɡina waso
ᏊᎵᎨᎵᎠ	kʷuliɡelia
ᏆᎭᎴᎢᏂ	kʷahaleini
ᏋᎷᏂᏗ	kʷə̃lunidi
ᏆᏂᎢᏂ	kʷaniːni
ᎠᏥᎸᏉᏗ ᏆᏕᎳᎻ	at͡silə̃kʷodi kʷadelami
ᏆᏊᏓ	kʷakʷuda
ᏊᎾᎢ	kʷunai
ᏉᎵᏫᎠ	kʷoliwia
ᏆᏏᎵᎢ	kʷasiliː
ᎾᏍᎩ ᏆᎭᎹᏍ	nasɡi kʷahamas
ᏊᏔᏂ	kʷutani
ᏊᏪ ᎤᎦᏚᏛᎢ	kʷuwe uɡadudə̃i
ᏆᏣᏩᎾ	kʷat͡sawana
ᏇᎳᎷᏍ	kʷelalus
ᏇᎵᏍ	kʷelis
ᎨᎾᏓ	ɡenada
ᎧᏂᎪ	kaniɡo
ᎬᎿᎨᏍᏛ ᎠᏰᏟ ᏍᎦᏚᎩ	ɡə̃hnaɡesdə̃ ajet͡ɬi sɡaduɡi
ᎧᏂᎪ	kaniɡo
ᏍᎦᏚᎩ	sɡaduɡi
ᏍᏫᏍ	swis
ᎢᏬᎵ ᎾᎿ ᎠᎹᏳᎶᏗ	iwoli nahna amajulodi
ᎠᏓᏍᏓᏴᎲᏍᎩ ᎤᎦᏚᏛ	adasdajə̃hə̃sɡi uɡadudə̃
ᏥᎵ	t͡sili
ᎧᎹᎷᏂ	kamaluni
ᏓᎶᏂᎨᏍᏛ	daloniɡesdə̃
ᎪᎸᎻᏈᎢᎠ	ɡolə̃mikʷiːa
ᎪᏍᏓ ᎵᎧ	ɡosda lika
ᎫᏆ	ɡukʷa
ᎢᎬᎾᏕᎾ ᎢᏤᏳᏍᏗ	iɡə̃nadena it͡sejusdi
ᏂᎦᏓ ᎤᏂᎲ ᎾᎿ ᎫᎳᎨᎣ	niɡada unihə̃ nahna ɡulaɡeo
ᏓᏂᏍᏓᏲᎯᎲ ᎤᎦᏚᏛᎢ	danisdajohihə̃ uɡadudə̃i
ᏌᎢᏆᏍ	saikʷas
ᏤᎩ ᏍᎦᏚᎩ	t͡seɡi sɡaduɡi
ᎠᏂᏛᏥ	anidə̃t͡si
ᏥᏊᏗ	t͡sikʷudi
ᏗᏂᎹᎦ	dinimaɡa
ᏙᎻᏂᎧ	dominika
ᏙᎻᏂᎧᏂ ᏍᎦᏚᎩ	dominikani sɡaduɡi
ᎠᎵᏥᎵᏯ	alit͡silija
ᎡᏆᏙᎵ	ekʷadoli
ᎡᏍᏙᏂᏯ	esdonija
ᎢᏥᏈᎢ	it͡sikʷiː
ᎡᎵᏟᏯ	elit͡ɬija
ᎠᏂᏍᏆᏂᏱ	aniskʷaniji
ᏫᏂᎦᏙᎯ	winiɡadohi
ᏫᏥ	wit͡si
ᏩᎩ ᏚᎦᏚᏛᎢ	waɡi duɡadudə̃i
ᏩᎩ ᎤᎦᏚᏛ	waɡi uɡadudə̃
ᎢᏍᎳᏍ ᎹᎸᏫᎾᏍ	islas malə̃winas
ᎠᏰᏟ ᏧᎾᎵᎪᎯ ᎾᎿ ᎹᎢᏉᏂᏏᏯ	ajet͡ɬi t͡sunaliɡohi nahna maikʷonisija
ᏪᎶ ᏚᎦᏚᏛᎢ	welo duɡadudə̃i
ᎦᎸᏥᏱ	ɡalə̃t͡siji
ᎦᏉᏂ	ɡakʷoni
ᎩᎵᏏᏲ	ɡilisijo
ᏋᎾᏓ	kʷə̃nada
ᏣᎠᏥᎢ	t͡saːt͡siː
ᎠᏂᎦᎸᏥ ᎩᎠ	aniɡalə̃t͡si ɡia
ᎬᏂᏏ	ɡə̃nisi
ᎦᎠᎾ	ɡaːna
ᏥᏆᎵᏓ	t͡sikʷalida
ᎢᏤᏍᏛᏱ	it͡sesdə̃ji
ᎦᎹᏈᎢᎠ	ɡamakʷiːa
ᎫᏇ	ɡukʷe
ᏩᏓᎷᏇ	wadalukʷe
ᎡᏆᏙᎵᎠᎵ ᎩᎢᏂ	ekʷadoliali ɡiːni
ᎪᎢᎯ	ɡoihi
ᏧᎦᏃᏮ ᏣᏥᏱ ᎠᎴ ᎾᏍᎩ ᏧᎦᏃᏮ ᎠᏍᏛᎭᏟ ᏚᎦᏚᏛ	t͡suɡanowə̃ t͡sat͡siji ale nasɡi t͡suɡanowə̃ asdə̃hat͡ɬi duɡadudə̃
ᏩᏔᎹᎳ	watamala
ᏆᎻ	kʷami
ᎫᏇ-ᏈᏌᎤᏫ	ɡukʷe kʷisauwi
ᎦᏯᎾ	ɡajana
ᎰᏂᎩ ᎪᏂᎩ	honiɡi ɡoniɡi
ᎲᏗ ᎤᎦᏚᏛᎢ ᎠᎴ ᎺᎩᏓᎾᎵᏗ ᏚᎦᏚᏛᎢ	hə̃di uɡadudə̃i ale meɡidanalidi duɡadudə̃i
ᎧᎶᎡᏏᎠ	kaloesia
ᎮᎢᏘ	heiti
ᎲᏂᎦᎵ	hə̃niɡali
ᎢᏂᏙᏂᏍᏯ	inidonisja
ᎠᎢᎴᏂᏗ	ailenidi
ᎢᏏᎵᏱ	isiliji
ᎤᏍᏗ ᎤᎦᏚᏛᎢ ᎾᎿ ᎠᏍᎦᏯ	usdi uɡadudə̃i nahna asɡaja
ᎢᏅᏗᎾ	inə̃dina
ᏈᏗᏏ ᏴᏫᏯ ᎠᎺᏉ ᎢᎬᎾᏕᏅ	kʷidisi jə̃wija amekʷo iɡə̃nadenə̃
ᎢᎳᎩ	ilaɡi
ᎢᎴᏂ	ileni
ᏧᏁᏍᏓᎸᎯ	t͡sunesdalə̃hi
ᏲᎶ	jolo
ᏨᎵᏏ	t͡sə̃lisi
ᏣᎺᎢᎧ	t͡sameika
ᏦᏓᏂ	t͡sodani
ᏣᏩᏂᏏ	t͡sawanisi
ᎨᏂᏯ	ɡenija
ᎩᎵᏣᎢᏍ	ɡilit͡sais
ᎧᎹᏉᏗᎠᏂ	kamakʷodiani
ᎧᎵᏆᏘ	kalikʷati
ᎪᎼᎳᏍ	ɡomolas
ᎠᏰᏟ ᎾᎿ ᎨᏥᎸᏉᏗ ᎠᏂᏪᏌ ᎠᎴ ᎠᏂᏁᏫᏍ	ajet͡ɬi nahna ɡet͡silə̃kʷodi aniwesa ale aninewis
ᏧᏴᏢ ᎪᎵᎠ	t͡sujə̃t͡ɬə̃ ɡolia
ᏧᎦᏃᏮ ᎪᎵᎠ	t͡suɡanowə̃ ɡolia
ᎫᏪᎢᏘ	ɡuweiti
ᎨᎢᎹᏂ ᏚᎦᏚᏛᎢ	ɡeimani duɡadudə̃i
ᎧᏎᎧᏍᏕᏂ	kasekasdeni
ᎴᎣᏍ	leos
ᎴᏆᎾᏂ	lekʷanani
ᎵᎦᏗᏂᏍᏓᏂ	liɡadinisdani
ᏍᎵ ᎳᏂᎧ	sli lanika
ᎳᏈᎵᏯ	lakʷilija
ᎴᏐᏙ	lesodo
ᎵᏗᏪᏂᎠ	lidiwenia
ᎸᎧᏎᏋᎩ	lə̃kasekʷə̃ɡi
ᎳᏘᏫᎠ	latiwia
ᎵᏈᏯ	likʷija
ᎼᎶᎪ	moloɡo
ᎹᎾᎪ	manaɡo
ᎹᎵᏙᏫᎠ	malidowia
ᎼᏂᏔᏁᎦᎶ	monitaneɡalo
ᎠᏥᎸᏉᏗ ᏡᏡ	at͡silə̃kʷodi t͡ɬut͡ɬu
ᎹᏓᎦᏍᎧᎵ	madaɡaskali
ᎹᏌᎵ ᏚᎪᏚᏛ	masali duɡodudə̃
ᎹᏏᏙᏂᎢᎠ	masidoniːa
ᎹᎵ	mali
ᎹᏯᎹᎵ	majamali
ᎹᏂᎪᎵᎠ	maniɡolia
ᎹᎧᎣ	makao
ᎾᏍᎩ ᎤᏴᏢ ᏗᏜ ᎹᎵᎠᎾ ᏚᎦᏚᏛ	nasɡi ujə̃t͡ɬə̃ did͡la maliana duɡadudə̃
ᎹᏘᏂᎨ	matiniɡe
ᎹᏘᎢᏯ	matiːja
ᎹᏂᏘᏌᎳᏗ	manitisaladi
ᎹᎵᏔ	malita
ᎼᎵᏏᎥᏍ	molisiə̃s
ᎹᎵᏗᏫᏍ	malidiwis
ᎹᎳᏫ	malawi
ᏍᏆᏂᏱ	skʷaniji
ᎹᎴᏏᎢᎠ	malesiːa
ᎼᏎᎻᏇᎩ	mosemikʷeɡi
ᎾᎻᏈᎢᏯ	namikʷiːja
ᎢᏤ ᎧᎵᏙᏂᎠᏂ	it͡se kalidoniani
ᏃᎵᏬᎵᎩ ᎤᎦᏚᏛᎢ	noliwoliɡi uɡadudə̃i
ᏂᏥᎵᏯ	nit͡silija
ᏂᎧᎳᏆ	nikalakʷa
ᏁᏛᎳᏂ	nedə̃lani
ᏃᏪ	nowe
ᏁᏆᎵ	nekʷali
ᏃᎤᎷ	noulu
ᏂᏳ	niju
ᎢᏤ ᏏᎢᎴᏂᏗ	it͡se siːlenidi
ᎣᎺᏂ	omeni
ᏆᎾᎹ	kʷanama
ᏇᎷ	kʷelu
ᎠᏂᎦᎸᏣ ᏆᎵᏂᏏᎠ	aniɡalə̃t͡sa kʷalinisia
ᏆᏇ ᎢᏤ ᎩᏂ	kʷakʷe it͡se ɡini
ᎠᏂᏈᎵᎩᏃ	anikʷiliɡino
ᏆᎩᏍᏖᏂ	kʷaɡisteni
ᏉᎳᏂ	kʷolani
ᏎᏂᏘ ᏈᏓ ᎠᎴ ᎻᏇᎶᏂ	seniti kʷida ale mikʷeloni
ᏈᎧᎵᏂ ᎤᎦᏚᏛᎢ	kʷikalini uɡadudə̃i
ᏇᎡᏙ ᎵᎢᎪ	kʷeːdo liːɡo
ᏆᎴᏍᏗᏂᎠᏂ ᏄᎬᏫᏳᏌᏕᎩ	kʷalesdiniani nuɡə̃wijusadeɡi
ᏉᏥᎦᎳ	kʷot͡siɡala
ᏆᎴᎠᏫ	kʷaleawi
ᏆᎳᏇᎢᏯ	kʷalakʷeija
ᎧᏔᎵ	katali
ᎶᎹᏂᏯ	lomanija
ᏒᏈᏯ	sə̃kʷija
ᏲᏂᎢ	joniː
ᎶᏩᏂᏓ	lowanida
ᏌᎤᏗ ᎡᎴᏈᎠ	saudi elekʷia
ᏐᎶᎹᏂ ᏚᎦᏚᏛᎢ	solomani duɡadudə̃i
ᏏᎡᏥᎵᏍ	siet͡silis
ᏑᏕᏂ	sudeni
ᏍᏫᏕᏂ	swideni
ᏏᏂᎦᏉᎵ	siniɡakʷoli
ᎠᏥᎸᏉᏗ ᎮᎵᎾ	at͡silə̃kʷodi helina
ᏍᎶᏫᏂᎠ	slowinia
ᏍᎶᏩᎩᎠ	slowaɡia
ᏏᎡᎳ ᎴᎣᏂ	siela leoni
ᎠᎹᏰᏟ	amajet͡ɬi
#
# Language names
#
ᎦᏳᎦ	ɡajuɡa
ᎠᏣᏗ	at͡sadi
ᏣᎳᎩ	t͡salaɡi
ᎠᏂᏓᏥ	anidat͡si
ᎩᎵᏏ	ɡilisi
ᏍᏆᏂ	skʷani
ᎦᎸᏥ	ɡalə̃t͡si
ᎬᏩᎵᏲᏥᎢ	ɡə̃walijot͡siː
ᏣᏩᏂᏏ	t͡sawanisi
ᎼᎻᎦ	momiɡa
ᎠᎫᏌ	aɡusa
ᏉᏧᎦᎵ	kʷot͡suɡali
ᏲᏂᎢ	joniː
ᏏᏂᎦ	siniɡa
ᏄᏬᎵᏍᏛᎾ ᎦᏬᏂᎯᏍᏗ	nuwolisdə̃na ɡawonihisdi
ᏓᎶᏂᎨ	daloniɡe
#
# Top 1000 words in Wikipedia
#
ᎯᎠ	hia
ᎠᎴ	ale
ᎭᏫᎾᏗᏢ	hawinadit͡ɬə̃
ᎾᏍᎩ	nasɡi
ᎨᏒᎢ	ɡesə̃i
ᏥᏄᏍᏗ	t͡sinusdi
ᎬᏙᏗ	ɡə̃dodi
ᎾᎿ	nahna
ᎾᏍᎩᎾᎢ	nasɡinai
ᎠᏰᎵ	ajeli
ᎾᎥᎢ	naə̃i
ᎤᏍᏗ	usdi
ᎤᎭ	uha
ᎤᎪᏗᏗ	uɡodidi
ᎤᏤᎵ	ut͡seli
ᏂᏛᎴᏅᏓ	nidə̃lenə̃da
ᎦᏙ	ɡado
ᎾᏍᏋ	naskʷə̃
ᎪᎯ	ɡohi
ᎢᎦᎢ	iɡai
ᏂᎨᏒᎾ	niɡesə̃na
ᏥᏄᏍᏛᎩ	t͡sinusdə̃ɡi
ᎢᎦᏛ	iɡadə̃
ᎡᎶᎯ	elohi
ᏰᎵᏇ	jelikʷe
ᎢᏧᎳᎭ	it͡sulaha
ᎾᏍᏇ	naskʷe
ᎦᏙᎯ	ɡadohi
ᎪᏪᎵ	ɡoweli
ᎤᏅᏌ	unə̃sa
ᎤᏟ	ut͡ɬi
ᎤᎾᏤᎵ	unat͡seli
ᏐᎢ	soi
ᎠᎹ	ama
ᎾᎾᎢ	nanai
ᏌᏊ	sakʷu
ᏄᏍᏛ	nusdə̃
ᏴᏫ	jə̃wi
ᏂᎦᏛ	niɡadə̃
ᏯᏛᎿ	jadə̃hna
ᎢᎬᏂᏏᏍᎩ	iɡə̃nisisɡi
ᎢᎦ	iɡa
ᏗᏂᏱᎴᎩ	dinijileɡi
ᎡᏆ	ekʷa
ᎯᎸᏍᎩ	hilə̃sɡi
ᎢᎬᏁᏗ	iɡə̃nedi
ᎤᏙᎯᏳ	udohiju
ᏧᎬᏩᎶᏗ	t͡suɡə̃walodi
ᎨᏒ	ɡesə̃
ᎢᎬᏱ	iɡə̃ji
ᎨᏒᎩ	ɡesə̃ɡi
ᎠᎾᏍᎬᏘ	anasɡə̃ti
ᎠᏍᎦᏯ	asɡaja
ᏱᏓᏟᎶᏍᏔᏅ	jidat͡ɬilostanə̃
ᏣᎳᎩ	t͡salaɡi
ᎢᏳ	iju
ᎤᏙᏢᏒ	udot͡ɬə̃sə̃
ᎬᏔᏅᎯ	ɡə̃tanə̃hi
ᏗᏙᎳᎩ	didolaɡi
ᎪᎱᏍᏗ	ɡohusdi
ᎢᏳᏓᎵᎭ	ijudaliha
ᎾᎿᎢ	nahnai
ᎢᏳᏍᏗ	ijusdi
ᎢᏴ	ijə̃
ᎬᎾᏬᏍᎬ	ɡə̃nawosɡə̃
ᏗᎧᏃᏗ	dikanodi
ᎯᎳᎪ	hilaɡo
ᎦᏬᏂᎯᏍᏗ	ɡawonihisdi
ᎬᏂᎨᏒ	ɡə̃niɡesə̃
ᎠᎵᏍᏓᏴᏗ	alisdajə̃di
ᏭᏪᏙᎢ	wuwedoi
ᎢᏧᎳ	it͡sula
ᏄᏍᏗᏓᏅ	nusdidanə̃
ᎤᏩᏒ	uwasə̃
ᎠᏕᎸ	adelə̃
ᎠᎪᏩᏛᏗ	aɡowadə̃di
ᏪᏌ	wesa
ᏗᎧᏃᎩᏛ	dikanoɡidə̃
ᎢᏤ	it͡se
ᏫᏚᏳᎪᏛ	widujuɡodə̃
ᏂᎬᎢ	niɡə̃i
ᎠᏛᎯᏍᏙᏗ	adə̃hisdodi
ᎢᏯᏛᏁᏗ	ijadə̃nedi
ᎤᏠᏱ	ut͡ɬoji
ᏧᏓᎴᏅᏓ	t͡sudalenə̃da
ᏰᎵ	jeli
ᏗᎦᏘᎸᏍᏗ	diɡatilə̃sdi
ᏗᎦᎸᏫᏍᏓᏁᏗ	diɡalə̃wisdanedi
ᎦᎸᎳᏗᏢ	ɡalə̃ladit͡ɬə̃
ᎡᎯ	ehi
ᎠᎺᏉᎯ	amekʷohi
ᎾᎾᎯ	nanahi
ᏔᎵ	tali
ᎾᎯᏳᎢ	nahijui
ᎠᏫᏒᏗ	awisə̃di
ᏰᎵᏊ	jelikʷu
ᎤᏪᏴ	uwejə̃
ᎢᏳᏃ	ijuno
ᎤᏔᏂᏗ	utanidi
ᎤᎦᎾᏭ	uɡanawu
ᏄᎵᏍᏔᏅ	nulistanə̃
ᎥᎦᏔᎲᎢ	ə̃ɡatahə̃i
ᏄᎵᏂᎬᎬ	nuliniɡə̃ɡə̃
ᎤᏴᏢ	ujə̃t͡ɬə̃
ᎠᎴᏂᏙᎲ	alenidohə̃
ᎣᏍᏛ	osdə̃
ᎤᏯᏅᎲ	ujanə̃hə̃
ᎠᎩᏍᏗ	aɡisdi
ᎤᏠᏱᎭ	ut͡ɬojiha
ᎠᏩᏛᏗ	awadə̃di
ᎠᏍᏓᏅᏅ	asdanə̃nə̃
ᎬᏩᏚᏫᏛ	ɡə̃waduwidə̃
ᎤᏁᎳᎩ	unelaɡi
ᎠᏂ	ani
ᏓᎶᏂᎨ	daloniɡe
ᎤᏁᎳᏅᎯ	unelanə̃hi
ᎠᏕᎳ	adela
ᎠᏂᏏᏴᏫᎭ	anisijə̃wiha
ᎦᏟᏌᏅ	ɡat͡ɬisanə̃
ᎧᏃᎮᎭ	kanoheha
ᎦᎪ	ɡaɡo
ᏫᎵ	wili
ᎪᏢᏅᎯ	ɡot͡ɬə̃nə̃hi
ᎠᏍᏓᏩᏛᏍᏗ	asdawadə̃sdi
ᎠᏰᎲ	ajehə̃
ᎾᏍᎩᏯᎢ	nasɡijai
ᎤᎾᏅᏛ	unanə̃də̃
ᏚᎾᏙᏢᏩᏗᏒ	dunadot͡ɬə̃wadisə̃
ᎧᏃᎮᏗ	kanohedi
ᎤᎾᏙᏢᎯ	unadot͡ɬə̃hi
ᎠᎦᏎᏍᏙᏗ	aɡasesdodi
ᎠᏓᏅᏍᏗ	adanə̃sdi
ᎠᎦᏘᏯ	aɡatija
ᏗᏕᎬᏔᏛ	dideɡə̃tadə̃
ᎦᏬᎯᎸᏙᏗ	ɡawohilə̃dodi
ᏓᏄᏩ	danuwa
ᎢᏯᏛᏁᎵᏓᏍᏗ	ijadə̃nelidasdi
ᏙᏯᏗᏢ	dojadit͡ɬə̃
ᏱᏂᎬᏛᎾ	jiniɡə̃də̃na
ᏍᎦᏚᎩ	sɡaduɡi
ᎪᏍᏓᏱ	ɡosdaji
ᎦᏅᎯᏓ	ɡanə̃hida
ᎠᎨᏴ	aɡejə̃
ᏴᏩᏁᎬ	jə̃waneɡə̃
ᎢᎾᎨ	inaɡe
ᏥᏳ	t͡siju
ᎤᏁᏍᏓᎳ	unesdala
ᎠᏥᎸ	at͡silə̃
ᎦᏚᎲᎢ	ɡaduhə̃i
ᏥᏍᏆ	t͡siskʷa
ᏗᎬᏩᎶᏒ	diɡə̃walosə̃
ᎠᎹᏰᏟ	amajet͡ɬi
ᏧᏣᏔᏊ	t͡sut͡satakʷu
ᎩᎵᏏ	ɡilisi
ᎭᏢᏃ	hat͡ɬə̃no
ᎤᏲᏨᎯ	ujot͡sə̃hi
ᏄᎬᏫᏳᏒ	nuɡə̃wijusə̃
ᎾᎯᏳᎨᏒ	nahijuɡesə̃
ᎪᏢᏗ	ɡot͡ɬə̃di
ᎤᎬᏫᏳᎯ	uɡə̃wijuhi
ᎦᏣᏄᎳ	ɡat͡sanula
ᎤᏃᎴ	unole
ᎣᏂ	oni
ᎠᏨᏍᏛ	at͡sə̃sdə̃
ᎦᎸᎳᏗ	ɡalə̃ladi
ᎠᏔᎴᏒ	atalesə̃
ᎡᏍᎦᏂ	esɡani
ᏳᎳᏛ	juladə̃
ᎢᏳᏩᎪᏗ	ijuwaɡodi
ᏏᏓᏁᎸᎯ	sidanelə̃hi
ᏎᏍᏗ	sesdi
ᎧᏃᎮᏍᎩ	kanohesɡi
ᎠᎹᏱ	amaji
ᎤᎦᏔ	uɡata
ᎠᏓ	ada
ᎤᏔᎾ	utana
ᏙᏒᏓᎵ	dosə̃dali
ᎤᎶᏐᏅ	ulosonə̃
ᎦᏚᎢ	ɡadui
ᎾᎥ	naə̃
ᎤᎾᏓᏟᏌᎲ	unadat͡ɬisahə̃
ᏧᏠᎯᏍᏗ	t͡sut͡ɬohisdi
ᎠᏂᏴᏫ	anijə̃wi
ᎩᎦᎨ	ɡiɡaɡe
ᏯᏓᎢᏗᏏ	jadaidisi
ᏚᏳᎪᏛ	dujuɡodə̃
ᏧᏓᎴᎿᎢ	t͡sudalehnai
ᏗᏎᏍᏗ	disesdi
ᎠᎦᏓᏅᏖᏗ	aɡadanə̃tedi
ᏗᏂᎧᏃᏩᏗᏙᎯ	dinikanowadidohi
ᏂᎦᎵᏍᏗᏍᎬᎫ	niɡalisdisɡə̃ɡu
ᎠᏣᏅᏙ	at͡sanə̃do
ᎬᏔᏂᏓᏍᏗ	ɡə̃tanidasdi
ᏄᎾᏓᎸ	nunadalə̃
ᎠᏍᏓᏩᏛᏍᏙᏗ	asdawadə̃sdodi
ᎧᎵ	kali
ᎡᎳᏗ	eladi
ᏓᏍᏓᏅᏅ	dasdanə̃nə̃
ᏅᏙ	nə̃do
ᏄᏓᎴᎿᎥ	nudalehnaə̃
ᎠᎦᏎᏍᏔᏅ	aɡasestanə̃
ᏗᎧᏃᎩᏍᏗ	dikanoɡisdi
ᏧᏕᏘᏴᏓ	t͡sudetijə̃da
ᎠᏣᏗ	at͡sadi
ᏓᏂᏍᏓᏲᎯᎲ	danisdajohihə̃
ᏗᎦᎶᎪᏗ	diɡaloɡodi
ᎧᏁᏨ	kanet͡sə̃
ᎤᎵᏍᎨᏛ	ulisɡedə̃
ᎪᎷᏩᏛᏗ	ɡoluwadə̃di
ᎠᏰᎸ	ajelə̃
ᎤᏓᎷᎸ	udalulə̃
ᎤᏁᎬ	uneɡə̃
ᎠᎾᎦᎵᏍᎩ	anaɡalisɡi
ᎠᏓᎴᏂᏍᎬ	adalenisɡə̃
ᏳᎴᏂ	juleni
ᏂᎯ	nihi
ᎢᏗᏢ	idit͡ɬə̃
ᏩᎶᏏ	walosi
ᎤᏔᏅ	utanə̃
ᎠᏂᎦᏲᎵ	aniɡajoli
ᏎᎷ	selu
ᏦᎢ	t͡soi
ᎤᏣᏘ	ut͡sati
ᎠᏠᏯᏍᏗᏍᎩ	at͡ɬojasdisɡi
ᎠᏏᏴᏫ	asijə̃wi
ᎧᏃᎮᎸᎯ	kanohelə̃hi
ᏥᎩ	t͡siɡi
ᎪᏢᏅ	ɡot͡ɬə̃nə̃
ᎤᏚᎳᏗ	uduladi
ᏒᏃᏱ	sə̃noji
ᎧᏁᏌᎢ	kanesai
ᎦᏛᎬᎢ	ɡadə̃ɡə̃i
ᎤᏓᏂᏝᏅ	udanit͡ɬanə̃
ᎠᏓᏁᎸ	adanelə̃
ᎿᏛᎦ	hnadə̃ɡa
ᎠᏲᎵ	ajoli
ᎠᏂᏯᏫᏍᎩ	anijawisɡi
ᎾᎥᏂᎨ	naə̃niɡe
ᎤᎳᏂᎬᎬ	ulaniɡə̃ɡə̃
ᎠᎵᏍᏕᎸᏗ	alisdelə̃di
ᏧᏩᎫᏛ	t͡suwaɡudə̃
ᎤᏣᏘᎾ	ut͡satina
ᎪᎯᏊ	ɡohikʷu
ᎦᏁᎸ	ɡanelə̃
ᏗᏕᎶᏆᏍᏗ	didelokʷasdi
ᏚᏙᎥ	dudoə̃
ᏠᎨᏏ	t͡ɬoɡesi
ᏙᎪᏩᎸ	doɡowalə̃
ᏄᎬᏫᏳᏌᏕᎩ	nuɡə̃wijusadeɡi
ᎠᏆᏤᎵ	akʷat͡seli
ᏌᎪᏂᎨ	saɡoniɡe
ᏄᏓᎴ	nudale
ᎾᎥᏂᎨᏍᏗ	naə̃niɡesdi
ᏡᎬ	t͡ɬuɡə̃
ᎫᏔᏍᏲᏍᏗ	ɡutasjosdi
ᎪᎷᏩᏛᎲ	ɡoluwadə̃hə̃
ᎦᎶᎯᏍᏗ	ɡalohisdi
ᎤᏬᎳᏨᎯ	uwolat͡sə̃hi
ᎤᏃᏴᎬ	unojə̃ɡə̃
ᏂᎦᏅᎯᏒ	niɡanə̃hisə̃
ᏧᏕᏘᏴᏗ	t͡sudetijə̃di
ᎤᏤᎵᏛ	ut͡selidə̃
ᎠᏓᏅᏖᏗ	adanə̃tedi
ᎠᏂᏃᎯᎵᏙᎲ	aninohilidohə̃
ᏗᏟᎶᏍᏙᏗ	dit͡ɬilosdodi
ᎥᎴᏂᏙᎲ	ə̃lenidohə̃
ᎠᎺᎵᎨ	ameliɡe
ᎠᎴᏂᏍᎬ	alenisɡə̃
ᎦᏟᏐᏗᎩ	ɡat͡ɬisodiɡi
ᎤᏩᎾᏕᏍᎩ	uwanadesɡi
ᎠᏠᏯᏍᏛ	at͡ɬojasdə̃
ᎦᏲᎵᎨ	ɡajoliɡe
ᎤᏔᏂᎢᏍᏗ	utaniːsdi
ᎤᏍᏗᏰᎬ	usdijeɡə̃
ᏗᏟᎶᏍᏔᏅ	dit͡ɬilostanə̃
ᏔᎵᏁ	taline
ᎾᏍᎩᎾ	nasɡina
ᎠᎵᏍᎪᎸᏙᏗ	alisɡolə̃dodi
ᏩᏎᎸᎯ	waselə̃hi
ᏑᏕᏘᏴᏓ	sudetijə̃da
ᏅᎩ	nə̃ɡi
ᎤᎵᏍᏛ	ulisdə̃
ᎠᏥᏅᏏᏓᏍᏗ	at͡sinə̃sidasdi
ᏄᏓᎨᏒ	nudaɡesə̃
ᏂᎦᏛᎢ	niɡadə̃i
ᎯᏍᎩ	hisɡi
ᎪᎢ	ɡoi
ᎠᏓᏍᏕᎸᏗ	adasdelə̃di
ᎦᎪᏘ	ɡaɡoti
ᎤᏂᎪᏗᏗ	uniɡodidi
ᎾᏊ	nakʷu
ᏅᏯ	nə̃ja
ᎬᎾ	ɡə̃na
ᎤᏍᏆᎸᎲ	uskʷalə̃hə̃
ᎡᎿᎢ	ehnai
ᏄᏍᏛᎢ	nusdə̃i
ᎧᎹᎹ	kamama
ᎣᏓᏅᏛ	odanə̃də̃
ᎢᎦᏘᎭ	iɡatiha
ᎠᏫ	awi
ᎠᎴᏫᏍᏙᏗ	alewisdodi
ᎠᏍᏆᏂᎪᏒᏗ	askʷaniɡosə̃di
ᏩᏎᏍᏗ	wasesdi
ᏚᎾᏙᏢᏒ	dunadot͡ɬə̃sə̃
ᎢᎬᏁᎸ	iɡə̃nelə̃
ᎠᎦᎷᎦ	aɡaluɡa
ᏭᏚᎸᏛ	wudulə̃də̃
ᎠᏓᏁᏗ	adanedi
ᏧᏂᎸᏫᏍᏓᏁᏗ	t͡sunilə̃wisdanedi
ᏯᏛᎾ	jadə̃na
ᎭᏫᏂᏗᏢ	hawinidit͡ɬə̃
ᎬᎿᎨ	ɡə̃hnaɡe
ᎦᏚᎲ	ɡaduhə̃
ᏧᎾᏍᏗ	t͡sunasdi
ᏄᎾᏛᏅ	nunadə̃nə̃
ᎠᏯ	aja
ᎾᏍᏊ	naskʷu
ᎣᏤᎵ	ot͡seli
ᏂᎬᏂᏏᏍᎬ	niɡə̃nisisɡə̃
ᏁᎵᏒ	nelisə̃
ᎡᎥ	eə̃
ᎠᏂᏙᎾᎥ	anidonaə̃
ᏂᎦᎥᏊ	niɡaə̃kʷu
ᏧᎵᎬᏩᎳᏅᎯ	t͡suliɡə̃walanə̃hi
ᏧᎸᏫᏍᏓᏁᏗ	t͡sulə̃wisdanedi
ᏣᏩᏂᏏ	t͡sawanisi
ᎦᏐᎯ	ɡasohi
ᎤᎾᏓᏡᎩ	unadat͡ɬuɡi
ᎢᏳᏕᏘᏴᏓ	ijudetijə̃da
ᎠᎦᏲᎳᏗᏍᏗ	aɡajoladisdi
ᎬᏗ	ɡə̃di
ᎢᏳᎵᏍᏙᏗ	ijulisdodi
ᎠᏥᏄᏉᏫᏍᎬ	at͡sinukʷowisɡə̃
ᎤᏜᏅᏛ	ud͡lanə̃də̃
ᎠᎦᏴᎵ	aɡajə̃li
ᏧᎴᎯᏌᏅᎯ	t͡sulehisanə̃hi
ᏂᎦᎥ	niɡaə̃
ᎪᏪᎸ	ɡowelə̃
ᎠᏙᎯ	adohi
ᏬᎭᎵ	wohali
ᏕᏡᎬ	det͡ɬuɡə̃
ᏓᏓᏚᎬ	dadaduɡə̃
ᎠᏍᏆᏂᎪᏙᏗ	askʷaniɡododi
ᎦᎷᎯᏍᏗ	ɡaluhisdi
ᏗᎦᏘᎴᎩ	diɡatileɡi
ᏀᎾ	nahna
ᏩᏚᎵᏏ	wadulisi
ᏙᎢ	doi
ᎠᏃᏪᎵᏍᎬ	anowelisɡə̃
ᎤᏂᎾᏗᏅᏗ	uninadinə̃di
ᏗᎦᎪᏗ	diɡaɡodi
ᎤᎾᎵᎪᎯ	unaliɡohi
ᎠᏍᏓᏩᏗᏒ	asdawadisə̃
ᎫᏢᎥᏍᎬ	ɡut͡ɬə̃sɡə̃
ᎣᏂᏯᎨᏍᏙᏗ	onijaɡesdodi
ᏑᏓᎴᎩ	sudaleɡi
ᏍᏉᎯᏧᏈ	skʷohit͡sukʷi
ᎦᏲᎵ	ɡajoli
ᎥᏝ	ə̃t͡ɬa
ᏗᎫᎪᏙᏗ	diɡuɡododi
ᎠᏓᏃᎮᏗ	adanohedi
ᎧᏬᏂᎯᏍᏗ	kawonihisdi
ᎦᎳᏅᎯ	ɡalanə̃hi
ᎠᏁᎸᏙᏗ	anelə̃dodi
ᎭᏰᎳᏍᏗ	hajelasdi
ᎤᏪᏴᎢ	uwejə̃i
ᎤᏓᏅᏖᏗ	udanə̃tedi
ᎠᏓᏁᎳᏅᎯ	adanelanə̃hi
ᎠᎾᎵᏐᏈᎸᏍᎬ	analisokʷilə̃sɡə̃
ᏭᏕᎵᎬᏗᏢ	wudeliɡə̃dit͡ɬə̃
ᎬᏗᏍᎬᎢ	ɡə̃disɡə̃i
ᏓᏎᏘ	daseti
ᎯᏯᏛ	hijadə̃
ᎤᏬᏢᏅ	uwot͡ɬə̃nə̃
ᏔᎷᎩᏍᎩ	taluɡisɡi
ᏅᏩᏙ	nə̃wado
ᎤᏁᎳᏅ	unelanə̃
ᎠᏟᎶᏍᏗ	at͡ɬilosdi
ᎠᏓᏃᎯᏎᏗ	adanohisedi
ᏚᏙᏢᏒ	dudot͡ɬə̃sə̃
ᎦᏃᏢᎩ	ɡanot͡ɬə̃ɡi
ᎤᏪᏥ	uwet͡si
ᎾᏛᏁ	nadə̃ne
ᎾᎥᏂᎨᏍᏙᏗ	naə̃niɡesdodi
ᎤᏛᏒ	udə̃sə̃
ᎤᏂᎸᏉᏗ	unilə̃kʷodi
ᎪᏪᎳᏅᎯ	ɡowelanə̃hi
ᎠᏂᏐᎢ	anisoi
ᏚᎷᏨ	dulut͡sə̃
ᏗᏍᏆᎸᏙᏗ	diskʷalə̃dodi
ᎬᏰᎸᏗ	ɡə̃jelə̃di
ᏫᎩᏇᏗᏯ	wiɡikʷedija
ᏚᏙᎳᏩᏛᎲ	dudolawadə̃hə̃
ᏗᎦᎳᏫᎢᏍᏗ	diɡalawiːsdi
ᏓᎦᏘᎴᎬ	daɡatileɡə̃
ᏌᎶᎵ	saloli
ᎦᏂᏝᎢ	ɡanit͡ɬai
ᎨᏯᏔᎯ	ɡejatahi
ᎠᎪᎲᎢ	aɡohə̃i
ᎥᏓᎵ	ə̃dali
ᎡᎷᏪᎢ	eluwei
ᏚᎳᏏᏔᏅᎩ	dulasitanə̃ɡi
ᏱᎩ	jiɡi
ᎦᎾᏄᎪᏫᏒ	ɡananuɡowisə̃
ᎠᏯᏖᎾ	ajatena
ᎠᎽᏰᎵ	amujeli
ᏂᎬᏩᏍᏛ	niɡə̃wasdə̃
ᎤᎶᎩᎸ	uloɡilə̃
ᎢᎬᏱᏗᏢ	iɡə̃jidit͡ɬə̃
ᎢᎪᎯ	iɡohi
ᎬᎾᏕᎾ	ɡə̃nadena
ᎦᏌᏙᏯᏍᏗ	ɡasadojasdi
ᏄᏓᎷᎸᎾ	nudalulə̃na
ᎠᎾᏓᏟᏏᏍᎬ	anadat͡ɬisisɡə̃
ᎦᏃᏥ	ɡanot͡si
ᎠᎵᏍᏕᎸᏙᏗ	alisdelə̃dodi
ᏗᎪᏪᎵ	diɡoweli
ᎩᎶ	ɡilo
ᎢᏯᏛᏁᎯ	ijadə̃nehi
ᎠᎹᏰᎵ	amajeli
ᏥᏍᏕᏥ	t͡sisdet͡si
ᏗᎦᏛᏗ	diɡadə̃di
ᎪᏪᎶᏗ	ɡowelodi
ᎧᏫ	kawi
ᎧᏃᎮᎸᏗ	kanohelə̃di
ᎥᏳᎩ	ə̃juɡi
ᎤᏍᏆᏂᎪᏗ	uskʷaniɡodi
ᎤᎵᎾᏫ	ulinawi
ᎤᏓᏎᎦᏤᏗ	udaseɡat͡sedi
ᎢᏯ	ija
ᏗᏂᎳᏫᎩ	dinilawiɡi
ᎤᏁᏓᏍᏗ	unedasdi
ᏄᎶᏒᏍᏛᎾ	nulosə̃sdə̃na
ᎦᏁᏰᎩ	ɡanejeɡi
ᎢᏗᎦᏘᎭ	idiɡatiha
ᎠᎾᎵᏖᎸᎲᏍᎬ	analitelə̃hə̃sɡə̃
ᏄᏠᏯᏍᏛᎾ	nut͡ɬojasdə̃na
ᎦᎾᏝᎢ	ɡanat͡ɬai
ᎤᏒᎧᎵ	usə̃kali
ᏃᏈᏏ	nokʷisi
ᎢᎦᏘ	iɡati
ᎪᏪᎳᏅ	ɡowelanə̃
ᎩᏔᏯ	ɡitaja
ᏬᏗᎨ	wodiɡe
ᏗᏕᎶᏆᏍᎩ	didelokʷasɡi
ᏕᎭᎷᏱ	dehaluji
ᏎᎼᏂ	semoni
ᎤᏙᎷᏩᏛᏓ	udoluwadə̃da
ᎤᎾᏤᎵᏛ	unat͡selidə̃
ᎣᏏ	osi
ᏄᏁᏌᏴᏢ	nunesajə̃t͡ɬə̃
ᏄᎵᏍᏛ	nulisdə̃
ᎤᏅᎪᎳᏛ	unə̃ɡoladə̃
ᎢᏗᎦᎪᏘ	idiɡaɡoti
ᎠᏂᏯᏩᏍᎩ	anijawasɡi
ᏍᏆᎳᎢ	skʷalai
ᎠᎪᎵᏰᏗ	aɡolijedi
ᏢᏓᏥ	t͡ɬə̃dat͡si
ᏗᏁᎸᏙᏗ	dinelə̃dodi
ᎪᏢᎯ	ɡot͡ɬə̃hi
ᎦᏂᏱᏍᎩ	ɡanijisɡi
ᎢᏳᏗᎾ	ijudina
ᎢᏅ	inə̃
ᎠᏂᎩᏍᏗ	aniɡisdi
ᏗᏂᎴᏱᏗᏍᎩ	dinilejidisɡi
ᎢᏰᎵᏍᏗᎢ	ijelisdiː
ᏂᏓᏙᎳᎬᎾ	nidadolaɡə̃na
ᎾᏛᏁᎸ	nadə̃nelə̃
ᎦᎾᏄᎪᏨᎢ	ɡananuɡot͡sə̃i
ᎤᏦᎠᏎᏗ	ut͡soasedi
ᎡᏂᏗ	enidi
ᎠᏓᏅᏙ	adanə̃do
ᎠᏏᎾᏍᏛ	asinasdə̃
ᎠᎴᏅᏗ	alenə̃di
ᎠᎨᏔᏗᏍᏗ	aɡetadisdi
ᏭᏕᎵᎬ	wudeliɡə̃
ᏗᏌᏊ	disakʷu
ᏓᎳᏏᏛ	dalasidə̃
ᎤᏍᏔᎦᎳᏱ	ustaɡalaji
ᎤᏁᎫᏥᏛ	uneɡut͡sidə̃
ᎤᎾᏥ	unat͡si
ᏴᏩᏚᏫᏛ	jə̃waduwidə̃
ᏙᏯ	doja
ᏄᏛᏁᎸ	nudə̃nelə̃
ᎶᎻ	lomi
ᎯᎸᎯᏳᎢ	hilə̃hijui
ᎠᏓᏁᏟᏴᏍᏗ	adanet͡ɬijə̃sdi
ᎠᏎᎸᎯ	aselə̃hi
ᏗᎦᏬᏂᎯᏍᏗ	diɡawonihisdi
ᏂᎬᎿᏅ	niɡə̃hnanə̃
ᎪᎯᏳᏙᏗ	ɡohijudodi
ᎦᏃᎯᎵᏙ	ɡanohilido
ᎤᏅᏔᏂᏓᏍᏗ	unə̃tanidasdi
ᎠᏓᎯᏍᏗ	adahisdi
ᎠᏎ	ase
ᎠᏍᏓᏯ	asdaja
ᎦᏓᏘ	ɡadati
ᏓᎾᎵᏍᏓᏴᎲᏍᎬ	danalisdajə̃hə̃sɡə̃
ᏅᏃᎯ	nə̃nohi
ᎪᎳ	ɡola
ᎠᏓᏠᎯᏍᏗ	adat͡ɬohisdi
ᏗᎦᎴᏴᏗᏍᎩ	diɡalejə̃disɡi
ᎾᎾᏛᏁᎲ	nanadə̃nehə̃
ᎦᏃᎸᎥᏍᎬ	ɡanolə̃sɡə̃
ᎤᎭᎸᏂ	uhalə̃ni
ᏩᎦᎸᎳᏗᏴ	waɡalə̃ladijə̃
ᏗᎬᏔᏂᏓᏍᏗ	diɡə̃tanidasdi
ᎦᎵᏓᏍᏛ	ɡalidasdə̃
ᎠᏣᏪᏐᎸᏍᏙᏗ	at͡sawesolə̃sdodi
ᎠᎴᏅᏗᏍᎬ	alenə̃disɡə̃
ᎠᎦᏍᎬ	aɡasɡə̃
ᏧᏓᎴᎾᎢ	t͡sudalenai
ᏗᎧᎿᏩᏛᏍᏗ	dikahnawadə̃sdi
ᎦᏌᏆᎸ	ɡasakʷalə̃
ᎤᏬᏚ	uwodu
ᎤᏚᎩ	uduɡi
ᎠᏲᎱᎯᏍᏗ	ajohuhisdi
ᏓᎬᎾ	daɡə̃na
ᎭᏫᏂ	hawini
ᎤᏛᏏᏗᏒ	udə̃sidisə̃
ᎤᏗᏗᏢ	udidit͡ɬə̃
ᏄᏦᏍᏛᎾ	nut͡sosdə̃na
ᎬᎪᏩᏛᏗ	ɡə̃ɡowadə̃di
ᎤᎵᏍᏕᎸᏗ	ulisdelə̃di
ᎢᏳᏊ	ijukʷu
ᎠᏥᎸᏉᏗ	at͡silə̃kʷodi
ᎠᏎᏊᎢ	asekʷui
ᏗᏔᎳᏗᏍᏗ	ditaladisdi
ᎤᎵᎶᎯ	ulilohi
ᎢᏳᏩᎫᏗ	ijuwaɡudi
ᎠᏫᏒᏅ	awisə̃nə̃
ᎠᎾᏓᏁᎲ	anadanehə̃
ᎠᎧᎵᏏᏐᏗ	akalisisodi
ᎧᎸᎬ	kalə̃ɡə̃
ᎢᎦᏛᎭ	iɡadə̃ha
ᎠᏃᏢᏍᎬ	anot͡ɬə̃sɡə̃
ᏗᎦᏘᏌᏅᎩ	diɡatisanə̃ɡi
ᏕᎦᏚᎲ	deɡaduhə̃
ᎧᎵᏬᎯ	kaliwohi
ᎦᏍᎩᎶ	ɡasɡilo
ᎤᏬᎯᏳᏒ	uwohijusə̃
ᎣᏂᏱᏳ	onijiju
ᎠᏠᏯᏍᏗ	at͡ɬojasdi
ᎠᏍᏛᎢ	asdə̃i
ᎠᏅᏬᏗ	anə̃wodi
ᏗᏓᎴᎾᏔᏅ	didalenatanə̃
ᎾᏂᎥ	naniə̃
ᎢᏳᏍᏗᏊ	ijusdikʷu
ᏐᏈᎵ	sokʷili
ᏂᎪᎯᎸᎢ	niɡohilə̃i
ᎠᎾᏓᏛᏂ	anadadə̃ni
ᏧᏴᏢ	t͡sujə̃t͡ɬə̃
ᎤᏙᎯᏳᎯᏯ	udohijuhija
ᎡᎳᏗᎨ	eladiɡe
ᎠᏂᏣᏍᎩᎵ	anit͡sasɡili
ᏚᎵᏍᏗ	dulisdi
ᏓᏓᏁᏤᎸ	dadanet͡selə̃
ᎧᎸᎬᎢᏗᏢ	kalə̃ɡə̃idit͡ɬə̃
ᎤᏯᎾᏛᏁᏗ	ujanadə̃nedi
ᎢᎬᏁᎯ	iɡə̃nehi
ᎠᏛᎯᏍᏔᏅ	adə̃histanə̃
ᏚᎾᏓᏟᏌᎲ	dunadat͡ɬisahə̃
ᏗᏂᏃᎨᏂ	dininoɡeni
ᏗᎫᎪᏔᏅ	diɡuɡotanə̃
ᎧᏂᎬᎾᎥ	kaniɡə̃naə̃
ᎠᏓᏎᎮᏗ	adasehedi
ᎠᏑᏰᏍᏗ	asujesdi
ᎠᎪᎢ	aɡoi
ᏂᎰᏂ	nihoni
ᎦᏄᎪᎬ	ɡanuɡoɡə̃
ᎤᏆᏓᏛ	ukʷadadə̃
ᎤᎬᏩᎵ	uɡə̃wali
ᎢᎬᎾᏗ	iɡə̃nadi
ᏗᎬᏟᎶᏍᏙᏗ	diɡə̃t͡ɬilosdodi
ᏏᏴᏫ	sijə̃wi
ᎡᎵᏍᏗ	elisdi
ᎠᏴ	ajə̃
ᎠᎷᏚᎧᏘ	aludukati
ᎠᎧᏔᏘ	akatati
ᎠᎦᏍᎩ	aɡasɡi
ᏅᎪᏢᎯᏐᏗᏱ	nə̃ɡot͡ɬə̃hisodiji
ᎾᏰᎯᏯ	najehija
ᎦᏁᎳ	ɡanela
ᎦᎵᏉᎩ	ɡalikʷoɡi
ᎢᏧᏩᎪᏗ	it͡suwaɡodi
ᎡᏆᎯᎨᏍᏙᏗ	ekʷahiɡesdodi
ᏗᏰᎳᏍᏗ	dijelasdi
ᎪᎦ	ɡoɡa
ᎤᎶᏒᎩ	ulosə̃ɡi
ᎡᏙᎠ	edoa
ᎠᏍᏆᎨᏂ	askʷaɡeni
ᎠᎴᏂᏓᏍᏗ	alenidasdi
ᏄᏪᏒᎩ	nuwesə̃ɡi
ᎠᏅᏓᏗᏍᏗ	anə̃dadisdi
ᎠᏓᎾᏅᏗ	adananə̃di
ᎠᏍᏚᎢᏍᎬ	asduisɡə̃
ᎠᏂᏃᏈᏏ	aninokʷisi
ᏫᏓᏎᎸᎢ	widaselə̃i
ᎾᏍᎦᏅᎾ	nasɡanə̃na
ᎫᎴ	ɡule
ᎤᏯᏍᎦ	ujasɡa
ᎤᏩᏌᏊ	uwasakʷu
ᎤᏗᏅᏒᎩ	udinə̃sə̃ɡi
ᎤᎳᏂᎩᏓ	ulaniɡida
ᎤᎨᏓᎵᏴ	uɡedalijə̃
ᎢᏚᏳᎪᏛ	idujuɡodə̃
ᎠᏓᎦᏴᎵᎨ	adaɡajə̃liɡe
ᎠᎧᎵᏬᎯ	akaliwohi
ᏩᏥᏂ	wat͡sini
ᏧᎸᏌᏓ	t͡sulə̃sada
ᏗᏓᎴᎲᏍᎬ	didalehə̃sɡə̃
ᏗᎦᏎᏍᏙᏗ	diɡasesdodi
ᎪᎷᏩᏛᏓ	ɡoluwadə̃da
ᎠᎹᏳᎸᏗ	amajulə̃di
ᏗᏂᏤᎷᎯᏍᎩ	dinit͡seluhisɡi
ᎦᏬᏂᏏᏍᏗ	ɡawonisisdi
ᎦᏬᏂᏍᎩ	ɡawonisɡi
ᎤᏩᎫᏗᏗᏒ	uwaɡudidisə̃
ᎠᎦᎾᏫᏗᏍᎩ	aɡanawidisɡi
ᏚᏯ	duja
ᏗᏗ	didi
ᏗᏂᏲᎵ	dinijoli
ᏓᎧᏁᎲ	dakanehə̃
ᏄᎾᏍᏛ	nunasdə̃
ᎾᎯᏳ	nahiju
ᎤᎾᎵᎪᏅᎯ	unaliɡonə̃hi
ᎠᏁᎳ	anela
ᏗᎧᏃᏗᎢ	dikanodiː
ᎦᏚ	ɡadu
ᎦᎸᏛ	ɡalə̃də̃
ᎣᏂᏗᏢ	onidit͡ɬə̃
ᎠᏏᎾᏒᎢ	asinasə̃i
ᏗᏁᏝᎾ	dinet͡ɬana
ᏄᏯᎩ	nujaɡi
ᎩᏟ	ɡit͡ɬi
ᎨᎳᏛᏍᏗ	ɡeladə̃sdi
ᎤᏲᎱᏒ	ujohusə̃
ᎤᏁᏍᎩᎸᏒ	unesɡilə̃sə̃
ᎢᏯᏓᏛᏁᎸ	ijadadə̃nelə̃
ᎠᏎᎯᎯ	asehihi
ᎠᏂᏛᏥ	anidə̃t͡si
ᎠᎦᏛᏗ	aɡadə̃di
ᏕᎦᏃᏣᎸ	deɡanot͡salə̃
ᎧᏁᎢᏍᏙᏗ	kaneisdodi
ᎦᏃᎸᏍᎩ	ɡanolə̃sɡi
ᎦᏃᎭᎵᏙᎯ	ɡanohalidohi
ᎠᏑᏰᏛ	asujedə̃
ᏗᏓᏁᏟᏴᎡᏗ	didanet͡ɬijə̃edi
ᏓᎬᏩᎶᏛ	daɡə̃walodə̃
ᏂᏓᏳᏅᏅ	nidajunə̃nə̃
ᎪᎯᏳᏙ	ɡohijudo
ᎥᎢᏒᎢ	ə̃isə̃i
ᎤᏬᏰᏂ	uwojeni
ᎤᏓᏔᏅ	udatanə̃
ᎤᏂᎦᏛᎲᏍᎩ	uniɡadə̃hə̃sɡi
ᎣᏓᎸ	odalə̃
ᎠᏛᏁᎵᏍᎩ	adə̃nelisɡi
ᎠᏍᏚᏗ	asdudi
ᎠᏍᎪᎵ	asɡoli
ᏩᎵᏃᎯᏯᏍᎬ	walinohijasɡə̃
ᏧᏁᎸᏗᏯ	t͡sunelə̃dija
ᏚᎬᏫᏳᎯ	duɡə̃wijuhi
ᏓᎾᏛᏁᎵᏍᎬ	danadə̃nelisɡə̃
ᏂᎦᎥᎢ	niɡaə̃i
ᎬᎨᏳᎢ	ɡə̃ɡejui
ᎧᏁᎢᏍᏔᏅᎯ	kaneistanə̃hi
ᎠᏰᎵᎤ	ajeliu
ᎠᎲᏏᏓᏍᏗ	ahə̃sidasdi
ᏙᏓᎸ	dodalə̃
ᏗᎦᏃᏣᎵ	diɡanot͡sali
ᏅᎠᏯᏍᏗ	nə̃ajasdi
ᎩᎵᏏᏲ	ɡilisijo
ᎧᏁᏉᎩ	kanekʷoɡi
ᎤᎴᏅᎲ	ulenə̃hə̃
ᎣᏩᏒ	owasə̃
ᎢᏴᎢ	ijə̃i
ᎢᏳᏆᏗᏅᏓ	ijukʷadinə̃da
ᎤᎫᎾ	uɡuna
ᎠᏲᎶᎬ	ajoloɡə̃
ᎠᏂᏁᏉᎬ	aninekʷoɡə̃
ᎾᏓᏛᏂᏌᏁᎲ	nadadə̃nisanehə̃
ᎤᏩᏂᎦᎸ	uwaniɡalə̃
ᎡᎳᏗᏢ	eladit͡ɬə̃
ᎠᏄᏱ	anuji
ᎠᏂᏍᎩᎾ	anisɡina
ᎠᏂᎶᏁᏍᎬ	anilonesɡə̃
ᏧᎾᏕᎶᏆᏍᏗ	t͡sunadelokʷasdi
ᏧᎾᏁᎸᏗ	t͡sunanelə̃di
ᎪᏯᏛ	ɡojadə̃
ᎦᏂ	ɡani
ᎤᏕᏅ	udenə̃
ᎤᏒᏙᏂ	usə̃doni
ᎠᏠᏯᏍᏔᏅ	at͡ɬojastanə̃
ᎠᏒᎾᏍᏗᏱ	asə̃nasdiji
ᎠᎵᏱᎵᏒ	alijilisə̃
ᏧᏪᏥ	t͡suwet͡si
ᎾᏍᎩᏍᎩᏂ	nasɡisɡini
ᎬᎩᏍᏗ	ɡə̃ɡisdi
ᎦᏁᎦ	ɡaneɡa
ᎤᏕᏘᏴᏌᏗᏒ	udetijə̃sadisə̃
ᎤᎾᎵᎪᏒ	unaliɡosə̃
ᏧᏂᎧᎿᏩᏛᏍᏗ	t͡sunikahnawadə̃sdi
ᏙᏱᏗᏢ	dojidit͡ɬə̃
ᏗᎦᏣᏄᎶ	diɡat͡sanulo
ᏄᏩᏁᎸ	nuwanelə̃
ᏄᎾᏰᎯᏍᏛᎾ	nunajehisdə̃na
ᎩᎳ	ɡila
ᎨᏐ	ɡeso
ᎦᎸᎳᏗᎨᏍᏗ	ɡalə̃ladiɡesdi
ᎤᏦᏍᏗ	ut͡sosdi
ᎤᎾᏣ	unat͡sa
ᎠᏓᎾᏅ	adananə̃
ᎠᏍᏚᎢᏛ	asduidə̃
ᎠᏁᏢᏔᏅᎯ	anet͡ɬə̃tanə̃hi
ᏚᎶᎩᎸ	duloɡilə̃
ᏕᎬᏔᏛ	deɡə̃tadə̃
ᏓᎵᏍᏛ	dalisdə̃
ᎧᏃᎮᏛ	kanohedə̃
ᎧᏁᏉᎥᎢ	kanekʷoə̃i
ᏧᎦᎾᏮ	t͡suɡanawə̃
ᏚᎾᏙᎥ	dunadoə̃
ᎦᎶᏄᎮᏛ	ɡalonuhedə̃
ᎦᎵᏦᏕ	ɡalit͡sode
ᎠᏕᏲᎲ	adejohə̃
ᎠᎾᏗᏒᎯᎯ	anadisə̃hihi
ᎠᎵᏏᎾᎯᏍᏙᏗ	alisinahisdodi
ᎠᎩᏍᎬᎢ	aɡisɡə̃i
ᏩᎴᎳ	walela
ᏗᎪᎵᏰᏗ	diɡolijedi
ᏌᏌ	sasa
ᏂᎦᎵᏍᏔᏂᏙᎲ	niɡalistanidohə̃
ᎦᎾᏄᎪᎢᏍᏗ	ɡananuɡoisdi
ᎦᎷᏨ	ɡalut͡sə̃
ᎤᏪᏅᏒ	uwenə̃sə̃
ᎤᏝᏅᏓᏕᎲ	ut͡ɬanə̃dadehə̃
ᏧᎾᎳᏏᏕᎾ	t͡sunalasidena
ᏗᎨᏥᎾᏝᎢ	diɡet͡sinat͡ɬai
ᎦᎸᎳᏗᎨᏍᏙᏗ	ɡalə̃ladiɡesdodi
ᎤᏍᎪᎸ	usɡolə̃
ᎤᎩᏒᎩ	uɡisə̃ɡi
ᎠᏓᏚᎬ	adaduɡə̃
ᎠᎴᏅᏔᏅ	alenə̃tanə̃
ᏓᎶᏂᎦᏍᏛ	daloniɡasdə̃
ᏗᏍᎩᏘᏍᏗ	disɡitisdi
ᎦᏙᎬ	ɡadoɡə̃
ᎤᏝᏅᏛ	ut͡ɬanə̃də̃
ᎤᏐᏅᎢ	usonə̃i
ᎤᏅᏗ	unə̃di
ᎤᏂᏥ	unit͡si
ᎤᎾᏓᏟᏌᏅ	unadat͡ɬisanə̃
ᎠᎵᏖᎸᏗ	alitelə̃di
ᏥᏌ	t͡sisa
ᏕᎦᎸᏛ	deɡalə̃də̃
ᏌᏊᎭ	sakʷuha
ᏅᏏᎾᏒ	nə̃sinasə̃
ᎾᏳ	naju
ᎨᏎ	ɡese
ᎧᏃᎩᏍᏗ	kanoɡisdi
ᎦᏂᏓᏛ	ɡanidadə̃
ᎤᏠᏯᏍᏗ	ut͡ɬojasdi
ᎤᎾᏙᏢᏒ	unadot͡ɬə̃sə̃
ᏚᏙᏢᏒᎢ	dudot͡ɬə̃sə̃i
ᏗᎨᎦᏃᏗ	diɡeɡanodi
ᏓᏬᎵ	dawoli
ᎾᏞᎬ	nat͡ɬeɡə̃
ᎧᏁᎢᏍᏔᏅ	kaneistanə̃
ᎤᏓᏅᏗ	udanə̃di
ᎤᎧᏲᏗ	ukajodi
ᎠᏯᏍᏗ	ajasdi
ᎠᏍᎩᏘᏍᏗ	asɡitisdi
ᏫᏓᏎᏄᎢ	widasenui
ᎬᎿᎦᏍᏛ	ɡə̃hnaɡasdə̃
ᎦᏂᏰᎩ	ɡanijeɡi
ᎤᎲᎢ	uhə̃i
ᏭᎵᏍᎨᏗᏴ	wulisɡedijə̃
ᏗᏓᏲᎯᏍᏗ	didajohisdi
ᎤᎾᎩᎾ	unaɡina
ᎤᎧᏁᎳ	ukanela
ᏧᎦᎶᎦ	t͡suɡaloɡa
ᏦᎢᏁ	t͡soine
ᏙᏯᏗᎳ	dojadila
ᏗᎦᏃᏢᎩ	diɡanot͡ɬə̃ɡi
ᏓᎾᏟᎲ	danat͡ɬihə̃
ᎨᎳᏍᏙᏗ	ɡelasdodi
ᎧᎵᏗᎳᏏᏗ	kalidilasidi
ᎤᏲᎱᏎᎸ	ujohuselə̃
ᎤᏍᏆᎸᎡᎲ	uskʷalə̃ehə̃
ᎤᏁᏉᏨᎯ	unekʷot͡sə̃hi
ᎣᎯᏍᏗ	ohisdi
ᎢᏰᎵᏍᏗ	ijelisdi
ᎢᎬᏂᏌᏅᎯ	iɡə̃nisanə̃hi
ᎠᏛᏅᎢᏍᏔᏅ	adə̃nə̃istanə̃
ᎠᏓᏙᎵᏍᏗ	adadolisdi
ᎠᏅᏱ	anə̃ji
ᏨᏍᎪᏱ	t͡sə̃sɡoji
ᏧᏂᏴᏫ	t͡sunijə̃wi
ᏧᎾᏓᏱᎵᏓᏍᏗ	t͡sunadajilidasdi
ᏗᏄᏬ	dinuwo
ᏗᎳᏏᏙᏗ	dilasidodi
ᏄᎵᏂᎬᎬᎾ	nuliniɡə̃ɡə̃na
ᎪᏢᎯᏐᏗ	ɡot͡ɬə̃hisodi
ᎦᎷᎾᏗ	ɡalunadi
ᎦᎴᏴᏔᏅ	ɡalejə̃tanə̃
ᎤᏬᎯᏳ	uwohiju
ᎤᏓᏡᎬ	udat͡ɬuɡə̃
ᎠᏰᏟ	ajet͡ɬi
ᎠᏍᎩᎾᏗᏍᏗ	asɡinadisdi
ᎠᏂᏍᎦᏯ	anisɡaja
ᎠᎦᏍᎦᏂ	aɡasɡani
ᏗᎪᏍᎩ	diɡosɡi
ᏒᎳᏗᏝ	sə̃ladit͡ɬa
ᎨᏎᎢ	ɡesei
ᎦᏅᏅ	ɡanə̃nə̃
ᎤᏬᎯᏳᏅ	uwohijunə̃
ᎤᏂᏁᏨ	uninet͡sə̃
ᎤᎾᏛᏁᎸᏗ	unadə̃nelə̃di
ᎢᏯᏓᏛᏁᏗ	ijadadə̃nedi
ᎢᎨᏍᏙᏗ	iɡesdodi
ᎠᏥᎾᏝᎢ	at͡sinat͡ɬai
ᎠᏛᏍᎬ	adə̃sɡə̃
ᎠᏌᎳᏙᏗ	asaladodi
ᏫᏂᏚᏳᎪᏛ	winidujuɡodə̃
ᏗᎬᏙᏗ	diɡə̃dodi
ᏕᎪᏪᎸ	deɡowelə̃
ᏓᏆᎴᎷ	dakʷalelu
ᎨᎦᏓᏅᏖᏗ	ɡeɡadanə̃tedi
ᎦᏛᎢ	ɡadə̃i
ᎦᏅᎯᏓᎨ	ɡanə̃hidaɡe
ᎥᏍᎩᏱ	ə̃sɡiji
ᎠᏰᏍᏛᏗ	ajesdə̃di
ᏓᏓᎴᏂᏍᎬ	dadalenisɡə̃
ᏅᏬᏘ	nə̃woti
ᏀᎾᎢ	nahnai
ᎾᏛᏁᎲᎢ	nadə̃nehə̃i
ᎾᏍᎦ	nasɡa
ᎪᎨᏱ	ɡoɡeji
ᎧᏩᏂ	kawani
ᎧᏃᎮᎸ	kanohelə̃
ᎦᏐᏆᎸ	ɡasokʷalə̃
ᎦᏇᏅᏗ	ɡakʷenə̃di
ᎦᏃᎴᏍᎬ	ɡanolesɡə̃
ᎤᏙᏢᏒᎢ	udot͡ɬə̃sə̃i
ᎤᏙᎷᏬᏗ	udoluwodi
ᎠᏤᎸ	at͡selə̃
ᏰᎵᏆ	jelikʷa
ᏥᏯ	t͡sija
ᏄᏍᏗ	nusdi
ᎦᏟᏐᏗ	ɡat͡ɬisodi
ᎠᏟᎶᏍᏙᏗ	at͡ɬilosdodi
ᎠᏙᏱᏯᏛ	adojijadə̃
ᎠᏓᏪᎳᎩᏍᎩ	adawelaɡisɡi
ᎠᏁᎯ	anehi
ᎠᎾᏓᏅᏖᏍᎬ	anadanə̃tesɡə̃
ᎠᎵᏂᎬᏁᏗᎢ	aliniɡə̃nediː
ᎠᎬᏩᎵ	aɡə̃wali
ᏒᏙᏂ	sə̃doni
ᏍᏆᎳ	skʷala
ᏂᎪᎯᎸ	niɡohilə̃
ᎦᎸᏉᏗ	ɡalə̃kʷodi
ᎤᏚᏃᎯᏍᏔᏍᎧ	udunohistaska
ᎢᏲᏍᏛ	ijosdə̃
ᎡᏆᏯ	ekʷaja
ᎠᏕᏴᎠᏍᎬ	adejə̃asɡə̃
ᏧᏓᎴᎾᎯ	t͡sudalenahi
ᏗᎦᏁᏟᏴᏍᏗ	diɡanet͡ɬijə̃sdi
ᎯᎪᏩᏔ	hiɡowata
ᎤᏓᏅᏘ	udanə̃ti
ᎤᎴᎾᎯᏛ	ulenahidə̃
ᏭᎵᏱᎶᎸ	wulijilolə̃
ᏧᎾᎦ	t͡sunaɡa
ᏗᏁᎶᏗᎢ	dinelodiː
ᏑᏓᎵ	sudali
ᎾᏕᏘᏴᎯᏒ	nadetijə̃hisə̃
ᎥᎵᏍᎦᏍᏙᏗᏍᎬ	ə̃lisɡasdodisɡə̃
ᎤᎵᏌᎳᏙᏗ	ulisaladodi
ᎣᏪᏅᏒ	owenə̃sə̃
ᎢᏗᏜ	idid͡la
ᎠᏓᏅᏖᎵᏙᎲ	adanə̃telidohə̃
ᏗᏓᏟᎶᏍᏔᏅ	didat͡ɬilostanə̃
ᏗᎪᎥᎯ	diɡoə̃hi
ᏗᎦᎾᏗᏫᏍᏗ	diɡanadiwisdi
ᏓᎪᎥᎩ	daɡoə̃ɡi
ᎧᎦᎵ	kaɡali
ᎤᎬᏫᏳ	uɡə̃wiju
ᎤᎦᎾᏩ	uɡanawa
ᎠᎳᏏᏅᏙᏗ	alasinə̃dodi
ᎠᎦᏙᎲᏍᏗ	aɡadohə̃sdi
ᏥᎨᏒ	t͡siɡesə̃
ᏗᏛᎪᏔᏅ	didə̃ɡotanə̃
ᏗᏗᎦᎴᏴ	didiɡalejə̃
ᏗᎦᎾᏗᎯᏍᏗ	diɡanadihisdi
ᏐᏁᎳᏚ	soneladu
ᏂᏚᏳᎪᏛ	nidujuɡodə̃
ᏂᎬᎾᏛ	niɡə̃nadə̃
ᎦᎷᎶᎩ	ɡaluloɡi
ᎤᏁᏍᎨᎲ	unesɡehə̃
ᎠᏴᏫᏯ	ajə̃wija
ᎠᏜ	ad͡la
ᎠᏓᏌᎳᏙᏗ	adasaladodi
ᎠᏍᏆᏙᏅ	askʷadonə̃
ᎠᎩᏒᎯ	aɡisə̃hi
ᏗᎪᏢᏅ	diɡot͡ɬə̃nə̃
ᏗᎦᎭᎵ	diɡahali
ᏕᎦᏅᏅ	deɡanə̃nə̃
ᎧᏃᎮᎸᏍᎩ	kanohelə̃sɡi
ᎦᎷᎩ	ɡaluɡi
ᎤᏓᏅᎦᎸᏓ	udanə̃ɡalə̃da
ᎤᎳᏫᏛᏓ	ulawidə̃da
ᎢᏧᏓᎴᎩ	it͡sudaleɡi
ᎠᏯᏙᎸ	ajadolə̃
ᏝᏰᎵ	t͡ɬajeli
ᏗᎦᎳᏫᏍᏗ	diɡalawisdi
ᏕᎦᎶᎨᏒ	deɡaloɡesə̃
ᏅᏓᏕᏆ	nə̃dadekʷa
ᎫᏰᏉᏂ	ɡujekʷoni
ᎢᏳᏟᎶᏛ	ijut͡ɬilodə̃
ᎢᏯᎦᏴᎵ	ijaɡajə̃li
ᎢᎦᏪᏛ	iɡawedə̃
ᎡᏙᎲᎩ	edohə̃ɡi
ᎠᏰᎸᏗ	ajelə̃di
ᎠᏂᏌᏙᏯᏍᎩ	anisadojasɡi
ᎦᏁᏟᏴᏍᏗ	ɡanet͡ɬijə̃sdi
ᎦᎾ	ɡana
ᎤᏴᏍᏗ	ujə̃sdi
ᎤᎳᏏᎩ	ulasiɡi
ᎤᎦᎾᏮ	uɡanawə̃
ᎠᏫᏗᏍᎩ	awidisɡi
ᎠᎵᏐᏆᎸᏗ	alisokʷalə̃di
ᎠᎴᏅᏙᏗ	alenə̃dodi
ᎠᎱᎵ	ahuli
ᏴᎩ	jə̃ɡi
ᏩᏙ	wado
ᏧᏄᏦᏍᏔ	t͡sunut͡sosta
ᏗᎪᏍᏓᏱ	diɡosdaji
ᏂᎬᏅ	niɡə̃nə̃
ᎫᎵᏍᏔᏅ	ɡulistanə̃
ᎪᏛᏙᏗ	ɡodə̃dodi
ᎧᏁᏉᏍᎬ	kanekʷosɡə̃
ᎦᎸᏥ	ɡalə̃t͡si
ᎦᎨᏛ	ɡaɡedə̃
ᎤᏴᎸ	ujə̃lə̃
ᎠᏓᏁᎳᏁᏗ	adanelanedi
ᎠᏂᏬᏂᎭ	aniwoniha
ᎠᎵᏁᎩ	alineɡi
ᎠᎦᎸᏥ	aɡalə̃t͡si
ᏫᎦᎶᎯᏍᏗ	wiɡalohisdi
ᏆᏏᎵ	kʷasili
ᎪᏛᏅ	ɡodə̃nə̃
ᎧᏬᎳᏕᏍᎬ	kawoladesɡə̃
ᎤᎷᏨᎩ	ulut͡sə̃ɡi
ᎠᏰᎳᏍᏗ	ajelasdi
ᎠᏎᏃ	aseno
ᎠᎺᏰᏟ	amejet͡ɬi
ᎠᎴᏫᏍᏔᏅ	alewistanə̃
ᏩᏎᎯᎰᎢ	wasehihoi
ᏗᏁᎶᏗ	dinelodi
ᏗᎾᏙᎳᎩ	dinadolaɡi
ᏗᎦᎪᎯᏗ	diɡaɡohidi
ᏓᏓᏛᎾᏍᏗᏍᎬ	dadadə̃nasdisɡə̃
ᏌᏊᎢᏳᎾᎵᏍᏔᏅᏍᎦᏚᎩ	sakʷuijunalistanə̃sɡaduɡi
ᏅᎬᎪᏔᏅᎯ	nə̃ɡə̃ɡotanə̃hi
ᎨᎾᏓ	ɡenada
ᎦᎶᏒᏍᏔᏅ	ɡalosə̃stanə̃
ᎡᎯᏍᏗ	ehisdi
ᎠᏰᎲᎩ	ajehə̃ɡi
ᎠᏫᏒ	awisə̃
ᎠᏎᏱᎩ	asejiɡi
ᎠᎾᎵᏏᎾᎯᏍᏗᏍᎬ	analisinahisdisɡə̃
ᏣᎴᎩ	t͡saleɡi
ᏝᏱᎪᎯᎩ	t͡ɬajiɡohiɡi
ᏙᎯ	dohi
ᏗᎾᎪᎳᏛᏅ	dinaɡoladə̃nə̃
ᏗᎦᏍᎩᎶ	diɡasɡilo
ᏅᏓ	nə̃da
ᎧᏁᎬᎢ	kaneɡə̃i
ᎤᏴᏜ	ujə̃d͡la
ᎤᎵᏍᎪᎸᏔᏅ	ulisɡolə̃tanə̃
ᎠᏲᎸᎯ	ajolə̃hi
ᎠᏥᎸᏍᎩ	at͡silə̃sɡi
ᎠᏍᏆᎵᏍᏗ	askʷalisdi
ᏯᏛᎾᏅᏙᎯᏳ	jadə̃nanə̃dohiju
ᏩᎦ	waɡa
ᏙᎪᏪᎸ	doɡowelə̃
ᏗᏂᏏᏴᏫᎭ	dinisijə̃wiha
ᏗᎦᏘᎴᏍᏗ	diɡatilesdi
ᏓᎦᏘᎴᎦ	daɡatileɡa
ᎫᏝᎢ	ɡut͡ɬai
ᎪᏪᎵᏍᏗ	ɡowelisdi
ᎪᎱᏍᏗᎨᏒ	ɡohusdiɡesə̃
ᎤᏲᎢ	ujoi
ᎤᏄᎸᎲᏍᎩ	unulə̃hə̃sɡi
ᎠᏴᏍᏙᏗ	ajə̃sdodi
ᎠᏰᎵᏗᎦᎳᏫᎢᏍᏗ	ajelidiɡalawiːsdi
ᎠᏛᏏᏒ	adə̃sisə̃
ᎠᏓᏅᏖᏍᎬ	adanə̃tesɡə̃
ᎠᏍᏛᎩ	asdə̃ɡi
ᏩᏂᎨᎢ	waniɡei
ᏙᏱᏗᏢᎦᏚᎲ	dojidit͡ɬə̃ɡaduhə̃
ᏗᏂᏅᏍᎨᏂ	dininə̃sɡeni
ᏗᎪᏪᎶᏗ	diɡowelodi
#
# Tones
Ꮧ Ꮧ̋ Ꮧ́ Ꮧ̄ Ꮧ̀ Ꮧ̌ Ꮧ̂	di di˥ di˦ di˧ di˧˩ di˨˦ di˥˧
#
# Caron and Breve seem to be used for the same purpose; they look similar
Ꮧ̆Ꮧ̌	di˨˦di˨˦
