ሁለቱም	хулэтум
ሁሉ	хулу
ሁሉም	хулум
ሁኔታ	хунета
ሁኔታዎችና	хунетаўочына
ሃይማኖቱን	хайыманотун
ሃይማኖት	хайыманот
ሆነ	хонэ
ሆኖ	хоно
ለሁሉም	лэхулум
ለልጆቻቸው	лэлыджочачэў
ለመሆን	лэмэхон
ለመምረጥ	лэмэмырэт̣
ለመሥራት	лэмэćырат
ለመሳተፍ	лэмэсатэф
ለመስጠት	лэмэсыт̣эт
ለመከላከያው	лэмэкэлакэяў
ለመጠቀም	лэмэт̣эк̣эм
ለመጠበቅ	лэмэт̣эбэк̣
ለመፈጸም	лэмэфэц̣эм
ለሚደረግባቸው	лэмидэрэгыбачэў
ለማርካት	лэмарыкат
ለማሰከበር	лэмасэкэбэр
ለማስተማር	лэмасытэмар
ለማስከበር	лэмасыкэбэр
ለማቋቋምና	лэмак̣ўак̣ўамына
ለማበላሸት	лэмабэлашэт
ለማንኛውም	лэманыньаўым
ለማዋል	лэмаўал
ለማድረግ	лэмадырэг
ለማግኘት	лэмагыньэт
ለሥራም	лэćырам
ለሰብዓዊ	лэсэбыʹаўи
ለቤተሰቡ	лэбетэсэбу
ለአንድ	лээныд
ለእራሱና	лэ͵ырасуна
ለእያንዳንዱ	лэ͵ыяныданыду
ለክብሩና	лэкыбыруна
ሊሆን	лихон
ሊያገለግል	лиягэлэгыл
ሊፈጸሙ	лифэц̣эму
ላይ	лайы
ሌላውን	лелаўын
ልብስ	лыбыс
ልዩ	лыю
ልዩነት	лыюнэт
ልዩነትም	лыюнэтым
ልጅ	лыдж
ሐሳቡን	х̣эсабун
ሐሳቦችን	х̣эсабочын
ሕሊና	х̣ылина
ሕክምና	х̣ыкымына
ሕዝብ	х̣ызыб
ሕዝቦች	х̣ызыбоч
ሕጉ	х̣ыгу
ሕግ	х̣ыг
ሕጎችና	х̣ыгочына
ሕጻናትም	х̣ыц̣анатым
ሕጻንነት	х̣ыц̣анынэт
መሆኑ	мэхону
መሆን	мэхон
መመልከት	мэмэлыкэт
መማር	мэмар
መሠረቱ	мэćэрэту
መሠረታዊ	мэćэрэтаўи
መሠረት	мэćэрэт
መሰረታዊ	мэсэрэтаўи
መሰረት	мэсэрэт
መሰናከል	мэсэнакэл
መሰጠት	мэсэт̣эт
መስጠት	мэсыт̣эт
መሻሻል	мэшашал
መብት	мэбыт
መብቶች	мэбыточ
መብቶችም	мэбыточым
መብቶችና	мэбыточына
መብቶችንና	мэбыточынына
መተባበር	мэтэбабэр
መንገድ	мэныгэд
መንግሥታት	мэныгыćытат
መንግሥት	мэныгыćыт
መንግስቱ	мэныгысыту
መንግስት	мэныгысыт
መንፈስ	мэныфэс
መካከል	мэкакэл
መካፈልና	мэкафэлына
መግባባትን	мэгыбабатын
መጠበቂያ	мэт̣эбэк̣ия
መጠበቅ	мэт̣эбэк̣
መጠን	мэт̣эн
ሙሉ	мулу
ሙያ	муя
ሚስት	мисыт
ማስተዋልና	масытэўалына
ማሻሻያና	машашаяна
ማኀበራዊ	мах̮эбэраўи
ማኀበር	мах̮эбэр
ማኀበርተኛ	мах̮эбэрытэньа
ማኀበሮችን	мах̮эбэрочын
ማናቸውም	маначэўым
ማንም	маным
ማንኛውም	маныньаўым
ማዳበርያ	мадабэрыя
ማድረግ	мадырэг
ምርጫ	мырыч̣а
ምርጫና	мырыч̣ана
ምርጫዎች	мырыч̣аўоч
ምንጮች	мыныч̣оч
ምክንያት	мыкыныят
ምክንያቶች	мыкыныяточ
ምግብ	мыгыб
ሥልጣን	ćылыт̣ан
ሥራ	ćыра
ሥራም	ćырам
ሥራዎች	ćыраўоч
ሥር	ćыр
ሥርዓት	ćырыʹат
ሰላምን	сэламын
ሰቡ	сэбу
ሰብ	сэб
ሰው	сэў
ሰዓቶች	сэʹаточ
ሲወለድ	сиўэлэд
ሳይቀጠር	сайык̣эт̣эр
ሳይኖሩ	сайынору
ሳይወሰኑ	сайыўэсэну
ሴቶች	сеточ
ስለሆነ	сылэхонэ
ስለሰብአዊ	сылэсэбыэўи
ስላለው	сылалэў
ስሙን	сымун
ስምምነት	сымымынэт
ስቃይ	сык̣айы
ሸሽቶ	шэшыто
ሸንጎ	шэныго
ቅጣት	к̣ыт̣ат
በሃይማኖት	бэхайыманот
በሆነ	бэхонэ
በሆነና	бэхонэна
በሆኑ	бэхону
በሌሎች	бэлелоч
በሐሳብ	бэх̣эсаб
በሕገ	бэх̣ыгэ
በሕግ	бэх̣ыг
በመሰረታዊ	бэмэсэрэтаўи
በመብትም	бэмэбытым
በመብቶቹ	бэмэбыточу
በመብቶቹና	бэмэбыточуна
በመንግሥቱም	бэмэныгыćытум
በመጣስ	бэмэт̣ас
በመፈጸም	бэмэфэц̣эм
በሙሉ	бэмулу
በሚከራከርበት	бэмикэракэрыбэт
በሚከሰስበት	бэмикэсэсыбэт
በሚያደርጉት	бэмиядэрыгут
በሚያገኝበት	бэмиягэньыбэт
በሚደረግ	бэмидэрэг
በሚደርሱ	бэмидэрысу
በሚገባ	бэмигэба
በሚጠቀምበት	бэмит̣эк̣эмыбэт
በሚጻጻፈው	бэмиц̣ац̣афэў
በሚፈልጉ	бэмифэлыгу
በሚፈርስበትም	бэмифэрысыбэтым
በሚፈጸሙ	бэмифэц̣эму
በማንኛውም	бэманыньаўым
በማያዳላ	бэмаядала
በምሥጢር	бэмыćыт̣ир
በሞግዚትነት	бэмогызитынэт
በሥራ	бэćыра
በሰላም	бэсэлам
በሰው	бэсэў
በሳይንስ	бэсайыныс
በቀጥታ	бэк̣эт̣ыта
በባርነት	бэбарынэт
በቤተሰቡ	бэбетэсэбу
በቤቱ	бэбету
በብሔራዊ	бэбых̣ераўи
በተመረጡ	бэтэмэрэт̣у
በተመሳሳይ	бэтэмэсасайы
በተቀረ	бэтэк̣эрэ
በተወሰነው	бэтэўэсэнэў
በተደነገጉ	бэтэдэнэгэгу
በተግባር	бэтэгыбар
በተፈጸመበት	бэтэфэц̣эмэбэт
በታሰበ	бэтасэбэ
በትክክለኛና	бэтыкыкылэньана
በትክክል	бэтыкыкыл
በችሎታ	бэчылота
በኀብረ	бэх̮эбырэ
በኀብረሰቡና	бэх̮эбырэсэбуна
በኀብረት	бэх̮эбырэт
በነጻ	бэнэц̣а
በነጻነትና	бэнэц̣анэтына
በነጻነቶቹ	бэнэц̣анэточу
በአንደኛ	бээныдэньа
በአገሩ	бээгэру
በአግባብ	бээгыбаб
በኢትዮጵያ	бэ͵итыёп̣ыя
በኢንተርናሽናል	бэ͵инытэрынашынал
በእያንዳንዱ	бэ͵ыяныданыду
በኪነ	бэкинэ
በክብርና	бэкыбырына
በወንድማማችነት	бэўэныдымамачынэт
በወንጀል	бэўэныджэл
በዘር	бэзэр
በዚሁ	бэзиху
በዚህ	бэзих
በዜግነት	бэзегынэт
በየብሔራዊ	бэебых̣ераўи
በየጊዜው	бэегизеў
በየጊዜውና	бэегизеўына
በዩኔስኮ	бэюнесыко
በይፋ	бэйыфа
በደህና	бэдэхына
በዴሞክራቲክ	бэдемокыратик
በጋብቻ	бэгабыча
በግል	бэгыл
በግዛት	бэгызат
በግዴታዎቹ	бэгыдетаўочу
በጠቅላላው	бэт̣эк̣ылалаў
በጥቅሞቹም	бэт̣ык̣ымочум
በፈጸመው	бэфэц̣эмэў
በፍርድ	бэфырыд
ቢሆን	бихон
ቢሆንም	бихоным
ቢሞት	бимот
ቢቀር	бик̣эр
ቢታመም	битамэм
ቢያረጅ	биярэдж
ቢያንስ	бияныс
ቢገጥመው	бигэт̣ымэў
ባለስልጣኖች	балэсылыт̣аноч
ባለቤትነት	балэбетынэт
ባል	бал
ባልተደነገገበት	балытэдэнэгэгэбэт
ባልፈጸመው	балыфэц̣эмэў
ባሏቸው	балўачэў
ባርነትና	барынэтына
ባይችል	байычыл
ቤተሰብ	бетэсэб
ቤተሰብን	бетэсэбын
ቤት	бет
ቤትና	бетына
ብሄራዊ	быхераўи
ብሔራዊ	бых̣ераўи
ብቻ	быча
ብቻውን	бычаўын
ተስማሚ	тэсымами
ተቃራኒ	тэк̣арани
ተቃውሞ	тэк̣аўымо
ተተረጎመ	тэтэрэгомэ
ተቻችሎ	тэчачыло
ተወላጅ	тэўэладж
ተዘጋጅቶ	тэзэгаджыто
ተይዞ	тэйызо
ተገቢ	тэгэби
ተግባር	тэгыбар
ተግባሮች	тэгыбароч
ተፈላጊ	тэфэлаги
ታሪክ	тарик
ትምህርት	тымыхырыт
ትክክለኛ	тыкыкылэньа
ትክክለኛና	тыкыкылэньана
ችሎ	чыло
ኀብረሰብ	х̮эбырэсэб
ነው	нэў
ነገር	нэгэр
ነጻ	нэц̣а
ነጻም	нэц̣ам
ነጻነት	нэц̣анэт
ነጻነትም	нэц̣анэтым
ነጻነትና	нэц̣анэтына
ነጻነትን	нэц̣анэтын
ነጻነትንና	нэц̣анэтынына
ነጻነቶች	нэц̣анэточ
ነጻና	нэц̣ана
ነፃነቶች	нэ`ц̣анэточ
ኑሮ	нуро
ኑሮና	нурона
ኑሮን	нурон
ኑሮው	нуроў
ንብረቱ	ныбырэту
ንግድም	ныгыдым
አለበት	элэбэт
አለው	элэў
አላቸው	элачэў
አላችው	элачыў
አማካኝነት	эмаканьынэт
አማካይነትና	эмакайынэтына
አስተሳሰብ	эсытэсасэб
አስተዳደር	эсытэдадэр
አስፈላጊ	эсыфэлаги
አስፈላጊዎች	эсыфэлагиўоч
አቅሙ	эк̣ыму
አቅርቦ	эк̣ырыбо
አቋም	эк̣ўам
አባል	эбал
አንቀጽ	энык̣эц̣
አንዱ	эныду
አንዳን	эныдан
አንድ	эныд
አካለ	экалэ
አይተረጎሙም	эйытэрэгомум
አይችልም	эйычылым
አይነፈገውም	эйынэфэгэўым
አይከሰስም	эйыкэсэсым
አይወሰድበትም	эйыўэсэдыбэтым
አይደረግም	эйыдэрэгым
አይገባቸውም	эйыгэбачэўым
አይገዛም	эйыгэзам
አይገደድም	эйыгэдэдым
አይፈረድበትም	эйыфэрэдыбэтым
አይፈጸምበትም	эйыфэц̣эмыбэтым
አገልግሎት	эгэлыгылот
አገልግሎቶችም	эгэлыгылоточым
አገሩ	эгэру
አገር	эгэр
አገሮች	эгэроч
አገዛዝ	эгэзаз
አፈጻጸም	эфэц̣ац̣эм
እምነቱን	ымынэтун
እራሱን	ырасун
እርምጃና	ырымыджана
እርዳታ	ырыдата
እስቲረጋገጥበት	ысытирэгагэт̣ыбэт
እነዚህ	ынэзих
እንደሆነ	ыныдэхонэ
እንደመሆኑ	ыныдэмэхону
እንደራሴዎች	ыныдэрасеўоч
እንደገና	ыныдэгэна
እንዲሁም	ыныдихум
እንዲሆን	ыныдихон
እንዲሰማለት	ыныдисэмалэт
እንዲስፋፋ	ыныдисыфафа
እንዲታሰር	ыныдитасэр
እንዲኖሩትና	ыныдинорутына
እንዲኖር	ыныдинор
እንዲከላከልለት	ыныдикэлакэлылэт
እንዲከበሩለት	ыныдикэбэрулэт
እንዲወገድለት	ыныдиўэгэдылэт
እንዲውሉ	ыныдиўылу
እንዲገለጹለት	ыныдигэлэц̣улэт
እንዲገለጽ	ыныдигэлэц̣
እንዲጠበቅ	ыныдит̣эбэк̣
እንዲጠበቅለት	ыныдит̣эбэк̣ылэт
እንዳያጣ	ыныдаят̣а
እንዳይደርስበት	ыныдайыдэрысыбэт
እኩል	ыкул
እኩልነት	ыкулынэт
እያንዳንዱ	ыяныданыду
እድገት	ыдыгэт
ከሆነ	кэхонэ
ከላይ	кэлайы
ከሌሎች	кэлелоч
ከሚቃረኑ	кэмик̣арэну
ከሚነሳሳ	кэминэсаса
ከሚኖርበት	кэминорыбэт
ከሚደረግ	кэмидэрэг
ከሚጥሱ	кэмит̣ысу
ከማንኛውም	кэманыньаўым
ከራሱ	кэрасу
ከሰብዓዊ	кэсэбыʹаўи
ከቁጥጥሩ	кэк̣ут̣ыт̣ыру
ከተደነገገው	кэтэдэнэгэгэў
ከእንደዚህ	кэ͵ыныдэзих
ከወንጀል	кэўэныджэл
ከዚህም	кэзихым
ከደመወዝ	кэдэмэўэз
ከደረሰው	кэдэрэсэў
ከጭቆና	кэч̣ык̣она
ከፍተኛ	кэфытэньа
ካልሆኑ	калыхону
ካስፈለገም	касыфэлэгэм
ክልሉ	кылылу
ክልክል	кылыкыл
ክስ	кыс
ክሶች	кысоч
ክብሩን	кыбырун
ክብር	кыбыр
ክፍል	кыфыл
ኮሚሽን	комишын
ወላድነትና	ўэладынэтына
ወላጆች	ўэладжоч
ወሰን	ўэсэн
ወንዶችና	ўэныдочына
ወንጀለኛ	ўэныджэлэньа
ወንጀሉ	ўэныджэлу
ወንጀል	ўэныджэл
ወንጀሎች	ўэныджэлоч
ወይም	ўэйым
ወደ	ўэдэ
ወገኖች	ўэгэноч
ወጥቶ	ўэт̣ыто
ዋና	ўана
ዋጋውን	ўагаўын
ውሳኔ	ўысане
ውሳን	ўысан
ውስጥ	ўысыт̣
ውጭ	ўыч̣
ዓላማዎች	ʹаламаўоч
ዓላማዎችን	ʹаламаўочын
ዓይነት	ʹайынэт
ዘር	зэр
ዘርነቱ	зэрынэту
ዘዴዎች	зэдеўоч
ዜናን	зенан
ዜግነቱ	зегынэту
ዜግነቱን	зегынэтун
የሀብት	ехэбыт
የሃሳብ	ехасаб
የሃብት	ехабыт
የሃይማኖት	ехайыманот
የህዝብ	ехызыб
የሆነ	ехонэ
የሆነው	ехонэў
የሆኑት	ехонут
የሆኑትን	ехонутын
የሌላ	елела
የሌሎችን	елелочын
የልዩ	елыю
የሐሳብና	ех̣эсабына
የሕሊናና	ех̣ылинана
የሕዝቡ	ех̣ызыбу
የመለወጥ	емэлэўэт̣
የመመለስ	емэмэлэс
የመመሥረት	емэмэćырэт
የመማር	емэмар
የመሥራት	емэćырат
የመሰብሰብና	емэсэбысэбына
የመቀበልንና	емэк̣эбэлынына
የመቆጠር	емэк̣от̣эр
የመተባበርን	емэтэбабэрын
የመታወቅ	емэтаўэк̣
የመንግስት	емэныгысыт
የመኖሩ	емэнору
የመኖር	емэнор
የመኖርንና	емэнорынына
የመካፈል	емэкафэл
የመዘዋወርና	емэзэўаўэрына
የመዝናናት	емэзынанат
የመግለጽ	емэгылэц̣
የመጠቀም	емэт̣эк̣эм
የመጠየቅና	емэт̣эек̣ына
የመጽናትንና	емэц̣ынатынына
የመፈጸምና	емэфэц̣эмына
የሙሉ	емулу
የሙያ	емуя
የሚረዱ	емирэду
የሚበቃ	емибэк̣а
የሚታገደው	емитагэдэў
የሚነካና	еминэкана
የሚወለዱ	емиўэлэду
የሚውል	емиўыл
የሚያስገኝለትና	емиясыгэньылэтына
የሚያበረታቱ	емиябэрэтату
የሚያገኘው	емиягэньэў
የሚያጎድፍ	емиягодыф
የሚያጠነክርና	емият̣энэкырына
የሚጎዳ	емигода
የሚፈልጉትን	емифэлыгутын
የሚፈጸመው	емифэц̣эмэў
የሚፈጽማቸው	емифэц̣ымачэў
የማምለክና	емамылэкына
የማስተማር	емасытэмар
የማኀበራዊ	емах̮эбэраўи
የማካፈልን	емакафэлын
የማክበር	емакыбэр
የማይተዳደር	емайытэдадэр
የማድረግ	емадырэг
የማግኘት	емагыньэт
የማግኘትን	емагыньэтын
የሞራሉንና	еморалунына
የሥራ	еćыра
የራሱ	ерасу
የሰው	есэў
የሳይንስ	есайыныс
የቀለም	ек̣элэм
የቅድሚያ	ек̣ыдымия
የቋንቋ	ек̣ўанык̣ўа
የባህል	ебахыл
የባሪያ	ебария
የብሔራዊ	ебых̣ераўи
የተለያየ	етэлэяе
የተመሳሳይ	етэмэсасайы
የተሰጡትን	етэсэт̣утын
የተባሉ	етэбалу
የተባበሩት	етэбабэрут
የተነሳ	етэнэса
የተከሰሰ	етэкэсэсэ
የተወሰኑ	етэўэсэну
የተዋረድ	етэўарэд
የተዘረዘረው	етэзэрэзэрэў
የተዘረዘሩት	етэзэрэзэрут
የተደገፈ	етэдэгэфэ
የተጠቀሱትን	етэт̣эк̣эсутын
የተፈጥሮ	етэфэт̣ыро
የተፈጥሮና	етэфэт̣ырона
የቴክኒክና	етекыникына
የትውልድ	етыўылыд
የኀብረ	ех̮эбырэ
የኀብረሰብ	ех̮эбырэсэб
የኀብረሰብና	ех̮эбырэсэбына
የኀብረተሰብ	ех̮эбырэтэсэб
የኀብረት	ех̮эбырэт
የኑሮ	енуро
የአሠራር	еэćэрар
የአንደኛ	еэныдэньа
የአንድ	еэныд
የአገዛዝ	еэгэзаз
የኢንተርናሽናል	е͵инытэрынашынал
የኤኮኖሚ	е͵иекономи
የእኩል	е͵ыкул
የከፍተኛ	екэфытэньа
የኪነ	екинэ
የወንጀል	еўэныджэл
የዕረፍት	еʹырэфыт
የዕረፍትና	еʹырэфытына
የዘር	езэр
የዜግነት	езегынэт
የይፋ	ейыфа
የደህንነታቸው	едэхынынэтачэў
የደረሱ	едэрэсу
የድምፅ	едымы`ц̣
የድርሰትና	едырысэтына
የድንበር	едыныбэр
የግብረ	егыбырэ
የግድ	егыд
የጠቅላላውን	ет̣эк̣ылалаўын
የጭካኔ	еч̣ыкане
የጾታ	ец̣ота
የፍርድ	ефырыд
የፖለቲካ	еполэтика
ያለ	ялэ
ያለአንዳች	ялээныдач
ያለው	ялэў
ያለጋብቻ	ялэгабыча
ያለጣልቃ	ялэт̣алык̣а
ያለፍርድ	ялэфырыд
ያላንዳች	яланыдач
ያልተለየ	ялытэлэе
ይህ	йых
ይህም	йыхым
ይህንን	йыхынын
ይበልጥ	йыбэлыт̣
ይኖሩበታል	йынорубэтал
ይገባል	йыгэбал
ይገባዋል	йыгэбаўал
ይጨምራል	йыч̣эмырал
ደህንነቱ	дэхынынэту
ደህንነቱን	дэхынынэтун
ደህንነት	дэхынынэт
ደመወዝ	дэмэўэз
ደረጃ	дэрэджа
ደረጃና	дэрэджана
ደረጃዎች	дэрэджаўоч
ደብዳቤ	дэбыдабе
ደግሞ	дэгымо
ድረስ	дырэс
ድርጅት	дырыджыт
ድርጅትም	дырыджытым
ድርጊትን	дырыгитын
ድርጊቶች	дырыгиточ
ገብነት	гэбынэт
ገብነትን	гэбынэтын
ገደብ	гэдэб
ጉዳዩ	гудаю
ጉዳይ	гудайы
ጊዜ	гизе
ጊዜና	гизена
ጊዜያትን	гизеятын
ጋር	гар
ጋብቻ	габыча
ጋብቻን	габычан
ግንኙነት	гыныньунэт
ግዛት	гызат
ግዴታ	гыдета
ግዴታዎች	гыдетаўоч
ጣልቃ	т̣алык̣а
ጤንነትና	т̣енынэтына
ጥረትና	т̣ырэтына
ጥቅሞቹን	т̣ык̣ымочун
ጥቅሞች	т̣ык̣ымоч
ጥበብ	т̣ыбэб
ጥንቃቄና	т̣ынык̣ак̣ена
ጥገኝነትን	т̣ыгэньынэтын
ጭምር	ч̣ымыр
ፀጥታና	`ц̣эт̣ытана
ፈቃድ	фэк̣ад
ፊት	фит
ፍርድ	фырыд
ፍጹም	фыц̣ум
ፖለቲካዊ	полэтикаўи
መቐለ	мэк̣̄элэ
መቐለን	мэк̣̄элэн
መቐሎ	мэк̣̄эло
መቐረት	мэк̣̄эрэт
መቐበሊ	мэк̣̄эбэли
መቐጸልታ	мэк̣̄эц̣элыта
መንቀሳቐሲ	мэнык̣эсак̣̄эси
መጠንቐቕታ	мэт̣энык̣̄эк̣̄ыта
መጥምቐ	мэт̣ымык̣̄э
ሙቐት	мук̣̄эт
ሙቐትን	мук̣̄этын
ማዕቐባት	маʹык̣̄эбат
ማዕቐብ	маʹык̣̄эб
ማዕቐብን	маʹык̣̄эбын
ርሕቐት	рых̣ык̣̄эт
ሸቐጣት	шэк̣̄эт̣ат
ሻቐለቶም	шак̣̄элэтом
ሻቐሎቱ	шак̣̄элоту
ሻቐሎት	шак̣̄элот
ሻቐሎቶም	шак̣̄элотом
ቐረባ	к̣̄эрэба
ቐረፅ	к̣̄эрэ`ц̣
ቐሪቡ	к̣̄эрибу
ቐሪቡሎም	к̣̄эрибулом
ቐሪባ	к̣̄эриба
ቐሪብና	к̣̄эрибына
ቐሪቦም	к̣̄эрибом
ቐርኒ	к̣̄эрыни
ቐሺ	к̣̄эши
ቐብሪ	к̣̄эбыри
ቐተልቲ	к̣̄этэлыти
ቐቲለ	к̣̄этилэ
ቐቲሉ	к̣̄этилу
ቐቲሎም	к̣̄этилом
ቐታሊ	к̣̄этали
ቐትሪ	к̣̄этыри
ቐኒሱ	к̣̄энису
ቐኒዩ	к̣̄энию
ቐኒዮም	к̣̄эниём
ቐንዲ	к̣̄эныди
ቐይሕ	к̣̄эйых̣
ቐዳመ	к̣̄эдамэ
ቐዳማይ	к̣̄эдамайы
ቐዳም	к̣̄эдам
ቐዳምነት	к̣̄эдамынэт
ቐዳሞት	к̣̄эдамот
ቐጠር	к̣̄эт̣эр
ቐጠርን	к̣̄эт̣эрын
ቐጺሉ	к̣̄эц̣илу
ቐጽሪ	к̣̄эц̣ыри
ቐፂሉ	к̣̄э`ц̣илу
ቐፂሉ’ሎ	к̣̄э`ц̣илу’ло
ቐፂሎም	к̣̄э`ц̣илом
ቐፃሊ	к̣̄э`ц̣али
ቐፅሪ	к̣̄э`ц̣ыри
ብቐሊሉ	бык̣̄элилу
ብቐረባ	бык̣̄эрэба
ብቐስ	бык̣̄эс
ብቐንዱ	бык̣̄эныду
ብቐንድነት	бык̣̄эныдынэт
ብቐደሙ	бык̣̄эдэму
ብቐዳማይን	бык̣̄эдамайын
ብቐዳም	бык̣̄эдам
ብቐዳምነት	бык̣̄эдамынэт
ብቐድሙ	бык̣̄эдыму
ብቐጠር	бык̣̄эт̣эр
ብቐጥታ	бык̣̄эт̣ыта
ብቐጥታን	бык̣̄эт̣ытан
ብቐጻሊ	бык̣̄эц̣али
ብቐፃልነት	бык̣̄э`ц̣алынэт
ብዘቐመጦ	бызэк̣̄эмэт̣о
ብዝቐልጠፈ	бызык̣̄элыт̣эфэ
ብዝቐረበ	бызык̣̄эрэбэ
ብጥንቃቐ	быт̣ынык̣ак̣̄э
ተቐሚጡ	тэк̣̄эмит̣у
ተቐማጢ	тэк̣̄эмат̣и
ተቐማጣይ	тэк̣̄эмат̣айы
ተቐማጦ	тэк̣̄эмат̣о
ተቐራራቢ	тэк̣̄эрараби
ተቐርቂሮም	тэк̣̄эрык̣иром
ተቐበልቲ	тэк̣̄эбэлыти
ተቐቢለን	тэк̣̄эбилэн
ተቐቢሉ	тэк̣̄эбилу
ተቐቢሉዎም	тэк̣̄эбилуўом
ተቐቢላ	тэк̣̄эбила
ተቐቢልና	тэк̣̄эбилына
ተቐቢልናዮ	тэк̣̄эбилынаё
ተቐቢሎም	тэк̣̄эбилом
ተቐቢሎምዎ	тэк̣̄эбиломыўо
ተቐቢሎምዎም	тэк̣̄эбиломыўом
ተቐቢሎሞ	тэк̣̄эбиломо
ተቐባሊት	тэк̣̄эбалит
ተቐባልነት	тэк̣̄эбалынэт
ተቐባልነትን	тэк̣̄эбалынэтын
ተቐባልነቶም	тэк̣̄эбалынэтом
ተቐቲሉ	тэк̣̄этилу
ተቐቲሉ’ሎ	тэк̣̄этилу’ло
ተቐቲሎም	тэк̣̄этилом
ተቐቲሎምን	тэк̣̄этиломын
ተቐናቐንቲ	тэк̣̄энак̣̄эныти
ተቐናቓኒአን	тэк̣̄энак̣̄аниэн
ተቐይሩ	тэк̣̄эйыру
ተቐዳደምቲ	тэк̣̄эдадэмыти
ተቐዳዳሚት	тэк̣̄эдадамит
ተቐዳዳማይ	тэк̣̄эдадамайы
ተቐጥቂጦም	тэк̣̄эт̣ык̣ит̣ом
ተንቀሳቐስቲ	тэнык̣эсак̣̄эсыти
ተጠቐምቲ	тэт̣эк̣̄эмыти
ተፈናቐልቲ	тэфэнак̣̄элыти
ትንቀሳቐስ	тынык̣эсак̣̄эс
ነቐፌታ	нэк̣̄эфета
ነቐፍቲ	нэк̣̄эфыти
ንመቐናቕንቶም	нымэк̣̄энак̣̄ынытом
ንሳቐ	нысак̣̄э
ንቐለብ	нык̣̄элэб
ንቐለብን	нык̣̄элэбын
ንቐዳማይ	нык̣̄эдамайы
ንቐጠር	нык̣̄эт̣эр
ንቐጻሊ	нык̣̄эц̣али
ንቐፃሊ	нык̣̄э`ц̣али
ንተቐናቐንቲ	нытэк̣̄энак̣̄эныти
ንክቐርቡ	ныкык̣̄эрыбу
ንክቐርብ	ныкык̣̄эрыб
ንዘይተዓጠቐ	нызэйытэʹат̣эк̣̄э
ንዘይተዓጥቐ	нызэйытэʹат̣ык̣̄э
ንዝሳቐዩ	нызысак̣̄эю
ንዝቐረበ	нызык̣̄эрэбэ
ንዝቐረበሎም	нызык̣̄эрэбэлом
ንዝቐረቡ	нызык̣̄эрэбу
ንዝቐረቦ	нызык̣̄эрэбо
ንዝቐርበሉ	нызык̣̄эрыбэлу
ንዝቐርቡ	нызык̣̄эрыбу
ንዝቐርብ	нызык̣̄эрыб
ንዝቐተለ	нызык̣̄этэлэ
ንዝተቐተሉ	нызытэк̣̄этэлу
ንዝተቐትለ	нызытэк̣̄этылэ
ንዝተቐትሉ	нызытэк̣̄этылу
ንዝተፈናቐሉ	нызытэфэнак̣̄элу
ንዝንቀሳቐሱ	нызынык̣эсак̣̄эсу
አቐዲሙ	эк̣̄эдиму
ኣቐሚጦም	ак̣̄эмит̣ом
ኣቐባሊ	ак̣̄эбали
ኣቐዲመን	ак̣̄эдимэн
ኣቐዲሙ	ак̣̄эдиму
ኣቐዲማ	ак̣̄эдима
ኣቐዲምና	ак̣̄эдимына
ኣቐዲምካ	ак̣̄эдимыка
ኣቐዲሞም	ак̣̄эдимом
ኣቐድም	ак̣̄эдым
ኣብዝቐፀለሉ	абызык̣̄э`ц̣элэлу
ኣይተቐበሉዎን	айытэк̣̄эбэлуўон
ኣይተቐበሎን	айытэк̣̄эбэлон
ኣይተፈቐደሎምን	айытэфэк̣̄эдэломын
ኣይጠቐሰን	айыт̣эк̣̄эсэн
ኣጠንቂቐን	ат̣энык̣ик̣̄эн
እናሓመቐ	ынах̣амэк̣̄э
እናቐረቡ	ынак̣̄эрэбу
እናቐፀለ	ынак̣̄э`ц̣элэ
እናተፀንቀቐ	ынатэ`ц̣энык̣эк̣̄э
እንተቐረበ	ынытэк̣̄эрэбэ
እንተቐሪቦም	ынытэк̣̄эрибом
እንተቐጺሉ	ынытэк̣̄эц̣илу
ከምዘሻቐሎ	кэмызэшак̣̄эло
ከምዘሻቐሎም	кэмызэшак̣̄элом
ከምዘይተፈቐደሎም	кэмызэйытэфэк̣̄эдэлом
ከምዝቐረበ	кэмызык̣̄эрэбэ
ከምዝቐርብ	кэмызык̣̄эрыб
ከምዝቐተለ	кэмызык̣̄этэлэ
ከምዝቐተሉ	кэмызык̣̄этэлу
ከምዝቐተሉን	кэмызык̣̄этэлун
ከምዝቐጸለ	кэмызык̣̄эц̣элэ
ከምዝቐፀለ	кэмызык̣̄э`ц̣элэ
ከምዝቐፀለን	кэмызык̣̄э`ц̣элэн
ከምዝተቐበልዎ	кэмызытэк̣̄эбэлыўо
ከምዝተቐተለ	кэмызытэк̣̄этэлэ
ከምዝተቐተሉ	кэмызытэк̣̄этэлу
ከምዝተቐተሉን	кэмызытэк̣̄этэлун
ከምዝተቐትለ	кэмызытэк̣̄этылэ
ከምዝተቐትሉ	кэмызытэк̣̄этылу
ከምዝተቐትሉን	кэмызытэк̣̄этылун
ከምዝንቀሳቐሱ	кэмызынык̣эсак̣̄эсу
ከይንቀሳቐስ	кэйынык̣эсак̣̄эс
ክቐርበሎም	кык̣̄эрыбэлом
ክቐርቡ	кык̣̄эрыбу
ክቐርቡን	кык̣̄эрыбун
ክቐርባ	кык̣̄эрыба
ክቐርብ	кык̣̄эрыб
ክቐርብ'ዩ	кык̣̄эрыб'ю
ክቐትል	кык̣̄этыл
ክንቀሳቐሱ	кынык̣эсак̣̄эсу
ክንቀሳቐስ	кынык̣эсак̣̄эс
ኽቐርብ’ዩ	к̱ык̣̄эрыб’ю
ወረቐት	ўэрэк̣̄эт
ወቐሳ	ўэк̣̄эса
ወደቐ	ўэдэк̣̄э
ዓቐብ	ʹак̣̄эб
ዓቐን	ʹак̣̄эн
ዓዲቐይሕ	ʹадик̣̄эйых̣
ዘሻቐለ	зэшак̣̄элэ
ዘቐመጦ	зэк̣̄эмэт̣о
ዘይተቐበለ	зэйытэк̣̄эбэлэ
ዘይዓጠቐ	зэйыʹат̣эк̣̄э
ዝረሓቐ	зырэх̣ак̣̄э
ዝረሓቐን	зырэх̣ак̣̄эн
ዝርሓቐ	зырых̣ак̣̄э
ዝሳቐ	зысак̣̄э
ዝሳቐዩ	зысак̣̄эю
ዝቐረበ	зык̣̄эрэбэ
ዝቐረበሉ	зык̣̄эрэбэлу
ዝቐረበሎም	зык̣̄эрэбэлом
ዝቐረቡ	зык̣̄эрэбу
ዝቐረባ	зык̣̄эрэба
ዝቐረቦም	зык̣̄эрэбом
ዝቐርበሉ	зык̣̄эрыбэлу
ዝቐርበሎም	зык̣̄эрыбэлом
ዝቐርቡ	зык̣̄эрыбу
ዝቐርብ	зык̣̄эрыб
ዝቐተለ	зык̣̄этэлэ
ዝቐተለን	зык̣̄этэлэн
ዝቐተሉ	зык̣̄этэлу
ዝቐትሉ	зык̣̄этылу
ዝቐትል	зык̣̄этыл
ዝቐነየ	зык̣̄энэе
ዝቐነዩ	зык̣̄энэю
ዝቐጸለ	зык̣̄эц̣элэ
ዝቐፀለ	зык̣̄э`ц̣элэ
ዝቐፀሉ	зык̣̄э`ц̣элу
ዝተለቐቑ	зытэлэк̣̄эк̣̄у
ዝተመረቐ	зытэмэрэк̣̄э
ዝተመረቐት	зытэмэрэк̣̄эт
ዝተቐመጠ	зытэк̣̄эмэт̣э
ዝተቐመጡ	зытэк̣̄эмэт̣у
ዝተቐበለት	зытэк̣̄эбэлэт
ዝተቐበሉ	зытэк̣̄эбэлу
ዝተቐበልዎ	зытэк̣̄эбэлыўо
ዝተቐበሩ	зытэк̣̄эбэру
ዝተቐብረ	зытэк̣̄эбырэ
ዝተቐተለ	зытэк̣̄этэлэ
ዝተቐተሉ	зытэк̣̄этэлу
ዝተቐተልሉ	зытэк̣̄этэлылу
ዝተቐትለ	зытэк̣̄этылэ
ዝተቐትሉ	зытэк̣̄этылу
ዝተቐትሉን	зытэк̣̄этылун
ዝተቐትልሉ	зытэк̣̄этылылу
ዝተንቀሳቐሱ	зытэнык̣эсак̣̄эсу
ዝተዓጠቐ	зытэʹат̣эк̣̄э
ዝተጠቐምሉ	зытэт̣эк̣̄эмылу
ዝተጠቐሰ	зытэт̣эк̣̄эсэ
ዝተጠቐሱ	зытэт̣эк̣̄эсу
ዝተጠቐዐ	зытэт̣эк̣̄эʹэ
ዝተፈቐደሎም	зытэфэк̣̄эдэлом
ዝተፈናቐሉ	зытэфэнак̣̄элу
ዝነቐፉ	зынэк̣̄эфу
ዝንቀሳቐሱ	зынык̣эсак̣̄эсу
ዝንቀሳቐሱን	зынык̣эсак̣̄эсун
ዝንቀሳቐስ	зынык̣эсак̣̄эс
ዝወቐዐ	зыўэк̣̄эʹэ
ዝወደቐት	зыўэдэк̣̄эт
ዝዘለቐ	зызэлэк̣̄э
ዝጠቐሰ	зыт̣эк̣̄эсэ
ዝጠቐሰት	зыт̣эк̣̄эсэт
ዝጠቐሱ	зыт̣эк̣̄эсу
ዝጸደቐ	зыц̣эдэк̣̄э
ዝፀደቐ	зы`ц̣эдэк̣̄э
የቐንየልና	ек̣̄эныелына
ይሳቐ	йысак̣̄э
ይሳቐዩ	йысак̣̄эю
ይሳቐዩ’ለው	йысак̣̄эю’лэў
ይቀላቐል	йык̣элак̣̄эл
ይቐርቡ	йык̣̄эрыбу
ይቐርብ	йык̣̄эрыб
ይንቀሳቐሱ	йынык̣эсак̣̄эсу
ይንቀሳቐስ	йынык̣эсак̣̄эс
ጠቐምቲ	т̣эк̣̄эмыти
ጠቐነ	т̣эк̣̄энэ
ጠቐነን	т̣эк̣̄энэн
ጥንቃቐ	т̣ынык̣ак̣̄э
ጥንቓቐ	т̣ынык̣̄ак̣̄э
ጽባቐ	ц̣ыбак̣̄э
ጽባቐን	ц̣ыбак̣̄эн
ፈቐዶ	фэк̣̄эдо
ተረቚሑ	тэрэк̣̄ўих̣у
ረቛሒታት	рэк̣̄ўах̣итат
ቑልቛል	к̣̄улык̣̄ўал
ቛንቛ	к̣̄ўанык̣̄ўа
ቛንቛን	к̣̄ўанык̣̄ўан
ብምዕቛብ	бымыʹык̣̄ўаб
ብቛንቁኦም	бык̣̄ўанык̣у͵ом
ብቛንቛ	бык̣̄ўанык̣̄ўа
ተቛም	тэк̣̄ўам
ተቛሪጹ	тэк̣̄ўариц̣у
ሎምቕነ	ломык̣̄ынэ
ሕማቕ	х̣ымак̣̄
መመረቕታ	мэмэрэк̣̄ыта
መቕተልቲ	мэк̣̄ытэлыти
መቕተልትን	мэк̣̄ытэлытын
መቕጻዕቲ	мэк̣̄ыц̣аʹыти
መቕፃዕቲ	мэк̣̄ы`ц̣аʹыти
መቕፅዒ	мэк̣̄ы`ц̣ыʹи
መናድቕ	мэнадык̣̄
መንደቕ	мэныдэк̣̄
መንድቕ	мэныдык̣̄
መጠንቀቕታ	мэт̣энык̣эк̣̄ыта
መጠንቀቕታን	мэт̣энык̣эк̣̄ытан
መጠንቐቕታ	мэт̣энык̣̄эк̣̄ыта
መጠይቕ	мэт̣эйык̣̄
መጠይቕን	мэт̣эйык̣̄ын
መጥይቕ	мэт̣ыйык̣̄
መፋርቕ	мэфарык̣̄
ምልቃቕ	мылык̣ак̣̄
ምርቕቲ	мырык̣̄ыти
ምስራቕ	мысырак̣̄
ምቕላብ	мык̣̄ылаб
ምቕማጥ	мык̣̄ымат̣
ምቕራቡ	мык̣̄ырабу
ምቕራብ	мык̣̄ыраб
ምቕራብና	мык̣̄ырабына
ምቕራብን	мык̣̄ырабын
ምቕራቦም	мык̣̄ырабом
ምቕባል	мык̣̄ыбал
ምቕባልን	мык̣̄ыбалын
ምቕባሎም	мык̣̄ыбалом
ምቕታሉ	мык̣̄ыталу
ምቕታል	мык̣̄ытал
ምቕታልን	мык̣̄ыталын
ምቕታሎም	мык̣̄ыталом
ምቕታሎምን	мык̣̄ыталомын
ምቕናስ	мык̣̄ынас
ምቕናዩ	мык̣̄ынаю
ምቕያር	мык̣̄ыяр
ምቕያድ	мык̣̄ыяд
ምቕይያር	мык̣̄ыйыяр
ምቕጥቃጥ	мык̣̄ыт̣ык̣ат̣
ምቕጻሉ	мык̣̄ыц̣алу
ምቕፃሉ	мык̣̄ы`ц̣алу
ምብራቕ	мыбырак̣̄
ምብራቕን	мыбырак̣̄ын
ምውቕ	мыўык̣̄
ምውዳቕ	мыўыдак̣̄
ምዕልቕላቕ	мыʹылык̣̄ылак̣̄
ምዕጣቕ	мыʹыт̣ак̣̄
ምጥቕዑ	мыт̣ык̣̄ыʹу
ምጥንቃቕ	мыт̣ынык̣ак̣̄
ምጭፍላቕ	мыч̣ыфылак̣̄
ምጽቕቓጥ	мыц̣ык̣̄ык̣̄ат̣
ምጽዳቕ	мыц̣ыдак̣̄
ምፅቕቓጥ	мы`ц̣ык̣̄ык̣̄ат̣
ምፅዳቕን	мы`ц̣ыдак̣̄ын
ሞቕሽሽ	мок̣̄ышыш
ረቂቕ	рэк̣ик̣̄
ርሑቕ	рых̣ук̣̄
ርሑቕን	рых̣ук̣̄ын
ሰሜናዊምብራቕ	сэменаўимыбырак̣̄
ሰረቕቲ	сэрэк̣̄ыти
ስቕ	сык̣̄
ስቕለት	сык̣̄ылэт
ስቕያት	сык̣̄ыят
ስቕያትን	сык̣̄ыятын
ሸቕሊ	шэк̣̄ыли
ሹቕ	шук̣̄
ሻቕሎት	шак̣̄ылот
ሻቕሎትን	шак̣̄ылотын
ሽቓቕን	шык̣̄ак̣̄ын
ቃለመጠይቕ	к̣алэмэт̣эйык̣̄
ቕልስ	к̣̄ылыс
ቕልውላው	к̣̄ылыўылаў
ቕልጡፍ	к̣̄ылыт̣уф
ቕሙጥ	к̣̄ымут̣
ቕርሺ	к̣̄ырыши
ቕርበት	к̣̄ырыбэт
ቕርጺ	к̣̄ырыц̣и
ቕቡል	к̣̄ыбул
ቕተለት	к̣̄ытэлэт
ቕትለታዊ	к̣̄ытылэтаўи
ቕትለታዊያን	к̣̄ытылэтаўиян
ቕትለት	к̣̄ытылэт
ቕትለትን	к̣̄ытылэтын
ቕነ	к̣̄ынэ
ቕኑዕ	к̣̄ынуʹы
ቕንያት	к̣̄ыныят
ቕዳሴ	к̣̄ыдасе
ቕድመ	к̣̄ыдымэ
ቕድሚ	к̣̄ыдыми
ብሕማቕ	бых̣ымак̣̄
ብምስራቕ	бымысырак̣̄
ብምቕማጥ	бымык̣̄ымат̣
ብምቕራብ	бымык̣̄ыраб
ብምቕባል	бымык̣̄ыбал
ብምቕታል	бымык̣̄ытал
ብምቕዋም	бымык̣̄ыўам
ብምቕያር	бымык̣̄ыяр
ብምቕጻል	бымык̣̄ыц̣ал
ብምቕፃል	бымык̣̄ы`ц̣ал
ብምጥዋቕ	бымыт̣ыўак̣̄
ብስቕታ	бысык̣̄ыта
ብቕልጡ	бык̣̄ылыт̣у
ብቕልጡፍ	бык̣̄ылыт̣уф
ብቕንዕና	бык̣̄ыныʹына
ብቕዓት	бык̣̄ыʹат
ብቕዓትን	бык̣̄ыʹатын
ብቕዓቶም	бык̣̄ыʹатом
ብቕደም	бык̣̄ыдэм
ብቕድሚ	бык̣̄ыдыми
ብብቕዓት	быбык̣̄ыʹат
ብንቕሓት	бынык̣̄ых̣ат
ብወቕዒ	быўэк̣̄ыʹи
ብዓሚቕ	быʹамик̣̄
ብዘላቕነት	бызэлак̣̄ынэт
ብዘቕረቦ	бызэк̣̄ырэбо
ብዘንጸባርቕ	бызэныц̣эбарык̣̄
ብዘይምቕራቡ	бызэйымык̣̄ырабу
ብዝወቕዐ	бызыўэк̣̄ыʹэ
ብዝፈቕዶ	бызыфэк̣̄ыдо
ብድሙቕ	быдымук̣̄
ብጠቕላላ	быт̣эк̣̄ылала
ብጽቡቕ	быц̣ыбук̣̄
ብፅቡቕ	бы`ц̣ыбук̣̄
ብፍቕርን	быфык̣̄ырын
ተሓለቕቲ	тэх̣алэк̣̄ыти
ተመረቕቲ	тэмэрэк̣̄ыти
ተቕማጥን	тэк̣̄ымат̣ын
ተቕርብ	тэк̣̄ырыб
ተጣበቕቲ	тэт̣абэк̣̄ыти
ነቕርብ	нэк̣̄ырыб
ነጸብራቕ	нэц̣эбырак̣̄
ነፀብራቕ	нэ`ц̣эбырак̣̄
ኑቕጣ	нук̣̄ыт̣а
ኑቕጣታት	нук̣̄ыт̣атат
ናቕፋ	нак̣̄ыфа
ንመቐናቕንቶም	нымэк̣̄энак̣̄ынытом
ንምቕራብ	нымык̣̄ыраб
ንምቕራብን	нымык̣̄ырабын
ንምቕራፍ	нымык̣̄ыраф
ንምቕባል	нымык̣̄ыбал
ንምቕያር	нымык̣̄ыяр
ንምቕጻል	нымык̣̄ыц̣ал
ንምቕፃል	нымык̣̄ы`ц̣ал
ንምብራቕ	нымыбырак̣̄
ንምትዕራቕ	нымытыʹырак̣̄
ንምጭፍላቕ	нымыч̣ыфылак̣̄
ንቕሓት	нык̣̄ых̣ат
ንቕትለት	нык̣̄ытылэт
ንቕድሚት	нык̣̄ыдымит
ንኣጠቓቕማ	ныат̣эк̣̄ак̣̄ыма
ንከቕርቡ	ныкэк̣̄ырыбу
ንከቕርብ	ныкэк̣̄ырыб
ንከቕርቦም	ныкэк̣̄ырыбом
ንክቕየር	ныкык̣̄ыер
ንክቕፅል	ныкык̣̄ы`ц̣ыл
ንክቕፅልን	ныкык̣̄ы`ц̣ылын
ንክቕፅዑ	ныкык̣̄ы`ц̣ыʹу
ንኽቕፅል	нык̱ык̣̄ы`ц̣ыл
ንኽፀድቕ	нык̱ы`ц̣эдык̣̄
ንዘቕረበቶ	нызэк̣̄ырэбэто
ንዘቕረብዎ	нызэк̣̄ырэбыўо
ንዘቕረቦ	нызэк̣̄ырэбо
ንዘቕረቦም	нызэк̣̄ырэбом
ንዝቕጽሉ	нызык̣̄ыц̣ылу
ንዝቕጽላ	нызык̣̄ыц̣ыла
ንዝቕጽል	нызык̣̄ыц̣ыл
ንዝቕፅሉ	нызык̣̄ы`ц̣ылу
ንዝቕፅል	нызык̣̄ы`ц̣ыл
ንዝተጠቕዑ	нызытэт̣эк̣̄ыʹу
ንዝተጠቕዓ	нызытэт̣эк̣̄ыʹа
ንፅቡቕ	ны`ц̣ыбук̣̄
ኖቕጣታት	нок̣̄ыт̣атат
አደነቕቲ	эдэнэк̣̄ыти
ኢራቕ	ирак̣̄
ኢሳቕ	исак̣̄
ኣስተማቕሩ	асытэмак̣̄ыру
ኣቕሪበ	ак̣̄ырибэ
ኣቕሪበን	ак̣̄ырибэн
ኣቕሪቡ	ак̣̄ырибу
ኣቕሪቡ’ሎ	ак̣̄ырибу’ло
ኣቕሪባ	ак̣̄ыриба
ኣቕሪባቶ	ак̣̄ырибато
ኣቕሪብና	ак̣̄ырибына
ኣቕሪቦም	ак̣̄ырибом
ኣብዘቕረብዎ	абызэк̣̄ырэбыўо
ኣብዝቕፅሉ	абызык̣̄ы`ц̣ылу
ኣብዝቕፅል	абызык̣̄ы`ц̣ыл
ኣብዝተጠቕዑ	абызытэт̣эк̣̄ыʹу
ኣይንቕበልን	айынык̣̄ыбэлын
ኣይንቕበሎን	айынык̣̄ыбэлон
ኣጠቓቕማ	ат̣эк̣̄ак̣̄ыма
እናወቕዑ	ынаўэк̣̄ыʹу
ከምዘሻቕሎም	кэмызэшак̣̄ылом
ከምዘቕረበ	кэмызэк̣̄ырэбэ
ከምዘቕረቡ	кэмызэк̣̄ырэбу
ከምዘቕርቡ	кэмызэк̣̄ырыбу
ከምዘጥቕዑ	кэмызэт̣ык̣̄ыʹу
ከምዝቕመጥ	кэмызык̣̄ымэт̣
ከምዝቕጽሉ	кэмызык̣̄ыц̣ылу
ከምዝቕጽል	кэмызык̣̄ыц̣ыл
ከምዝቕፅሉ	кэмызык̣̄ы`ц̣ылу
ከምዝቕፅል	кэмызык̣̄ы`ц̣ыл
ከምዝቕፅልሉ	кэмызык̣̄ы`ц̣ылылу
ከምዝቕፅልሉን	кэмызык̣̄ы`ц̣ылылун
ከምዝቕፅልን	кэмызык̣̄ы`ц̣ылын
ከምዝተጠቕዑ	кэмызытэт̣эк̣̄ыʹу
ከምዝወድቕ	кэмызыўэдык̣̄
ከቕርቡ	кэк̣̄ырыбу
ከቕርብ	кэк̣̄ырыб
ከቕርብ’ዩ	кэк̣̄ырыб’ю
ከቕርቦ	кэк̣̄ырыбо
ከቕርቦም	кэк̣̄ырыбом
ከብቕዕ	кэбык̣̄ыʹы
ከዕጥቕ	кэʹыт̣ык̣̄
ከጠንቅቕ	кэт̣энык̣ык̣̄
ካብዝተጠቕዑ	кабызытэт̣эк̣̄ыʹу
ክርሕቕ	кырых̣ык̣̄
ክቕርቡ	кык̣̄ырыбу
ክቕበሉ	кык̣̄ыбэлу
ክቕበል	кык̣̄ыбэл
ክቕበልዎ	кык̣̄ыбэлыўо
ክቕበሎ	кык̣̄ыбэло
ክቕተሉ	кык̣̄ытэлу
ክቕንስ	кык̣̄ыныс
ክቕየር	кык̣̄ыер
ክቕየዱ	кык̣̄ыеду
ክቕይሩ	кык̣̄ыйыру
ክቕይር	кык̣̄ыйыр
ክቕጽሉ	кык̣̄ыц̣ылу
ክቕጽል	кык̣̄ыц̣ыл
ክቕጽል’ዩ	кык̣̄ыц̣ыл’ю
ክቕፅሉ	кык̣̄ы`ц̣ылу
ክቕፅላ	кык̣̄ы`ц̣ыла
ክቕፅል	кык̣̄ы`ц̣ыл
ክቕፅልሉ	кык̣̄ы`ц̣ылылу
ክቕፅልን	кык̣̄ы`ц̣ылын
ክተስተማቕሩ	кытэсытэмак̣̄ыру
ክተቕርብ	кытэк̣̄ырыб
ክትቕበል	кытык̣̄ыбэл
ክትቕፅል	кытык̣̄ы`ц̣ыл
ክነቕርብ	кынэк̣̄ырыб
ክንቕፅለሉ	кынык̣̄ы`ц̣ылэлу
ክንቕፅል	кынык̣̄ы`ц̣ыл
ክወድቕ	кыўэдык̣̄
ክፀድቕ	кы`ц̣эдык̣̄
ወረቓቕቲ	ўэрэк̣̄ак̣̄ыти
ውቕሮ	ўык̣̄ыро
ውዱቕ	ўыдук̣̄
ዑቕባ	ʹук̣̄ыба
ዑቕባሚካኤል	ʹук̣̄ыбамика͵иел
ዑቕባን	ʹук̣̄ыбан
ዒራቕ	ʹирак̣̄
ዒራቕን	ʹирак̣̄ын
ዓሙቕ	ʹамук̣̄
ዓሚቕ	ʹамик̣̄
ዓቕሊ	ʹак̣̄ыли
ዓቕመን	ʹак̣̄ымэн
ዓቕሙ	ʹак̣̄ыму
ዓቕሚ	ʹак̣̄ыми
ዓቕምታትን	ʹак̣̄ымытатын
ዓቕምና	ʹак̣̄ымына
ዓቕምን	ʹак̣̄ымын
ዓቕሞም	ʹак̣̄ымом
ዓብደረዛቕ	ʹабыдэрэзак̣̄
ዓብድረዛቕ	ʹабыдырэзак̣̄
ዓዘቕቲ	ʹазэк̣̄ыти
ዕጡቕ	ʹыт̣ук̣̄
ዘላቕን	зэлак̣̄ын
ዘሰቅቕ	зэсэк̣ык̣̄
ዘሻቕለና	зэшак̣̄ылэна
ዘሻቕል	зэшак̣̄ыл
ዘቕረበ	зэк̣̄ырэбэ
ዘቕረበት	зэк̣̄ырэбэт
ዘቕረበቶ	зэк̣̄ырэбэто
ዘቕረቡ	зэк̣̄ырэбу
ዘቕረቡዎ	зэк̣̄ырэбуўо
ዘቕረባ	зэк̣̄ырэба
ዘቕረብሉ	зэк̣̄ырэбылу
ዘቕረብናዮ	зэк̣̄ырэбынаё
ዘቕረብኦ	зэк̣̄ырэбы͵о
ዘቕረብዎ	зэк̣̄ырэбыўо
ዘቕረብዎም	зэк̣̄ырэбыўом
ዘቕረቦ	зэк̣̄ырэбо
ዘቕረቦም	зэк̣̄ырэбом
ዘቕርቡ	зэк̣̄ырыбу
ዘቕርቡዎም	зэк̣̄ырыбуўом
ዘቕርብ	зэк̣̄ырыб
ዘቕርብዎ	зэк̣̄ырыбыўо
ዘቕርቦ	зэк̣̄ырыбо
ዘቕርቦም	зэк̣̄ырыбом
ዘቕነዐ	зэк̣̄ынэʹэ
ዘቕንዐ	зэк̣̄ыныʹэ
ዘንጸባርቕ	зэныц̣эбарык̣̄
ዘንፀባርቕ	зэны`ц̣эбарык̣̄
ዘውድቕ	зэўыдык̣̄
ዘዕለቕለቖም	зэʹылэк̣̄ылэк̣̄ом
ዘይቕበሉ	зэйык̣̄ыбэлу
ዘይቕበል	зэйык̣̄ыбэл
ዘይቕደድን	зэйык̣̄ыдэдын
ዘደንቕ	зэдэнык̣̄
ዘጥቕዑ	зэт̣ык̣̄ыʹу
ዘጥቕዓ	зэт̣ык̣̄ыʹа
ዘጥቕዖም	зэт̣ык̣̄ыʹом
ዝሕለቕ	зых̣ылэк̣̄
ዝሕለቕን	зых̣ылэк̣̄ын
ዝቕል	зык̣̄ыл
ዝቕመጡ	зык̣̄ымэт̣у
ዝቕመጥ	зык̣̄ымэт̣
ዝቕበሉ	зык̣̄ыбэлу
ዝቕባበ	зык̣̄ыбабэ
ዝቕባበን	зык̣̄ыбабэн
ዝቕይር	зык̣̄ыйыр
ዝቕጽሉ	зык̣̄ыц̣ылу
ዝቕጽላ	зык̣̄ыц̣ыла
ዝቕጽል	зык̣̄ыц̣ыл
ዝቕፅሉ	зык̣̄ы`ц̣ылу
ዝቕፅላ	зык̣̄ы`ц̣ыла
ዝቕፅል	зык̣̄ы`ц̣ыл
ዝበቕዐ	зыбэк̣̄ыʹэ
ዝበቕዑ	зыбэк̣̄ыʹу
ዝተዋቕዐ	зытэўак̣̄ыʹэ
ዝተጠቕምሉ	зытэт̣эк̣̄ымылу
ዝተጠቕሰ	зытэт̣эк̣̄ысэ
ዝተጠቕሱ	зытэт̣эк̣̄ысу
ዝተጠቕዐ	зытэт̣эк̣̄ыʹэ
ዝተጠቕዑ	зытэт̣эк̣̄ыʹу
ዝተጠቕዓ	зытэт̣эк̣̄ыʹа
ዝተጠቕዓት	зытэт̣эк̣̄ыʹат
ዝተጥቕዑ	зытэт̣ык̣̄ыʹу
ዝነቕፉ	зынэк̣̄ыфу
ዝወቕዐ	зыўэк̣̄ыʹэ
ዝወድቕ	зыўэдык̣̄
ዝዘልቕ	зызэлык̣̄
ዝድነቕ	зыдынэк̣̄
ዝጠቕሙ	зыт̣эк̣̄ыму
ዝጣበቕ	зыт̣абэк̣̄
ዝፈቕዶ	зыфэк̣̄ыдо
የሻቕሎም	ешак̣̄ылом
የቕርበልኩም	ек̣̄ырыбэлыкум
የቕርቡ	ек̣̄ырыбу
የቕርብ	ек̣̄ырыб
የጠንቅቕ	ет̣энык̣ык̣̄
የጠንቕቁ	ет̣энык̣̄ык̣у
የጠንቕቅ	ет̣энык̣̄ык̣
የጠንቕቑ	ет̣энык̣̄ык̣̄у
የጠንቕቕ	ет̣энык̣̄ык̣̄
ይሕመቕ	йых̣ымэк̣̄
ይስሓቕ	йысых̣ак̣̄
ይቕረ	йык̣̄ырэ
ይቕረታ	йык̣̄ырэта
ይቕሬታ	йык̣̄ырета
ይቕተሉ	йык̣̄ытэлу
ይቕየር	йык̣̄ыер
ይቕጽሉ	йык̣̄ыц̣ылу
ይቕጽል	йык̣̄ыц̣ыл
ይቕጽል'ሎ	йык̣̄ыц̣ыл'ло
ይቕጽል’ሎ	йык̣̄ыц̣ыл’ло
ይቕፅል	йык̣̄ы`ц̣ыл
ይነቕፉ	йынэк̣̄ыфу
ይነቕፍዎ	йынэк̣̄ыфыўо
ይንጸባረቕ	йыныц̣эбарэк̣̄
ይጠቕሱ	йыт̣эк̣̄ысу
ይጠቕስ	йыт̣эк̣̄ыс
ይፀብቕ	йы`ц̣эбык̣̄
ደረቕ	дэрэк̣̄
ደቒቕ	дэк̣̄ик̣̄
ደቒቕን	дэк̣̄ик̣̄ын
ደቓይቕ	дэк̣̄айык̣̄
ድሙቕ	дымук̣̄
ገብረጻድቕ	гэбырэц̣адык̣̄
ገብረፃዲቕን	гэбырэ`ц̣адик̣̄ын
ጠቕላሊ	т̣эк̣̄ылали
ጠቕላላ	т̣эк̣̄ылала
ጠቕሚ	т̣эк̣̄ыми
ጠቕምታቱን	т̣эк̣̄ымытатун
ጠዊቕኩም	т̣эўик̣̄ыкум
ጠውቕ	т̣эўык̣̄
ጥቕሚ	т̣ык̣̄ыми
ጥቕምቲ	т̣ык̣̄ымыти
ጥቕኡ	т̣ык̣̄ы͵у
ጥቕኦም	т̣ык̣̄ы͵ом
ጥቕዓት	т̣ык̣̄ыʹат
ጥቡቕ	т̣ыбук̣̄
ጥብቕ	т̣ыбык̣̄
ጭቕጭቕ	ч̣ык̣̄ыч̣ык̣̄
ጸቕጢ	ц̣эк̣̄ыт̣и
ጽቕጥቅጥን	ц̣ык̣̄ыт̣ык̣ыт̣ын
ጽቡቕ	ц̣ыбук̣̄
ጽቡቕ’ዩ	ц̣ыбук̣̄’ю
ጽዑቕ	ц̣ыʹук̣̄
ፀቕጢ	`ц̣эк̣̄ыт̣и
ፅቡቕ	`ц̣ыбук̣̄
ፅቡቕን	`ц̣ыбук̣̄ын
ፅዑቕ	`ц̣ыʹук̣̄
ፍቕረዝጊ	фык̣̄ырэзыги
ፍቕሪ	фык̣̄ыри
ፍቕርን	фык̣̄ырын
ሃሊቖም	халик̣̄ом
ለቒቖም	лэк̣̄ик̣̄ом
ሕጂተቖጻጻሪ	х̣ыджитэк̣̄оц̣ац̣ари
መሪቖም	мэрик̣̄ом
መቖምያ	мэк̣̄омыя
መዕቖቢ	мэʹык̣̄оби
ሪሒቖም	рих̣ик̣̄ом
ርሒቖም	рых̣ик̣̄ом
ቖልዑ	к̣̄олыʹу
ቖሲሎም	к̣̄осилом
ቖፀሮ	к̣̄о`ц̣эро
ተመሪቖም	тэмэрик̣̄ом
ተቖማጢዑ	тэк̣̄омат̣иʹу
ተቖጢቦም	тэк̣̄от̣ибом
ተቖጻጺሮም	тэк̣̄оц̣ац̣иром
ተቖጻጻሪ	тэк̣̄оц̣ац̣ари
ተቖፂሩ’ሎ	тэк̣̄о`ц̣иру’ло
ተቖፃፂሩ	тэк̣̄о`ц̣а`ц̣иру
ተቖፃፂሮም	тэк̣̄о`ц̣а`ц̣иром
ተቖፃፂሮምዋ	тэк̣̄о`ц̣а`ц̣иромыўа
ተቖፃፂሮምዎ	тэк̣̄о`ц̣а`ц̣иромыўо
ተቖፃፃሪ	тэк̣̄о`ц̣а`ц̣ари
ንቖልዑት	нык̣̄олыʹут
ንዝቖሰሉ	нызык̣̄осэлу
ኣድናቖት	адынак̣̄от
ኣድናቖትን	адынак̣̄отын
ኣጠንቂቖም	ат̣энык̣ик̣̄ом
ኣፅዲቖም	а`ц̣ыдик̣̄ом
ከምዝቖሰሉ	кэмызык̣̄осэлу
ከምዝቖሰሉን	кэмызык̣̄осэлун
ወዲቖም	ўэдик̣̄ом
ዘዕለቕለቖም	зэʹылэк̣̄ылэк̣̄ом
ዘጽደቖ	зэц̣ыдэк̣̄о
ዘፅደቖ	зэ`ц̣ыдэк̣̄о
ዝሓቖፈ	зых̣ак̣̄офэ
ዝቖመ	зык̣̄омэ
ዝቖመት	зык̣̄омэт
ዝቖረፁ	зык̣̄орэ`ц̣у
ዝቖሰለ	зык̣̄осэлэ
ዝቖሰሉ	зык̣̄осэлу
ዝቖሰሉን	зык̣̄осэлун
ዝተሓቖፉ	зытэх̣ак̣̄офу
ዝተቖጥዑ	зытэк̣̄от̣ыʹу
ጠሊቖም	т̣элик̣̄ом
ፈቖዶ	фэк̣̄одо
ለቒቑ	лэк̣̄ик̣̄у
መቑሰልቲ	мэк̣̄усэлыти
መቑሰልትን	мэк̣̄усэлытын
ምቑራፅ	мык̣̄ура`ц̣
ምቑሳሎም	мык̣̄усалом
ምቑሳሎምን	мык̣̄усаломын
ሪሒቑ	рих̣ик̣̄у
ርሒቑ	рых̣ик̣̄у
ርቑሓት	рык̣̄ух̣ат
ስነቑጠባ	сынэк̣̄ут̣эба
ቑልቛል	к̣̄улык̣̄ўал
ቑሸት	к̣̄ушэт
ቑጠባ	к̣̄ут̣эба
ቑጥዐ	к̣̄ут̣ыʹэ
ቑጽሪ	к̣̄уц̣ыри
ቑፅሪ	к̣̄у`ц̣ыри
ብቑዓት	бык̣̄уʹат
ብቑዕ	бык̣̄уʹы
ብቑጠባ	бык̣̄ут̣эба
ተመሪቑ	тэмэрик̣̄у
ተረቑሑ	тэрэк̣̄ух̣у
ተረቑሖም	тэрэк̣̄ух̣ом
ተሰሪቑ	тэсэрик̣̄у
ተዓጢቑ	тэʹат̣ик̣̄у
ነቑጣታት	нэк̣̄ут̣атат
ንምቑፃር	нымык̣̄у`ц̣ар
ንዘቑፀረ	нызэк̣̄у`ц̣эрэ
አጽዲቑ	эц̣ыдик̣̄у
ኣቑሑ	ак̣̄ух̣у
ኣቑሑት	ак̣̄ух̣ут
ኣቑሑትን	ак̣̄ух̣утын
ኣቑሑቶም	ак̣̄ух̣утом
ኣቑሲሉ	ак̣̄усилу
ኣቑሲሎም	ак̣̄усилом
ኣቑጺሩ’ሎ	ак̣̄уц̣иру’ло
ኣቑፂሩ	ак̣̄у`ц̣иру
ኣጠንቂቑ	ат̣энык̣ик̣̄у
ኣጠንቂቑ’ሎ	ат̣энык̣ик̣̄у’ло
ኣጠንቒቑ	ат̣энык̣̄ик̣̄у
ኣጽዲቑ	ац̣ыдик̣̄у
ኣፅዲቑ	а`ц̣ыдик̣̄у
ኣፅዲቑ’ሎ	а`ц̣ыдик̣̄у’ло
ኣፅዲቑዎ	а`ц̣ыдик̣̄уўо
ከምዘቑሰሉ	кэмызэк̣̄усэлу
ከምዘቑፀረ	кэмызэк̣̄у`ц̣эрэ
ክርሕቑ	кырых̣ык̣̄у
ክቑጠቡ	кык̣̄ут̣эбу
ክቑጠቡን	кык̣̄ут̣эбун
ክቑጠባን	кык̣̄ут̣эбан
ክቑጠብ	кык̣̄ут̣эб
ወዲቑ	ўэдик̣̄у
ወዲቑ’ሎ	ўэдик̣̄у’ло
ዑቑባ	ʹук̣̄уба
ዑቑባሚካኤል	ʹук̣̄убамика͵иел
ዕቑር	ʹык̣̄ур
ዕቑባ	ʹык̣̄уба
ዘቑሰለን	зэк̣̄усэлэн
ዘቑጸረ	зэк̣̄уц̣эрэ
ዘቑፀረ	зэк̣̄у`ц̣эрэ
ዝሃለቑ	зыхалэк̣̄у
ዝሕለቑ	зых̣ылэк̣̄у
ዝቑጸሩ	зык̣̄уц̣эру
ዝቑጸራ	зык̣̄уц̣эра
ዝቑጸር	зык̣̄уц̣эр
ዝቑፀሩ	зык̣̄у`ц̣эру
ዝቑፀር	зык̣̄у`ц̣эр
ዝተለቐቑ	зытэлэк̣̄эк̣̄у
ዝተመረቑ	зытэмэрэк̣̄у
ዝተዓጠቑ	зытэʹат̣эк̣̄у
ዝተዓጥቑ	зытэʹат̣ык̣̄у
ዝወደቑ	зыўэдэк̣̄у
ዝዓጠቑ	зыʹат̣эк̣̄у
ዝጠለቑ	зыт̣элэк̣̄у
ዝጣበቑሎም	зыт̣абэк̣̄улом
የጠንቅቑ	ет̣энык̣ык̣̄у
የጠንቕቑ	ет̣энык̣̄ык̣̄у
ጠወቑ	т̣эўэк̣̄у
ጠዉቑ	т̣эўук̣̄у
ጠውቑ	т̣эўык̣̄у
ጥውቑ	т̣ыўык̣̄у
ጸዲቑ	ц̣эдик̣̄у
ፀዲቑ	`ц̣эдик̣̄у
ፍቑራት	фык̣̄урат
ሃሊቖም	халик̣̄ом
ለቒቖም	лэк̣̄ик̣̄ом
ሕጂተቖጻጻሪ	х̣ыджитэк̣̄оц̣ац̣ари
መሪቖም	мэрик̣̄ом
መቖምያ	мэк̣̄омыя
መዕቖቢ	мэʹык̣̄оби
ሪሒቖም	рих̣ик̣̄ом
ርሒቖም	рых̣ик̣̄ом
ቖልዑ	к̣̄олыʹу
ቖሲሎም	к̣̄осилом
ቖፀሮ	к̣̄о`ц̣эро
ተመሪቖም	тэмэрик̣̄ом
ተቖማጢዑ	тэк̣̄омат̣иʹу
ተቖጢቦም	тэк̣̄от̣ибом
ተቖጻጺሮም	тэк̣̄оц̣ац̣иром
ተቖጻጻሪ	тэк̣̄оц̣ац̣ари
ተቖፂሩ’ሎ	тэк̣̄о`ц̣иру’ло
ተቖፃፂሩ	тэк̣̄о`ц̣а`ц̣иру
ተቖፃፂሮም	тэк̣̄о`ц̣а`ц̣иром
ተቖፃፂሮምዋ	тэк̣̄о`ц̣а`ц̣иромыўа
ተቖፃፂሮምዎ	тэк̣̄о`ц̣а`ц̣иромыўо
ተቖፃፃሪ	тэк̣̄о`ц̣а`ц̣ари
ንቖልዑት	нык̣̄олыʹут
ንዝቖሰሉ	нызык̣̄осэлу
ኣድናቖት	адынак̣̄от
ኣድናቖትን	адынак̣̄отын
ኣጠንቂቖም	ат̣энык̣ик̣̄ом
ኣፅዲቖም	а`ц̣ыдик̣̄ом
ከምዝቖሰሉ	кэмызык̣̄осэлу
ከምዝቖሰሉን	кэмызык̣̄осэлун
ወዲቖም	ўэдик̣̄ом
ዘዕለቕለቖም	зэʹылэк̣̄ылэк̣̄ом
ዘጽደቖ	зэц̣ыдэк̣̄о
ዘፅደቖ	зэ`ц̣ыдэк̣̄о
ዝሓቖፈ	зых̣ак̣̄офэ
ዝቖመ	зык̣̄омэ
ዝቖመት	зык̣̄омэт
ዝቖረፁ	зык̣̄орэ`ц̣у
ዝቖሰለ	зык̣̄осэлэ
ዝቖሰሉ	зык̣̄осэлу
ዝቖሰሉን	зык̣̄осэлун
ዝተሓቖፉ	зытэх̣ак̣̄офу
ዝተቖጥዑ	зытэк̣̄от̣ыʹу
ጠሊቖም	т̣элик̣̄ом
ፈቖዶ	фэк̣̄одо
፩	`1
፪	`2
፫	`3
፬	`4
፭	`5
፮	`6
፯	`7
፰	`8
፱	`9
፲	`10
፳	`20
፴	`30
፵	`40
፶	`50
፷	`60
፸	`70
፹	`80
፺	`90
፻	`100
፼	`10000
