рдкреН	ЁСпЙ
рдЕ	ЁСпИ
рдмреН	ЁСпО
рдЪреН	ЁСпМ
рджреН	ЁСпА
рдП	ЁСпВ
рдлреН	ЁСпЩ
рдЧреН	ЁСпК
рд╣реН	ЁСпЛ
рдЗ	ЁСпГ
рдЬреН	ЁСпП
рдХреН	ЁСпЖ
рдореН	ЁСпЗ
рд▓реН	ЁСпР
рд╡реН	ЁСпУ
рдиреН	ЁСпН
рдУ	ЁСпС
рд░реН	ЁСпД
рд╕реН	ЁСпТ
рддреН	ЁСпБ
рдЙ	ЁСпЕ
рдЕреН	ЁСпа
рдпреН	ЁСпФ
рдЖ	ЁСпЦ
рдмреНрд╡реН	ЁСпХ
рдЫреН	ЁСпЭ
рдбреН	ЁСпЧ
рдЦреН	ЁСпЫ
ЁСпЪ	ЁСпЪ
рдереН	ЁСпШ
рдЯреН	ЁСпЮ
рд╢реН	ЁСпЬ
рдареН	ЁСпЯ
реР	ЁСпб
╠Г	╠Г
╠Н	╠Н
╠Б	╠Б
╠А	╠А
реж	ЁСп░
рез	ЁСп▒
реи	ЁСп▓
рей	ЁСп│
рек	ЁСп┤
рел	ЁСп╡
рем	ЁСп╢
рен	ЁСп╖
рео	ЁСп╕
реп	ЁСп╣
рдмрд╛рдЕреНрдЪрд╛	ЁСпОЁСпЦЁСпаЁСпМЁСпЦ
рджреБрдирд┐рдпрд╛рд▓рд╛рдИ	ЁСпАЁСпЕЁСпНЁСпГЁСпФЁСпЦЁСпРЁСпЦЁСпГ:
рдХреЗ	ЁСпЖЁСпВ
рднрдиреНрдиреЗ	ЁСпОЁСпЛЁСпИЁСпНЁСпНЁСпВ 
рдХрд╕реЛ	ЁСпЖЁСпИЁСпТЁСпС
рдЧрд░реНрдиреЗ	ЁСпКЁСпИЁСпДЁСпНЁСпВ
рдЬрд╕реНрддреЛ	ЁСпПЁСпИЁСпТЁСпБЁСпС
рдмрд╛рд░рд┐рдЬреЗрдореНрд▓рд╛ рд╕реНрд╡рд╛рдЧрдд	ЁСпОЁСпЦЁСпДЁСпГЁСпПЁСпВЁСпЗЁСпРЁСпЦ ЁСпТЁСпУЁСпЦЁСпКЁСпИЁСпБ
рдмреНрд▓рд┐рд╛рдГрдЪрд╛	ЁСпОЁСпРЁСпГЁСпЦ:ЁСпМЁСпЦ
рдмреНрд▓реЛрдЗрдБрдЪрд╛	ЁСпОЁСпРЁСпСЁСпГ╠ГЁСпМЁСпЦ