ababuj	آواووخ
abades	آواذیس
abadia	آواذیا
abadiano	آواذیانو
abadin	آواذین
abanades	آواناذیس
abanilla	آوانیلیا
abaran	آواران
abegondo	آویغوندو
abejar	آویخار
abejuela	آویخویلا
abengibra	آوینخیورا
abenojar	آوینوخار
abiego	آویغو
abla	آولا
ablitas	آولیتاس
abrera	آوریرا
abrucena	آوروثینا
acebo	آثیوو
acedera	آثیذیرا
acehuche	آثیاوچه
aceuchal	آثیوچال
acrijos	آکریخوس
adahuesca	آذااوسکا
adamuz	آذاموث
adanero	آذانیرو
aday	آذای
adeje	آذیخه
ademuz	آذیموث
ador	آذور
adra	آذرا
adradas	آذراذاس
adrados	آذراذوس
adzaneta	آذثانیتا
agaete	آغایته
ager	آخیر
agoncillo	آغونثیلیو
agost	آغوست
agramon	آغرامون
agramunt	آغرامونت
agreda	آغریذا
agres	آغریس
agron	آغرون
aguadulce	آغواذولثه
aguamansa	آغوامانسا
aguaron	آغوارون
aguas	آغواس
aguaviva	آغواویوا
agudo	آغوذو
agüera	آغویرا
agüero	آغویرو
aguila	آغیلا
aguilafuente	آغیلافوینته
aguilas	آغیلاس
agüimes	آغویمیس
agullana	آغولیانا
agulo	آغولو
ahigal	آایغال
ahillones	آایلیونیس
aianis	آیانیس
aibar	آیوار
aiguamurcia	آیغوامورثیا
ainsa	آینسا
aizpun	آیثپون
ajamil	آخامیل
alaejos	آلایخوس
alagon	آلاغون
alajar	آلاخار
alajero	آلاخیرو
alameda	آلامیذا
alamedilla	آلامیذیلیا
alamillo	آلامیلیو
alaminos	آلامینوس
alange	آلانخه
alarcon	آلارکون
alarilla	آلاریلیا
alaro	آلارو
alatoz	آلاتوث
alayor	آلایور
alba	آلوا
albacete	آلواثیته
albages	آلواخیس
albaladejo	آلوالاذیخو
albalatillo	آلوالاتیلیو
albana	آلوانا
albanchez	آلوانچیث
albares	آلواریس
albarracin	آلواراثین
albatana	آلواتانا
albatera	آلواتیرا
albendea	آلویندیا
albendin	آلویندین
albentosa	آلوینتوسا
alberique	آلویریکه
alberite	آلویریته
albesa	آلویسا
albinana	آلوینانا
albocacer	آلووکاثیر
alboloduy	آلوولوذوی
albolote	آلوولوته
albondon	آلووندون
alboraya	آلوورایا
alborea	آلووریا
albox	آلووکس
albudeite	آلووذییته
albujon	آلووخون
albuñol	آلوونول
albuñuelas	آلوونویلاس
alcadozo	آلکاذوثو
alcaine	آلکاینه
alcampel	آلکامپیل
alcanadre	آلکاناذره
alcanar	آلکانار
alcanices	آلکانیثیس
alcaniz	آلکانیث
alcantara	آلکانتارا
alcantarilla	آلکانتاریلیا
alcantud	آلکانتوذ
alcaracejos	آلکاراثیخوس
alcaraz	آلکاراث
alcarras	آلکاراس
alcaucin	آلکاوثین
alcaudete	آلکاوذیته
alcazaren	آلکاثارین
alceda	آلثیذا
alcira	آلثیرا
alcoba	آلکووا
alcobendas	آلکووینداس
alcocebre	آلکوثیوره
alcocer	آلکوثیر
alcohujate	آلکواوخاته
alcolea	آلکولیا
alcollarin	آلکولیارین
alconchel	آلکونچیل
alconera	آلکونیرا
alcontar	آلکونتار
alcora	آلکورا
alcorisa	آلکوریسا
alcoroches	آلکوروچیس
alcover	آلکوویر
alcoy	آلکوی
alcubierre	آلکوویره
alcubillas	آلکوویلیاس
alcublas	آلکوولاس
alcudia	آلکوذیا
alcuescar	آلکویسکار
alcuneza	آلکونیثا
aldaya	آلدایا
aldea	آلدیا
aldeacentenera	آلدیاثینتینیرا
aldealpozo	آلدیالپوثو
aldeaquemada	آلدیاکیماذا
aldearrodrigo	آلدیاروذریغو
aldeavieja	آلدیاویخا
aldehuela	آلدیاولا
aldeire	آلدییره
aldover	آلدوویر
aledo	آلیذو
alegria	آلیغریا
alerre	آلیره
aleson	آلیسون
alfacar	آلفاکار
alfaiz	آلفایث
alfajarin	آلفاخارین
alfambra	آلفامبرا
alfamen	آلفامین
alfara	آلفارا
alfaraz	آلفاراث
alfaro	آلفارو
alfarras	آلفاراس
alfoz	آلفوث
algaida	آلغایذا
algamitas	آلغامیتاس
algarinejo	آلغارینیخو
algarra	آلغارا
algarrobo	آلغاروو
algatocin	آلغاتوثین
algeciras	آلخیثیراس
algemesi	آلخیمیسی
algete	آلخیته
alginet	آلخینیت
algodonales	آلغوذونالیس
algora	آلغورا
algria	آلغریا
alguaire	آلغوایره
alguazas	آلغواثاس
algueña	آلغینا
alia	آلیا
aliaga	آلیاغا
alicante	آلیکانته
aliseda	آلیسیذا
aljaraque	آلخاراکه
aljibe	آلخیوه
aljorra	آلخورا
aljucen	آلخوثین
allariz	آلیاریث
allepuz	آلیپوث
aller	آلیر
alles	آلیس
allo	آلیو
alloza	آلیوثا
almacellas	آلماثیلیاس
almachar	آلماچار
almaciles	آلماثیلیس
almaden	آلماذین
almadenejos	آلماذینیخوس
almadrones	آلماذرونیس
almagro	آلماغرو
almajano	آلماخانو
almaluez	آلمالویث
almansa	آلمانسا
almanza	آلمانثا
almaraz	آلماراث
almatret	آلماتریت
almazan	آلماثان
almazora	آلماثورا
almazul	آلماثول
almedina	آلمیذینا
almedinilla	آلمیذینیلیا
almegijar	آلمیخیخار
almeida	آلمییذا
almenar	آلمینار
almenara	آلمینارا
almendra	آلمیندرا
almendral	آلمیندرال
almendralejo	آلمیندرالیخو
almendricos	آلمیندریکوس
almendros	آلمیندروس
almeria	آلمیریا
almogia	آلموخیا
almoguera	آلموغیرا
almohaja	آلموآخا
almoharin	آلموآرین
almonte	آلمونته
almoradi	آلموراذی
almorox	آلموروکس
almudebar	آلموذیوار
almuñécar	آلمونیکار
almuniente	آلمونینته
almuradiel	آلموراذیل
almusafes	آلموسافیس
alobras	آلووراس
alocen	آلوثین
alora	آلورا
alos	آلوس
alosno	آلوسنو
alovera	آلوویرا
alozaina	آلوثاینا
alp	آلپ
alpandeire	آلپاندییره
alpanseque	آلپانسیکه
alpedroches	آلپیذروچیس
alpeñés	آلپینیس
alpens	آلپینس
alpera	آلپیرا
alperiz	آلپیریث
alpuente	آلپوینته
alquezar	آلکیثار
alsasua	آلساسوا
altable	آلتاوله
altamira	آلتامیرا
altarejos	آلتاریخوس
altea	آلتیا
altorricon	آلتوریکون
altoteiro	آلتوتییرو
altura	آلتورا
alustante	آلوستانته
alvires	آلویریس
alzola	آلثولا
amaya	آمایا
amer	آمیر
ames	آمیس
ameyugo	آمییوغو
amezaga	آمیثاغا
amieva	آمیوا
amoeiro	آموییرو
amorebieta	آموریویتا
amposta	آمپوستا
ampudia	آمپوذیا
ampuero	آمپویرو
ampurias	آمپوریاس
amurrio	آموریو
amusco	آموسکو
aña	آنا
anchuras	آنچوراس
ancin	آنثین
andalucia	آندالوثیا
andavias	آنداویاس
andilla	آندیلیا
andoain	آندواین
andorra	آندورا
andosilla	آندوسیلیا
andraitx	آندرایچ
andujar	آندوخار
angles	آنگلیس
anglesola	آنگلیسولا
angüés	آنگویس
anguiano	آنگیانو
anguix	آنگیکس
aniñón	آنینون
anleo	آنلیو
añon	آنون
añora	آنورا
anso	آنسو
antas	آنتاس
antequera	آنتیکیرا
antigüedad	آنتیغویذاذ
antonaña	آنتونانا
anzanigo	آنثانیغو
anzuola	آنثوولا
anzur	آنثور
apatamonasterio	آپاتاموناستیریو
apellaniz	آپیلیانیث
aquilue	آکیلوه
aracena	آراثینا
arafo	آرافو
aragon	آراغون
aragoncillo	آراغونثیلیو
aranarache	آراناراچه
aranaz	آراناث
arandillo	آراندیلیو
aranjuez	آرانخویث
arano	آرانو
aranzazu	آرانثاثو
aranzuegue	آرانثویغه
arapiles	آراپیلیس
aras	آراس
aravaca	آراواکا
araya	آرایا
arbeca	آرویکا
arbo	آروو
arbos	آرووس
arceniega	آرثینیغا
archena	آرچینا
archilla	آرچیلیا
arcos	آرکوس
arcusa	آرکوسا
ardisa	آرذیسا
aren	آرین
arenas	آریناس
areo	آریو
ares	آریس
areta	آریتا
arevalillo	آریوالیلیو
arevalo	آریوالو
arganda	آرغاندا
arganza	آرغانثا
arguedas	آرغیذاس
arguellite	آرغیلیته
arguineguin	آرغینیغین
arguis	آرغیس
arija	آریخا
arinaga	آریناغا
ariñez	آرینیث
ariño	آرینو
arive	آریوه
ariza	آریثا
arizala	آریثالا
arjona	آرخونا
arjonilla	آرخونیلیا
arlanzon	آرلانثون
armuna	آرمونا
arnedillo	آرنیذیلیو
arnedo	آرنیذو
arnes	آرنیس
arnoya	آرنویا
arnuero	آرنویرو
aroche	آروچه
aroizu	آرویثو
arona	آرونا
arquillos	آرکیلیوس
arrabalde	آراوالده
arrancacepas	آرانکاثیپاس
arrazola	آراثولا
arrecife	آریثیفه
arredondo	آریذوندو
arriate	آریاته
arrieta	آریتا
arrigorriaga	آریغوریاغا
arriondas	آریونداس
arroba	آرووا
arroniz	آرونیث
arroyal	آرویال
arroyos	آرویوس
arta	آرتا
artajona	آرتاخونا
artana	آرتانا
artazu	آرتاثو
arteijo	آرتییخو
artenara	آرتینارا
artes	آرتیس
artieda	آرتیذا
arties	آرتیس
arucas	آروکاس
arure	آروره
arzúa	آرثوا
asco	آسکو
asin	آسین
asomadilla	آسوماذیلیا
ason	آسون
aspariegos	آسپاریغوس
aspe	آسپه
astillero	آستیلیرو
astudillo	آستوذیلیو
asturianos	آستوریانوس
asturias	آستوریاس
atalaya	آتالایا
atalayasa	آتالایاسا
ataquines	آتاکینیس
atarfe	آتارفه
atauta	آتاوتا
atea	آتیا
ateca	آتیکا
atienza	آتینثا
atocha	آتوچا
auñón	آونون
ausejo	آوسیخو
autol	آوتول
autoria	آوتوریا
aveinte	آویینته
avellanes	آویلیانیس
avila	آویلا
aviles	آویلیس
avinyo	آوینیو
avinyonet	آوینیونیت
avion	آویون
ayamonte	آیامونته
ayedo	آیذو
ayllon	آیلیون
ayna	آینا
ayora	آیورا
aytona	آیتونا
azagra	آثاغرا
azaila	آثایلا
azañón	آثانون
azanuy	آثانوی
azcoitia	آثکویتیا
aznalcazar	آثنالکاثار
aznalcollar	آثنالکولیار
azpeitia	آثپییتیا
azuaga	آثواغا
azuara	آثوارا
azuelo	آثویلو
babilafuente	باویلافوینته
bacares	باکاریس
badajoz	باذاخوث
badalona	باذالونا
badaran	باذاران
badenas	باذیناس
badolatosa	باذولاتوسا
badules	باذولیس
baena	باینا
baeza	بایثا
baga	باغا
baguena	باغینا
bagur	باغور
bahillo	باایلیو
bailen	بایلین
baillo	بایلیو
bajamar	باخامار
balaguer	بالاغیر
balazote	بالاثوته
balces	بالثیس
balconete	بالکونیته
baleira	بالییرا
balerma	بالیرما
balimbra	بالیمبرا
balira	بالیرا
ballerias	بالیریاس
ballestar	بالیستار
ballesteros	بالیستیروس
ballobar	بالیووار
balsareny	بالسارینی
balsicas	بالسیکاس
baltanas	بالتاناس
baltar	بالتار
bañares	باناریس
bande	بانده
bañeras	بانیراس
bañobarez	بانوواریث
bañolas	بانولاس
bañon	بانون
banyoles	بانیولیس
banyos	بانیوس
baracaldo	باراکالدو
barahona	بارااونا
barajas	باراخاس
baralla	بارالیا
barambio	بارامبیو
barasoain	باراسواین
barbadanes	بارواذانیس
barbadillo	بارواذیلیو
barbalimpia	باروالیمپیا
barbastro	بارواسترو
barca	بارکا
barcarrota	بارکاروتا
barcena	بارثینا
barcheta	بارچیتا
barcience	بارثینثه
barcones	بارکونیس
bareyo	بارییو
bargas	بارغاس
barjos	بارخوس
barqueros	بارکیروس
barracas	باراکاس
barrachina	باراچینا
barraco	باراکو
barrax	باراکس
barreiros	بارییروس
barriomartin	باریومارتین
barro	بارو
barruecopardo	بارویکوپارذو
barzana	بارثانا
basauri	باساوری
bascara	باسکارا
basella	باسیلیا
batea	باتیا
baterno	باتیرنو
bayo	بایو
bayona	بایونا
baza	باثا
beade	باذه
beariz	باریث
beas	باس
becarrea	بکاریا
beceite	بثییته
bechi	بچی
bedar	بذار
bedmar	بذمار
begijar	بخیخار
begonte	بغونته
beire	بیره
beires	بیریس
bejar	بخار
bejis	بخیس
belchite	بلچیته
belianes	بلیانیس
belinchón	بلینچون
bello	بلیو
belltall	بلیتالی
bellver	بلیویر
bellvey	بلیویی
bellvis	بلیویس
belmez	بلمیث
belmonte	بلمونته
belmontejo	بلمونتیخو
belorado	بلوراذو
belver	بلویر
bembibre	بمبیوره
benabarre	بناواره
benacazon	بناکاثون
benafigos	بنافیغوس
benagalbon	بناغالوون
benaguacil	بناغواثیل
benahadux	بناآذوکس
benahavis	بناآویس
benajarafa	بناخارافا
benalauria	بنالاوریا
benamaurel	بناماوریل
benameji	بنامیخی
benamocarra	بناموکارا
benaocaz	بناوکاث
benaojan	بناوخان
benarraba	بناراوا
benasal	بناسال
benasque	بناسکه
benatae	بناتاه
benavente	بناوینته
benavides	بناویذیس
benavites	بناویتیس
benegiles	بنیخیلیس
benejama	بنیخاما
benejuzar	بنیخوثار
benferri	بنفیری
beniarda	بنیارذا
beniarres	بنیاریس
benicasim	بنیکاسیم
benichembla	بنیچیمبلا
benifallet	بنیفالیت
benifallim	بنیفالیم
benifayo	بنیفایو
beniganim	بنیغانیم
benilloba	بنیلیووا
benimasot	بنیماسوت
beninar	بنینار
beniopa	بنیوپا
benisa	بنیسا
benisanet	بنیسانیت
beniseno	بنیسینو
benitachell	بنیتاچیلی
benizalon	بنیثالون
benuza	بنوثا
benzu	بنثو
beranga	برانگا
berantevilla	برانتیویلیا
bercedo	برثیذو
bercero	برثیرو
berducedo	برذوثیذو
berdun	برذون
berga	برغا
bergasa	برغاسا
bergondo	برغوندو
bergüenda	برغویندا
berja	برخا
berlanga	برلانگا
bermeo	برمیو
berriz	بریث
berrocal	بروکال
berzocana	برثوکانا
besalu	بسالو
besaya	بسایا
bescane	بسکانه
betancuria	بتانکوریا
betanzos	بتانثوس
betelu	بتیلو
betera	بتیرا
beteta	بتیتا
bezes	بثیس
biar	بیار
bibey	بیویی
biel	بیل
bielsa	بیلسا
bienvenida	بینبینیذا
biescas	بیسکاس
bigastro	بیغاسترو
biguezal	بیغیثال
bimeda	بیمیذا
bimenes	بیمینیس
binaced	بیناثیذ
binefar	بینیفار
binies	بینیس
binisalem	بینیسالیم
binue	بینوه
biosca	بیوسکا
biota	بیوتا
biscarrues	بیسکارویس
biurrun	بیورون
bizberri	بیثویری
blanca	بلانکا
blancas	بلانکاس
blancos	بلانکوس
blanes	بلانیس
blanquilla	بلانکیلیا
blazques	بلاثکیس
blecua	بلیکوا
blesa	بلیسا
boada	بواذا
boadilla	بواذیلیا
boal	بوال
bobadilla	بوواذیلیا
boboras	بووراس
bocairente	بوکایرینته
boceguillas	بوثیغیلیاس
bocigas	بوثیغاس
boecillo	بویثیلیو
bogarra	بوغارا
bogarre	بوغاره
bohoyo	بواویو
boimorto	بویمورتو
bojar	بوخار
bolaños	بولانوس
bolea	بولیا
boltaña	بولتانا
bonanza	بونانثا
boñar	بونار
bonares	بوناریس
boniches	بونیچیس
bonilla	بونیلیا
boqueijon	بوکییخون
bordon	بورذون
borines	بورینیس
borja	بورخا
bornoba	بورنووا
bornos	بورنوس
borobia	بوروویا
borox	بوروکس
borres	بوریس
borriol	بوریول
bosost	بوسوست
bot	بوت
botorrita	بوتوریتا
boveda	بوویذا
brabatas	براواتاس
brañosera	برانوسیرا
braojos	براوخوس
brea	بریا
breda	بریذا
brenes	برینیس
bretun	بریتون
brihuega	بریاوغا
briñas	بریناس
brion	بریون
briones	بریونیس
briviesca	بریویسکا
bronchales	برونچالیس
broto	بروتو
brozas	بروثاس
brunete	برونیته
brunola	برونولا
buciegas	بوثیغاس
budia	بوذیا
buena	بوینا
buenavista	بویناویستا
buendia	بویندیا
bueu	بویو
bufali	بوفالی
bugarra	بوغارا
buger	بوخیر
buitre	بویتره
bujalance	بوخالانثه
bujan	بوخان
bujaraloz	بوخارالوث
bullas	بولیاس
buñero	بونیرو
buniel	بونیل
buñol	بونول
buñola	بونولا
buñuel	بونویل
burbaguena	بورواغینا
bures	بوریس
burgo	بورغو
burgohondo	بورغواوندو
burgos	بورغوس
burguete	بورغیته
burgui	بورغی
burguillos	بورغیلیوس
buron	بورون
burriana	بوریانا
burujon	بوروخون
busot	بوسوت
busquistar	بوسکیستار
cabana	کاوانا
cabañaquinta	کاواناکینتا
cabañas	کاواناس
cabanes	کاوانیس
cabanillas	کاوانیلیاس
cabe	کاوه
cabezamesada	کاویثامیساذا
cabezarados	کاویثاراذوس
cabezo	کاویثو
cabolafuente	کاوولافوینته
cabra	کاورا
cabrales	کاورالیس
cabranes	کاورانیس
cabreiros	کاورییروس
cabrillanes	کاوریلیانیس
cabrillas	کاوریلیاس
cacabelos	کاکاویلوس
caceres	کاثیریس
cachilla	کاچیلیا
cachorrilla	کاچوریلیا
cacin	کاثین
cadagua	کاذاغوا
cadaques	کاذاکیس
cadavedo	کاذاویذو
cadi	کاذی
cadiar	کاذیار
cadreita	کاذرییتا
cadrete	کاذریته
cala	کالا
calaceite	کالاثییته
calaf	کالاف
calafell	کالافیلی
calahorra	کالااورا
calamocha	کالاموچا
calamonte	کالامونته
calañas	کالاناس
calanda	کالاندا
calasparra	کالاسپارا
calatanazor	کالاتاناثور
calatayud	کالاتایوذ
calatorao	کالاتوراو
calaveruela	کالاویرویلا
caldas	کالداس
calderina	کالدیرینا
caleruega	کالیرویغا
caleta	کالیتا
calicasas	کالیکاساس
calig	کالیغ
callejas	کالیخاس
calonge	کالونخه
calpe	کالپه
caltojar	کالتوخار
calvia	کالویا
calzadilla	کالثاذیلیا
camaleno	کامالینو
camallera	کامالیرا
camarao	کاماراو
camarasa	کاماراسا
camarena	کامارینا
camarillas	کاماریلیاس
camariñas	کاماریناس
camas	کاماس
cambados	کامباذوس
cambil	کامبیل
cambre	کامبره
cambrils	کامبریلس
caminomorisco	کامینوموریسکو
caminreal	کامینریال
campanario	کامپاناریو
campanet	کامپانیت
campanillas	کامپانیلیاس
campano	کامپانو
campaspero	کامپاسپیرو
campdevanol	کامپذیوانول
campello	کامپیلیو
campillo	کامپیلیو
campillos	کامپیلیوس
campisabalos	کامپیساوالوس
campomanes	کامپومانیس
camporredondo	کامپوریذوندو
camporrells	کامپوریلیس
camporrobles	کامپوروولیس
campos	کامپوس
campotejar	کامپوتیخار
camprodor	کامپروذور
camprovin	کامپرووین
camunas	کاموناس
cañada	کاناذا
cañadajuncosa	کاناذاخونکوسا
canales	کانالیس
canals	کانالس
cañamares	کاناماریس
cañamero	کانامیرو
cañar	کانار
cañaveral	کاناویرال
cañaveras	کاناویراس
cancarix	کانکاریکس
cancienes	کانثینیس
candas	کانداس
candasnos	کانداسنوس
candelaria	کاندیلاریا
candelario	کاندیلاریو
candeleda	کاندیلیذا
candilichera	کاندیلیچیرا
candin	کاندین
canedo	کانیذو
canena	کانینا
canero	کانیرو
canfranc	کانفرانک
cangas	کانگاس
caniles	کانیلیس
canillas	کانیلیاس
canizal	کانیثال
canizares	کانیثاریس
canizo	کانیثو
canjayar	کانخایار
cantalapiedra	کانتالاپیذرا
cantalejo	کانتالیخو
cantalojas	کانتالوخاس
cantalpino	کانتالپینو
cantareros	کانتاریروس
cantavieja	کانتاویخا
canteras	کانتیراس
cantillana	کانتیلیانا
cantoral	کانتورال
cantoria	کانتوریا
canyellas	کانیلیاس
caparroso	کاپاروسو
capdella	کاپذیلیا
capdepera	کاپذیپیرا
capellades	کاپیلیاذیس
capilduy	کاپیلدوی
capilla	کاپیلیا
carabaña	کاراوانا
carabanchel	کاراوانچیل
caracuel	کاراکویل
caralps	کارالپس
caravaca	کاراواکا
carbajo	کارواخو
carbia	کارویا
carcaboso	کارکاووسو
carcabuey	کارکاوویی
carcagente	کارکاخینته
carcar	کارکار
carcastillo	کارکاستیلیو
carcelen	کارثیلین
carchel	کارچیل
carchelejo	کارچیلیخو
cardejon	کارذیخون
cardona	کارذونا
carenas	کاریناس
cariñena	کارینینا
cariño	کارینو
carlet	کارلیت
carmena	کارمینا
carracedelo	کاراثیذیلو
carral	کارال
carranque	کارانکه
carranza	کارانثا
carrascalejo	کاراسکالیخو
carrascosa	کاراسکوسا
carratraca	کاراتراکا
carreña	کارینا
carril	کاریل
carrizal	کاریثال
carrizo	کاریثو
carrizosa	کاریثوسا
carrocera	کاروثیرا
carroo	کاروو
cartama	کارتاما
cartaya	کارتایا
cartelle	کارتیله
carucedo	کاروثیذو
casalarreina	کاسالاریینا
casar	کاسار
casarabonela	کاساراوونیلا
casarejos	کاساریخوس
casares	کاساریس
casariche	کاساریچه
casasimarro	کاساسیمارو
casatejada	کاساتیخاذا
casavieja	کاساویخا
cascante	کاسکانته
caseda	کاسیذا
caseras	کاسیراس
caserras	کاسیراس
casinos	کاسینوس
caso	کاسو
caspe	کاسپه
castala	کاستالا
castalla	کاستالیا
castanesa	کاستانیسا
castaño	کاستانو
castaras	کاستاراس
castejon	کاستیخون
castelflorite	کاستیلفلوریته
castellanos	کاستیلیانوس
castelldans	کاستیلیدانس
castelldefels	کاستیلیدیفیلس
castellote	کاستیلیوته
castells	کاستیلیس
castelltallat	کاستیلیتالیات
castellvell	کاستیلیویلی
castelseras	کاستیلسیراس
castelvispal	کاستیلویسپال
castielfabib	کاستیلفاویو
castildelgado	کاستیلدیلغاذو
castiliscar	کاستیلیسکار
castilla	کاستیلیا
castillejar	کاستیلیخار
castilmimbre	کاستیلمیمبره
castilnuevo	کاستیلنویوو
castralvo	کاسترالوو
castril	کاستریل
castrillon	کاستریلیون
castrocalion	کاستروکالیون
castrocontrigo	کاستروکونتریغو
castrodeza	کاستروذیثا
castrogeriz	کاستروخیریث
castrogonzalo	کاستروغونثالو
castromocho	کاستروموچو
castromonte	کاسترومونته
castromudarra	کاستروموذارا
castronuevo	کاسترونویوو
castronuño	کاسترونونو
castropodame	کاستروپوذامه
castropol	کاستروپول
castuera	کاستویرا
catadau	کاتاذاو
catarroja	کاتاروخا
cati	کاتی
catllal	کاتلیال
catoira	کاتویرا
catoute	کاتووته
catral	کاترال
caude	کاوذه
caudete	کاوذیته
caudiel	کاوذیل
caurel	کاوریل
cavezon	کاویثون
cayon	کایون
cazalegas	کاثالیغاس
cea	ثا
ceadea	ثاذیا
ceanuri	ثانوری
cebanico	ثوانیکو
cebolla	ثوولیا
cebollar	ثوولیار
cebollera	ثوولیرا
cebreros	ثوریروس
cebron	ثورون
ceclavin	ثکلاوین
cecos	ثکوس
cedeira	ثذییرا
cedillo	ثذیلیو
cedrillas	ثذریلیاس
cee	ثه
cehegin	ثایخین
ceinos	ثینوس
cejo	ثخو
celadas	ثلاذاس
celanova	ثلانووا
cella	ثلیا
celtiberia	ثلتیویریا
cenia	ثنیا
cenicero	ثنیثیرو
cenicientos	ثنیثینتوس
cenizate	ثنیثاته
cenlle	ثنله
centellas	ثنتیلیاس
centenillo	ثنتینیلیو
centro	ثنترو
cepeda	ثپیذا
cerceda	ثرثیذا
cercedilla	ثرثیذیلیا
cerda	ثرذا
cerdedo	ثرذیذو
cerdido	ثرذیذو
cerezo	ثریثو
cernegula	ثرنیغولا
cerollera	ثرولیرا
cerralbo	ثرالوو
cervera	ثرویرا
cespedossa	ثسپیذوسا
cestona	ثستونا
cesuras	ثسوراس
cetina	ثتینا
ceuti	ثوتی
chamartin	چامارتین
chamberi	چامبیری
chantada	چانتاذا
chapineria	چاپینیریا
charches	چارچیس
chauchina	چاوچینا
chavaler	چاوالیر
checa	چکا
cheles	چلیس
chella	چلیا
chelva	چلوا
chera	چرا
chercos	چرکوس
chert	چیرت
cherta	چرتا
cheste	چسته
chiclana	چیکلانا
chilches	چیلچیس
chilizarrias	چیلیثاریاس
chillon	چیلیون
chiloeches	چیلویچیس
chimerraes	چیمیرایس
chinchon	چینچون
chío	چیو
chipiona	چیپیونا
chiprana	چیپرانا
chirivel	چیریویل
chiva	چیوا
chodos	چوذوس
chovar	چووار
chueca	چویکا
chulilla	چولیلیا
chullo	چولیو
ciadoncha	ثیاذونچا
cibea	ثیویا
cidad	ثیذاذ
cidones	ثیذونیس
ciempozuelos	ثیمپوثویلوس
cieza	ثیثا
cifuentes	ثیفوینتیس
cigales	ثیغالیس
cigüenza	ثیغوینثا
cillamayor	ثیلیامایور
cillas	ثیلیاس
cilleros	ثیلیروس
cimballa	ثیمبالیا
cinctorres	ثینکتوریس
cintruenigo	ثینتروینیغو
cional	ثیونال
ciordia	ثیورذیا
ciperez	ثیپیریث
cirat	ثیرات
cirauqui	ثیراوکی
ciria	ثیریا
ciriza	ثیریثا
ciruelos	ثیرویلوس
cirugeda	ثیروخیذا
cisla	ثیسلا
cisneros	ثیسنیروس
cistierna	ثیستیرنا
ciudadela	ثیوذاذیلا
ciutadilla	ثیوتاذیلیا
clariana	کلاریانا
coaña	کوانا
cobatillas	کوواتیلیاس
cobdar	کووذار
cobeta	کوویتا
cobreros	کووریروس
coca	کوکا
cocentaina	کوثینتاینا
codeseda	کوذیسیذا
codos	کوذوس
cofete	کوفیته
cogollos	کوغولیوس
cogolludo	کوغولیوذو
coín	کوین
coiros	کویروس
coles	کولیس
colgadizos	کولغاذیثوس
colindres	کولیندریس
collados	کولیاذوس
collanzo	کولیانثو
colliga	کولیغا
colmenar	کولمینار
colmenarejo	کولمیناریخو
colomera	کولومیرا
colunga	کولونگا
comares	کوماریس
combarros	کومباروس
comillas	کومیلیاس
competa	کومپیتا
compostela	کومپوستیلا
concud	کونکوذ
conil	کونیل
conjo	کونخو
conques	کونکیس
conquista	کونکیستا
consuegra	کونسویغرا
contes	کونتیس
copons	کوپونس
corbaton	کورواتون
corbelle	کورویله
corbera	کورویرا
corchuela	کورچویلا
corconte	کورکونته
corcubion	کورکوویون
cordoba	کورذووا
cordova	کورذووا
cordovin	کورذووین
corella	کوریلیا
coreses	کوریسیس
corgo	کورغو
coria	کوریا
coripe	کوریپه
coristanco	کوریستانکو
corme	کورمه
cornago	کورناغو
corpa	کورپا
corralejo	کورالیخو
corrales	کورالیس
corredoiras	کوریذویراس
corrubedo	کوروویذو
cortegada	کورتیغاذا
cortegana	کورتیغانا
cortelazor	کورتیلاثور
cortes	کورتیس
corullon	کورولیون
corvera	کورویرا
cosa	کوسا
coscurita	کوسکوریتا
coslada	کوسلاذا
cospeito	کوسپییتو
costitx	کوستیچ
cosvenda	کوسویندا
cotiella	کوتیلیا
cotillas	کوتیلیاس
cotillo	کوتیلیو
cotobad	کوتوواذ
cousa	کووسا
covadonga	کوواذونگا
covarrubias	کوواروویاس
covas	کوواس
covelo	کوویلو
cox	کوکس
cozar	کوثار
creciente	کریثینته
cremenes	کریمینیس
crespos	کریسپوس
cretas	کریتاس
crevillente	کریویلینته
cripan	کریپان
cristobal	کریستووال
cruce	کروثه
cuadros	کواذروس
cualedro	کوالیذرو
cuatretonda	کواتریتوندا
cubells	کوویلیس
cubla	کوولا
cucutas	کوکوتاس
cudillero	کوذیلیرو
cuellar	کویلیار
cuenca	کوینکا
culla	کولیا
cullera	کولیرا
culleredo	کولیریذو
cuntis	کونتیس
curueña	کوروینا
daimiel	دایمیل
dalias	دالیاس
dancharinea	دانچارینیا
darnius	دارنیوس
daroca	داروکا
darrical	داریکال
darro	دارو
degaña	دغانا
deifontes	دیفونتیس
deleitosa	دلییتوسا
delicias	دلیثیاس
denia	دنیا
destriana	دستریانا
deusto	دوستو
deva	دوا
deya	دیا
deza	دثا
dicastillo	دیکاستیلیو
diezma	دیثما
dilar	دیلار
dima	دیما
diustes	دیوستیس
dobro	دوورو
dodro	دوذرو
dolar	دولار
dolores	دولوریس
domeno	دومینو
domingo	دومینگو
donado	دوناذو
dosbarrios	دوسواریوس
dozon	دوثون
driebes	دریویس
dueñas	دویناس
dumbria	دومبریا
durango	دورانگو
duraton	دوراتون
durcal	دورکال
ea	ایا
echalar	ایچالار
echalecu	ایچالیکو
echano	ایچانو
echarri	ایچاری
ecija	ایثیخا
egues	ایغیس
eibar	اییوار
ejulve	ایخولوه
elanchove	ایلانچووه
elche	ایلچه
elda	ایلدا
elgoibar	ایلغویوار
elizondo	ایلیثوندو
eljas	ایلخاس
elorrio	ایلوریو
embid	ایمبیذ
embun	ایمبون
empanadas	ایمپاناذاس
encinas	اینثیناس
encinasola	اینثیناسولا
encinedo	اینثینیذو
encinillas	اینثینیلیاس
enciso	اینثیسو
endrinal	ایندرینال
enfesta	اینفیستا
enguera	اینگیرا
enguidanos	اینگیذانوس
enix	اینیکس
entrena	اینترینا
entrimo	اینتریمو
enveija	اینبییخا
epila	ایپیلا
erice	ایریثه
erillas	ایریلیاس
eriste	ایریسته
erla	ایرلا
ermua	ایرموا
errazu	ایراثو
erro	ایرو
erustes	ایروستیس
escairon	ایسکایرون
escalada	ایسکالاذا
escalante	ایسکالانته
escalo	ایسکالو
escalona	ایسکالونا
escalonilla	ایسکالونیلیا
escamilla	ایسکامیلیا
escanuela	ایسکانویلا
escarroz	ایسکاروث
escatron	ایسکاترون
esclavitud	ایسکلاویتوذ
escombreas	ایسکومبریاس
escorca	ایسکورکا
escoriaza	ایسکوریاثا
escorihuela	ایسکوریاولا
escriche	ایسکریچه
escucha	ایسکوچا
escullar	ایسکولیار
escurial	ایسکوریال
escusa	ایسکوسا
escuzar	ایسکوثار
esfiliana	ایسفیلیانا
esgos	ایسغوس
espadan	ایسپاذان
espadaña	ایسپاذانا
espadañedo	ایسپاذانیذو
espadilla	ایسپاذیلیا
esparragalejo	ایسپاراغالیخو
esparraguera	ایسپاراغیرا
espasante	ایسپاسانته
espeja	ایسپیخا
espejo	ایسپیخو
espeluy	ایسپیلوی
espera	ایسپیرا
espes	ایسپیس
espiel	ایسپیل
espigüete	ایسپیغویته
espin	ایسپین
espina	ایسپینا
espinama	ایسپیناما
espinilla	ایسپینیلیا
espirdo	ایسپیرذو
esplegares	ایسپلیغاریس
esplugas	ایسپلوغاس
esplus	ایسپلوس
espolla	ایسپولیا
espot	ایسپوت
esquivias	ایسکیویاس
establiments	ایستاولیمینتس
estadilla	ایستاذیلیا
estallo	ایستالیو
estanyol	ایستانیول
esteban	ایستیوان
estella	ایستیلیا
estena	ایستینا
estepa	ایستیپا
estepar	ایستیپار
estepona	ایستیپونا
estivella	ایستیویلیا
estopiñan	ایستوپینان
estremera	ایستریمیرا
etreros	ایتریروس
eulate	ایولاته
extremadura	ایستریماذورا
ezcaray	ایثکارای
ezcurra	ایثکورا
fabara	فاوارا
fabero	فاویرو
facinas	فاثیناس
falces	فالثیس
falconera	فالکونیرا
falset	فالسیت
famorca	فامورکا
fañanas	فاناناس
fanlo	فانلو
farajan	فاراخان
farasdues	فاراسذویس
farena	فارینا
fariza	فاریثا
fatarella	فاتاریلیا
faura	فاورا
favareta	فاواریتا
fayon	فایون
febro	فورو
felanitx	فلانیچ
felechosa	فلیچوسا
felix	فلیکس
fene	فنه
feria	فریا
fermoselle	فرموسیله
fernancaballero	فرنانکاوالیرو
ferreira	فرییرا
ferrerias	فریریاس
ferreruela	فریرویلا
figols	فیغولس
figueras	فیغیراس
figueroles	فیغیرولیس
figuerosa	فیغیروسا
finana	فینانا
finestrat	فینیسترات
finisterre	فینیستیره
fiscal	فیسکال
fitero	فیتیرو
flassa	فلاسا
flix	فلیکس
fondon	فوندون
fonelas	فونیلاس
fonfria	فونفریا
fonollosa	فونولیوسا
fonsagrada	فونساغراذا
fontanar	فونتانار
fontanarejo	فونتاناریخو
fontanosas	فونتانوساس
fontao	فونتاو
fontellas	فونتیلیاس
fontioso	فونتیوسو
fontiveros	فونتیویروس
fontllonga	فونتلیونگا
fonz	فونث
forcarey	فورکاریی
foronda	فوروندا
forua	فوروا
foz	فوث
frades	فراذیس
fraga	فراغا
frailes	فرایلیس
francos	فرانکوس
frechilla	فریچیلیا
fredes	فریذیس
freginals	فریخینالس
freila	فرییلا
fresnedilla	فریسنیذیلیا
fresnedo	فریسنیذو
frias	فریاس
frigiliana	فریخیلیانا
friol	فریول
fromista	فرومیستا
frumales	فرومالیس
fuencaliente	فوینکالینته
fuencarral	فوینکارال
fuencemillan	فوینثیمیلیان
fuendejalon	فویندیخالون
fuendetodos	فویندیتوذوس
fuenferrada	فوینفیراذا
fuengirola	فوینخیرولا
fuenlabrada	فوینلاوراذا
fuenllana	فوینلیانا
fuenmayor	فوینمایور
fuensalida	فوینسالیذا
fuensanta	فوینسانتا
fuentealbilla	فوینتیالویلیا
fuenteboa	فوینتیووا
fuentecen	فوینتیثین
fuenteguinaldo	فوینتیغینالدو
fuenteheridos	فوینتیایریذوس
fuentelapeña	فوینتیلاپینا
fuentelcesped	فوینتیلثیسپیذ
fuentelmonje	فوینتیلمونخه
fuentelsaz	فوینتیلساث
fuentemilanos	فوینتیمیلانوس
fuentenovilla	فوینتینوویلیا
fuentepelayo	فوینتیپیلایو
fuentepinilla	فوینتیپینیلیا
fuenterrabia	فوینتیراویا
fuenterrebollo	فوینتیریوولیو
fuenterrobles	فوینتیروولیس
fuentes	فوینتیس
fuentesaúco	فوینتیساوکو
fuentescusa	فوینتیسکوسا
fuentesecas	فوینتیسیکاس
fuentespalda	فوینتیسپالدا
fuentespina	فوینتیسپینا
fuentidueña	فوینتیذوینا
funes	فونیس
furnas	فورناس
fustiñana	فوستینانا
gabaldon	گاوالدون
gabarret	گاواریت
gabasa	گاواسا
gador	گاذور
gajanejos	گاخانیخوس
gajates	گاخاتیس
galapagar	گالاپاغار
galapagos	گالاپاغوس
galar	گالار
galaroza	گالاروثا
galbarra	گالوارا
galdacano	گالداکانو
galdames	گالدامیس
galende	گالینده
galera	گالیرا
galicia	گالیثیا
galinduste	گالیندوسته
galisteo	گالیستیو
gallegos	گالیغوس
gallinal	گالینال
gallur	گالیور
galvez	گالویث
gamonal	گامونال
ganame	گانامه
gandesa	گاندیسا
gandia	گاندیا
ganuelas	گانویلاس
garaballa	گاراوالیا
garayoa	گارایوا
garcillan	گارثیلیان
gargaligas	گارغالیغاس
gargallo	گارغالیو
gargüera	گارغویرا
garinoain	گارینواین
garoiez	گارویث
garraf	گاراف
garralda	گارالدا
garray	گارای
garrigas	گاریغاس
garrovillas	گاروویلیاس
garrucha	گاروچا
gascueña	گاسکوینا
gata	گاتا
gatova	گاتووا
gaucin	گاوثین
gauna	گاونا
gava	گاوا
gavanes	گاوانیس
gelida	خلیذا
gelsa	خلسا
gelves	خلویس
genalguacil	خنالغواثیل
genave	خناوه
genevilla	خنیویلیا
gerena	خرینا
germade	خرماذه
gerona	خرونا
gerri	خری
gesera	خسیرا
geve	خوه
gibarroyo	خیوارویو
gijon	خیخون
gilena	خیلینا
gimenells	خیمینیلیس
gironella	خیرونیلیا
godall	گوذالی
godelleta	گوذیلیتا
goiriz	گویریث
goizueta	گویثویتا
golada	گولاذا
golpejas	گولپیخاس
gomara	گومارا
gomecello	گومیثیلیو
gomesende	گومیسینده
gondomar	گوندومار
gor	گور
gorafe	گورافه
gormaz	گورماث
gotarrendura	گوتاریندورا
gozon	گوثون
gradefes	گراذیفیس
grado	گراذو
grajera	گراخیرا
granada	گراناذا
granadella	گراناذیلیا
granadilla	گراناذیلیا
granatula	گراناتولا
grandes	گراندیس
grañén	گرانین
granollers	گرانولیرس
graus	گراوس
gravalos	گراوالوس
grazalema	گراثالیما
griegos	گریغوس
griñón	گرینون
grisen	گریسین
grove	گرووه
guadahortuna	گواذااورتونا
guadajoz	گواذاخوث
guadalajara	گواذالاخارا
guadalaviar	گواذالاویار
guadalcanal	گواذالکانال
guadalcazar	گواذالکاثار
guadalupe	گواذالوپه
guadamur	گواذامور
guadarrama	گواذاراما
guadarranque	گواذارانکه
guadasuar	گواذاسوار
guadix	گواذیکس
gualchos	گوالچوس
gualta	گوالتا
guardiola	گوارذیولا
guardo	گوارذو
guareña	گوارینا
guaro	گوارو
guarroman	گوارومان
gudar	گوذار
guecho	گچو
güeñes	گوینیس
güesa	گویسا
guetaria	گتاریا
guiana	گیانا
guijo	گیخو
guijuelo	گیخویلو
guillarey	گیلیاریی
guillena	گیلینا
guillerias	گیلیریاس
guimaray	گیمارای
guimera	گیمیرا
guisona	گیسونا
guitiriz	گیتیریث
gulina	گولینا
guntin	گونتین
guriezo	گوریثو
gurp	گورپ
hacinas	آثیناس
haro	آرو
hecho	ایچو
helechal	ایلیچال
helechosa	ایلیچوسا
hellin	ایلین
henarejos	ایناریخوس
henche	اینچه
herbes	ایرویس
herencia	ایرینثیا
hernani	ایرنانی
hernansancho	ایرنانسانچو
herramelluri	ایرامیلیوری
herrera	ایریرا
herreria	ایریریا
herrerias	ایریریاس
herreros	ایریروس
herreruela	ایریرویلا
hervas	ایرواس
higa	ایغا
higuera	ایغیرا
higueruela	ایغیرویلا
higueruelas	ایغیرویلاس
hijar	ایخار
hinodejo	اینوذیخو
hinojal	اینوخال
hinojales	اینوخالیس
hinojares	اینوخاریس
hinojos	اینوخوس
hinojosa	اینوخوسا
hinojosas	اینوخوساس
holguera	اولغیرا
hombrados	اومبراذوس
honrubia	اونروویا
hontalbilla	اونتالویلیا
hontanares	اونتاناریس
hontanaya	اونتانایا
hontecillos	اونتیثیلیوس
hontoba	اونتووا
horche	اورچه
hornos	اورنوس
hospitalet	اوسپیتالیت
hoyos	اویوس
hoyuelos	اویویلوس
huarte	اوارته
huelago	اولاغو
huelamo	اولامو
huelma	اولما
huelva	اولوا
huelves	اولویس
hueneja	اونیخا
huermeces	اورمیثیس
huerrios	اوریوس
huertahernando	اورتاایرناندو
huerteles	اورتیلیس
huerto	اورتو
huesa	اوسا
huesca	اوسکا
huescar	اوسکار
huete	اوته
humanes	اومانیس
humilladero	اومیلیاذیرو
husillos	اوسیلیوس
ibahernando	ایواایرناندو
ibdes	ایوذیس
ibi	ایوی
iborra	ایوورا
ibros	ایوروس
idocin	ایذوثین
iglesias	ایغلیسیاس
igualada	ایغوالاذا
igualeja	ایغوالیخا
igüeña	ایغوینا
ilche	ایلچه
ilerda	ایلیرذا
ilipa	ایلیپا
illana	ایلیانا
illano	ایلیانو
illas	ایلیاس
illescas	ایلیسکاس
illora	ایلیورا
illueca	ایلیویکا
imon	ایمون
incinillas	اینثینیلیاس
incio	اینثیو
infantes	اینفانتیس
infiesto	اینفیستو
iniesta	اینیستا
instincion	اینستینثیون
irijo	ایریخو
irijoa	ایریخوا
irueste	ایرویسته
irun	ایرون
irura	ایرورا
irurita	ایروریتا
irurozqui	ایروروثکی
isaba	ایساوا
iscar	ایسکار
isil	ایسیل
isona	ایسونا
isso	ایسو
istan	ایستان
isuerre	ایسویره
itrabo	ایتراوو
ituero	ایتویرو
izalzu	ایثالثو
izarra	ایثارا
iznájar	ایثناخار
iznalloz	ایثنالیوث
iznatoraf	ایثناتوراف
jabaga	خاواغا
jabalera	خاوالیرا
jabaloyas	خاوالویاس
jabalquinto	خاوالکینتو
jabarriega	خاواریغا
jabugo	خاووغو
jaca	خاکا
jadraque	خاذراکه
jaen	خاین
jalance	خالانثه
jalon	خالون
jaraba	خاراوا
jaraco	خاراکو
jarafuel	خارافویل
jaraicejo	خارایثیخو
jarandilla	خاراندیلیا
jaray	خارای
jarque	خارکه
jatar	خاتار
jatiel	خاتیل
jativa	خاتیوا
jaulin	خاولین
jaurrieta	خاوریتا
javea	خاویا
jayena	خاینا
jemenuño	خمینونو
jeresa	خریسا
jerica	خریکا
jerte	خرته
jimena	خیمینا
jirueque	خیرویکه
jodar	خوذار
jorairatar	خورایراتار
jorcas	خورکاس
jorquera	خورکیرا
jove	خووه
jubera	خوویرا
jubrique	خووریکه
judes	خوذیس
judio	خوذیو
jumilla	خومیلیا
juncajo	خونکاخو
juncosa	خونکوسا
juneda	خونیذا
labacolla	لاواکولیا
labajos	لاواخوس
laborcillas	لاوورثیلیاس
lacalahorra	لاکالااورا
lachar	لاچار
lacumbre	لاکومبره
lage	لاخه
laguarres	لاغواریس
laguarta	لاغوارتا
lagunaseca	لاغوناسیکا
lagunilla	لاغونیلیا
lalin	لالین
lama	لاما
lanaja	لاناخا
lancara	لانکارا
lanciego	لانثیغو
landete	لاندیته
lanestosa	لانیستوسا
langreo	لانگریو
languilla	لانگیلیا
lanjaron	لانخارون
lantadilla	لانتاذیلیا
lanteira	لانتییرا
lanz	لانث
lanza	لانثا
lapeza	لاپیثا
lardero	لارذیرو
laredo	لاریذو
laroco	لاروکو
laroles	لارولیس
larrainzar	لاراینثار
larraona	لاراونا
larrion	لاریون
lasarte	لاسارته
latina	لاتینا
latre	لاتره
lavadores	لاواذوریس
lavapiés	لاواپیس
layana	لایانا
layna	لاینا
layos	لایوس
laza	لاثا
leache	لاچه
lebrija	لوریخا
lecera	لثیرا
leciñena	لثینینا
lecumberri	لکومبیری
ledaña	لذانا
ledanca	لذانکا
ledesma	لذیسما
leganés	لغانیس
leganiel	لغانیل
leiro	لیرو
leitariegos	لیتاریغوس
leiza	لیثا
lemona	لمونا
lences	لنثیس
lepe	لپه
lequeitio	لکییتیو
lerga	لرغا
lerida	لریذا
lerin	لرین
lerma	لرما
les	لیس
lesaca	لساکا
letur	لتور
letux	لتوکس
leza	لثا
lezama	لثاما
lezuza	لثوثا
librilla	لیوریلیا
libros	لیوروس
lidon	لیذون
liédena	لیذینا
lietor	لیتور
lijar	لیخار
lillol	لیلیول
limpias	لیمپیاس
linares	لیناریس
liñola	لینولا
liria	لیریا
lizarraga	لیثاراغا
llado	لیاذو
llafranc	لیافرانک
llagostera	لیاغوستیرا
llanes	لیانیس
llansa	لیانسا
llauri	لیاوری
llera	لیرا
llerena	لیرینا
llers	لیرس
lles	لیس
llivia	لیویا
llobregales	لیووریغالیس
llodio	لیوذیو
llombay	لیومبای
lloseta	لیوسیتا
llovera	لیوویرا
llubi	لیووی
lluchmayor	لیوچمایور
loarre	لواره
lobatejo	لوواتیخو
lobera	لوویرا
lobon	لوون
lodosa	لوذوسا
loeches	لویچیس
logroño	لوغرونو
logrosan	لوغروسان
loja	لوخا
lombrana	لومبرانا
longares	لونگاریس
lopera	لوپیرا
lorca	لورکا
lorcha	لورچا
lorenzana	لورینثانا
lores	لوریس
lorqui	لورکی
losacino	لوساثینو
lousame	لووسامه
lovios	لوویوس
lozoya	لوثویا
lozoyuela	لوثویویلا
luanco	لوانکو
luarca	لوارکا
lubian	لوویان
lubrin	لوورین
lucar	لوکار
lucena	لوثینا
luceni	لوثینی
lucillo	لوثیلیو
ludiente	لوذینته
luelmo	لویلمو
luesia	لویسیا
luezas	لویثاس
lugan	لوغان
lugo	لوغو
lugones	لوغونیس
lugros	لوغروس
lujar	لوخار
lumbier	لومبیر
lumbrales	لومبرالیس
lumbreras	لومبریراس
lumpiaque	لومپیاکه
luna	لونا
luque	لوکه
luyego	لویغو
luzaga	لوثاغا
luzon	لوثون
macael	ماکایل
maceda	ماثیذا
machero	ماچیرو
macotera	ماکوتیرا
maderuelo	ماذیرویلو
madridejos	ماذریذیخوس
madrigalejo	ماذریغالیخو
madriguera	ماذریغیرا
madrigueras	ماذریغیراس
madrona	ماذرونا
madronera	ماذرونیرا
madroño	ماذرونو
maella	مایلیا
maello	مایلیو
maestre	مایستره
maestu	مایستو
magacela	ماغاثیلا
magallon	ماغالیون
magaña	ماغانا
magaz	ماغاث
magina	ماخینا
maguilla	ماغیلیا
mahide	ماایذه
mahon	مااون
mahora	مااورا
mainar	ماینار
majadas	ماخاذاس
majaelrayo	ماخایلرایو
mala	مالا
malagon	مالاغون
malaguilla	مالاغیلیا
malanquilla	مالانکیلیا
malcocinado	مالکوثیناذو
malgrat	مالغرات
mallen	مالین
malon	مالون
malpica	مالپیکا
maluenda	مالویندا
mampodre	مامپوذره
manacor	ماناکور
manchita	مانچیتا
mandayona	ماندایونا
mañeru	مانیرو
manilva	مانیلوا
manises	مانیسیس
manlleu	مانلیو
manresa	مانریسا
manresana	مانریسانا
mansilla	مانسیلیا
mantañes	مانتانیس
mantiel	مانتیل
manzanares	مانثاناریس
manzaneda	مانثانیذا
manzanedo	مانثانیذو
manzaneque	مانثانیکه
manzanera	مانثانیرا
maqueda	ماکیذا
maracena	ماراثینا
maranchon	مارانچون
marazoleja	ماراثولیخا
marbella	مارویلیا
marcilla	مارثیلیا
marganell	مارغانیلی
mariana	ماریانا
marin	مارین
marinaleda	مارینالیذا
marines	مارینیس
marmolejo	مارمولیخو
marron	مارون
marrube	مارووه
marrupe	ماروپه
martorell	مارتوریلی
martos	مارتوس
marugan	ماروغان
masa	ماسا
masalaves	ماسالاویس
masamagrell	ماساماغریلی
masanasa	ماساناسا
mascaraque	ماسکاراکه
masegoso	ماسیغوسو
maside	ماسیذه
masquefa	ماسکیفا
massanas	ماساناس
matabuena	ماتاووینا
matagalls	ماتاغالیس
matalebreras	ماتالیوریراس
matallana	ماتالیانا
matamorosa	ماتاموروسا
matanza	ماتانثا
matapozuelos	ماتاپوثویلوس
mataro	ماتارو
matarrubia	ماتاروویا
matedeon	ماتیذیون
matienzo	ماتینثو
matute	ماتوته
mausoleo	ماوسولیو
mayalde	مایالده
mayals	مایالس
mayorga	مایورغا
mazarete	ماثاریته
mazaricos	ماثاریکوس
mazarron	ماثارون
mazarulleque	ماثارولیکه
mazateron	ماثاتیرون
mazuecos	ماثویکوس
meano	مانو
meco	مکو
mediana	مذیانا
medina	مذینا
mediña	مذینا
medinaceli	مذیناثیلی
mediodia	مذیوذیا
mediona	مذیونا
meijaboy	میخاووی
meira	میرا
meis	میس
mejorada	مخوراذا
meliana	ملیانا
melida	ملیذا
mellid	ملیذ
melon	ملون
membrilla	ممبریلیا
membrillar	ممبریلیار
membrillera	ممبریلیرا
membrio	ممبریو
menasalbas	مناسالواس
mencal	منکال
mendavia	منداویا
mendigorria	مندیغوریا
meneses	منیسیس
mengabril	منگاوریل
mengibar	منخیوار
mentrida	منتریذا
mequinenza	مکینینثا
mera	مرا
merida	مریذا
mesia	مسیا
mesones	مسونیس
mestanza	مستانثا
miajadas	میاخاذاس
miedes	میذیس
mieras	میراس
mieres	میریس
mieza	میثا
miguelturra	میغیلتورا
mijares	میخاریس
mijas	میخاس
milagro	میلاغرو
millana	میلیانا
millares	میلیاریس
millena	میلینا
minana	مینانا
minateda	میناتیذا
minaya	مینایا
minglanilla	مینگلانیلیا
mingorria	مینگوریا
miño	مینو
mira	میرا
mirabel	میراویل
mirambel	میرامبیل
mirandilla	میراندیلیا
miravalles	میراوالیس
miravet	میراویت
miravete	میراویته
moaña	موانا
mocejon	موثیخون
mochales	موچالیس
moclin	موکلین
moeche	مویچه
mofrecho	موفریچو
mogente	موخینته
mogon	موغون
moguer	موغیر
mohedas	موایذاس
mohorte	مواورته
mojacar	موخاکار
mojados	موخاذوس
mojina	موخینا
mola	مولا
molaton	مولاتون
molinaseca	مولیناسیکا
molinicos	مولینیکوس
molinos	مولینوس
molledo	مولیذو
mollerusa	مولیروسا
mollet	مولیت
mollina	مولینا
mollo	مولیو
moluengo	مولوینگو
molvizar	مولویثار
mombeltran	مومبیلتران
mombuey	مومبویی
monachil	موناچیل
monbeltran	مونبیلتران
moncada	مونکاذا
moncalvo	مونکالوو
moncayo	مونکایو
moncloa	مونکلوا
moncofar	مونکوفار
monda	موندا
mondariz	مونداریث
mondejar	موندیخار
mondoñedo	موندونیذو
mondragon	موندراغون
monduber	موندوویر
monegrillo	مونیغریلیو
monesterio	مونیستیریو
moneva	مونیوا
monfero	مونفیرو
monflorite	مونفلوریته
mongo	مونگو
monistrol	مونیسترول
monleras	مونلیراس
monovar	مونووار
monreal	مونریال
monroy	مونروی
monroyo	مونرویو
monsagro	مونساغرو
monserrat	مونسیرات
montalban	مونتالوان
montalbanejo	مونتالوانیخو
montalbo	مونتالوو
montalbos	مونتالووس
montalvos	مونتالووس
montan	مونتان
montanchez	مونتانچیث
montanyola	مونتانیولا
montarto	مونتارتو
monteagudo	مونتیاغوذو
montearagon	مونتیاراغون
montederramo	مونتیذیرامو
montefrio	مونتیفریو
montejaque	مونتیخاکه
montejicar	مونتیخیکار
montellano	مونتیلیانو
montemolin	مونتیمولین
monterrey	مونتیریی
monterroso	مونتیروسو
monterrubio	مونتیروویو
montesa	مونتیسا
montesclaros	مونتیسکلاروس
montiel	مونتیل
montijo	مونتیخو
montilla	مونتیلیا
montillana	مونتیلیانا
montizon	مونتیثون
montmelo	مونتمیلو
monton	مونتون
montoro	مونتورو
montras	مونتراس
montroy	مونتروی
montuenga	مونتوینگا
montuiri	مونتویری
monturque	مونتورکه
monzon	مونثون
mora	مورا
moral	مورال
moraleja	مورالیخا
morales	مورالیس
moralina	مورالینا
moraña	مورانا
morante	مورانته
moratalla	موراتالیا
morcillo	مورثیلیو
moreda	موریذا
morell	موریلی
morella	موریلیا
morentin	مورینتین
mores	موریس
morey	موریی
moriles	موریلیس
morillejo	موریلیخو
morla	مورلا
moros	موروس
mos	موس
mosqueruela	موسکیرویلا
mostoles	موستولیس
motilla	موتیلیا
motilleja	موتیلیخا
motos	موتوس
motril	موتریل
moya	مویا
moyuela	مویویلا
mozoncillo	موثونثیلیو
muchamiel	موچامیل
mucientes	موثینتیس
muel	مویل
mugaire	موغایره
mugardos	موغارذوس
mugia	موخیا
mugica	موخیکا
muiños	موینوس
mula	مولا
muñana	مونانا
munebrega	مونیوریغا
munera	مونیرا
mungia	مونخیا
munico	مونیکو
muniesa	مونیسا
munilla	مونیلیا
muñogalindo	مونوغالیندو
muñogrande	مونوغرانده
muntadas	مونتاذاس
muras	موراس
murchante	مورچانته
murcia	مورثیا
murguia	مورغیا
muriel	موریل
muro	مورو
muros	موروس
murtas	مورتاس
murueta	مورویتا
nacimiento	ناثیمینتو
nagore	ناغوره
naharros	ناآروس
najera	ناخیرا
nambroca	نامبروکا
naquera	ناکیرا
narboneta	ناروونیتا
naron	نارون
nava	ناوا
navacerrada	ناواثیراذا
navachica	ناواچیکا
navaconcejo	ناواکونثیخو
navafria	ناوافریا
navahermosa	ناواایرموسا
navahondilla	ناوااوندیلیا
navajas	ناواخاس
naval	ناوال
navalacruz	ناوالاکروث
navalagamella	ناوالاغامیلیا
navalcaballo	ناوالکاوالیو
navalcan	ناوالکان
navaleno	ناوالینو
navalguijo	ناوالغیخو
navalilla	ناوالیلیا
navalmanzano	ناوالمانثانو
navalmoral	ناوالمورال
navalmoralejo	ناوالمورالیخو
navalonguilla	ناوالونگیلیا
navalosa	ناوالوسا
navalpino	ناوالپینو
navalsauz	ناوالساوث
navaluenga	ناوالوینگا
navardun	ناوارذون
navarres	ناواریس
navarrete	ناواریته
navas	ناواس
navasa	ناواسا
navascues	ناواسکویس
navasfrias	ناواسفریاس
navata	ناواتا
navelgas	ناویلغاس
naves	ناویس
navia	ناویا
nebreda	نوریذا
neda	نذا
negredo	نغریذو
negreira	نغرییرا
neila	نیلا
nerja	نرخا
nerpio	نرپیو
nerva	نروا
nestar	نستار
niebla	نیولا
nieves	نیویس
nigran	نیغران
niguelas	نیغیلاس
nijar	نیخار
noain	نواین
noalejo	نوالیخو
noblejas	نوولیخاس
noceda	نوثیذا
noez	نویث
nofuentes	نوفوینتیس
nogales	نوغالیس
nograles	نوغرالیس
noguera	نوغیرا
nogueruelas	نوغیرویلاس
nois	نویس
nolay	نولای
nombela	نومبیلا
nonaspe	نوناسپه
noreña	نورینا
novales	نووالیس
novallas	نووالیاس
novelda	نوویلدا
noves	نوویس
novillas	نوویلیاس
noya	نویا
nueno	نوینو
nueva	نویوا
nules	نولیس
nulles	نولیس
numancia	نومانثیا
nuñomoral	نونومورال
obon	اوون
ocaña	اوکانا
ocejon	اوثیخون
ocentejo	اوثینتیخو
ochagavia	اوچاغاویا
ochandiano	اوچاندیانو
oden	اوذین
odon	اوذون
ohanes	اوآنیس
oímbra	اویمبرا
ojen	اوخین
ojos	اوخوس
olalla	اولالیا
olave	اولاوه
olazagutia	اولاثاغوتیا
olba	اولوا
oleiros	اولییروس
oliana	اولیانا
olias	اولیاس
oliete	اولیته
oliola	اولیولا
olite	اولیته
oliva	اولیوا
olivares	اولیواریس
olivella	اولیویلیا
olivenza	اولیوینثا
olleria	اولیریا
ollo	اولیو
olmedillas	اولمیذیلیاس
olmedo	اولمیذو
olmillos	اولمیلیوس
olocau	اولوکاو
olombrada	اولومبراذا
olost	اولوست
olot	اولوت
olvan	اولوان
olvega	اولویغا
olvena	اولوینا
olvera	اولویرا
olza	اولثا
oña	اونا
oñate	اوناته
oncala	اونکالا
onda	اوندا
ondara	اوندارا
ondarroa	اونداروا
onis	اونیس
ontaneda	اونتانیذا
onteniente	اونتینینته
ontur	اونتور
onzonilla	اونثونیلیا
oquillas	اوکیلیاس
orbara	اوروارا
orce	اورثه
orcera	اورثیرا
orcheta	اورچیتا
orduña	اورذونا
orea	اوریا
orejo	اوریخو
orense	اورینسه
ores	اوریس
orgaña	اورغانا
orgaz	اورغاث
orgiva	اورخیوا
oria	اوریا
orihuela	اوریاولا
orio	اوریو
oris	اوریس
orista	اوریستا
orle	اورله
orol	اورول
oropesa	اوروپیسا
oroso	اوروسو
orozco	اوروثکو
orrios	اوریوس
orrius	اوریوس
orusco	اوروسکو
osera	اوسیرا
osor	اوسور
osorno	اوسورنو
ostiz	اوستیث
osuna	اوسونا
oteiza	اوتییثا
oteo	اوتیو
otero	اوتیرو
otivar	اوتیوار
otura	اوتورا
oural	اوورال
outes	اووتیس
ouviaño	اوویانو
ovejo	اوویخو
oviedo	اوویذو
oya	اویا
oyarzun	اویارثون
oyon	اویون
ozaeta	اوثایتا
padron	پاذرون
padul	پاذول
paguera	پاغیرا
pajares	پاخاریس
pajaron	پاخارون
pajaroncillo	پاخارونثیلیو
palafrugell	پالافروخیلی
palamos	پالاموس
palancas	پالانکاس
palanques	پالانکیس
palanquinos	پالانکینوس
palencia	پالینثیا
palenciana	پالینثیانا
palentino	پالینتینو
palenzuela	پالینثویلا
pallares	پالیاریس
pallars	پالیارس
palleja	پالیخا
pallerols	پالیرولس
palma	پالما
palo	پالو
palomas	پالوماس
palomeque	پالومیکه
palomera	پالومیرا
pals	پالس
pampliega	پامپلیغا
pamplona	پامپلونا
pancorbo	پانکوروو
pancrudo	پانکروذو
panes	پانیس
paniza	پانیثا
panticosa	پانتیکوسا
pantoja	پانتوخا
panton	پانتون
paones	پاونیس
papeles	پاپیلیس
paracuellos	پاراکویلیوس
paradas	پاراذاس
paradaseca	پاراذاسیکا
paradela	پاراذیلا
paramo	پارامو
parauta	پاراوتا
parcent	پارثینت
pardilla	پارذیلیا
paredes	پاریذیس
pareja	پاریخا
parets	پاریتس
parga	پارغا
parla	پارلا
parlaba	پارلاوا
parres	پاریس
parrillas	پاریلیاس
partaloa	پارتالوا
parzan	پارثان
pasajes	پاساخیس
pasaron	پاسارون
pastoriza	پاستوریثا
pastrana	پاسترانا
pauls	پاولس
pavias	پاویاس
paymogo	پایموغو
pechina	پچینا
pedralba	پذرالوا
pedralbes	پذرالویس
pedreguer	پذریغیر
pedrera	پذریرا
pedroche	پذروچه
pedrola	پذرولا
pedroso	پذروسو
pedrouzos	پذرووثوس
pegalajar	پغالاخار
pego	پغو
pelahustan	پلااوستان
peleagonzalo	پلیاغونثالو
pelegrina	پلیغرینا
peloche	پلوچه
peñacerrada	پناثیراذا
peñafiel	پنافیل
peñaflor	پنافلور
peñagolosa	پناغولوسا
penagos	پناغوس
peñalba	پنالوا
peñalen	پنالین
peñarrubia	پناروویا
peñascosa	پناسکوسا
peñausende	پناوسینده
peniscola	پنیسکولا
pepino	پپینو
peracense	پراثینسه
perafita	پرافیتا
peral	پرال
peralejos	پرالیخوس
peralta	پرالتا
peraltilla	پرالتیلیا
peralveche	پرالویچه
peramola	پرامولا
peranzanes	پرانثانیس
peratallada	پراتالیاذا
perdiguera	پرذیغیرا
perelada	پریلاذا
perello	پریلیو
pereña	پرینا
pereruela	پریرویلا
periana	پریانا
perorrubio	پروروویو
pertusa	پرتوسا
perves	پرویس
pesaguero	پساغیرو
pescueza	پسکویثا
pesquera	پسکیرا
pesues	پسویس
petin	پتین
pias	پیاس
picacho	پیکاچو
picasent	پیکاسینت
picon	پیکون
picorro	پیکورو
piedrabuena	پیذراووینا
piedrafita	پیذرافیتا
piedrahita	پیذراایتا
piera	پیرا
pilas	پیلاس
piloña	پیلونا
pina	پینا
pinar	پینار
pinarejo	پیناریخو
pinarejos	پیناریخوس
pineda	پینیذا
pinet	پینیت
pinillos	پینیلیوس
pinofranqueado	پینوفرانکیاذو
piñor	پینور
pinos	پینوس
pinoso	پینوسو
pintano	پینتانو
pipaon	پیپاون
piqueras	پیکیراس
pira	پیرا
pitillas	پیتیلیاس
pizarra	پیثارا
pizarral	پیثارال
plan	پلان
planes	پلانیس
plasencia	پلاسینثیا
plasenzuela	پلاسینثویلا
plencia	پلینثیا
pliego	پلیغو
plou	پلوو
pobes	پوویس
poblete	پوولیته
poboleda	پوولیذا
pol	پول
polanco	پولانکو
polenino	پولینینو
polentinos	پولینتینوس
polientes	پولینتیس
pollensa	پولینسا
pollos	پولیوس
polopos	پولوپوس
pomar	پومار
pomer	پومیر
ponferrada	پونفیراذا
ponga	پونگا
pons	پونس
pontevedra	پونتیویذرا
pontones	پونتونیس
pontons	پونتونس
ponzano	پونثانو
porcuna	پورکونا
porquera	پورکیرا
porrera	پوریرا
porreras	پوریراس
porriño	پورینو
porron	پورون
portaje	پورتاخه
porto	پورتو
porzuna	پورثونا
posada	پوساذا
posadas	پوساذاس
posadilla	پوساذیلیا
potes	پوتیس
povedilla	پوویذیلیا
poyales	پویالیس
poyatos	پویاتوس
poyo	پویو
poyos	پویوس
pozaldez	پوثالدیث
pozoantiguo	پوثوانتیغوو
pozohondo	پوثواوندو
pozondon	پوثوندون
pozorrubio	پوثوروویو
pozoseco	پوثوسیکو
pozuelo	پوثویلو
pradairo	پراذایرو
pradales	پراذالیس
pradejon	پراذیخون
pradena	پراذینا
prades	پراذیس
pradillo	پراذیلیو
prado	پراذو
pradoluengo	پراذولوینگو
pratdip	پراتذیپ
pravia	پراویا
preixens	پرییکسینس
prejano	پریخانو
priego	پریغو
prioro	پریورو
proaza	پرواثا
progalo	پروغالو
pruna	پرونا
puenteareas	پوینتیاریاس
puentedeume	پوینتیذیومه
puentenansa	پوینتینانسا
puenteviesgo	پوینتیویسغو
pueyo	پوییو
pujerra	پوخیرا
pulgar	پولغار
pulpi	پولپی
pungin	پونخین
purchena	پورچینا
purujosa	پوروخوسا
purullena	پورولینا
puzol	پوثول
quart	کوارت
quel	کیل
quemada	کماذا
quero	کرو
quesa	کسا
quesada	کساذا
quintanapalla	کینتاناپالیا
quintanavides	کینتاناویذیس
quintanilla	کینتانیلیا
quintela	کینتیلا
quinto	کینتو
quiroga	کیروغا
quiros	کیروس
quisicedo	کیسیثیذو
quismondo	کیسموندو
rabade	راواذه
rabanales	راوانالیس
rabasa	راواسا
rabo	راوو
radona	راذونا
rafales	رافالیس
ragama	راغاما
ragol	راغول
rajadell	راخاذیلی
ramacastañas	راماکاستاناس
ramallosa	رامالیوسا
rascafria	راسکافریا
rasines	راسینیس
raso	راسو
rasquera	راسکیرا
rasueros	راسویروس
reales	رالیس
rebalsadores	روالساذوریس
rebollera	روولیرا
rebollo	روولیو
recas	رکاس
redona	رذونا
redondela	رذوندیلا
regenjo	رخینخو
reillo	ریلیو
reina	رینا
reinosa	رینوسا
relleu	رلیو
rellinas	رلیناس
rena	رنا
renales	رنالیس
renedo	رنیذو
renera	رنیرا
rengos	رنگوس
renteria	رنتیریا
reocin	روثین
requejo	رکیخو
requena	رکینا
resoba	رسووا
respaldiza	رسپالدیثا
restiello	رستیلیو
retamal	رتامال
retamosa	رتاموسا
retiendas	رتینداس
reus	روس
revillarruz	رویلیاروث
revolcadores	روولکاذوریس
riahuelas	ریااولاس
rialp	ریالپ
rianjo	ریانخو
riaño	ریانو
riaza	ریاثا
ribadavia	ریواذاویا
ribadeo	ریواذیو
ribadesella	ریواذیسیلیا
ribadumia	ریواذومیا
ribaforada	ریوافوراذا
ribafrecha	ریوافریچا
ribarredonda	ریواریذوندا
ribatajada	ریواتاخاذا
ribesalbes	ریویسالویس
ribota	ریووتا
ricla	ریکلا
ricobayo	ریکووایو
ricote	ریکوته
riello	ریلیو
rielves	ریلویس
riglos	ریغلوس
rigoitia	ریغویتیا
rilla	ریلیا
riner	رینیر
rio	ریو
riobarba	ریوواروا
riocabado	ریوکاواذو
riocaldo	ریوکالدو
riodeva	ریوذیوا
riofrio	ریوفریو
riogordo	ریوغورذو
rioja	ریوخا
riolobos	ریولووس
riopar	ریوپار
rios	ریوس
riosa	ریوسا
riotorto	ریوتورتو
ripoll	ریپولی
ripollet	ریپولیت
risco	ریسکو
riudarenas	ریوذاریناس
riudaura	ریوذاورا
riudecanas	ریوذیکاناس
riudecols	ریوذیکولس
riudoms	ریوذومس
riveira	ریوییرا
rivero	ریویرو
roa	روا
roales	روالیس
robleda	روولیذا
robledo	روولیذو
robledollano	روولیذولیانو
robres	رووریس
rocallaura	روکالیاورا
rociana	روثیانا
rodana	روذانا
rodeiro	روذییرو
rodellar	روذیلیار
rodenas	روذیناس
rodiezmo	روذیثمو
rodoña	روذونا
rodos	روذوس
rois	رویس
rojales	روخالیس
rollan	رولیان
romanones	رومانونیس
roncal	رونکال
roncesvalles	رونثیسوالیس
ronda	روندا
roquetas	روکیتاس
rosal	روسال
rosas	روساس
rosell	روسیلی
rota	روتا
rotova	روتووا
royuela	رویویلا
ruanes	روانیس
rubena	رووینا
rubi	رووی
rubiales	روویالیس
rubian	روویان
rubiana	روویانا
rubio	روویو
rubite	روویته
rudilla	روذیلیا
rueda	رویذا
ruesta	رویستا
ruguilla	روغیلیا
ruidera	رویذیرا
rupia	روپیا
rus	روس
rute	روته
sabadell	ساواذیلی
sabero	ساویرو
sabiñánigo	ساوینانیغو
sabiote	ساویوته
sacañet	ساکانیت
sacedon	ساثیذون
sacedoncillo	ساثیذونثیلیو
saceruela	ساثیرویلا
sacramenia	ساکرامینیا
sada	ساذا
sadaba	ساذاوا
saelices	سایلیثیس
sagaro	ساغارو
sagides	ساخیذیس
sagra	ساغرا
sagunto	ساغونتو
sahagun	ساآغون
salada	سالاذا
salamanca	سالامانکا
salamon	سالامون
salar	سالار
salardu	سالارذو
salas	سالاس
salce	سالثه
salcedo	سالثیذو
saldaña	سالدانا
saldon	سالدون
salduero	سالدویرو
salinas	سالیناس
salinas	سالیناس
sallent	سالینت
salmeron	سالمیرون
salmoral	سالمورال
salobral	سالوورال
salobre	سالووره
salobrena	سالوورینا
salomo	سالومو
salorino	سالورینو
salou	سالوو
salsadella	سالساذیلیا
salt	سالت
salvacañete	سالواکانیته
salvatierra	سالواتیرا
samboal	سامبوال
samos	ساموس
sampedor	سامپیذور
samper	سامپیر
sanabria	ساناوریا
sanahuja	سانااوخا
sancedo	سانثیذو
sanchidrian	سانچیذریان
sanchonuño	سانچونونو
sandianes	ساندیانیس
sando	ساندو
sangenjo	سانخینخو
sangüesa	سانگویسا
sansol	سانسول
santacara	سانتاکارا
santaella	سانتایلیا
santany	سانتانی
santibañez	سانتیوانیث
santillana	سانتیلیانا
santiso	سانتیسو
santiuste	سانتیوسته
santiz	سانتیث
santolea	سانتولیا
santomera	سانتومیرا
santoña	سانتونا
santovenia	سانتووینیا
santucri	سانتوکری
santurce	سانتورثه
santurde	سانتورذه
sanzoles	سانثولیس
sapeira	ساپییرا
saragossa	ساراغوسا
sariego	ساریغو
sariñena	سارینینا
sarratella	ساراتیلیا
sarreal	ساریال
sarreaus	ساریاوس
sarria	ساریا
sarrion	ساریون
sarroca	ساروکا
sarvise	سارویسه
sasamon	ساسامون
sasdonigas	ساسذونیغاس
sastago	ساستاغو
sauca	ساوکا
saucedilla	ساوثیذیلیا
saucelle	ساوثیله
saviñan	ساوینان
saviñao	ساویناو
sax	ساکس
sayaton	سایاتون
sebulcor	سوولکور
secorun	سکورون
sedano	سذانو
sedella	سذیلیا
segorbe	سغوروه
segurilla	سغوریلیا
selaya	سلایا
selgua	سلغوا
sella	سلیا
sellano	سلیانو
selva	سلوا
semillas	سمیلیاس
sena	سنا
senes	سنیس
senmanat	سنمانات
senra	سنرا
senterada	سنتیراذا
sepulveda	سپولویذا
sequeros	سکیروس
serantes	سرانتیس
seriña	سرینا
seron	سرون
seros	سروس
serra	سرا
serrada	سراذا
serradero	سراذیرو
serradilla	سراذیلیا
serranillos	سرانیلیوس
serrateix	سراتییکس
serrejon	سریخون
sesa	سسا
seseña	سسینا
sesma	سسما
sestao	سستاو
sestrica	سستریکا
setcases	ستکاسیس
setenil	ستینیل
setiles	ستیلیس
seva	سوا
sevilla	سویلیا
seville	سویله
sierro	سیرو
sietamo	سیتامو
sigüenza	سیغوینثا
sigüés	سیغویس
siles	سیلیس
silla	سیلیا
silleda	سیلیذا
sils	سیلس
simancas	سیمانکاس
sineu	سینیو
sinlabajos	سینلاواخوس
sipan	سیپان
siruela	سیرویلا
sisamon	سیسامون
sisante	سیسانته
sober	سوویر
sobradillo	سووراذیلیو
sobrado	سووراذو
sobrelapeña	سووریلاپینا
sobrescobio	سووریسکوویو
socobos	سوکووس
socuellamos	سوکویلیاموس
sodupe	سوذوپه
solares	سولاریس
solera	سولیرا
solivella	سولیویلیا
sollana	سولیانا
soller	سولیر
solosancho	سولوسانچو
solsona	سولسونا
somio	سومیو
somolinos	سومولینوس
somontano	سومونتانو
somontin	سومونتین
somosierra	سوموسیرا
somozas	سوموثاس
soncillo	سونثیلیو
sondica	سوندیکا
soneja	سونیخا
sopeira	سوپییرا
sorbas	سورواس
soria	سوریا
sorihuela	سوریاولا
sorlada	سورلاذا
sorpe	سورپه
sorribes	سوریویس
sort	سورت
sorzano	سورثانو
soses	سوسیس
sotes	سوتیس
sotiello	سوتیلیو
sotodosos	سوتوذوسوس
sotomayor	سوتومایور
sotopalacios	سوتوپالاثیوس
sotos	سوتوس
sotoserrano	سوتوسیرانو
sotresgudo	سوتریسغوذو
sotuelamos	سوتویلاموس
suances	سوانثیس
subijana	سوویخانا
subirana	سوویرانا
sucina	سوثینا
sudanell	سوذانیلی
sueca	سویکا
sumbilla	سومبیلیا
suria	سوریا
tabara	تاوارا
taberno	تاویرنو
taboada	تاوواذا
taboadela	تاوواذیلا
tabuenca	تاووینکا
tafalla	تافالیا
tahal	تاآل
tahus	تااوس
tal	تال
talamantes	تالامانتیس
talarrubias	تالاروویاس
talavan	تالاوان
talayon	تالایون
talayuela	تالایویلا
talayuelas	تالایویلاس
talayuelo	تالایویلو
taliga	تالیغا
talladell	تالیاذیلی
tallante	تالیانته
tamajon	تاماخون
tamame	تامامه
tamames	تامامیس
tamariu	تاماریو
tambre	تامبره
tamurejo	تاموریخو
tapioles	تاپیولیس
taracena	تاراثینا
taradell	تاراذیلی
taramundi	تاراموندی
tarancon	تارانکون
taravilla	تاراویلیا
tarazona	تاراثونا
tarbena	تاروینا
tardajos	تارذاخوس
tardelcuende	تارذیلکوینده
tardienta	تارذینتا
tarifa	تاریفا
tarija	تاریخا
tarna	تارنا
tarragona	تاراغونا
tarrasa	تاراسا
tarrega	تاریغا
tarrio	تاریو
tarroja	تاروخا
tarros	تاروس
tauste	تاوسته
tavaruela	تاوارویلا
tazones	تاثونیس
teba	توا
tebar	توار
tejadillos	تخاذیلیوس
tejares	تخاریس
tejeiro	تخییرو
tejera	تخیرا
tembleque	تمبلیکه
tempul	تمپول
tendilla	تندیلیا
tenebron	تنیورون
teo	تو
termens	ترمینس
termino	ترمینو
terminon	ترمینون
terradas	تراذاس
terriente	ترینته
terrinches	ترینچیس
terroba	ترووا
teruel	ترویل
teulada	تولاذا
teverga	تویرغا
tiana	تیانا
tibi	تیوی
tibidabo	تیویذاوو
tiebas	تیواس
tiedra	تیذرا
tielve	تیلوه
tierga	تیرغا
tiermas	تیرماس
tierzo	تیرثو
tiesa	تیسا
tijola	تیخولا
tinajas	تیناخاس
tineo	تینیو
tiñosillos	تینوسیلیوس
tirgo	تیرغو
tirig	تیریغ
tirteafuera	تیرتیافویرا
titaguas	تیتاغواس
tiurana	تیورانا
tivenys	تیوینیس
tivisa	تیویسا
tobarra	تووارا
tobia	توویا
tocina	توثینا
todellego	توذیلیغو
todolella	توذولیلیا
toledo	تولیذو
tolocirio	تولوثیریو
tolosa	تولوسا
tolox	تولوکس
tolva	تولوا
tomelloso	تومیلیوسو
tomiño	تومینو
tona	تونا
topares	توپاریس
toques	توکیس
tor	تور
tora	تورا
toras	توراس
tordehumos	تورذیاوموس
tordera	تورذیرا
tordomar	تورذومار
tordoya	تورذویا
torello	توریلیو
toreno	تورینو
torija	توریخا
toril	توریل
torla	تورلا
tormon	تورمون
tornavacas	تورناواکاس
toro	تورو
torquemada	تورکیماذا
torralba	تورالوا
torreadrada	توریاذراذا
torrebeleña	توریویلینا
torrebeses	توریویسیس
torrecaballeros	توریکاوالیروس
torrecampo	توریکامپو
torrecilla	توریثیلیا
torredembarra	توریذیمبارا
torredonjimeno	توریذونخیمینو
torrefarrera	توریفاریرا
torregrosa	توریغروسا
torreiglesias	تورییغلیسیاس
torrejoncillo	توریخونثیلیو
torrelaguna	توریلاغونا
torrelapaja	توریلاپاخا
torrelavega	توریلاویغا
torrellano	توریلیانو
torrellas	توریلیاس
torrelobaton	توریلوواتون
torrelodones	توریلوذونیس
torremanzanas	توریمانثاناس
torremayor	توریمایور
torremegia	توریمیخیا
torremocha	توریموچا
torremolinos	توریمولینوس
torremontalbo	توریمونتالوو
torrente	تورینته
torrenueva	تورینویوا
torreorgaz	توریورغاث
torreperogil	توریپیروخیل
torrequebradilla	توریکیوراذیلیا
torrequemada	توریکیماذا
torres	توریس
torresandino	توریساندینو
torresmenudas	توریسمینوذاس
torrevelilla	توریویلیلیا
torrevieja	توریویخا
torrijas	توریخاس
torrijo	توریخو
torrijos	توریخوس
torronteras	تورونتیراس
torrox	توروکس
tortajada	تورتاخاذا
tortella	تورتیلیا
tortola	تورتولا
tortonda	تورتوندا
tortuera	تورتویرا
tortuero	تورتویرو
torviscon	تورویسکون
torviscoso	تورویسکوسو
tosas	توساس
totana	توتانا
totanes	توتانیس
touro	توورو
tous	تووس
trabada	تراواذا
trabadelo	تراواذیلو
trabanca	تراوانکا
trabazos	تراواثوس
tragacete	تراغاثیته
traiguera	ترایغیرا
tramacastilla	تراماکاستیلیا
trasierra	تراسیرا
traslavina	تراسلاوینا
trasmiras	تراسمیراس
trasobares	تراسوواریس
traspinedo	تراسپینیذو
trazo	تراثو
trebujena	تریووخینا
tredos	تریذوس
tremp	تریمپ
tresjuncos	تریسخونکوس
treto	تریتو
trevelez	تریویلیث
treviana	تریویانا
trevias	تریویاس
treviño	تریوینو
triacastela	تریاکاستیلا
trigueros	تریغیروس
trillo	تریلیو
triollo	تریولیو
triste	تریسته
troncedo	ترونثیذو
tronchon	ترونچون
trubia	تروویا
truchas	تروچاس
truchillas	تروچیلیاس
trujillanos	تروخیلیانوس
trujillo	تروخیلیو
trujillos	تروخیلیوس
tudanca	توذانکا
tudela	توذیلا
tuejar	تویخار
tulebras	تولیوراس
turcia	تورثیا
turegano	توریغانو
turis	توریس
turleque	تورلیکه
turon	تورون
turre	توره
turrillas	توریلیاس
turruncun	تورونکون
tuy	توی
ubeda	اوویذا
ubidea	اوویذیا
ubrique	اووریکه
uceda	اوثیذا
ucero	اوثیرو
udias	اوذیاس
ugijar	اوخیخار
ujo	اوخو
ujue	اوخوه
ulea	اولیا
ulldecona	اولیدیکونا
ulldemolins	اولیدیمولینس
umbrete	اومبریته
uña	اونا
uncastillo	اونکاستیلیو
unquera	اونکیرا
unzue	اونثوه
urbies	اورویس
urda	اورذا
urracal	اوراکال
urries	اوریس
urroz	اوروث
urueña	اوروینا
urueñas	اورویناس
usagre	اوساغره
used	اوسیذ
useras	اوسیراس
utebo	اوتیوو
utiel	اوتیل
utrera	اوتریرا
utrillas	اوتریلیاس
uztarroz	اوثتاروث
vadocondes	باذوکوندیس
vadollano	باذولیانو
valacloche	بالاکلوچه
valcavadillo	بالکاواذیلیو
valdaracete	بالداراثیته
valdarachas	بالداراچاس
valdeajos	بالدیاخوس
valdeavero	بالدیاویرو
valdeaveruelo	بالدیاویرویلو
valdecaballeros	بالدیکاوالیروس
valdecabras	بالدیکاوراس
valdecarros	بالدیکاروس
valdecebollas	بالدیثیوولیاس
valdecebro	بالدیثیورو
valdeconcha	بالدیکونچا
valdeconejos	بالدیکونیخوس
valdecuenca	بالدیکوینکا
valdedios	بالدیذیوس
valdefresno	بالدیفریسنو
valdefuentes	بالدیفوینتیس
valdegamas	بالدیغاماس
valdeganga	بالدیغانگا
valdegovia	بالدیغوویا
valdehijaderos	بالدیایخاذیروس
valdelagua	بالدیلاغوا
valdelaguna	بالدیلاغونا
valdelcubo	بالدیلکوو
valdelinares	بالدیلیناریس
valdelosa	بالدیلوسا
valdelugueros	بالدیلوغیروس
valdemaluque	بالدیمالوکه
valdemorillo	بالدیموریلیو
valdemoro	بالدیمورو
valdenoceda	بالدینوثیذا
valdenoches	بالدینوچیس
valdeobispo	بالدیوویسپو
valdeolivas	بالدیولیواس
valdeorras	بالدیوراس
valdepeñas	بالدیپیناس
valdepielago	بالدیپیلاغو
valdepolo	بالدیپولو
valdeprados	بالدیپراذوس
valderas	بالدیراس
valderrey	بالدیریی
valderrobres	بالدیرووریس
valdesamario	بالدیساماریو
valdesaz	بالدیساث
valdespina	بالدیسپینا
valdespino	بالدیسپینو
valdestillas	بالدیستیلیاس
valdeteja	بالدیتیخا
valdetorres	بالدیتوریس
valdevimbre	بالدیویمبره
valdezarza	بالدیثارثا
valdihuelo	بالدیاولو
valdilecha	بالدیلیچا
valdoviño	بالدووینو
valdunquillo	بالدونکیلیو
valencia	بالینثیا
valenzuela	بالینثویلا
valeria	بالیریا
valga	بالغا
valjunquera	بالخونکیرا
vallada	بالیاذا
valladolises	بالیاذولیسیس
vallanca	بالیانکا
vallbona	بالیوونا
valldemosa	بالیدیموسا
valle	باله
vallecas	بالیکاس
vallelado	بالیلاذو
vallfogona	بالیفوغونا
vallibona	بالیوونا
vallirana	بالیرانا
vallmoll	بالیمولی
vallromanas	بالیروماناس
valls	بالیس
valmala	بالمالا
valmaseda	بالماسیذا
valmojado	بالموخاذو
valnera	بالنیرا
valor	بالور
valronquillo	بالرونکیلیو
valseca	بالسیکا
valsequillo	بالسیکیلیو
valtajeros	بالتاخیروس
vandellos	باندیلیوس
vañes	بانیس
vascongadas	باسکونگاذاس
vecinos	بثینوس
vedra	بذرا
vegadeo	بغاذیو
vegamian	بغامیان
veganzones	بغانثونیس
vegapagar	بغاپاغار
vegaquemada	بغاکیماذا
vegarienza	بغارینثا
velada	بلاذا
velascalvaro	بلاسکالوارو
velefique	بلیفیکه
velilla	بلیلیا
vellisca	بلیسکا
vendrell	بندریلی
venialbo	بنیالوو
ventas	بنتاس
ventillas	بنتیلیاس
venturada	بنتوراذا
vera	برا
verdu	برذو
verea	بریا
veredas	بریذاس
vergara	برغارا
vergel	برخیل
verges	برخیس
verin	برین
vezdemarban	بثذیماروان
viacamp	بیاکامپ
viana	بیانا
vianos	بیانوس
viascon	بیاسکون
viator	بیاتور
vicalvaro	بیکالوارو
vicar	بیکار
vicien	بیثین
vicolozano	بیکولوثانو
vidangoz	بیذانگوث
vidiago	بیذیاغو
vidreras	بیذریراس
viella	بیلیا
viguera	بیغیرا
vilabella	بیلاویلیا
vilaboa	بیلاووا
vilada	بیلاذا
vilademat	بیلاذیمات
vilademuls	بیلاذیمولس
viladrau	بیلاذراو
vilagrasa	بیلاغراسا
vilaller	بیلالیر
vilanova	بیلانووا
vilaplana	بیلاپلانا
vilapouca	بیلاپووکا
vilarrodona	بیلاروذونا
vilaseca	بیلاسیکا
vilatan	بیلاتان
vilches	بیلچیس
villabona	بیلیاوونا
villacañas	بیلیاکاناس
villacarriedo	بیلیاکاریذو
villacarrillo	بیلیاکاریلیو
villacastin	بیلیاکاستین
villaconejos	بیلیاکونیخوس
villada	بیلیاذا
villadecanes	بیلیاذیکانیس
villadepera	بیلیاذیپیرا
villadiego	بیلیاذیغو
villaescusa	بیلیایسکوسا
villafames	بیلیافامیس
villaflores	بیلیافلوریس
villafranca	بیلیافرانکا
villafranqueza	بیلیافرانکیثا
villafrechos	بیلیافریچوس
villafruela	بیلیافرویلا
villagaton	بیلیاغاتون
villager	بیلیاخیر
villagonzalo	بیلیاغونثالو
villahermosa	بیلیاایرموسا
villahoz	بیلیااوث
villajoyosa	بیلیاخویوسا
villalba	بیلیالوا
villalengua	بیلیالینگوا
villalmanzo	بیلیالمانثو
villalonga	بیلیالونگا
villalpando	بیلیالپاندو
villalube	بیلیالووه
villaluenga	بیلیالوینگا
villalumbroso	بیلیالومبروسو
villalvaro	بیلیالوارو
villamalea	بیلیامالیا
villamalur	بیلیامالور
villamañan	بیلیامانان
villamandos	بیلیاماندوس
villamanrique	بیلیامانریکه
villamanta	بیلیامانتا
villamantilla	بیلیامانتیلیا
villamarin	بیلیامارین
villamartin	بیلیامارتین
villamayor	بیلیامایور
villamea	بیلیامیا
villamediana	بیلیامیذیانا
villamejil	بیلیامیخیل
villamesias	بیلیامیسیاس
villamizar	بیلیامیثار
villamol	بیلیامول
villamuelas	بیلیامویلاس
villanúa	بیلیانوا
villanubla	بیلیانوولا
villanueva	بیلیانویوا
villaobispo	بیلیاوویسپو
villapalacios	بیلیاپالاثیوس
villaquejida	بیلیاکیخیذا
villaquilambre	بیلیاکیلامبره
villaralbo	بیلیارالوو
villaralto	بیلیارالتو
villarejo	بیلیاریخو
villarente	بیلیارینته
villaricos	بیلیاریکوس
villarino	بیلیارینو
villarrabe	بیلیاراوه
villarramiel	بیلیارامیل
villarrasa	بیلیاراسا
villarreal	بیلیاریال
villarrobledo	بیلیاروولیذو
villarrodrigo	بیلیاروذریغو
villarroya	بیلیارویا
villarrubia	بیلیاروویا
villarrubio	بیلیاروویو
villasabariego	بیلیاساواریغو
villasandino	بیلیاساندینو
villasante	بیلیاسانته
villasarracino	بیلیاساراثینو
villasayas	بیلیاسایاس
villaseca	بیلیاسیکا
villaselan	بیلیاسیلان
villasilos	بیلیاسیلوس
villasrubias	بیلیاسروویاس
villastar	بیلیاستار
villatobas	بیلیاتوواس
villatoro	بیلیاتورو
villatoya	بیلیاتویا
villaturiel	بیلیاتوریل
villava	بیلیاوا
villavaquerin	بیلیاواکیرین
villavendimio	بیلیاویندیمیو
villaviciosa	بیلیاویثیوسا
villaviudas	بیلیاویوذاس
villayon	بیلیایون
villaza	بیلیاثا
villegas	بیلیغاس
villel	بیلیل
villena	بیلینا
villerias	بیلیریاس
villodrigo	بیلیوذریغو
villoldo	بیلیولدو
villora	بیلیورا
villores	بیلیوریس
villoria	بیلیوریا
vilvestre	بیلویستره
vimianzo	بیمیانثو
vinaceite	بیناثییته
vinaroz	بیناروث
vindel	بیندیل
vinebre	بینیوره
viñuela	بینویلا
viñuelas	بینویلاس
vinuesa	بینویسا
viruela	بیرویلا
visaurin	بیساورین
visiedo	بیسیذو
vitigudino	بیتیغوذینو
viver	بیویر
vivero	بیویرو
viveros	بیویروس
vizcaínos	بیثکاینوس
vizmanos	بیثمانوس
yanguas	یانگواس
yatova	یاتووا
yebes	یویس
yebra	یورا
yecla	یکلا
yegen	یخین
yela	یلا
yepes	یپیس
yerga	یرغا
yesa	یسا
yeste	یسته
yuncler	یونکلیر
yuncos	یونکوس
yunquera	یونکیرا
zafarraya	ثافارایا
zagra	ثاغرا
zahara	ثاآرا
zahinos	ثااینوس
zaidin	ثایذین
zalla	ثالیا
zamarramala	ثامارامالا
zamayon	ثامایون
zambra	ثامبرا
zambrana	ثامبرانا
zamora	ثامورا
zaorejas	ثاوریخاس
zaragoza	ثاراغوثا
zaratan	ثاراتان
zarauz	ثاراوث
zarra	ثارا
zarzalejo	ثارثالیخو
zas	ثاس
zizur	ثیثور
zorita	ثوریتا
zubia	ثوویا
zubieta	ثوویتا
zubiri	ثوویری
zucaina	ثوکاینا
zudaire	ثوذایره
zuera	ثویرا
zuheros	ثوایروس
zujar	ثوخار
zumarraga	ثوماراغا
zumaya	ثومایا
zuniga	ثونیغا
zurgena	ثورخینا
zurzarren	ثورثارین
