# Producing single letter transliterations, some with lengtheners
áº¡	ğ¤¢ğ¥ˆ
áº 	ğ¤€ğ¥ˆ
áº’áº’	ğ¤”ğ¥†ğ¥†
áº’	ğ¤”ğ¥Š
á¹­	ğ¤¼ğ¥ˆ
á¹¬á¹¬	ğ¤šğ¥‰
á¹¬	ğ¤šğ¥ˆ
á¹£	ğ¤§ğ¥ˆ
á¹¢á¹¢	ğ¤…ğ¥‰
á¹¢	ğ¤…ğ¥ˆ
á¸¥	ğ¤¸ğ¥ˆ
á¸¤á¸¤	ğ¤–ğ¥‰
á¸¤	ğ¤–ğ¥ˆ
á¸	ğ¤£ğ¥ˆ
á¸Œá¸Œ	ğ¤ğ¥‰
á¸Œ	ğ¤ğ¥ˆ
É—É—	ğ¤¯ğ¥†
Æ	ğ¤‡
ÆÆ	ğ¤‡ğ¥†
É“É“	ğ¤©ğ¥†
É“	ğ¤©
Æ´Æ´	ğ¤°ğ¥†
ÆÆ	ğ¤‰ğ¥…ğ¥Š
Æ	ğ¤‰ğ¥Š
ÆŠ	ğ¤
Æ†Æ†	ğ¤Œğ¥…ğ¥Š
Æ†	ğ¤Œğ¥Š
Å‹Å‹	ğ¤½ğ¥†
Å‹	ğ¤½
ÅŠÅ‹	ğ¤›ğ¥†
ÅŠ	ğ¤›
Ã±	ğ¤»
Ã‘	ğ¤™
zz	ğ¥ğ¥†
z	ğ¥
yy	ğ¤´ğ¥†
y	ğ¤´
ww	ğ¤±ğ¥†
vv	ğ¤¾ğ¥†
v	ğ¤¾
u	ğ¤µ
uu	ğ¤µğ¥…
tt	ğ¤¼ğ¥†
t	ğ¤¼
ssh	ğ¥ƒğ¥†
ss	ğ¤§ğ¥†
sh	ğ¥ƒ
s	ğ¤§
rr	ğ¤ªğ¥†
r	ğ¤ª
qq	ğ¤¹ğ¥†
q	ğ¤¹
pp	ğ¤¨ğ¥†
p	ğ¤¨
oo	ğ¤®ğ¥…
o	ğ¤®
nn	ğ¤²ğ¥†
N	ğ¤
n	ğ¤²
mm	ğ¤¥ğ¥†
m	ğ¤¥
ll	ğ¤¤ğ¥†
l	ğ¤¤
kp	ğ¥‚
kkp	ğ¥‚ğ¥†
kkh	ğ¤¿ğ¥†
kk	ğ¤³ğ¥†
kh	ğ¤¿
jj	ğ¤¶ğ¥†
hh	ğ¤¸ğ¥†
h	ğ¤¸
gÌ£	ğ¤ºğ¥ˆ
ggb	ğ¥€ğ¥†
gg	ğ¤ºğ¥†
gb	ğ¥€
g	ğ¤º
ff	ğ¤¬ğ¥†
e	ğ¤«
ee	ğ¤«ğ¥…
dd	ğ¤£ğ¥†
d	ğ¤£
cc	ğ¤­ğ¥†
c	ğ¤·
bb	ğ¤¦ğ¥†
b	ğ¤¦
aa	ğ¤¢ğ¥„
a	ğ¤¢
Zz	ğ¤Ÿğ¥†
Z	ğ¤Ÿ
Yy	ğ¤’ğ¥†
Y	ğ¤’
Ww	ğ¤ğ¥†
Vv	ğ¤œğ¥†
V	ğ¤œ
U	ğ¤“
Uu	ğ¤“ğ¥…
Tt	ğ¤šğ¥†
TTH	ğ¤…ğ¥ˆğ¥†
TH	ğ¤…ğ¥Š
T	ğ¤š
Ssh	ğ¤¡ğ¥†
Ss	ğ¤…ğ¥†
SH	ğ¤¡
S	ğ¤…
R	ğ¤ˆ
RR	ğ¤ªğ¥‡
Rr	ğ¤ˆğ¥‡
Qq	ğ¤—ğ¥†
Q	ğ¤—
Pp	ğ¤†ğ¥†
P	ğ¤†
Oo	ğ¤Œğ¥…
O	ğ¤Œ
# Doubled nasals
nnd	ğ¤²ğ¤£
NND	ğ¤ğ¤
mmb	ğ¤²ğ¤¦
MMB	ğ¤ğ¤„
nnj	ğ¤²ğ¤¶
NNJ	ğ¤ğ¤”
nng	ğ¤²ğ¤º
NNG	ğ¤ğ¤˜
# Nasalized in initial position - no nyondal
nj	ğ¤²ğ¤¶
Nj	ğ¤ğ¤¶
NJ	ğ¤ğ¤”
ng	ğ¤²ğ¤º
Ng	ğ¤ğ¤º
NG	ğ¤ğ¤˜
ND	ğ¤ğ¤
Nd	ğ¤ğ¤£
nd	ğ¤²ğ¤£
a nj	ğ¤¢ ğ¤²ğ¤¶
a Nj	ğ¤¢ ğ¤ğ¤¶
a NJ	ğ¤¢ ğ¤ğ¤”
a ng	ğ¤¢ ğ¤²ğ¤º
a Ng	ğ¤¢ ğ¤ğ¤º
a NG	ğ¤¢ ğ¤ğ¤˜
a ND	ğ¤¢ ğ¤ğ¤
a Nd	ğ¤¢ ğ¤ğ¤£
a nd	ğ¤¢ ğ¤²ğ¤£
MB	ğ¤ğ¤„
Mb	ğ¤ğ¤¦
mb	ğ¤²ğ¤¦
NN	ğ¤ğ¥†
Nn	ğ¤ğ¥†
Mmb	ğ¤ğ¤¦
Mm	ğ¤ƒğ¥†
# Non-initial positions with short vowel. Include nyondal in the nasalization
anj	ğ¤¢ğ¤²ğ¥‹ğ¤¶
aNj	ğ¤¢ğ¤ğ¥‹ğ¤¶
aNJ	ğ¤¢ğ¤ğ¥‹ğ¤”
ang	ğ¤¢ğ¤²ğ¥‹ğ¤º
aNg	ğ¤¢ğ¤ğ¥‹ğ¤º
aNG	ğ¤¢ğ¤ğ¥‹ğ¤˜
aND	ğ¤¢ğ¤ğ¥‹ğ¤
aNd	ğ¤¢ğ¤ğ¥‹ğ¤£
and	ğ¤¢ğ¤²ğ¥‹ğ¤£
aMB	ğ¤¢ğ¤ğ¥‹ğ¤„
aMb	ğ¤¢ğ¤ğ¥‹ğ¤¦
amb	ğ¤¢ğ¤²ğ¥‹ğ¤¦
AMB	ğ¤€ğ¤ğ¥‹ğ¤„
AND	ğ¤€ğ¤ğ¥‹ğ¤
ANG	ğ¤€ğ¤ğ¥‹ğ¤˜
ANJ	ğ¤€ğ¤ğ¥‹ğ¤”
# Tests for long vowel before nd, mb, nj, ng --> no nyondal
AAMB	ğ¤€ğ¥„ğ¤ğ¤„
AAND	ğ¤€ğ¥„ğ¤ğ¤
AANG	ğ¤€ğ¥„ğ¤ğ¤˜
AANJ	ğ¤€ğ¥„ğ¤ğ¤”
aamb	ğ¤¢ğ¥„ğ¤²ğ¤¦
aand	ğ¤¢ğ¥„ğ¤²ğ¤£
aang	ğ¤¢ğ¥„ğ¤²ğ¤º
aanj	ğ¤¢ğ¥„ğ¤²ğ¤¶
# Single and multi-letter conversions
M	ğ¤ƒ
Ll	ğ¤‚ğ¥†
L	ğ¤‚
Kkp	ğ¤ ğ¥†
Kkh	ğ¤ğ¥†
Kk	ğ¤‘ğ¥†
KP	ğ¤ 
KH	ğ¤
JÌ£	ğ¤”ğ¥ˆ
j	ğ¤¶
j	ğ¤¶
jj	ğ¤¶ğ¥†
Jj	ğ¤”ğ¥†
JJ	ğ¤”ğ¥†
J	ğ¤”
II	ğ¤‹ğ¥…
Ii	ğ¤‹ğ¥…
ii	ğ¤­ğ¥…
i	ğ¤­
I	ğ¤‹
Hh	ğ¤–ğ¥†
H	ğ¤–
GÌ£GÌ£	ğ¤˜ğ¥‰
GÌ£	ğ¤˜ğ¥ˆ
Ggb	ğ¤ğ¥†
Gg	ğ¤˜ğ¥†
GB	ğ¤
G	ğ¤˜
FF	ğ¤Šğ¥†
Ee	ğ¤‰ğ¥…
E	ğ¤‰
Dd	ğ¤ğ¥†
D	ğ¤
Cc	ğ¤‹ğ¥†
C	ğ¤•
BB	ğ¤„ğ¥†
Bb	ğ¤„ğ¥†
B	ğ¤„
AA	ğ¤€ğ¥„
A	ğ¤€
oâ€™o	ğ¤®ğ¤®
Oâ€™o	ğ¤Œğ¤®
Aâ€™A	ğ¤€ğ¤€
Aâ€™a	ğ¤€ğ¤¢
aâ€™a	ğ¤¢ğ¤¢
Ã‘Ã‘	ğ¤™ğ¥†
Ã‘Ã±	ğ¤™ğ¥†
Ã±Ã±	ğ¤»ğ¥†
áº“	ğ¤¶ğ¥Š
áº’áº“	ğ¤”ğ¥†ğ¥†
áº“áº“	ğ¤¶ğ¥†ğ¥†
ÆÉ›	ğ¤‰ğ¥…ğ¥Š
É›É›	ğ¤«ğ¥…ğ¥Š
É›	ğ¤«ğ¥Š
É”É”	ğ¤®ğ¥…ğ¥Š
É”	ğ¤®ğ¥Š
0	ğ¥
1	ğ¥‘
2	ğ¥’
3	ğ¥“
4	ğ¥”
5	ğ¥•
6	ğ¥–
7	ğ¥—
8	ğ¥˜
9	ğ¥™
Â¿	ğ¥Ÿ
?	ØŸ
Â¡	ğ¥

# Days of the week and months of the year
Altine	ğ¤€ğ¤¤ğ¤¼ğ¤­ğ¤²ğ¤«
Salasa	ğ¤…ğ¤¢ğ¤¤ğ¤¢ğ¤§ğ¤¢
Alarba	ğ¤€ğ¤¤ğ¤¢ğ¤ªğ¤¦ğ¤¢
Alamise	ğ¤€ğ¤¤ğ¤¢ğ¤¥ğ¤­ğ¤§ğ¤«
JumÉ“are	ğ¤”ğ¤µğ¤¥ğ¤©ğ¤¢ğ¤ªğ¤«
Asawe	ğ¤€ğ¤§ğ¤¢ğ¤±ğ¤«
Alat	ğ¤€ğ¤¤ğ¤¢ğ¤¼
Zaanviye	ğ¤Ÿğ¤¢ğ¥„ğ¤²ğ¤¾ğ¤­ğ¤´ğ¤«
Feviiriye	ğ¤Šğ¤«ğ¤¾ğ¤­ğ¥…ğ¤ªğ¤­ğ¤´ğ¤«
Maars	ğ¤ƒğ¤¢ğ¥„ğ¤ªğ¤§
Avirilaku	ğ¤€ğ¤¾ğ¤­ğ¤ªğ¤­ğ¤¤ğ¤¢ğ¤³ğ¤µ
Footi	ğ¤Šğ¤®ğ¥…ğ¤¼ğ¤­
Zweng	ğ¤Ÿğ¤±ğ¤«ğ¤²ğ¥‹ğ¤º
Zwiye	ğ¤Ÿğ¤±ğ¤­ğ¤´ğ¤«
Ut	ğ¤“ğ¤¼
Septamber	ğ¤…ğ¤«ğ¤¨ğ¤¼ğ¤¢ğ¤²ğ¥‹ğ¤¦ğ¤«ğ¤ª
Oktober	ğ¤Œğ¤³ğ¤¼ğ¤®ğ¤¦ğ¤«ğ¤ª
Novamber	ğ¤ğ¤®ğ¤¾ğ¤¢ğ¤²ğ¥‹ğ¤¦ğ¤«ğ¤ª
Desamber	ğ¤ğ¤«ğ¤§ğ¤¢ğ¤²ğ¥‹ğ¤¦ğ¤«ğ¤ª
# Some continents
Afrik	ğ¤€ğ¤¬ğ¤ªğ¤­ğ¤³
Asii	ğ¤€ğ¤§ğ¤­ğ¥…
Orop	ğ¤Œğ¤ªğ¤®ğ¤¨
Ostarali	ğ¤Œğ¤§ğ¤¼ğ¤¢ğ¤ªğ¤¢ğ¤¤ğ¤­
Antartik	ğ¤€ğ¤²ğ¤¼ğ¤¢ğ¤ªğ¤¼ğ¤­ğ¤³
Amerik FuÉ—naange	ğ¤€ğ¤¥ğ¤«ğ¤ªğ¤­ğ¤³ ğ¤Šğ¤µğ¤¯ğ¤²ğ¤¢ğ¥„ğ¤²ğ¤ºğ¤«
Amerik Worgo	ğ¤€ğ¤¥ğ¤«ğ¤ªğ¤­ğ¤³ ğ¤ğ¤®ğ¤ªğ¤ºğ¤®
# Transport
oto	ğ¤®ğ¤¼ğ¤®
baskur	ğ¤¦ğ¤¢ğ¤§ğ¤³ğ¤µğ¤ª
kamiyong	ğ¤³ğ¤¢ğ¤¥ğ¤­ğ¤´ğ¤®ğ¤²ğ¥‹ğ¤º
Taksi	ğ¤šğ¤¢ğ¤³ğ¤§ğ¤­
jirki	ğ¤¶ğ¤­ğ¤ªğ¤³ğ¤­
laana ndiwoowa	ğ¤¤ğ¤¢ğ¥„ğ¤²ğ¤¢ ğ¤²ğ¤£ğ¤­ğ¤±ğ¤®ğ¥…ğ¤±ğ¤¢
elikopteer	ğ¤«ğ¤¤ğ¤­ğ¤³ğ¤®ğ¤¨ğ¤¼ğ¤«ğ¥…ğ¤ª
neldugo	ğ¤²ğ¤«ğ¤¤ğ¤£ğ¤µğ¤ºğ¤®
kombeewal	ğ¤³ğ¤®ğ¤²ğ¥‹ğ¤¦ğ¤«ğ¥…ğ¤±ğ¤¢ğ¤¤
laana ndiwoowa	ğ¤¤ğ¤¢ğ¥„ğ¤²ğ¤¢ ğ¤²ğ¤£ğ¤­ğ¤±ğ¤®ğ¥…ğ¤±ğ¤¢
# Languages and terms about people and writing
Pulaar	ğ¤†ğ¤µğ¤¤ğ¤¢ğ¥„ğ¤ª
YimÉ“e FulÉ“e	ğ¤’ğ¤­ğ¤¥ğ¤©ğ¤« ğ¤Šğ¤µğ¤¤ğ¤©ğ¤«
Binndol Adlam	ğ¤„ğ¤­ğ¤²ğ¤£ğ¤®ğ¤¤ ğ¤€ğ¤£ğ¤¤ğ¤¢ğ¤¥
Binndi Arab	ğ¤„ğ¤­ğ¤²ğ¤£ğ¤­ ğ¤€ğ¤ªğ¤¢ğ¤¦
Binndol latin	ğ¤„ğ¤­ğ¤²ğ¤£ğ¤®ğ¤¤ ğ¤¤ğ¤¢ğ¤¼ğ¤­ğ¤²
Inglisia	ğ¤‹ğ¤²ğ¥‹ğ¤ºğ¤¤ğ¤­ğ¤§ğ¤­ğ¤¢
Farayse	ğ¤Šğ¤¢ğ¤ªğ¤¢ğ¤´ğ¤§ğ¤«
Arab	ğ¤€ğ¤ªğ¤¢ğ¤¦
Hawsa	ğ¤–ğ¤¢ğ¤±ğ¤§ğ¤¢
Espanis	ğ¤‰ğ¤§ğ¤¨ğ¤¢ğ¤²ğ¤­ğ¤§
ÆŠemngal Mende	ğ¤ğ¤«ğ¤¥ğ¤²ğ¤ºğ¤¢ğ¤¤ ğ¤ƒğ¤«ğ¤²ğ¥‹ğ¤£ğ¤«
Sinuwaa en	ğ¤…ğ¤­ğ¤²ğ¤µğ¤±ğ¤¢ğ¥„ ğ¤«ğ¤²
Hindi	ğ¤–ğ¤­ğ¤²ğ¥‹ğ¤£ğ¤­
Suwahili	ğ¤…ğ¤µğ¤±ğ¤¢ğ¤¸ğ¤­ğ¤¤ğ¤­
# Geographic features
Geec Atlantik	ğ¤˜ğ¤«ğ¥…ğ¤· ğ¤€ğ¤¼ğ¤¤ğ¤¢ğ¤²ğ¤¼ğ¤­ğ¤³
Geec Indiya	ğ¤˜ğ¤«ğ¥…ğ¤· ğ¤‹ğ¤²ğ¥‹ğ¤£ğ¤­ğ¤´ğ¤¢
Geec Arktik	ğ¤˜ğ¤«ğ¥…ğ¤· ğ¤€ğ¤ªğ¤³ğ¤¼ğ¤­ğ¤³
Geec Pasifik	ğ¤˜ğ¤«ğ¥…ğ¤· ğ¤†ğ¤¢ğ¤§ğ¤­ğ¤¬ğ¤­ğ¤³
Lake Caad	ğ¤‚ğ¤¢ğ¤³ğ¤« ğ¤•ğ¤¢ğ¥„ğ¤£
Maayo Konngo	ğ¤ƒğ¤¢ğ¥„ğ¤´ğ¤® ğ¤‘ğ¤®ğ¤²ğ¤ºğ¤®
Maayo Amazonie	ğ¤ƒğ¤¢ğ¥„ğ¤´ğ¤® ğ¤€ğ¤¥ğ¤¢ğ¥ğ¤®ğ¤²ğ¤­ğ¤«
Jeereende Saharaa	ğ¤”ğ¤«ğ¥…ğ¤ªğ¤«ğ¥…ğ¤²ğ¤£ğ¤« ğ¤…ğ¤¢ğ¤¸ğ¤¢ğ¤ªğ¤¢ğ¥„
Maayo Niil	ğ¤ƒğ¤¢ğ¥„ğ¤´ğ¤® ğ¤ğ¤­ğ¥…ğ¤¤
# Some cities
Konakri	ğ¤‘ğ¤®ğ¤²ğ¤¢ğ¤³ğ¤ªğ¤­
KayhayÉ—i	ğ¤‘ğ¤¢ğ¤´ğ¤¸ğ¤¢ğ¤´ğ¤¯ğ¤­
Nayroobi	ğ¤ğ¤¢ğ¤´ğ¤ªğ¤®ğ¥…ğ¤¦ğ¤­
Deli	ğ¤ğ¤«ğ¤¤ğ¤­
Pari	ğ¤†ğ¤¢ğ¤ªğ¤­
Londres	ğ¤‚ğ¤®ğ¤²ğ¥‹ğ¤£ğ¤ªğ¤«ğ¤§
Pekin	ğ¤†ğ¤«ğ¤³ğ¤­ğ¤²
Tokiyoo	ğ¤šğ¤®ğ¤³ğ¤­ğ¤´ğ¤®ğ¥…
Buwenos Ayres	ğ¤„ğ¤µğ¤±ğ¤«ğ¤²ğ¤®ğ¤§ ğ¤€ğ¤´ğ¤ªğ¤«ğ¤§
Sidney                             	ğ¤…ğ¤­ğ¤£ğ¤²ğ¤«ğ¤´                             
# Regions of the world
Afganistaan	ğ¤€ğ¤¬ğ¤ºğ¤¢ğ¤²ğ¤­ğ¤§ğ¤¼ğ¤¢ğ¥„ğ¤²
Albaani	ğ¤€ğ¤¤ğ¤¦ğ¤¢ğ¥„ğ¤²ğ¤­
Alseri	ğ¤€ğ¤¤ğ¤§ğ¤«ğ¤ªğ¤­
Samoa Ameriknaajo	ğ¤…ğ¤¢ğ¤¥ğ¤®ğ¤¢ ğ¤€ğ¤¥ğ¤«ğ¤ªğ¤­ğ¤³ğ¤²ğ¤¢ğ¥„ğ¤¶ğ¤®
Andoraaji	ğ¤€ğ¤²ğ¥‹ğ¤£ğ¤®ğ¤ªğ¤¢ğ¥„ğ¤¶ğ¤­
Angalteer	ğ¤€ğ¤²ğ¥‹ğ¤ºğ¤¢ğ¤¤ğ¤¼ğ¤«ğ¥…ğ¤ª
Antigu e Barbuda	ğ¤€ğ¤²ğ¤¼ğ¤­ğ¤ºğ¤µ ğ¤« ğ¤„ğ¤¢ğ¤ªğ¤¦ğ¤µğ¤£ğ¤¢
Arjantiin	ğ¤€ğ¤ªğ¤¶ğ¤¢ğ¤²ğ¤¼ğ¤­ğ¥…ğ¤²
Leydi Armeni	ğ¤‚ğ¤«ğ¤´ğ¤£ğ¤­ ğ¤€ğ¤ªğ¤¥ğ¤«ğ¤²ğ¤­
Leydi Aruba	ğ¤‚ğ¤«ğ¤´ğ¤£ğ¤­ ğ¤€ğ¤ªğ¤µğ¤¦ğ¤¢
Ostarali	ğ¤Œğ¤§ğ¤¼ğ¤¢ğ¤ªğ¤¢ğ¤¤ğ¤­
Otiris	ğ¤Œğ¤¼ğ¤­ğ¤ªğ¤­ğ¤§
Azerbaijaan	ğ¤€ğ¥ğ¤«ğ¤ªğ¤¦ğ¤¢ğ¤­ğ¤¶ğ¤¢ğ¥„ğ¤²
Leydi Bahamas	ğ¤‚ğ¤«ğ¤´ğ¤£ğ¤­ ğ¤„ğ¤¢ğ¤¸ğ¤¢ğ¤¥ğ¤¢ğ¤§
Bahreyn	ğ¤„ğ¤¢ğ¤¸ğ¤ªğ¤«ğ¤´ğ¤²
Banngalteer	ğ¤„ğ¤¢ğ¤²ğ¤ºğ¤¢ğ¤¤ğ¤¼ğ¤«ğ¥…ğ¤ª
Barbados	ğ¤„ğ¤¢ğ¤ªğ¤¦ğ¤¢ğ¤£ğ¤®ğ¤§
Bielorussi	ğ¤„ğ¤­ğ¤«ğ¤¤ğ¤®ğ¤ªğ¤µğ¤§ğ¥†ğ¤­
Belsik	ğ¤„ğ¤«ğ¤¤ğ¤§ğ¤­ğ¤³
Beliis	ğ¤„ğ¤«ğ¤¤ğ¤­ğ¥…ğ¤§
BeneÅ‹	ğ¤„ğ¤«ğ¤²ğ¤«ğ¤½
Bermuda	ğ¤„ğ¤«ğ¤ªğ¤¥ğ¤µğ¤£ğ¤¢
Butaan	ğ¤„ğ¤µğ¤¼ğ¤¢ğ¥„ğ¤²
Boliwi	ğ¤„ğ¤®ğ¤¤ğ¤­ğ¤±ğ¤­
Bosni e Hersegovina	ğ¤„ğ¤®ğ¤§ğ¤²ğ¤­ ğ¤« ğ¤–ğ¤«ğ¤ªğ¤§ğ¤«ğ¤ºğ¤®ğ¤¾ğ¤­ğ¤²ğ¤¢
Bostwana	ğ¤„ğ¤®ğ¤§ğ¤¼ğ¤±ğ¤¢ğ¤²ğ¤¢
Beresiil	ğ¤„ğ¤«ğ¤ªğ¤«ğ¤§ğ¤­ğ¥…ğ¤¤
Buruney	ğ¤„ğ¤µğ¤ªğ¤µğ¤²ğ¤«ğ¤´
Leydi Bulgari	ğ¤‚ğ¤«ğ¤´ğ¤£ğ¤­ ğ¤„ğ¤µğ¤¤ğ¤ºğ¤¢ğ¤ªğ¤­
Burkinaa	ğ¤„ğ¤µğ¤ªğ¤³ğ¤­ğ¤²ğ¤¢ğ¥„
Ko Burundi	ğ¤‘ğ¤® ğ¤„ğ¤µğ¤ªğ¤µğ¤²ğ¥‹ğ¤£ğ¤­
Kabo Verde (Kap Verde)	ğ¤‘ğ¤¢ğ¤¦ğ¤® ğ¤œğ¤«ğ¤ªğ¤£ğ¤« (ğ¤‘ğ¤¢ğ¤¨ ğ¤œğ¤«ğ¤ªğ¤£ğ¤«)
Kammboje	ğ¤‘ğ¤¢ğ¤²ğ¤¦ğ¤®ğ¤¶ğ¤«
Kameruun	ğ¤‘ğ¤¢ğ¤¥ğ¤«ğ¤ªğ¤µğ¥…ğ¤²
Kanadaa	ğ¤‘ğ¤¢ğ¤²ğ¤¢ğ¤£ğ¤¢ğ¥„
Duunde Kayman	ğ¤ğ¤µğ¥…ğ¤²ğ¤£ğ¤« ğ¤‘ğ¤¢ğ¤´ğ¤¥ğ¤¢ğ¤²
Ndenndaandi Afrik hakkundeejo	ğ¤ğ¤£ğ¤«ğ¤²ğ¤£ğ¤¢ğ¥„ğ¤²ğ¤£ğ¤­ ğ¤€ğ¤¬ğ¤ªğ¤­ğ¤³ ğ¤¸ğ¤¢ğ¤³ğ¥†ğ¤µğ¤²ğ¥‹ğ¤£ğ¤«ğ¥…ğ¤¶ğ¤®
Caad	ğ¤•ğ¤¢ğ¥„ğ¤£
Siili	ğ¤…ğ¤­ğ¥…ğ¤¤ğ¤­
Siin	ğ¤…ğ¤­ğ¥…ğ¤²
Kolommbi	ğ¤‘ğ¤®ğ¤¤ğ¤®ğ¤²ğ¤¦ğ¤­
Leydi Komoor	ğ¤‚ğ¤«ğ¤´ğ¤£ğ¤­ ğ¤‘ğ¤®ğ¤¥ğ¤®ğ¥…ğ¤ª
Ndenndaandi Konngo Demokaraasi	ğ¤ğ¤£ğ¤«ğ¤²ğ¤£ğ¤¢ğ¥„ğ¤²ğ¤£ğ¤­ ğ¤‘ğ¤®ğ¤²ğ¤ºğ¤® ğ¤ğ¤«ğ¤¥ğ¤®ğ¤³ğ¤¢ğ¤ªğ¤¢ğ¥„ğ¤§ğ¤­
Ndenndaandi Konngo	ğ¤ğ¤£ğ¤«ğ¤²ğ¤£ğ¤¢ğ¥„ğ¤²ğ¤£ğ¤­ ğ¤‘ğ¤®ğ¤²ğ¤ºğ¤®
Kosta Rika	ğ¤‘ğ¤®ğ¤§ğ¤¼ğ¤¢ ğ¤ˆğ¤­ğ¤³ğ¤¢
Kodduwaar	ğ¤‘ğ¤®ğ¤£ğ¥†ğ¤µğ¤±ğ¤¢ğ¥„ğ¤ª
Korowasi	ğ¤‘ğ¤®ğ¤ªğ¤®ğ¤±ğ¤¢ğ¤§ğ¤­
Kubaa	ğ¤‘ğ¤µğ¤¦ğ¤¢ğ¥„
Kurasao	ğ¤‘ğ¤µğ¤ªğ¤¢ğ¤§ğ¤¢ğ¤®
Siprus	ğ¤…ğ¤­ğ¤¨ğ¤ªğ¤µğ¤§
Leydi Cekoslowaki	ğ¤‚ğ¤«ğ¤´ğ¤£ğ¤­ ğ¤•ğ¤«ğ¤³ğ¤®ğ¤§ğ¤¤ğ¤®ğ¤±ğ¤¢ğ¤³ğ¤­
Danemark	ğ¤ğ¤¢ğ¤²ğ¤«ğ¤¥ğ¤¢ğ¤ªğ¤³
Jibuuti	ğ¤”ğ¤­ğ¤¦ğ¤µğ¥…ğ¤¼ğ¤­
Dominik	ğ¤ğ¤®ğ¤¥ğ¤­ğ¤²ğ¤­ğ¤³
Leydi Dominik	ğ¤‚ğ¤«ğ¤´ğ¤£ğ¤­ ğ¤ğ¤®ğ¤¥ğ¤­ğ¤²ğ¤­ğ¤³
Timor FuÉ—naange (Timor FuÉ—naange)	ğ¤šğ¤­ğ¤¥ğ¤®ğ¤ª ğ¤Šğ¤µğ¤¯ğ¤²ğ¤¢ğ¥„ğ¤²ğ¤ºğ¤« (ğ¤šğ¤­ğ¤¥ğ¤®ğ¤ª ğ¤Šğ¤µğ¤¯ğ¤²ğ¤¢ğ¥„ğ¤²ğ¤ºğ¤«)
Ekuwator	ğ¤‰ğ¤³ğ¤µğ¤±ğ¤¢ğ¤¼ğ¤®ğ¤ª
Misra	ğ¤ƒğ¤­ğ¤§ğ¤ªğ¤¢
Salvadoor	ğ¤…ğ¤¢ğ¤¤ğ¤¾ğ¤¢ğ¤£ğ¤®ğ¥…ğ¤ª
Gine Ekuwatoor	ğ¤˜ğ¤­ğ¤²ğ¤« ğ¤‰ğ¤³ğ¤µğ¤±ğ¤¢ğ¤¼ğ¤®ğ¥…ğ¤ª
Eritree	ğ¤‰ğ¤ªğ¤­ğ¤¼ğ¤ªğ¤«ğ¥…
Estoni	ğ¤‰ğ¤§ğ¤¼ğ¤®ğ¤²ğ¤­
Eswatini (Swaasiland)	ğ¤‰ğ¤§ğ¤±ğ¤¢ğ¤¼ğ¤­ğ¤²ğ¤­ (ğ¤…ğ¤±ğ¤¢ğ¥„ğ¤§ğ¤­ğ¤¤ğ¤¢ğ¤²ğ¥‹ğ¤£)
Ecoppi	ğ¤‰ğ¤·ğ¤®ğ¤¨ğ¥†ğ¤­
Duundeeji Faro	ğ¤ğ¤µğ¥…ğ¤²ğ¤£ğ¤«ğ¥…ğ¤¶ğ¤­ ğ¤Šğ¤¢ğ¤ªğ¤®
Fiiji	ğ¤Šğ¤­ğ¥…ğ¤¶ğ¤­
Finlande	ğ¤Šğ¤­ğ¤²ğ¤¤ğ¤¢ğ¤²ğ¥‹ğ¤£ğ¤«
Farayse	ğ¤Šğ¤¢ğ¤ªğ¤¢ğ¤´ğ¤§ğ¤«
Gine Farayse	ğ¤˜ğ¤­ğ¤²ğ¤« ğ¤Šğ¤¢ğ¤ªğ¤¢ğ¤´ğ¤§ğ¤«
Polineesi Farayse	ğ¤†ğ¤®ğ¤¤ğ¤­ğ¤²ğ¤«ğ¥…ğ¤§ğ¤­ ğ¤Šğ¤¢ğ¤ªğ¤¢ğ¤´ğ¤§ğ¤«
Gabon	ğ¤˜ğ¤¢ğ¤¦ğ¤®ğ¤²
Leydi Gammbi	ğ¤‚ğ¤«ğ¤´ğ¤£ğ¤­ ğ¤˜ğ¤¢ğ¤²ğ¤¦ğ¤­
Leydi Gaza	ğ¤‚ğ¤«ğ¤´ğ¤£ğ¤­ ğ¤˜ğ¤¢ğ¥ğ¤¢
Joorji	ğ¤”ğ¤®ğ¥…ğ¤ªğ¤¶ğ¤­
AlmaaÃ±	ğ¤€ğ¤¤ğ¤¥ğ¤¢ğ¥„ğ¤»
Ganaa	ğ¤˜ğ¤¢ğ¤²ğ¤¢ğ¥„
Geres	ğ¤˜ğ¤«ğ¤ªğ¤«ğ¤§
Giriinlannde	ğ¤˜ğ¤­ğ¤ªğ¤­ğ¥…ğ¤²ğ¤¤ğ¤¢ğ¤²ğ¤£ğ¤«
Grenada	ğ¤˜ğ¤ªğ¤«ğ¤²ğ¤¢ğ¤£ğ¤¢
Guadalupu	ğ¤˜ğ¤µğ¤¢ğ¤£ğ¤¢ğ¤¤ğ¤µğ¤¨ğ¤µ
Guam	ğ¤˜ğ¤µğ¤¢ğ¤¥
Guwatemala	ğ¤˜ğ¤µğ¤±ğ¤¢ğ¤¼ğ¤«ğ¤¥ğ¤¢ğ¤¤ğ¤¢
Gersi	ğ¤˜ğ¤«ğ¤ªğ¤§ğ¤­
Gine	ğ¤˜ğ¤­ğ¤²ğ¤«
Gine Bisaawo	ğ¤˜ğ¤­ğ¤²ğ¤« ğ¤„ğ¤­ğ¤§ğ¤¢ğ¥„ğ¤±ğ¤®
Guyana	ğ¤˜ğ¤µğ¤´ğ¤¢ğ¤²ğ¤¢
Hayiti	ğ¤–ğ¤¢ğ¤´ğ¤­ğ¤¼ğ¤­
Honduras	ğ¤–ğ¤®ğ¤²ğ¥‹ğ¤£ğ¤µğ¤ªğ¤¢ğ¤§
Hong Kong	ğ¤–ğ¤®ğ¤²ğ¥‹ğ¤º ğ¤‘ğ¤®ğ¤²ğ¥‹ğ¤º
Islande	ğ¤‹ğ¤§ğ¤¤ğ¤¢ğ¤²ğ¥‹ğ¤£ğ¤«
Indiya	ğ¤‹ğ¤²ğ¥‹ğ¤£ğ¤­ğ¤´ğ¤¢
Indoneesi	ğ¤‹ğ¤²ğ¥‹ğ¤£ğ¤®ğ¤²ğ¤«ğ¥…ğ¤§ğ¤­
Iraan	ğ¤‹ğ¤ªğ¤¢ğ¥„ğ¤²
Irak	ğ¤‹ğ¤ªğ¤¢ğ¤³
Irlannda	ğ¤‹ğ¤ªğ¤¤ğ¤¢ğ¤²ğ¤£ğ¤¢
Duunde Man	ğ¤ğ¤µğ¥…ğ¤²ğ¤£ğ¤« ğ¤ƒğ¤¢ğ¤²
Israayiil	ğ¤‹ğ¤§ğ¤ªğ¤¢ğ¥„ğ¤´ğ¤­ğ¥…ğ¤¤
Itali	ğ¤‹ğ¤¼ğ¤¢ğ¤¤ğ¤­
Jamayka	ğ¤”ğ¤¢ğ¤¥ğ¤¢ğ¤´ğ¤³ğ¤¢
Japon	ğ¤”ğ¤¢ğ¤¨ğ¤®ğ¤²
Jersey	ğ¤”ğ¤«ğ¤ªğ¤§ğ¤«ğ¤´
Urdun	ğ¤“ğ¤ªğ¤£ğ¤µğ¤²
Kasakstaan	ğ¤‘ğ¤¢ğ¤§ğ¤¢ğ¤³ğ¤§ğ¤¼ğ¤¢ğ¥„ğ¤²
KeÃ±iya	ğ¤‘ğ¤«ğ¤»ğ¤­ğ¤´ğ¤¢
Kiribaati	ğ¤‘ğ¤­ğ¤ªğ¤­ğ¤¦ğ¤¢ğ¥„ğ¤¼ğ¤­
Koree worgo	ğ¤‘ğ¤®ğ¤ªğ¤«ğ¥… ğ¤±ğ¤®ğ¤ªğ¤ºğ¤®
Koree worgo,	ğ¤‘ğ¤®ğ¤ªğ¤«ğ¥… ğ¤±ğ¤®ğ¤ªğ¤ºğ¤®,
Kosovo	ğ¤‘ğ¤®ğ¤§ğ¤®ğ¤¾ğ¤®
Kuwoyt	ğ¤‘ğ¤µğ¤±ğ¤®ğ¤´ğ¤¼
Kirgisistaan	ğ¤‘ğ¤­ğ¤ªğ¤ºğ¤­ğ¤§ğ¤­ğ¤§ğ¤¼ğ¤¢ğ¥„ğ¤²
Laos	ğ¤‚ğ¤¢ğ¤®ğ¤§
leydi Letoni	ğ¤¤ğ¤«ğ¤´ğ¤£ğ¤­ ğ¤‚ğ¤«ğ¤¼ğ¤®ğ¤²ğ¤­
Leydi Liban	ğ¤‚ğ¤«ğ¤´ğ¤£ğ¤­ ğ¤‚ğ¤­ğ¤¦ğ¤¢ğ¤²
Lesoto	ğ¤‚ğ¤«ğ¤§ğ¤®ğ¤¼ğ¤®
Liberiyaa	ğ¤‚ğ¤­ğ¤¦ğ¤«ğ¤ªğ¤­ğ¤´ğ¤¢ğ¥„
Libi	ğ¤‚ğ¤­ğ¤¦ğ¤­
Liktensiin	ğ¤‚ğ¤­ğ¤³ğ¤¼ğ¤«ğ¤²ğ¤§ğ¤­ğ¥…ğ¤²
Lituwaani	ğ¤‚ğ¤­ğ¤¼ğ¤µğ¤±ğ¤¢ğ¥„ğ¤²ğ¤­
Leydi Luksemburg	ğ¤‚ğ¤«ğ¤´ğ¤£ğ¤­ ğ¤‚ğ¤µğ¤³ğ¤§ğ¤«ğ¤²ğ¥‹ğ¤¦ğ¤µğ¤ªğ¤º
Makao	ğ¤ƒğ¤¢ğ¤³ğ¤¢ğ¤®
Madagaskaar	ğ¤ƒğ¤¢ğ¤£ğ¤¢ğ¤ºğ¤¢ğ¤§ğ¤³ğ¤¢ğ¥„ğ¤ª
Malawi	ğ¤ƒğ¤¢ğ¤¤ğ¤¢ğ¤±ğ¤­
Malesi	ğ¤ƒğ¤¢ğ¤¤ğ¤«ğ¤§ğ¤­
Maldiif en	ğ¤ƒğ¤¢ğ¤¤ğ¤£ğ¤­ğ¥…ğ¤¬ ğ¤«ğ¤²
Maali	ğ¤ƒğ¤¢ğ¥„ğ¤¤ğ¤­
Malta	ğ¤ƒğ¤¢ğ¤¤ğ¤¼ğ¤¢
Duunde Marshall	ğ¤ğ¤µğ¥…ğ¤²ğ¤£ğ¤« ğ¤ƒğ¤¢ğ¤ªğ¥ƒğ¤¢ğ¤¤ğ¥†
Martinik	ğ¤ƒğ¤¢ğ¤ªğ¤¼ğ¤­ğ¤²ğ¤­ğ¤³
Leydi Moritani	ğ¤‚ğ¤«ğ¤´ğ¤£ğ¤­ ğ¤ƒğ¤®ğ¤ªğ¤­ğ¤¼ğ¤¢ğ¤²ğ¤­
Moritani	ğ¤ƒğ¤®ğ¤ªğ¤­ğ¤¼ğ¤¢ğ¤²ğ¤­
Mayote	ğ¤ƒğ¤¢ğ¤´ğ¤®ğ¤¼ğ¤«
Meksik	ğ¤ƒğ¤«ğ¤³ğ¤§ğ¤­ğ¤³
Mikroneesi	ğ¤ƒğ¤­ğ¤³ğ¤ªğ¤®ğ¤²ğ¤«ğ¥…ğ¤§ğ¤­
Moldavi	ğ¤ƒğ¤®ğ¤¤ğ¤£ğ¤¢ğ¤¾ğ¤­
Monako	ğ¤ƒğ¤®ğ¤²ğ¤¢ğ¤³ğ¤®
Mongoli	ğ¤ƒğ¤®ğ¤²ğ¥‹ğ¤ºğ¤®ğ¤¤ğ¤­
Montenegro	ğ¤ƒğ¤®ğ¤²ğ¤¼ğ¤«ğ¤²ğ¤«ğ¤ºğ¤ªğ¤®
Maruk	ğ¤ƒğ¤¢ğ¤ªğ¤µğ¤³
Mosammbik	ğ¤ƒğ¤®ğ¤§ğ¤¢ğ¤²ğ¤¦ğ¤­ğ¤³
Miyanmaar (Birmaani)	ğ¤ƒğ¤­ğ¤´ğ¤¢ğ¤²ğ¤¥ğ¤¢ğ¥„ğ¤ª (ğ¤„ğ¤­ğ¤ªğ¤¥ğ¤¢ğ¥„ğ¤²ğ¤­)
Namibi	ğ¤ğ¤¢ğ¤¥ğ¤­ğ¤¦ğ¤­
Naaru	ğ¤ğ¤¢ğ¥„ğ¤ªğ¤µ
Nepal	ğ¤ğ¤«ğ¤¨ğ¤¢ğ¤¤
Pays-Bas	ğ¤†ğ¤¢ğ¤´ğ¤§-ğ¤„ğ¤¢ğ¤§
Kaledoni keso	ğ¤‘ğ¤¢ğ¤¤ğ¤«ğ¤£ğ¤®ğ¤²ğ¤­ ğ¤³ğ¤«ğ¤§ğ¤®
Leydi Nuwel Selannde	ğ¤‚ğ¤«ğ¤´ğ¤£ğ¤­ ğ¤ğ¤µğ¤±ğ¤«ğ¤¤ ğ¤…ğ¤«ğ¤¤ğ¤¢ğ¤²ğ¤£ğ¤«
Nikaraguwaa	ğ¤ğ¤­ğ¤³ğ¤¢ğ¤ªğ¤¢ğ¤ºğ¤µğ¤±ğ¤¢ğ¥„
Niiseer	ğ¤ğ¤­ğ¥…ğ¤§ğ¤«ğ¥…ğ¤ª
Naajeeriya	ğ¤ğ¤¢ğ¥„ğ¤¶ğ¤«ğ¥…ğ¤ªğ¤­ğ¤´ğ¤¢
Maseduwaan worgo	ğ¤ƒğ¤¢ğ¤§ğ¤«ğ¤£ğ¤µğ¤±ğ¤¢ğ¥„ğ¤² ğ¤±ğ¤®ğ¤ªğ¤ºğ¤®
Duunde Mariana FuÉ—naange	ğ¤ğ¤µğ¥…ğ¤²ğ¤£ğ¤« ğ¤ƒğ¤¢ğ¤ªğ¤­ğ¤¢ğ¤²ğ¤¢ ğ¤Šğ¤µğ¤¯ğ¤²ğ¤¢ğ¥„ğ¤²ğ¤ºğ¤«
Norwees	ğ¤ğ¤®ğ¤ªğ¤±ğ¤«ğ¥…ğ¤§
Oman	ğ¤Œğ¤¥ğ¤¢ğ¤²
Pakistaan	ğ¤†ğ¤¢ğ¤³ğ¤­ğ¤§ğ¤¼ğ¤¢ğ¥„ğ¤²
Palau	ğ¤†ğ¤¢ğ¤¤ğ¤¢ğ¤µ
Panama	ğ¤†ğ¤¢ğ¤²ğ¤¢ğ¤¥ğ¤¢
Papouasie-Nouvelle-Ginee	ğ¤†ğ¤¢ğ¤¨ğ¤®ğ¤µğ¤¢ğ¤§ğ¤­ğ¤«-ğ¤ğ¤®ğ¤µğ¤¾ğ¤«ğ¤¤ğ¥†ğ¤«-ğ¤˜ğ¤­ğ¤²ğ¤«ğ¥…
Paraguwaay	ğ¤†ğ¤¢ğ¤ªğ¤¢ğ¤ºğ¤µğ¤±ğ¤¢ğ¥„ğ¤´
Peru	ğ¤†ğ¤«ğ¤ªğ¤µ
Filipiin	ğ¤Šğ¤­ğ¤¤ğ¤­ğ¤¨ğ¤­ğ¥…ğ¤²
PoloÃ±	ğ¤†ğ¤®ğ¤¤ğ¤®ğ¤»
Portigaal	ğ¤†ğ¤®ğ¤ªğ¤¼ğ¤­ğ¤ºğ¤¢ğ¥„ğ¤¤
Porto Riko	ğ¤†ğ¤®ğ¤ªğ¤¼ğ¤® ğ¤ˆğ¤­ğ¤³ğ¤®
Kataar	ğ¤‘ğ¤¢ğ¤¼ğ¤¢ğ¥„ğ¤ª
Kawral	ğ¤‘ğ¤¢ğ¤±ğ¤ªğ¤¢ğ¤¤
Rumaani	ğ¤ˆğ¤µğ¤¥ğ¤¢ğ¥„ğ¤²ğ¤­
Riisi	ğ¤ˆğ¤­ğ¥…ğ¤§ğ¤­
Ruwannda	ğ¤ˆğ¤µğ¤±ğ¤¢ğ¤²ğ¤£ğ¤¢
Saint Kits e Nevis	ğ¤…ğ¤¢ğ¤­ğ¤²ğ¤¼ ğ¤‘ğ¤­ğ¤¼ğ¤§ ğ¤« ğ¤ğ¤«ğ¤¾ğ¤­ğ¤§
Lusiya Senngo	ğ¤‚ğ¤µğ¤§ğ¤­ğ¤´ğ¤¢ ğ¤…ğ¤«ğ¤²ğ¤ºğ¤®
San Vicent e Grenadin	ğ¤…ğ¤¢ğ¤² ğ¤œğ¤­ğ¤·ğ¤«ğ¤²ğ¤¼ ğ¤« ğ¤˜ğ¤ªğ¤«ğ¤²ğ¤¢ğ¤£ğ¤­ğ¤²
Samoa	ğ¤…ğ¤¢ğ¤¥ğ¤®ğ¤¢
San Marino	ğ¤…ğ¤¢ğ¤² ğ¤ƒğ¤¢ğ¤ªğ¤­ğ¤²ğ¤®
Sao Tome e Principe	ğ¤…ğ¤¢ğ¤® ğ¤šğ¤®ğ¤¥ğ¤« ğ¤« ğ¤†ğ¤ªğ¤­ğ¤²ğ¤·ğ¤­ğ¤¨ğ¤«
Leydi Sawdit	ğ¤‚ğ¤«ğ¤´ğ¤£ğ¤­ ğ¤…ğ¤¢ğ¤±ğ¤£ğ¤­ğ¤¼
Senegaal	ğ¤…ğ¤«ğ¤²ğ¤«ğ¤ºğ¤¢ğ¥„ğ¤¤
Serbi	ğ¤…ğ¤«ğ¤ªğ¤¦ğ¤­
Senegaal	ğ¤…ğ¤«ğ¤²ğ¤«ğ¤ºğ¤¢ğ¥„ğ¤¤
Siyeraa Leyoon	ğ¤…ğ¤­ğ¤´ğ¤«ğ¤ªğ¤¢ğ¥„ ğ¤‚ğ¤«ğ¤´ğ¤®ğ¥…ğ¤²
Singapuur	ğ¤…ğ¤­ğ¤²ğ¥‹ğ¤ºğ¤¢ğ¤¨ğ¤µğ¥…ğ¤ª
Sint Maarten	ğ¤…ğ¤­ğ¤²ğ¤¼ ğ¤ƒğ¤¢ğ¥„ğ¤ªğ¤¼ğ¤«ğ¤²
Slowaki	ğ¤…ğ¤¤ğ¤®ğ¤±ğ¤¢ğ¤³ğ¤­
Sloveni	ğ¤…ğ¤¤ğ¤®ğ¤¾ğ¤«ğ¤²ğ¤­
Duundeere Suleymaani	ğ¤ğ¤µğ¥…ğ¤²ğ¤£ğ¤«ğ¥…ğ¤ªğ¤« ğ¤…ğ¤µğ¤¤ğ¤«ğ¤´ğ¤¥ğ¤¢ğ¥„ğ¤²ğ¤­
Somali	ğ¤…ğ¤®ğ¤¥ğ¤¢ğ¤¤ğ¤­
Afrik worgo	ğ¤€ğ¤¬ğ¤ªğ¤­ğ¤³ ğ¤±ğ¤®ğ¤ªğ¤ºğ¤®
EspaaÃ±	ğ¤‰ğ¤§ğ¤¨ğ¤¢ğ¥„ğ¤»
Siri Lanka	ğ¤…ğ¤­ğ¤ªğ¤­ ğ¤‚ğ¤¢ğ¤²ğ¤³ğ¤¢
Sudaan	ğ¤…ğ¤µğ¤£ğ¤¢ğ¥„ğ¤²
Sudaan worgo	ğ¤…ğ¤µğ¤£ğ¤¢ğ¥„ğ¤² ğ¤±ğ¤®ğ¤ªğ¤ºğ¤®
Surinaam	ğ¤…ğ¤µğ¤ªğ¤­ğ¤²ğ¤¢ğ¥„ğ¤¥
Suwed	ğ¤…ğ¤µğ¤±ğ¤«ğ¤£
Siwis	ğ¤…ğ¤­ğ¤±ğ¤­ğ¤§
Siiri	ğ¤…ğ¤­ğ¥…ğ¤ªğ¤­
Taywaan	ğ¤šğ¤¢ğ¤´ğ¤±ğ¤¢ğ¥„ğ¤²
Tajikistaan	ğ¤šğ¤¢ğ¤¶ğ¤­ğ¤³ğ¤­ğ¤§ğ¤¼ğ¤¢ğ¥„ğ¤²
Tansani	ğ¤šğ¤¢ğ¤²ğ¤§ğ¤¢ğ¤²ğ¤­
Taylande	ğ¤šğ¤¢ğ¤´ğ¤¤ğ¤¢ğ¤²ğ¥‹ğ¤£ğ¤«
Togo	ğ¤šğ¤®ğ¤ºğ¤®
Tonga	ğ¤šğ¤®ğ¤²ğ¥‹ğ¤ºğ¤¢
Trinidad e Tobago	ğ¤šğ¤ªğ¤­ğ¤²ğ¤­ğ¤£ğ¤¢ğ¤£ ğ¤« ğ¤šğ¤®ğ¤¦ğ¤¢ğ¤ºğ¤®
Tuunus	ğ¤šğ¤µğ¥…ğ¤²ğ¤µğ¤§
Paula	ğ¤†ğ¤¢ğ¤µğ¤¤ğ¤¢
Turkmenistaan	ğ¤šğ¤µğ¤ªğ¤³ğ¤¥ğ¤«ğ¤²ğ¤­ğ¤§ğ¤¼ğ¤¢ğ¥„ğ¤²
Tuwaalu	ğ¤šğ¤µğ¤±ğ¤¢ğ¥„ğ¤¤ğ¤µ
Uganndaa	ğ¤“ğ¤ºğ¤¢ğ¤²ğ¤£ğ¤¢ğ¥„
Ukrani	ğ¤“ğ¤³ğ¤ªğ¤¢ğ¤²ğ¤­
Emiraaji Arab DentuÉ—i	ğ¤‰ğ¤¥ğ¤­ğ¤ªğ¤¢ğ¥„ğ¤¶ğ¤­ ğ¤€ğ¤ªğ¤¢ğ¤¦ ğ¤ğ¤«ğ¤²ğ¤¼ğ¤µğ¤¯ğ¤­
Leydi Biritaan	ğ¤‚ğ¤«ğ¤´ğ¤£ğ¤­ ğ¤„ğ¤­ğ¤ªğ¤­ğ¤¼ğ¤¢ğ¥„ğ¤²
LeyÉ—eele dentuÉ—e Amerik	ğ¤‚ğ¤«ğ¤´ğ¤¯ğ¤«ğ¥…ğ¤¤ğ¤« ğ¤£ğ¤«ğ¤²ğ¤¼ğ¤µğ¤¯ğ¤« ğ¤€ğ¤¥ğ¤«ğ¤ªğ¤­ğ¤³
Duundeere Virgin Amerik	ğ¤ğ¤µğ¥…ğ¤²ğ¤£ğ¤«ğ¥…ğ¤ªğ¤« ğ¤œğ¤­ğ¤ªğ¤ºğ¤­ğ¤² ğ¤€ğ¤¥ğ¤«ğ¤ªğ¤­ğ¤³
Uruguwaay	ğ¤“ğ¤ªğ¤µğ¤ºğ¤µğ¤±ğ¤¢ğ¥„ğ¤´
Usbekistaan	ğ¤“ğ¤§ğ¤¦ğ¤«ğ¤³ğ¤­ğ¤§ğ¤¼ğ¤¢ğ¥„ğ¤²
Vanuatu	ğ¤œğ¤¢ğ¤²ğ¤µğ¤¢ğ¤¼ğ¤µ
Wuro Vatikan	ğ¤ğ¤µğ¤ªğ¤® ğ¤œğ¤¢ğ¤¼ğ¤­ğ¤³ğ¤¢ğ¤²
Wenesuela	ğ¤ğ¤«ğ¤²ğ¤«ğ¤§ğ¤µğ¤«ğ¤¤ğ¤¢
Wiyetnaam	ğ¤ğ¤­ğ¤´ğ¤«ğ¤¼ğ¤²ğ¤¢ğ¥„ğ¤¥
Cisjordanie	ğ¤•ğ¤­ğ¤§ğ¤¶ğ¤®ğ¤ªğ¤£ğ¤¢ğ¤²ğ¤­ğ¤«
Yemen	ğ¤’ğ¤«ğ¤¥ğ¤«ğ¤²
Sammbi	ğ¤…ğ¤¢ğ¤²ğ¤¦ğ¤­
Simmbaabuwee	ğ¤…ğ¤­ğ¤²ğ¤¦ğ¤¢ğ¥„ğ¤¦ğ¤µğ¤±ğ¤«ğ¥…

# Some longer test cases
Daartol Afrik e teeminannde 20siire ina saÉ—ti	ğ¤ğ¤¢ğ¥„ğ¤ªğ¤¼ğ¤®ğ¤¤ ğ¤€ğ¤¬ğ¤ªğ¤­ğ¤³ ğ¤« ğ¤¼ğ¤«ğ¥…ğ¤¥ğ¤­ğ¤²ğ¤¢ğ¤²ğ¤£ğ¤« ğ¥’ğ¥ğ¤§ğ¤­ğ¥…ğ¤ªğ¤« ğ¤­ğ¤²ğ¤¢ ğ¤§ğ¤¢ğ¤¯ğ¤¼ğ¤­
O adat tan omo adda.	ğ¤Œ ğ¤¢ğ¤£ğ¤¢ğ¤¼ ğ¤¼ğ¤¢ğ¤² ğ¤®ğ¤¥ğ¤® ğ¤¢ğ¤£ğ¥†ğ¤¢.
'ÆŠum ko konngol jarriborgol e É—emngal Fulfulde!'	'ğ¤ğ¤µğ¤¥ ğ¤³ğ¤® ğ¤³ğ¤®ğ¤²ğ¤ºğ¤®ğ¤¤ ğ¤¶ğ¤¢ğ¤ªğ¥†ğ¤­ğ¤¦ğ¤®ğ¤ªğ¤ºğ¤®ğ¤¤ ğ¤« ğ¤¯ğ¤«ğ¤¥ğ¤²ğ¤ºğ¤¢ğ¤¤ ğ¤Šğ¤µğ¤¤ğ¤¬ğ¤µğ¤¤ğ¤£ğ¤«!'
'MiÉ—o jogii miÃ±iraaÉ“e tato worÉ“e e miÃ±iraaÉ“e rewÉ“e É—iÉ—o. Enen fof eÉ—en nguuri e wuro wooto, ko ina wona waktuuji É—iÉ—i e wuro men adanngo.'	'ğ¤ƒğ¤­ğ¤¯ğ¤® ğ¤¶ğ¤®ğ¤ºğ¤­ğ¥… ğ¤¥ğ¤­ğ¤»ğ¤­ğ¤ªğ¤¢ğ¥„ğ¤©ğ¤« ğ¤¼ğ¤¢ğ¤¼ğ¤® ğ¤±ğ¤®ğ¤ªğ¤©ğ¤« ğ¤« ğ¤¥ğ¤­ğ¤»ğ¤­ğ¤ªğ¤¢ğ¥„ğ¤©ğ¤« ğ¤ªğ¤«ğ¤±ğ¤©ğ¤« ğ¤¯ğ¤­ğ¤¯ğ¤®. ğ¤‰ğ¤²ğ¤«ğ¤² ğ¤¬ğ¤®ğ¤¬ ğ¤«ğ¤¯ğ¤«ğ¤² ğ¤²ğ¤ºğ¤µğ¥…ğ¤ªğ¤­ ğ¤« ğ¤±ğ¤µğ¤ªğ¤® ğ¤±ğ¤®ğ¥…ğ¤¼ğ¤®, ğ¤³ğ¤® ğ¤­ğ¤²ğ¤¢ ğ¤±ğ¤®ğ¤²ğ¤¢ ğ¤±ğ¤¢ğ¤³ğ¤¼ğ¤µğ¥…ğ¤¶ğ¤­ ğ¤¯ğ¤­ğ¤¯ğ¤­ ğ¤« ğ¤±ğ¤µğ¤ªğ¤® ğ¤¥ğ¤«ğ¤² ğ¤¢ğ¤£ğ¤¢ğ¤²ğ¤ºğ¤®.'
