ကို	ko
စေ	hcay
များ	myarr
သည်	sai
ခွင့်	hkwng
နှင့်	nhang
ရ	r
ရှိ	shi
ဖြစ်	hpyit
ခြင်း	hkyinn
နိုင်	nine
သော	saw
ည့်	eet
လူ	luu
မ	m
တွင်	twin
သ	s
လည်းကောင်း	laeekaungg
စွာ	hcwar
တိုင်း	tine
အခွင့်အရေး	aahkwngaarayy
ရန်	raan
လွတ်လပ်	lwatlaut
တို့	thoet
အပိုဒ်	aapod
သော်လည်းကောင်း	sawlaeekaungg
မိမိ	mimi
မှု	mhu
မည်	mai
နိုင်ငံ	ninengan
ရေး	rayy
က	k
ခံ	hkan
ဖြင့်	hpyang
မှ	mha
ပြု	pyu
ဥပဒေ	upaday
တစ်	tait
ထို	hto
အတွက်	aatwat
ခံစား	hkanhcarr
တူညီ	tuunye
အဖွဲ့	aahpwal
ဆိုင်ရာ	sinerar
လူ့	lhu
အားဖြင့်	aarrhpyang
ကုလသမဂ္ဂ	kulasamagg
သို့တည်းမဟုတ်	shoettaeemahote
အခြား	aahkyarr
ကြ	kya
ဆောင်ရွက်	saungrwat
ထား	htarr
န့်	ant
ပါဝင်	parwain
ပိုင်	pine
ပြည်	pyi
ဝင်	wain
အခြေခံ	aahkyayhkan
အပြင်	aapyin
ကြေညာစာတမ်း	kyaynyarhcartam
ပေး	payy
အခါ	aahkar
အရ	aar
ခပ်သိမ်း	hkautsaim
ပြစ်မှု	pyitmhu
ပြီး	pyee
မျှ	myaha
လည်း	laee
လွတ်လပ်ခွင့်	lwatlauthkwng
သူ	suu
ကာ	kar
ကြီး	kyee
နယ်မြေ	naalmyay
နေထိုင်	nayhtine
ပညာ	panyar
ဘဲ	bhell
မည်သူ	maisuu
ရယူ	rayuu
သောကြောင့်	sawkyawwng
ဟု	hu
အ	a
အဆိုပါ	aasopar
ကိုးကွယ်	koekwal
ကြေညာ	kyaynyar
ကွယ်	kwal
ခု	hku
ခွဲခြား	hkwalhkyarr
ဂုဏ်သိက္ခာ	gunsikhkar
တ	t
တကွ	takw
တို့သည်	thoetsai
ထို့ပြင်	hthoetpyin
မိသားစု	misarrhcu
ရရှိ	rashi
ရာ	rar
ရောက်	rout
လိုက်	lite
အခွင့်	aahkwng
အဆင့်အတန်း	aasangaataann
အလုပ်	aalote
ဦး	u
ကျင့်သုံး	kyangsone
ကြောင့်	kyawwng
တိုင်းပြည်	tinepyi
တိုးတက်	toetaat
နည်း	naee
နိုင်ငံရေး	ninenganrayy
ပြ	pya
ဘာသာ	bharsar
ဘာ့	bhar
မဟုတ်	mahote
မ္	m
မျှတ	myahat
လာ	lar
လူမှု	luumhu
လေးစား	layyhcarr
လျှင်	shin
အပြည်	aapyi
အမှု	aamhu
အရေး	aarayy
အားလုံး	aarrlone
အေးချမ်း	aayyhkyam
ဤ	i
ခံယူ	hkanyuu
ချက်	hkyet
ငှာ	nghar
စောင့်ရှောက်	hcawngshout
ဆက်ဆံ	saatsan
ဆန္ဒ	sand
တရား	tararr
ထိုက်	htite
နိုင်ငံသားအဖြစ်	ninengansarraahpyit
နေ	nay
ပါ	par
ဖော်ပြ	hpawpya
ဖြစ်သည်	hpyitsai
ယုံကြည်	yonekyi
ယောက်	yout
ရိုသေ	rosay
ရှေ့မှောက်	shaemhaout
လိုအပ်	loaaut
လုပ်	lote
လုံး	lone
လူအ	luua
သက်ဝင်	saatwain
သုံးစွဲ	sonehcwal
သူများ	suumyarr
အကြောင်း	aakyaungg
အချင်းချင်း	aahkyinnhkyinn
အစည်း	aahcaee
အဖြစ်	aahpyit
အား	aarr
အောင်	aaung
ကလေး	kalayy
ကိုယ်တိုင်	kotine
ကြား	kyarr
ခဲ့	hkae
ချိုး	hkyoe
ဂုဏ်	gun
စစ်ဆေး	hcaitsayy
စရိုက်	hcarite
စိတ်	hcate
စိတ်ချ	hcatehkya
စီရင်	hcerain
ညီလာခံ	nyelarhkan
ညှဉ်းပန်း	nyhainpaann
ထိမ်းမြား	htaimmyarr
ထိုသို့	htoshoet
ဒေသ	days
ပညာသင်	panyarsain
ပိုင်းခြား	pinehkyarr
ပိုမို	pomo
မိန်းမ	meinm
မူလ	muul
မဲ	mell
ယူဆ	yuus
ရည်ရွယ်	rairwal
ရာတွင်	rartwin
ရွေးချယ်	rwayhkyaal
လက္ခဏာ	lakhkanar
လို့	lhoet
လုံခြုံ	lonehkyuan
လူမှုရေး	luumhurayy
လူ့အဖွဲ့အစည်း	lhuaahpwalaahcaee
သင့်	sang
သင်ကြား	sainkyarr
သတ်	saat
သဘောတရား	sabhawtararr
သာ	sar
အကာအကွယ်	aakaraakwal
အကျိုး	aakyoe
အချိန်	aahkyane
အခြေအနေ	aahkyayaanay
အတိုင်း	aatine
အတွင်း	aatwin
အပြစ်ဒဏ်	aapyitdan
အရာ	aarar
အသက်မွေး	aasaatmway
အာဏာပိုင်	aarnarpine
အားပေး	aarrpayy
အုပ်ချုပ်	aotehkyaote
ကင်းလွတ်	kainnlwat
ကာလ	karl
ကိုယ်ပိုင်	kopine
ကျယ်	kyaal
ကြမ်းကြုတ်	kyamkyuat
ကြားနာ	kyarrnar
ချင်း	hkyinn
ချုပ်ချယ်	hkyaotehkyaal
ငံ	ngan
ငြိမ်းချမ်း	ngyaaimhkyam
စဉ်	hcain
စနစ်	hcanait
စာတမ်း	hcartam
စာသား	hcarsarr
စား	hcarr
စေခိုင်း	hcayhkine
စောင့်စည်း	hcawnghcaee
စွ	hcw
စွက်ဖက်	hcwathpaat
ဆိုင်	sine
ဆောင်	saung
ဉာဏ်	nyarn
ညီ	nye
တင်	tain
တစ်နိုင်	taitnine
တတ်	taat
တန်း	taann
တရားစွဲဆိုခြင်း	tararrhcwalsohkyinn
တရားရုံး	tararrrone
တာဝန်	tarwaan
တော်	taw
ထင်မြင်	htainmyin
ထင်ရှား	htainsharr
ထပ်မံ	htautman
ထိ	hti
ထိန်းသိမ်း	hteinsaim
နယ်နိမိတ်	naalnimate
နေအိမ်	nayaain
နောက်	nout
နှစ်	nhait
နှိပ်စက်	nhaiuthcaat
ပစ္စည်းဥစ္စာ	pahchcaeeuhchcar
ပိုင်ဆိုင်	pinesine
ပုတ်ခတ်	potehkaat
ပေါင်းသင်း	paunggsainn
ပေါ်ပေါက်	pawpout
ပျက်စီး	pyethcee
ပျော်	pyaw
ပြင်	pyin
ပြုလုပ်	pyulote
ပြောင်းလဲ	pyaungglell
ဖီဆန်	hpesaan
ဖောက်	hpout
ဖျက်ဆီး	hpyetsee
ဖြ	hpya
ဖြစ်ထွန်း	hpyithtwann
ဖွင့်	hpwng
ဖွား	hpwarr
ဖွဲ့စည်း	hpwalhcaee
ဖွဲ့စည်းပုံ	hpwalhcaeepone
ဖွံ့ဖြိုး	hpwanhpyaoe
ဘက်	bhaat
များသည်	myarrsai
မျိုးရိုး	myoeroe
မွေး	mway
ယဉ်ကျေးမှု	yainkyaayymhu
ယူ	yuu
ယူဆချက်	yuusahkyet
ယောကျာ်း	yawkyaar
ရက်	raat
ရက်စက်	raathcaat
ရင်းနှီး	rainnnhaee
ရွက်	rwat
ရွေးကောက်ပွဲ	rwaykoutpwal
လစာ	lahcar
လုပ်ကိုင်	lotekine
လုပ်ငန်း	lotengaann
လူမျိုး	luumyoe
လောက	lawk
လောက်	lout
လျက်	lyet
လွှတ်	lwhaat
ဝ	w
ဝေငှ	wayngha
ဝှမ်း	wham
သန်	saan
သဘော	sabhaw
သိပ္ပံ	sippan
သို့	shoet
သုခုမပညာ	suhkumapanyar
သူ့	shu
သောက်	sout
ဟ	h
အကူအညီ	aakuuaanye
အစည်းအဝေး	aahcaeeaawayy
အစုံ	aahcone
အညီအမျှ	aanyeaamyaha
အတည်ပြု	aataipyu
အထက်ပါ	aahtaatpar
အထောက်	aahtout
အဓိပ္ပာယ်	aadhipparal
အပံ့	aapan
အများ	aamyarr
အလုပ်လက်မဲ့	aalotelaatmae
အသိအမှတ်ပြု	aasiaamhaatpyu
အသိုက်အဝန်း	aasiteaawaann
အာဏာ	aarnar
အားထုတ်	aarrhtote
အားလပ်	aarrlaut
ကတိ	kati
ကမ္ဘာ	kambhar
ကိစ္စ	kihchc
ကိုယ်	ko
ကိုယ်ကျင့်တရား	kokyangtararr
ကိုယ်စားလှယ်	kohcarrlhaal
ကိုယ်အင်္ဂါ	koaaingar
ကောက်ယူ	koutyuu
ကောင်းမွန်သော	kaunggmwansaw
ကဲ့သို့	kaeshoet
ကျင့်	kyang
ကျင့်ဝတ်	kyangwaat
ကျင်	kyin
ကျင်းပ	kyinnp
ကျန်း	kyann
ကျန်းမာရေး	kyannmarrayy
ကျား	kyarr
ကျူးလွန်	kyauulwan
ကျူးလွန်သည်	kyauulwansai
ကျေးကျွန်	kyaayykyawan
ကျေးကျွန်အဖြစ်	kyaayykyawanaahpyit
ကြားသိ	kyarrsi
ကြိုးပမ်း	kyaoepam
ကြီးပွား	kyeepwarr
ကြီးလေးသော	kyeelayysaw
ကြေညာချက်	kyaynyarhkyet
ကြောက်ရွံ့	kyawwatrwan
ကြောင်း	kyaungg
ကြေးငွေ	kyayngway
ကြံစည်	kyaanhcai
ကြံဆ	kyaans
ကြံဆောင်	kyaansaung
ကြွေးကြော်	kyawaykyaw
ကွာရှင်း	kwarshinn
ခင်မင်	hkainmain
ခိုလှုံ	hkolhuan
ခုခံ	hkuhkan
ချစ်ခင်	hkyithkain
ချိ	hkyai
ချိန်	hkyane
ချို့ငဲ့	hkyahoetngae
ချီ	hkyae
ချုပ်	hkyaote
ချေပ	hkyaayp
ခြား	hkyarr
ခွာ	hkwar
ငယ်	ngaal
ငြင်းပယ်	ngyinnpaal
ငွေကြေး	ngwaykyay
စ	hc
စကားချီး	hcakarrhkyaee
စက်မှု	hcaatmhu
စစ်	hcait
စပ်လျဉ်း	hcautlyain
စာပေ	hcarpay
စာပေးစာယူ	hcarpayyhcaryuu
စာမျက်နှာ	hcarmyetnhar
စာသင်ကျောင်း	hcarsainkyaungg
စိ	hci
စီ	hce
စီးပွား	hceepwarr
စီးပွားရေး	hceepwarrrayy
စုပေါင်း	hcupaungg
စုဝေး	hcuwayy
စေသော	hcaysaw
စွပ်စွဲ	hcwuthcwal
စွမ်း	hcwm
စွဲကိုင်	hcwalkine
ဆ	s
ဆင့်ဆို	sangso
ဆည်းပူး	saeepuu
ဆန်	saan
ဆို	so
ဆီး	see
ဆုံး	sone
ဆုံးဖြတ်	sonehpyat
ဆုံးမ	sonem
ဆောက်တည်	souttai
ဆော်	saw
ဆေးဝါး	sayywarr
ဆွဲ	swal
ဇစ်မြစ်	jaitmyit
ဇာတိ	jarti
တစ်ခုခု	taithkuhku
တစ်စု	taithcu
တစ်ဆင့်	taitsang
တစ်ရပ်	taitraut
တည်တံ့	taitan
တည်း	taee
တရားစွဲဆို	tararrhcwalso
တရားလက်လွတ်	tararrlaatlwat
တားမြစ်	tarrmyit
တိုင်းသူပြည်သား	tinesuupyisarr
တိုးတက်မှု	toetaatmhu
တွေးခေါ်	twayhkaw
ထက်	htaat
ထို့	hthoet
ထုတ်	htote
ထူထောင်	htuuhtaung
ထောက်ထား	htouthtarr
ထွက်	htwat
ထွန်းကား	htwannkarr
ဒီ	de
ဒီဇင်ဘာလ	dejainbharl
နစ်နာချက်	naitnarhkyet
နယ်ပယ်	naalpaal
နား	narr
နားလည်မှု	narrlaimhu
နိုင်ငံတကာ	ninengantakar
နိုင်ထက်စီးနင်း	ninehtaathceenainn
နောက်ဆုံး	noutsone
နေ့	nae
နွယ်	nwal
နှင်	nhain
နှစ်သက်	nhaitsaat
နှစ်ဦးနှစ်	nhaitunhait
နှလုံးသွင်း	nhaloneswin
နှိပ်စက်ကလူ	nhaiuthcaatkaluu
နှောင်	nhaawin
ပင်	pain
ပစ္စည်း	pahchcaee
ပညာရေး	panyarrayy
ပညာသည်	panyarsai
ပတ်	paat
ပတ်သက်	paatsaat
ပါရှိ	parshi
ပါသည်	parsai
ပိတ်	pate
ပိုင့်	pong
ပိုင်ဆိုင်ခွင့်	pinesinehkwng
ပုဂ္ဂိုလ်	puggol
ပုန်ကန်	ponekaan
ပူ	puu
ပူးပေါင်း	puupaungg
ပေါင်း	paungg
ပေါ်	paw
ပေါ်လာ	pawlar
ပျက်ကွက်	pyetkwat
ပြစ်	pyit
ပြည်တွင်း	pyitwin
ပြည်ပ	pyip
ပြည်သူပြည်သား	pyisuupyisarr
ပြဌာန်း	pyahtarann
ပြန်	pyan
ပြန်လာ	pyanlar
ပြသ	pyas
ပြောဆို	pyawwso
ပြေး	pyay
ပွဲ	pwal
ဖက်စပ်	hpaathcaut
ဖတ်	hpaat
ဖန်တီး	hpaantee
ဖမ်းဆီး	hpamsee
ဖိစီး	hpihcee
ဖောက်ဖျက်	hpouthpyet
ဖျက်သိမ်း	hpyetsaim
ဖြစ်မြောက်	hpyitmyawwat
ဖြာ	hpyaar
ဘဝ	bhaw
ဘာသာစကား	bharsarhcakarr
မတတ်	mataat
မထီလေးစား	mahtelayyhcarr
မလွှဲသာ	malwhaellsar
မာ	mar
မား	marr
မိခင်	mihkain
မိဘ	mibh
မို	mo
မုဆိုးမ	musoem
မူ	muu
မေတ္တာ	mayttar
မဲ့	mae
မ့်	m
မြင့်	myang
မြင်သာ	myinsar
မြောက်	myawwat
မြှင့်	myahang
မွေ့လျော်	mwaelyaw
မှန်သော	mhaansaw
ယခု	yahku
ယင်းသို့	yainnshoet
ယေဘူယျ	yaybhuuyya
ယောက်ျား	youtyarr
ရည်	rai
ရည်ရွယ်ချက်	rairwalhkyet
ရပိုင်ခွင့်	rapinehkwng
ရပ်	raut
ရပ်တည်	rauttai
ရပ်ရွာ	rautrwar
ရာဇဝင်	rarjawain
ရေ	ray
ရွေးကောက်	rwaykout
ရွှေ့ပြောင်း	shwaepyaungg
ရှင်	shin
ရှင်သန်	shinsaan
ရှင်းလင်း	shinnlainn
ရှာ	shar
ရှာမှီး	sharmhaee
ရှောင်	shawin
လက်ခံ	laathkan
လက်ထပ်	laathtaut
လက်နက်	laatnaat
လက်မှုပညာ	laatmhupanyar
လက်ဦး	laatu
လင်မယား	lainmayarr
လမ်း	lam
လမ်းများ	lammyarr
လို	lo
လိုက်စား	litehcarr
လိုလားချက်	lolarrhkyet
လုပ်ရပ်	loteraut
လူမျိုးစု	luumyoehcu
လူမှုဆက်ဆံရေး	luumhusaatsanrayy
လူသား	luusarr
လူအား	luuaarr
လျော်ကန်	lyawkaan
လျှို့ဝှက်	shhoetwhaat
လျှောက်	shout
လွတ်ကင်း	lwatkainn
လှန်	lhaan
လှုံ	lhuan
ဝတ္တရား	wattararr
ဝတ်ပြု	waatpyu
ဝန်ထမ်း	waanhtam
ဝမ်းစာ	wamhcar
ဝယ်	waal
ဝေဖန်	wayhpaan
သက်ဆိုင်ရာ	saatsinerar
သက်ရောက်	saatrout
သက်သာ	saatsar
သင့်တော်	sangtaw
သင့်မြတ်	sangmyat
သင်	sain
သင်ပြ	sainpya
သင်ယူ	sainyuu
သည်းခံ	saeehkan
သတင်း	satainn
သတို့သမီး	sathoetsamee
သတို့သား	sathoetsarr
သတ်မှတ်	saatmhaat
သန္နိဋ္ဌာန်ချ	sannithtaranhkya
သဖြင့်	sahpyang
သဖွယ်	sahpwal
သဘာ	sabhar
သဘာဝကျ	sabharwakya
သဘောဆန္ဒ	sabhawsand
သယံဇာတ	sayanjart
သာယာ	saryar
သာလျှင်	sarshin
သား	sarr
သိတတ်	sitaat
သိမှတ်	simhaat
သို့မဟုတ်	shoetmahote
သွန်သင်	swansain
သွား	swarr
သွားလာ	swarrlar
ဟာ	har
ဟူ	huu
ဟူသမျှ	huusamyaha
ဟူသော	huusaw
အကိုင်	aakine
အကျင့်သိက္ခာ	aakyangsikhkar
အကျိုးကျေးဇူး	aakyoekyaayyjuu
အကျိုးအမြတ်	aakyoeaamyat
အကြောင်းပြု	aakyaunggpyu
အကြောင်းအရာ	aakyaunggaarar
အခကြေးငွေ	aahkakyayngway
အခင်း	aahkainn
အခမဲ့	aahkamae
အချုပ်အခြာ	aahkyaoteaahkyaar
အခြေပြု	aahkyaypyu
အင်အား	aainaarr
အစဉ်	aahcain
အစည်းအရုံး	aahcaeeaarone
အစာ	aahcar
အစား	aahcarr
အစိုးရ	aahcoer
အစေအပါး	aahcayaaparr
အဆင့်	aasang
အဆုံးအဖြတ်	aasoneaahpyat
အတင်းအကျပ်	aatainnaakyaut
အတန်း	aataann
အထက်	aahtaat
အထက်တန်း	aahtaattaann
အထိ	aahti
အထူး	aahtuu
အထောက်အထား	aahtoutaahtarr
အထွေထွေ	aahtwayhtway
အဓမ္မ	aadhamm
အဓိက	aadhik
အနည်းဆုံး	aanaeesone
အနားယူ	aanarryuu
အနေ	aanay
အနှောင့်	aanhaawng
အပြစ်	aapyit
အပြု	aapyu
အမျိုး	aamyoe
အမှတ်	aamhaat
အမှန်	aamhaan
အယှက်	aayhaat
အရည်အချင်း	aaraiaahkyinn
အရောင်	aaraung
အရောင်းအဝယ်	aaraunggaawaal
အရွယ်ရောက်	aarwalrout
အလားတူ	aalarrtuu
အလုပ်ခွင်	aalotehkwin
အလုပ်သမား	aalotesamarr
အဝ	aaw
အဝတ်အထည်	aawaataahtai
အသက်	aasaat
အသက်အရွယ်	aasaataarwal
အသင်းအဖွဲ့	aasainnaahpwal
အသား	aasarr
အသိ	aasi
အသီးသီး	aaseesee
အသုံး	aasone
အာနိသင်	aarnisain
အားလျော်စွာ	aarrlyawhcwar
အိမ်ထောင်	aainhtaung
အိမ်ထောင်ပြု	aainhtaungpyu
အိုမင်း	aomainn
အုတ်မြစ်	aotemyit
အုပ်စိုး	aotehcoe
ဥစ္စာ	uhchcar
