# Baby names
ਅਂਗਦ	अंगद
ਅਂਗਦ ਦੇਵ	अंगद देव
ਅਂਗਾਰਿਕਾ	अंगारिका
ਅਂਤਰਜੋਤ	अंतरजोत
ਅਂਤਰਪ੍ਰਿਤ	अंतरप्रित
ਅਂਤਰਾ	अंतरा
ਅਕਲਤਟ	अकलतट
ਅਕਲਰੂਪ	अकलरूप
ਅਕਲਸ਼ਰਣ	अकलशरण
ਅਕਲਸੀਮਾਰ	अकलसीमार
ਅਕਾਲਜੋਗ	अकालजोग
ਅਕਾਲਦੀਪ	अकालदीप
ਅਕਾਲਪ੍ਰੀਤ	अकालप्रीत
ਅਕਾਲਬੀਰ	अकालबीर
ਅਗਮਜੀਤ	अगमजीत
ਅਗਮਜੋਤ	अगमजोत
ਅਗਮ੍ਪਾਲ	अगम्पाल
ਅਗਮ੍ਪ੍ਰੀਤ	अगम्प्रीत
ਅਜ੍ਮੀਨ੍ਦੇਰ	अज्मीन्देर
ਅਝਾਦਬੀਰ	अझादबीर
ਅਝੀਝ	अझीझ
ਅਤੀਨਦੇਰ੍ਜਿਤ	अतीनदेर्जित
ਅਤੀਨ੍ਦੇਰ	अतीन्देर
ਅਤ੍ਤਾਮਜਿਤ	अत्तामजित
ਅਨਂਤਦੇਵ	अनंतदेव
ਅਨਂਤਰ	अनंतर
ਅਨਂਤਵੀਰ	अनंतवीर
ਅਨਂਤ੍ਜੀਤ	अनंत्जीत
ਅਨਾਹਤ	अनाहत
ਅਨਿਂਦਿਤਾ	अनिंदिता
ਅਨਿਸ਼ਾ	अनिशा
ਅਨੀਲਜੋਤ	अनीलजोत
ਅਨੀਸ਼੍ਕੋਉਂਰ	अनीश्कोउंर
ਅਨੁਂਜਪਾਲ	अनुंजपाल
ਅਨੁਂਪਜੋਤ	अनुंपजोत
ਅਨੁਰਾਧਾ	अनुराधा
ਅਨੁਸ਼੍ਕਾ	अनुश्का
ਅਨੂਪਜੋਤ	अनूपजोत
ਅਨੂਪਬੀਰ	अनूपबीर
ਅਨੂਪਲੋਕ	अनूपलोक
ਅਪੂਰ੍ਵਾ	अपूर्वा
ਅਪ੍ਰੀਨਦੇਰ	अप्रीनदेर
ਅਬਨੀ	अबनी
ਅਬਿਚਾਲ	अबिचाल
ਅਬਿਨਾਸ਼	अबिनाश
ਅਭਿਜੀਤ	अभिजीत
ਅਭਿਰੂਪ	अभिरूप
ਅਮਨਜੀਤ	अमनजीत
ਅਮਰਜੋਤ	अमरजोत
ਅਮਰਤ	अमरत
ਅਮਰਿਂਦਰ	अमरिंदर
ਅਮਰਿਤ	अमरित
ਅਮਲਜੋਤ	अमलजोत
ਅਮਾਨਜੀਵਨ	अमानजीवन
ਅਮਾਨੀਨ੍ਦੇਰ	अमानीन्देर
ਅਮਾਨ੍ਰੂਪ	अमान्रूप
ਅਮਾਰ੍ਪਾਲ	अमार्पाल
ਅਮਾਰ੍ਬੀਰ	अमार्बीर
ਅਮਿਕ	अमिक
ਅਮਿਤ	अमित
ਅਮਿਤੋਜ	अमितोज
ਅਮੀਤਪਾਲ	अमीतपाल
ਅਮੀਤ੍ਬੀਰ	अमीत्बीर
ਅਮੋਲ੍ਰਸ	अमोल्रस
ਅਮ੍ਨੀਨ੍ਦੇਰ	अम्नीन्देर
ਅਮ੍ਰੀਤਬਾਨ	अम्रीतबान
ਅਮ੍ਰੀਤ੍ਪ੍ਰਿਤ	अम्रीत्प्रित
ਅਮ੍ਰੀਤ੍ਵਾਨੀ	अम्रीत्वानी
ਅਰਮਾਨੀ	अरमानी
ਅਰਵਜੋਤ	अरवजोत
ਅਰੀਨਾਜੇਤ	अरीनाजेत
ਅਰੀਨ੍ਦੇਰ੍ਜੀਤ	अरीन्देर्जीत
ਅਰੁਨਜੀਤ	अरुनजीत
ਅਰੁਨਜੋਤ	अरुनजोत
ਅਰ੍ਚਨਾ	अर्चना
ਅਰ੍ਦਮਨ	अर्दमन
ਅਰ੍ਨਾਲੀਨ੍ਦੇਰ	अर्नालीन्देर
ਅਰ੍ਸ਼੍ਦੀਪ	अर्श्दीप
ਅਲੋਕ੍ਪਾਲ	अलोक्पाल
ਅਲ੍ਪਨਾ	अल्पना
ਅਵਨੀਨਦੇਰ	अवनीनदेर
ਅਵਿਰ	अविर
ਅਵ੍ਲੀਨ	अव्लीन
ਅਸਂਖ	असंख
ਅਸ਼ਮਿਤ	अशमित
ਅਸ਼ਰ੍ਨਾਮ	अशर्नाम
ਅਸ਼ਰ੍ਪ੍ਰੀਤ	अशर्प्रीत
ਅਸ਼ਰ੍ਪ੍ਰੇਮ	अशर्प्रेम
ਅਸ਼ਰ੍ਵੀਰ	अशर्वीर
ਅਸ਼ਿਮਾ	अशिमा
ਅਸੀਮ	असीम
ਅਸੀਸ	असीस
ਅਸ੍ਨੇਹ	अस्नेह
ਆਖਰੀ	आखरी
ਆਤ੍ਮਜਾ	आत्मजा
ਆਨਂਦਮਯੀ	आनंदमयी
ਆਨਂਦਰੂਪ	आनंदरूप
ਆਯਕਾਰ	आयकार
ਆਯਾਤਪ੍ਰਿਤ	आयातप्रित
ਆਯੁਸ਼੍ਮਤਿ	आयुश्मति
ਆਰਮਾਨ	आरमान
ਆਰਾਧ	आराध
ਆਰਾਧਨਾ	आराधना
ਆਰ੍ਯਨ	आर्यन
ਇਂਦਰਬੀਰ	इंदरबीर
ਇਂਦਿਵਰ	इंदिवर
ਇਕਪ੍ਰਿਤ	इकप्रित
ਇਕਬਾਲ	इकबाल
ਇਕਰੂਪ	इकरूप
ਇਕ੍ਪੂਜ	इक्पूज
ਇਕ੍ਮਾਨ	इक्मान
ਇਚ੍ਕਜਿਤ	इच्कजित
ਇਨ੍ਦਾਰਤੇਜ	इन्दारतेज
ਇਨ੍ਦਾਰਮਿਤ	इन्दारमित
ਇਨ੍ਦਾਰ੍ਦੀਪ	इन्दार्दीप
ਇਨ੍ਦਾਰ੍ਪ੍ਰਿਤ	इन्दार्प्रित
ਇਨ੍ਦਾਰ੍ਪ੍ਰੇਮ	इन्दार्प्रेम
ਇਨ੍ਦੇਰ	इन्देर
ਇਨ੍ਦੇਰਪਲ	इन्देरपल
ਇਨ੍ਦੇਰਮਾਨ	इन्देरमान
ਇਨ੍ਦੇਰਹਾਰ੍ਜਿਤ	इन्देरहार्जित
ਇਮਰਾਤ	इमरात
ਈਖ੍ਤਿਅਰ	ईख्तिअर
ਈਨ੍ਦਰ੍ਜੀਏਤ	ईन्दर्जीएत
ਈਨ੍ਦੇਰਤੇਕ	ईन्देरतेक
ਈਨ੍ਦੇਰਵੀਰ	ईन्देरवीर
ਈਬਾਦਤ	ईबादत
ਈਸ਼ਪਾਲ	ईशपाल
ਈਸ਼ਲੀਨ	ईशलीन
ਈਸ਼ਾਰਤੇਕ	ईशारतेक
ਈਸ਼ਾਰਪਾਲ	ईशारपाल
ਈਸ਼੍ਤ੍ਵਰ੍ਜਿਤ	ईश्त्वर्जित
ਈਸ਼੍ਪ੍ਰਿਤ	ईश्प्रित
ਈਸ਼੍ਵਾਰ੍ਜਿਤ	ईश्वार्जित
ਈਸ਼੍ਵੀਨਦੇਰ	ईश्वीनदेर
ਉਖ੍ਤਿਅਰ	उख्तिअर
ਉਚਪਾਲ	उचपाल
ਉਚਪ੍ਰਿਤ	उचप्रित
ਉਚੀਤਦੀਪ	उचीतदीप
ਉਚੀਤਪ੍ਰਿਤ	उचीतप्रित
ਉਚੀਤਬੀਰ	उचीतबीर
ਉਚੀਤਰੂਪ	उचीतरूप
ਉਚੀਤਲੋਕ	उचीतलोक
ਉਚੀਤਵਂਤ	उचीतवंत
ਉਜਗਰ੍ਜੋਤ	उजगर्जोत
ਉਜਗਰ੍ਦੀਪ	उजगर्दीप
ਉਜਗਰ੍ਬੀਰ	उजगर्बीर
ਉਜਾਗਰ	उजागर
ਉਜਾਲਾ	उजाला
ਉਜ੍ਜਲਜੋਤ	उज्जलजोत
ਉਤ੍ਤਮ	उत्तम
ਉਤ੍ਤਮਪਾਲ	उत्तमपाल
ਉਤ੍ਤਮਲੀਵ	उत्तमलीव
ਉਤ੍ਤਾਮਕਾਰਾਮ	उत्तामकाराम
ਉਤ੍ਤਾਮਜੋਧ	उत्तामजोध
ਉਤ੍ਤਾਮਤਿਰਥ	उत्तामतिरथ
ਉਤ੍ਤਾਮਤੇਕ	उत्तामतेक
ਉਤ੍ਤਾਮਦੀਪ	उत्तामदीप
ਉਤ੍ਤਾਮਪਦ	उत्तामपद
ਉਤ੍ਤਾਮ੍ਰਸ	उत्ताम्रस
ਉਤ੍ਤਾਮ੍ਰੂਪ	उत्ताम्रूप
ਉਤ੍ਰਕ੍ਸ਼	उत्रक्श
ਉਦੀਤਦੀਪ	उदीतदीप
ਉਦੀਤਪ੍ਰਿਤ	उदीतप्रित
ਉਦੀਤਬੀਰ	उदीतबीर
ਉਦੈਬੀਰ	उदैबीर
ਉਦੈਭਗਤ	उदैभगत
ਉਦ੍ਦਾਮਜੀਤ	उद्दामजीत
ਉਪਕਰਮ	उपकरम
ਉਪਕਿਰਤ	उपकिरत
ਉਪਜਿਤ	उपजित
ਉਪਨਿਤ	उपनित
ਉਪੀਨਦੇਰ੍ਪ੍ਰਿਤ	उपीनदेर्प्रित
ਉਪੇਨ੍ਦੇਰ	उपेन्देर
ਉਮੀਦ	उमीद
ਊਤ੍ਤਮ੍ਗਿਆਨ	ऊत्तम्गिआन
ਏਕਂਕਰ	एकंकर
ਏਕਬੀਰ	एकबीर
ਏਕਮ	एकम
ਏਕਮਪੂਜ	एकमपूज
ਏਕਮਬੀਰ	एकमबीर
ਏਕਮ੍ਜੋਤ	एकम्जोत
ਏਕਮ੍ਰੂਪ	एकम्रूप
ਏਕਾਨਪ੍ਰੀਤ	एकानप्रीत
ਏਕ੍ਕਾਮ	एक्काम
ਏਤੀਬਾਰ	एतीबार
ਏਤ੍ਤਲੀਨ	एत्तलीन
ਏਰਸ਼ੀਨ	एरशीन
ਏਵੇਨਿਤ	एवेनित
ਏਸ਼ਨਾ	एशना
ਏਸ਼੍ਵਰ	एश्वर
ਓਨਕਾਰ੍ਜਿਤ	ओनकार्जित
ਓਨਕਾਰ੍ਜੀਤ	ओनकार्जीत
ਓਨਕਾਰ੍ਪ੍ਰਿਤ	ओनकार्प्रित
ਓਮਪ੍ਰਿਤ	ओमप्रित
ਕਂਵਲ	कंवल
ਕਂਵਲਜੀਤ	कंवलजीत
ਕਨਵਾਰ੍ਜਾਗਤ	कनवार्जागत
ਕਨਵਾਰ੍ਜਿਤ	कनवार्जित
ਕਨਵਾਰ੍ਪ੍ਰੇਮ	कनवार्प्रेम
ਕਨਵਾਲ੍ਜੋਤ	कनवाल्जोत
ਕਨਵਾਲ੍ਨੈਨ	कनवाल्नैन
ਕਨਵਾਲ੍ਪਾਲ	कनवाल्पाल
ਕਨਵਾਲ੍ਪ੍ਰੇਮ	कनवाल्प्रेम
ਕਨਵਾਲ੍ਬੀਰ	कनवाल्बीर
ਕਨਵਾਲ੍ਰੂਪ	कनवाल्रूप
ਕਨ੍ਚਨ੍ਦੀਪ	कन्चन्दीप
ਕਨ੍ਚਾਨ੍ਪਾਲ	कन्चान्पाल
ਕਨ੍ਵਾਰਪਾਲ	कन्वारपाल
ਕਮਾਲ੍ਲਾ	कमाल्ला
ਕਰਨਦੀਪ	करनदीप
ਕਰਨਪਾਲ	करनपाल
ਕਰਨਪ੍ਰਿਤ	करनप्रित
ਕਰਨਰੂਪ	करनरूप
ਕਰਮਪਲ	करमपल
ਕਰਮਪੁਲ	करमपुल
ਕਰਮ੍ਜੋਤ	करम्जोत
ਕਰੁਨ੍ਯਾ	करुन्या
ਕਲਬੀਰ	कलबीर
ਕਲਾਜੋਤ	कलाजोत
ਕਲਾਪ੍ਰੇਮ	कलाप्रेम
ਕਵਨਿਤ	कवनित
ਕਵਨੀਰ	कवनीर
ਕਵਾਲ੍ਨਾਨ	कवाल्नान
ਕਵਿਰਾਜ	कविराज
ਕਸਮ	कसम
ਕਾਨਵਾਲੀਨ੍ਦੇਰ	कानवालीन्देर
ਕਾਮਾਂਲਜੋਤ	कामांलजोत
ਕਾਮਾਂਲਮਿਤ	कामांलमित
ਕਾਮਾਂਲਮੋਹਨ	कामांलमोहन
ਕਾਮਾਂਲ੍ਪਤਿ	कामांल्पति
ਕਾਰਮਨ	कारमन
ਕਾਵਾਲਪ੍ਰਿਤ	कावालप्रित
ਕਿਰਣਜੀਤ	किरणजीत
ਕਿਰਨਰੂਪ	किरनरूप
ਕਿਰਨਸੁਖ	किरनसुख
ਕਿਸ਼ੇਨ	किशेन
ਕੁਂਵਰਜੀਤ	कुंवरजीत
ਕੁਲ	कुल
ਕੁਲਜੋਤ	कुलजोत
ਕੁਲਮਿਤ	कुलमित
ਕੁਲਰਾਤਨ	कुलरातन
ਕੁਲਰੂਪ	कुलरूप
ਕੁਲਵਂਠ	कुलवंठ
ਕੁਸ਼ਪ੍ਰਿਤ	कुशप्रित
ਕੇਵਾਲਦੀਪ	केवालदीप
ਕੇਵਾਲਬੀਰ	केवालबीर
ਕੋਉਰ	कोउर
ਕੋਮਾਂਲਜੀਤ	कोमांलजीत
ਕੋਮਾਂਲਪ੍ਰੇਮ	कोमांलप्रेम
ਕੋਮਾਲਦੀਪ	कोमालदीप
ਕੋਮਾਲਮਿਤ	कोमालमित
ਕੌਰ	कौर
ਕ੍ਰਿਸ਼੍ਦੀਪ	क्रिश्दीप
ਕ੍ਸ਼ਾਗਨ	क्शागन
ਕ੍ਸ਼ਾਗਰ	क्शागर
ਕ੍ਸ਼ਿਤਿਜ	क्शितिज
ਕ੍ਸ਼੍ਹੀਮ	क्श्हीम
ਖਰਗ	खरग
ਖਾਲਾਕ੍ਵੀਰ	खालाक्वीर
ਖੁਂਸ਼ਜੋਤ	खुंशजोत
ਖੁਸ	खुस
ਖੁਸ਼	खुश
ਖੁਸ਼ਜੀਤ	खुशजीत
ਖੇਮਵਂਤ	खेमवंत
ਗਗਨ	गगन
ਗਗਨਜੀਵ	गगनजीव
ਗਗਨਜੋਤ	गगनजोत
ਗਗਨਪ੍ਰਿਤ	गगनप्रित
ਗਗਨਮਿਤ	गगनमित
ਗਤਲੀਨ	गतलीन
ਗਤਸ਼ਰਣ	गतशरण
ਗਤਸੀਮਾਰ	गतसीमार
ਗਰੀਨ੍ਦੇਰ	गरीन्देर
ਗਰ੍ਗੋਤ	गर्गोत
ਗਾਤਨੀਵਾਸ	गातनीवास
ਗਿਅਨ	गिअन
ਗੀਂਜੀਵਨ	गींजीवन
ਗੀਂਰਾਤਨ	गींरातन
ਗੀਂਲੀਨ	गींलीन
ਗੀਅਂਗੀਤ	गीअंगीत
ਗੀਅਂਚੇਤਨ	गीअंचेतन
ਗੀਅਂਜੋਤ	गीअंजोत
ਗੀਅਂਪ੍ਰਿਤ	गीअंप्रित
ਗੀਅਂਰੂਪ	गीअंरूप
ਗੀਅਨੀਨਦੇਰ	गीअनीनदेर
ਗੀਅਨ੍ਬੀਰ	गीअन्बीर
ਗੀਆਨਪ੍ਰਿਤ	गीआनप्रित
ਗੀਆਨਲੀਨ	गीआनलीन
ਗੀਤ	गीत
ਗੀਤਲੀਨ	गीतलीन
ਗੀਤੀਨਦੇਰ	गीतीनदेर
ਗੁਣਿਤ	गुणित
ਗੁਨ ਦਾਤ	गुन दात
ਗੁਨਕਿਰਤ	गुनकिरत
ਗੁਨਜਸ	गुनजस
ਗੁਨਜਿਤ	गुनजित
ਗੁਨਜੀਵਨ	गुनजीवन
ਗੁਨਜੁਨ	गुनजुन
ਗੁਨਜੋਤ	गुनजोत
ਗੁਨਪ੍ਰਿਤ	गुनप्रित
ਗੁਨਮਿਤ	गुनमित
ਗੁਨਰਾਜ	गुनराज
ਗੁਨਸ਼ਾਂਤ	गुनशांत
ਗੁਨਾਤਮ	गुनातम
ਗੁਨਿਤਪੁਲ	गुनितपुल
ਗੁਨਿਤਪ੍ਰਿਤ	गुनितप्रित
ਗੁਨ੍ਰਿਤ	गुन्रित
ਗੁਰਕਮਲ਼	गुरकमल़
ਗੁਰਗਿਯਨ	गुरगियन
ਗੁਰਜਾਸ	गुरजास
ਗੁਰਜੀਵਨ	गुरजीवन
ਗੁਰਜੋਗ	गुरजोग
ਗੁਰਜੋਤ	गुरजोत
ਗੁਰਝੀਲ	गुरझील
ਗੁਰਤਰਣ	गुरतरण
ਗੁਰਤਿਰਥ	गुरतिरथ
ਗੁਰਦਰ੍ਸ਼ਨ	गुरदर्शन
ਗੁਰਦਿਤ	गुरदित
ਗੁਰਦੀਤ੍ਤਾ	गुरदीत्ता
ਗੁਰਦ੍ਵੀਪ	गुरद्वीप
ਗੁਰਨਾਦ	गुरनाद
ਗੁਰਨਾਮਾਸ੍ਕਾਰ	गुरनामास्कार
ਗੁਰਨੀਧ	गुरनीध
ਗੁਰਨੀਰ੍ਮਾਲ	गुरनीर्माल
ਗੁਰਨੀਸ਼ਾਨ	गुरनीशान
ਗੁਰਨ੍ਯਮ	गुरन्यम
ਗੁਰਪਰ੍ਵਿਨ	गुरपर्विन
ਗੁਰਪੀਨਦੇਰ	गुरपीनदेर
ਗੁਰਪ੍ਰੀਤਮ	गुरप्रीतम
ਗੁਰਬਕ੍ਸ਼	गुरबक्श
ਗੁਰਬਲੀਹਾਰ	गुरबलीहार
ਗੁਰਬੀਨ੍ਦੇਰ	गुरबीन्देर
ਗੁਰਬੀਰ	गुरबीर
ਗੁਰਭਜਨ	गुरभजन
ਗੁਰਭਾਗਤ	गुरभागत
ਗੁਰਮਾਰ	गुरमार
ਗੁਰਮਾਹੇਰ	गुरमाहेर
ਗੁਰਮੁਖ	गुरमुख
ਗੁਰਮੇਹਾਰ	गुरमेहार
ਗੁਰਮੈਲ	गुरमैल
ਗੁਰਮ੍ਰਿਤ	गुरम्रित
ਗੁਰਲੋਚਨ	गुरलोचन
ਗੁਰਵਿਂਦਰ	गुरविंदर
ਗੁਰਵੀਨ੍ਦੇਰ	गुरवीन्देर
ਗੁਰਵੀਰ	गुरवीर
ਗੁਰਸਨ੍ਦੀਪ	गुरसन्दीप
ਗੁਰਸ਼ਾਨ	गुरशान
ਗੁਰਸੁਖ	गुरसुख
ਗੁਰਸੇਵ	गुरसेव
ਗੁਰਹਾਰ੍ਪਾਲ	गुरहार्पाल
ਗੁਰਿਂਦਰ	गुरिंदर
ਗੁਰੀਨਦੇਰ੍ਪਾਲ	गुरीनदेर्पाल
ਗੁਰੁਕਾਰ	गुरुकार
ਗੁਰੁਗੁਲ੍ਝਾਰ	गुरुगुल्झार
ਗੁਰੁਚਰਣ	गुरुचरण
ਗੁਰੁਦਰ੍ਸ਼ਨ	गुरुदर्शन
ਗੁਰੁਦਾਸ	गुरुदास
ਗੁਰੁਦੀਪ	गुरुदीप
ਗੁਰੁਪ੍ਰੇਮ	गुरुप्रेम
ਗੁਰੁਬੀਰ	गुरुबीर
ਗੁਰੁਮਾਂਨ੍ਦੀਰ	गुरुमांन्दीर
ਗੁਰੁਸੀਮ੍ਰਣ	गुरुसीम्रण
ਗੁਰ੍ਕੀਰਣ	गुर्कीरण
ਗੁਰ੍ਕੀਰਪਾਲ	गुर्कीरपाल
ਗੁਰ੍ਚਾਰਾਨ੍ਜੋਤ	गुर्चारान्जोत
ਗੁਰ੍ਜਨਪਾਲ	गुर्जनपाल
ਗੁਰ੍ਜੁ	गुर्जु
ਗੁਰ੍ਤੇਜ	गुर्तेज
ਗੁਰ੍ਨੀਵਾਝ	गुर्नीवाझ
ਗੁਰ੍ਨੂਰ	गुर्नूर
ਗੁਰ੍ਪ੍ਰਿਤੀ	गुर्प्रिती
ਗੁਰ੍ਮੀਤ	गुर्मीत
ਗੁਰ੍ਮੀਨਦੇਰ	गुर्मीनदेर
ਗੁਰ੍ਮੁਖਨੀਹਲ	गुर्मुखनीहल
ਗੁਰ੍ਸ਼ਣ	गुर्शण
ਗੁਰ੍ਸ਼ਾਂਤ	गुर्शांत
ਗੁਰ੍ਸ਼ੀਲ	गुर्शील
ਗੁਰ੍ਸਾਹੇਬ	गुर्साहेब
ਗੁਲਦੀਪ	गुलदीप
ਗੁਲਵਂਤ	गुलवंत
ਗੁਲਸ਼ਾਨ੍ਰੂਪ	गुलशान्रूप
ਗੁਲ੍ਵਾਨ੍ਤਪ੍ਰਿਤ	गुल्वान्तप्रित
ਗੁਲ੍ਸ਼ਾਨਪ੍ਰਿਤ	गुल्शानप्रित
ਗੁਲ੍ਸ਼ਾਨਮਿਤ	गुल्शानमित
ਗੋਪਲਪ੍ਰਿਤ	गोपलप्रित
ਗੋਬਿਂਦ	गोबिंद
ਗੋਬੀਨਦੇਰ	गोबीनदेर
ਗੋਬੀਨਦੇਰ੍ਜਿਤ	गोबीनदेर्जित
ਗੋਬੀਨ੍ਦਰਾਈ	गोबीन्दराई
ਗੌਰਵ੍ਪ੍ਰਿਤ	गौरव्प्रित
ਘਮਾਂਨਦ੍ਜਿਤ	घमांनद्जित
ਘਮਾਂਨਦ੍ਪਾਲ	घमांनद्पाल
ਚਂਚਲਜਿਤ	चंचलजित
ਚਂਚਲ੍ਪ੍ਰੀਤ	चंचल्प्रीत
ਚਂਦਨ	चंदन
ਚਂਦਨਦੀਪ	चंदनदीप
ਚਮਕੌਰ	चमकौर
ਚਮਨਜਿਤ	चमनजित
ਚਮਨਪ੍ਰਿਤ	चमनप्रित
ਚਮਨਰੂਪ	चमनरूप
ਚਰਨਕਾਨ੍ਵਾਲ	चरनकान्वाल
ਚਰਨਜੋਤ /ਚਰਨਜ੍ਯੋਤ	चरनजोत /चरनज्योत
ਚਰਨਪ੍ਰੇਮ	चरनप्रेम
ਚਾਂਦ	चांद
ਚਿਤਰਾਮਣ	चितरामण
ਚਿਤਸਰੂਪ	चितसरूप
ਚੀਤਪ੍ਰਿਤ	चीतप्रित
ਚੇਤਨ੍ਦੀਪ	चेतन्दीप
ਜਗਜੀਤ	जगजीत
ਜਗਜੀਵ	जगजीव
ਜਗਜੀਵਨ	जगजीवन
ਜਗਤਜੀਤ	जगतजीत
ਜਗਤਪ੍ਰੇਮ	जगतप्रेम
ਜਗਤਰਣ	जगतरण
ਜਗਤਰੂਪ	जगतरूप
ਜਗਨ	जगन
ਜਗਪਾਲ	जगपाल
ਜਗਪ੍ਰਿਤ	जगप्रित
ਜਗਪ੍ਰੇਮ	जगप्रेम
ਜਗਮਿਤ	जगमित
ਜਗਮੇਹਾਰ	जगमेहार
ਜਗਮੋਹਨ	जगमोहन
ਜਗਰਾਜ	जगराज
ਜਗਰੂਪ	जगरूप
ਜਗਵੀਨ੍ਦੇਰ	जगवीन्देर
ਜਗਵੀਰ	जगवीर
ਜਗੀਨਦੇਰ	जगीनदेर
ਜਗੀਨ੍ਦੇਰਪਾਲ	जगीन्देरपाल
ਜਗ੍ਵੀਰ	जग्वीर
ਜਘ੍ਰ	जघ्र
ਜਤੀਨਦੇਰ੍ਜਿਤ	जतीनदेर्जित
ਜਤੀਨਦੇਰ੍ਬੀਰ	जतीनदेर्बीर
ਜਤੀਨਦੇਰ੍ਮਿਤ	जतीनदेर्मित
ਜਨਜਿਤ	जनजित
ਜਨਜੋਤ	जनजोत
ਜਨਪ੍ਰਿਤ	जनप्रित
ਜਨਰਾਜ	जनराज
ਜਨਿਸ਼	जनिश
ਜਪਜਿਤ	जपजित
ਜਪਧਾਰਾਮ	जपधाराम
ਜਪਧਿਰ	जपधिर
ਜਪਨਾਮ	जपनाम
ਜਪਸ਼ੇਰ	जपशेर
ਜਪੁਜੀ	जपुजी
ਜਬਰਜਂਗ	जबरजंग
ਜਮੀਲ	जमील
ਜਯਂਸ਼	जयंश
ਜਯਪਾਲ	जयपाल
ਜਰ੍ਨੈਲ	जर्नैल
ਜਲਿਨ੍ਦ੍ਰ	जलिन्द्र
ਜਲ੍ਬੀਰ	जल्बीर
ਜਸਂਜੋਤ	जसंजोत
ਜਸਂਪਾਲ	जसंपाल
ਜਸਂਮਿਤ	जसंमित
ਜਸਕੀਰਣ	जसकीरण
ਜਸਗੁਰ੍ਕੀਰ੍ਤਤ	जसगुर्कीर्तत
ਜਸਜੀਨ੍ਦੇਰ	जसजीन्देर
ਜਸਜੀਵਨ	जसजीवन
ਜਸਜੋਤ	जसजोत
ਜਸਤਰਣ	जसतरण
ਜਸਨਾਮ	जसनाम
ਜਸਪਾਲ (ਪੁਲ )	जसपाल (पुल )
ਜਸਬੀਰ	जसबीर
ਜਸਭੂਪ	जसभूप
ਜਸਮਿਂਦਰ	जसमिंदर
ਜਸਮੋਹਨ	जसमोहन
ਜਸਰੂਪ	जसरूप
ਜਸ੍ਕਰਣ	जस्करण
ਜਸ੍ਕੀਰਿਤ	जस्कीरित
ਜਸ੍ਕੀਰ੍ਪਲ	जस्कीर्पल
ਜਸ੍ਗੁਨ	जस्गुन
ਜਸ੍ਮਿਤ	जस्मित
ਜਸ੍ਮੀਨਪ੍ਰਿਤ	जस्मीनप्रित
ਜਸ੍ਰਜਪ੍ਰਿਤ	जस्रजप्रित
ਜਸ੍ਸੀ	जस्सी
ਜਾਗ	जाग
ਜਾਗਰੀਤ	जागरीत
ਜਾਤਵਂਤ	जातवंत
ਜਾਤਿਨਦੇਰ੍ਦੀਪ	जातिनदेर्दीप
ਜਾਨਾਕਪ੍ਰਿਤ	जानाकप्रित
ਜਾਪਮਾਨ	जापमान
ਜਾਸਨਿਤ	जासनित
ਜਾਸ਼ਾਨਪ੍ਰਿਤ	जाशानप्रित
ਜਾਸ੍ਮੀਲ	जास्मील
ਜੀਵਨਦੀਪ ; ਜੀਵਨਦੀਪ ; ਜੀਵਨਦੀਪ	जीवनदीप ; जीवनदीप ; जीवनदीप
ਜੀਵਨਪਲ	जीवनपल
ਜੀਵਨਪ੍ਰਿਤ	जीवनप्रित
ਜੀਵਾਨਬੀਰ	जीवानबीर
ਜੁਗਦ	जुगद
ਜੁਪੀਨਦੇਰਦੀਪ	जुपीनदेरदीप
ਜੁਪੀਨਦੇਰ੍ਬੀਰ	जुपीनदेर्बीर
ਜੁਸਜਿਤ	जुसजित
ਜੁਸਪੁਲ	जुसपुल
ਜੁਸਮੈਲ	जुसमैल
ਜੇਬਾ	जेबा
ਜੇਸਪਾਲ	जेसपाल
ਜੈਕਾਰ	जैकार
ਜੈਪ੍ਰਜ	जैप्रज
ਜੈਪ੍ਰਤਨ	जैप्रतन
ਜੈਬੀਰ	जैबीर
ਜੈਸਂਗਤ	जैसंगत
ਜੈਸੁਖਬੀਰ	जैसुखबीर
ਜੋਗਧੀਆਨ	जोगधीआन
ਜੋਗਪ੍ਰਕਾਸ਼	जोगप्रकाश
ਜੋਗੀਨਦੇਰ੍ਬੀਰ	जोगीनदेर्बीर
ਜੋਗੀਨਦੇਰ੍ਮਿਤ	जोगीनदेर्मित
ਜੋਗੇਨਦੇਰ	जोगेनदेर
ਜੋਤਪ੍ਰਕਾਸ਼	जोतप्रकाश
ਜੋਬਨਰੂਪ	जोबनरूप
ਜੋਹਾਰ	जोहार
ਜ੍ਞਾਨਜਿਤ	ज्ञानजित
ਜ੍ਞਾਨਜੋਤ	ज्ञानजोत
ਜ੍ਞਾਨਪ੍ਰਿਤ	ज्ञानप्रित
ਜ੍ਞਾਨਰੂਪ	ज्ञानरूप
ਜ੍ਞਾਨਵੀਰ	ज्ञानवीर
ਜ੍ਞਾਨੇਨ੍ਦੇਰ	ज्ञानेन्देर
ਜ੍ਹਮਕ	ज्हमक
ਜ੍ਹਾਗਰ	ज्हागर
ਝਈਤੂਨ	झईतून
ਝਹਾਗਨ	झहागन
ਝਾਮੀਨਾਹ	झामीनाह
ਝੀਤੁਨ	झीतुन
ਝੀਲ	झील
ਝੁਲਾਖਾ	झुलाखा
ਝੁਲ੍ਫਾ	झुल्फा
ਝੇਬਵਂਤ	झेबवंत
ਝੋਰਾਵਾਰ	झोरावार
ਟੇਇਜਿਨ੍ਦੇਰ	टेइजिन्देर
ਤਕਦੀਰ	तकदीर
ਤਖਤ	तखत
ਤਤਜੋਗ	ततजोग
ਤਤਬੀਰ	ततबीर
ਤਤਵਿਚਾਰ	ततविचार
ਤਤ੍ਰਾਤਨ	तत्रातन
ਤਦਬੀਰ	तदबीर
ਤਨਦੀਪ	तनदीप
ਤਨਵੀਰ	तनवीर
ਤਮਨ੍ਪ੍ਰਿਤ	तमन्प्रित
ਤਰਣਵੀਰ	तरणवीर
ਤਰਲੋਚਨ	तरलोचन
ਤਰਸੇਮ	तरसेम
ਤਰੁਨਜਿਤ	तरुनजित
ਤਲਵਿਨ	तलविन
ਤਾਜਦਾਰ	ताजदार
ਤਾਜੀਨਦੇਰ੍ਦੀਪ	ताजीनदेर्दीप
ਤਾਜੀਨਦੇਰ੍ਪ੍ਰੇਮ	ताजीनदेर्प्रेम
ਤਾਨੁਪ੍ਰਿਤ	तानुप्रित
ਤਾਪਨਪਾਲ	तापनपाल
ਤੀਰਨ /ਤਿਹ੍ਰਣ /ਤੇਯ੍ਰੁਣ	तीरन /तिह्रण /तेय्रुण
ਤੀਰਾਥ੍ਰਾਮ	तीराथ्राम
ਤੁਵਿਜਾਤ	तुविजात
ਤੇਕਜੀਤ	तेकजीत
ਤੇਕਦੀਪ	तेकदीप
ਤੇਕਪ੍ਰਿਤ	तेकप्रित
ਤੇਕ੍ਪਾਲ	तेक्पाल
ਤੇਘਬਹਾਦੁਰ	तेघबहादुर
ਤੇਜਧਾਰਾਮ	तेजधाराम
ਤੇਜਨਾਮ	तेजनाम
ਤੇਜਪ੍ਰਤਾਪ	तेजप्रताप
ਤੇਜ਼	तेज़
ਤੇਜਾਸਵੀਰ	तेजासवीर
ਤੇਜੀਨਦੇਰ੍ਜੀਤ	तेजीनदेर्जीत
ਤੇਜੀਨਦੇਰ੍ਪਾਲ	तेजीनदेर्पाल
ਤੋਤਾਸਿਂਹ	तोतासिंह
ਤ੍ਰਿਪਲ	त्रिपल
ਤ੍ਰਿਲੋਚਨ	त्रिलोचन
ਤ੍ਰੀਭਾਵਾਨ	त्रीभावान
ਤ੍ਰੀਸ਼ਾਨਜੋਤ	त्रीशानजोत
ਤ੍ਰੀਸ਼ਾਨਦੀਪ	त्रीशानदीप
ਤ੍ਰੀਸ਼ਾਨਬੀਰ	त्रीशानबीर
ਥਾਕੁਰਨਾਮ	थाकुरनाम
ਥਾਲਭੂਪ	थालभूप
ਥਾਲਰਾਜ	थालराज
ਥੀਰਮਾਨ	थीरमान
ਥੀਰ੍ਧੀਆਨ	थीर्धीआन
ਦਮਨਜਿਤ	दमनजित
ਦਮਨਜੋਤ	दमनजोत
ਦਯਾਜੋਤ	दयाजोत
ਦਯਾਦੀਪ	दयादीप
ਦਰਮੀਨ੍ਦੇਰ	दरमीन्देर
ਦਰ੍ਪ੍ਰਿਤ	दर्प्रित
ਦਲਜੋਧ	दलजोध
ਦਲਬੀਨਦੇਰ	दलबीनदेर
ਦਲਬੀਨ੍ਦੇਰ੍ਜਿਤ	दलबीन्देर्जित
ਦਲਰਾਜ	दलराज
ਦਲੇਰ	दलेर
ਦਵੀਨ੍ਦੇਰ	दवीन्देर
ਦਿਦਾਰ	दिदार
ਦਿਨਤੇਕ	दिनतेक
ਦਿਪਲੀਨ	दिपलीन
ਦਿਲਜੋਤ	दिलजोत
ਦਿਲਨਿਤ	दिलनित
ਦਿਲਪ੍ਰਿਤ	दिलप्रित
ਦਿਲਮਿਤ	दिलमित
ਦਿਲਰਿਤ	दिलरित
ਦਿਲਸ਼ਾਨ	दिलशान
ਦਿਲਸ਼ੇਰ	दिलशेर
ਦਿਵ੍ਯਜ੍ਯੋਤ	दिव्यज्योत
ਦੀਲਜੀਤ	दीलजीत
ਦੀਲਬਾਘ	दीलबाघ
ਦੀਲ੍ਜਿਤ	दील्जित
ਦੀਵ੍ਯਜੋਤ	दीव्यजोत
ਦੇਵਜੀਤ	देवजीत
ਦੇਵਪ੍ਰਿਤ	देवप्रित
ਦੇਵਾਤ੍ਮਾ	देवात्मा
ਦੇਵੀਨ੍ਦੇਰ	देवीन्देर
ਧਰਮਜ੍ਯੋਤ	धरमज्योत
ਧਰਮਪਾਲ	धरमपाल
ਧਰਮਪ੍ਰੀਤ	धरमप्रीत
ਧਰਮਲੀਨ	धरमलीन
ਧੀਅਨ੍ਜੋਗ	धीअन्जोग
ਨਕ੍ਸ਼ਤ੍ਰਾ	नक्शत्रा
ਨਮ੍ਰੀਤਾਬੀਰ	नम्रीताबीर
ਨਯਨਦੀਪ	नयनदीप
ਨਰਿਨ੍ਦਰ	नरिन्दर
ਨਰੇਨ੍ਦ੍ਰ	नरेन्द्र
ਨਵਜੀਤ	नवजीत
ਨਵਜੀਵਨ	नवजीवन
ਨਵਦੀਪ	नवदीप
ਨਵਬੀਰ	नवबीर
ਨਵਮਿਤ	नवमित
ਨਵ੍ਜੀਨ੍ਦੇਰ	नव्जीन्देर
ਨਾਗਂਦਰ	नागंदर
ਨਾਨਕੀ	नानकी
ਨਾਨਵੀਰ	नानवीर
ਨਾਨ੍ਦਾਨਜਿਤ	नान्दानजित
ਨਾਨ੍ਦਾਨਪ੍ਰਿਤ	नान्दानप्रित
ਨਾਮਜੀਵ	नामजीव
ਨਾਮਜੋਗ	नामजोग
ਨਾਮਜੋਤ	नामजोत
ਨਾਮਜੋਧ	नामजोध
ਨਾਮਧਾਰ	नामधार
ਨਾਮਧਿਯਨ	नामधियन
ਨਾਮਧਿਰ	नामधिर
ਨਾਮਨੀਰ੍ਮਾਲ	नामनीर्माल
ਨਾਮਨੀਵਾਸ	नामनीवास
ਨਾਮਪ੍ਰਿਤ	नामप्रित
ਨਾਮਪ੍ਰੇਮ	नामप्रेम
ਨਾਮਭਾਗਤ	नामभागत
ਨਾਮਵਿਚਾਰ	नामविचार
ਨਾਮਸ਼ਰਣ	नामशरण
ਨਾਮਾਂਡੋਲ਼	नामांडोल़
ਨਾਮਾਹਾਰ	नामाहार
ਨਾਮੁਤ੍ਤਮ	नामुत्तम
ਨਾਮ੍ਰਾਤਨ	नाम्रातन
ਨਾਮ੍ਰਿਤਾ	नाम्रिता
ਨਾਮ੍ਰੀਤਾਜੋਤ	नाम्रीताजोत
ਨਾਮ੍ਰੀਤਾਦੀਪ	नाम्रीतादीप
ਨਾਮ੍ਰੀਤਾਪ੍ਰਿਤ	नाम्रीताप्रित
ਨਾਰ	नार
ਨਾਰਂਜਨ	नारंजन
ਨਾਰੀਤਪਲ	नारीतपल
ਨਾਰੀਨਦੇਰਦੀਪ	नारीनदेरदीप
ਨਾਰੈਨ	नारैन
ਨਾਵਿਨਜਿਤ	नाविनजित
ਨਾਵ੍ਕੀਰਣ	नाव्कीरण
ਨਾਵ੍ਕੀਰਨਜੋਤ	नाव्कीरनजोत
ਨਾਵ੍ਪ੍ਰਿਤ	नाव्प्रित
ਨਿਮਾਈ	निमाई
ਨਿਰਂਜਨ	निरंजन
ਨਿਰਂਜਨਾ	निरंजना
ਨਿਰ੍ਮਲਜੀਤ	निर्मलजीत
ਨਿਲਾਮਜੋਤ	निलामजोत
ਨਿਲਾਮਪੁਲ	निलामपुल
ਨਿਲਾਮਪ੍ਰਿਤ	निलामप्रित
ਨਿਲਾਮਬੇਰ	निलामबेर
ਨਿਸ਼ਾ	निशा
ਨਿਹ੍ਚਾਲਤੇਕ	निह्चालतेक
ਨਿਹ੍ਚਾਲਮਿਤ	निह्चालमित
ਨੀਤਨਾਮ	नीतनाम
ਨੀਨਦੇਰ੍ਬੀਰ	नीनदेर्बीर
ਨੀਮਮਾਂਪ੍ਰਿਤ	नीममांप्रित
ਨੀਮਮਾਂਰ੍ਦੀਪ	नीममांर्दीप
ਨੀਮ੍ਮਾਂਰਤਾ	नीम्मांरता
ਨੀਮ੍ਰਤ	नीम्रत
ਨੀਰਮਾਂਲਦੀਪ	नीरमांलदीप
ਨੀਰਮਾਂਲਬੀਰ	नीरमांलबीर
ਨੀਰਮੋਲ	नीरमोल
ਨੀਰਵੈਰ	नीरवैर
ਨੀਰ੍ਭਾਉ	नीर्भाउ
ਨੀਰ੍ਮਾਂਲਕਾਰਾਮ	नीर्मांलकाराम
ਨੀਰ੍ਮਾਂਲਜੀਵ	नीर्मांलजीव
ਨੀਰ੍ਮਾਂਲਜੋਤ	नीर्मांलजोत
ਨੀਰ੍ਮਾਂਲਤੇਕ	नीर्मांलतेक
ਨੀਰ੍ਮਾਂਲਧਾਰਾਮ	नीर्मांलधाराम
ਨੀਰ੍ਮਾਂਲਪ੍ਰਿਤ	नीर्मांलप्रित
ਨੀਸ਼ਾਨ੍ਦੀਪ	नीशान्दीप
ਨੀਹ੍ਚਾਲ੍ਪ੍ਰੇਮ	नीह्चाल्प्रेम
ਨੂਰਦੇਵ	नूरदेव
ਨੂਰਨਿਤ	नूरनित
ਨੂਰਪ੍ਰਿਤ	नूरप्रित
ਨੇਕਨਾਮ	नेकनाम
ਨੇਕੀਨਦੇਰ	नेकीनदेर
ਨੇਕ੍ਦੀਪ	नेक्दीप
ਨੇਕ੍ਪਾਲ	नेक्पाल
ਨੇਹ੍ਚਾਲਪ੍ਰਿਤ	नेह्चालप्रित
ਨੈਨਤਾਰ	नैनतार
ਨੈਨਦੀਪ	नैनदीप
ਨੈਨੀਨਦੇਰ	नैनीनदेर
ਨੋਉਲਖ	नोउलख
ਨੌਹਨੀਹਲ	नौहनीहल
ਨ੍ਰੀਪਜੋਤ	न्रीपजोत
ਪਤਵਂਤ	पतवंत
ਪਤਵੀਰ	पतवीर
ਪਦਾਮਜਿਤ	पदामजित
ਪਦਾਮਪ੍ਰੇਮ	पदामप्रेम
ਪਦ੍ਮਸ਼੍ਰੀ	पद्मश्री
ਪਰਤਾਪ ; ਪਰਤਾਪ	परताप ; परताप
ਪਰਤਾਪੀ	परतापी
ਪਰਦੀਪ	परदीप
ਪਰਬੀਨ	परबीन
ਪਰਮਕਮਲ਼	परमकमल़
ਪਰਮਕਿਰਤ	परमकिरत
ਪਰਮਗੁਨ	परमगुन
ਪਰਮਜਾਪ	परमजाप
ਪਰਮਜੀਤ ; ਪਰਮਜੀਤ	परमजीत ; परमजीत
ਪਰਮਜੁਗਤ	परमजुगत
ਪਰਮਜੋਗ	परमजोग
ਪਰਮਜੋਧ	परमजोध
ਪਰਮਠਾਕਰ	परमठाकर
ਪਰਮਤੇਕ	परमतेक
ਪਰਮਦੀਪ	परमदीप
ਪਰਮਧਾਰਾਮ	परमधाराम
ਪਰਮਧਿਰ	परमधिर
ਪਰਮਪਾਲ	परमपाल
ਪਰਮਪ੍ਰੇਮ	परमप्रेम
ਪਰਮਬੋਧ	परमबोध
ਪਰਮਯੋਗ	परमयोग
ਪਰਮਰਂਗ	परमरंग
ਪਰਮਲੀਨ	परमलीन
ਪਰਮਸ਼ਾਂਤ	परमशांत
ਪਰਮਸਿਤਾਲ	परमसिताल
ਪਰਮਸੁਖ	परमसुख
ਪਰਮਸੇਵਕ	परमसेवक
ਪਰਮਾਧਾਰ	परमाधार
ਪਰਮਾਰ੍ਥ	परमार्थ
ਪਰਮਿਂਦਰ	परमिंदर
ਪਰਮੀਤ	परमीत
ਪਰਮ੍ਦਯਾ	परम्दया
ਪਰਸਂਜੀਤ	परसंजीत
ਪਰਸ਼ੋਤਮ	परशोतम
ਪਰਾਮਨੀਵਾਸ	परामनीवास
ਪਰੀਦਰ੍ਸ਼ਨ	परीदर्शन
ਪਰ੍ਗਤ	पर्गत
ਪਰ੍ਵੀਨ੍ਦੇਰ	पर्वीन्देर
ਪਲਬੀਨਦੇਰ	पलबीनदेर
ਪਲਵੀਨ੍ਦੇਰ੍ਪਾਲ	पलवीन्देर्पाल
ਪਵਾਨਜੋਤ	पवानजोत
ਪਵਾਨਦੀਪ	पवानदीप
ਪਵਾਨਪ੍ਰਿਤ	पवानप्रित
ਪਵਾਨਵੀਰ	पवानवीर
ਪਵੀਤ	पवीत
ਪਾਰਂਗਤ	पारंगत
ਪੁਨੀਤ	पुनीत
ਪੁਨੀਤਪਾਲ	पुनीतपाल
ਪੁਰਾਨਪ੍ਰੇਮ	पुरानप्रेम
ਪੁਰਾਨ੍ਜੀਤ	पुरान्जीत
ਪੁਸ਼ਪ੍ਰਿਤ	पुशप्रित
ਪੁਸ਼੍ਪਿਤਾ	पुश्पिता
ਪੂਰਨਜੀਤ	पूरनजीत
ਪ੍ਰਗਿਤ	प्रगित
ਪ੍ਰਜਨਾ	प्रजना
ਪ੍ਰਣਿਤ	प्रणित
ਪ੍ਰਨੀਤਾ	प्रनीता
ਪ੍ਰਫੂਲਦੀਪ	प्रफूलदीप
ਪ੍ਰਭਕੀਰਤ	प्रभकीरत
ਪ੍ਰਭਕੀਰ੍ਪਾਲ	प्रभकीर्पाल
ਪ੍ਰਭਗੀਤ	प्रभगीत
ਪ੍ਰਭਚਰਣ	प्रभचरण
ਪ੍ਰਭਚੇਤਨ	प्रभचेतन
ਪ੍ਰਭਜਿਤ	प्रभजित
ਪ੍ਰਭਜੀਤ	प्रभजीत
ਪ੍ਰਭਜੀਵਨ	प्रभजीवन
ਪ੍ਰਭਜੋਗ	प्रभजोग
ਪ੍ਰਭਜੋਤੇ	प्रभजोते
ਪ੍ਰਭਜੋਧ	प्रभजोध
ਪ੍ਰਭਤਿਰਥ	प्रभतिरथ
ਪ੍ਰਭਦਾਸ	प्रभदास
ਪ੍ਰਭਧਿਯਨ	प्रभधियन
ਪ੍ਰਭਧਿਰਾਜ	प्रभधिराज
ਪ੍ਰਭਨਾਮ	प्रभनाम
ਪ੍ਰਭਨੂਰ	प्रभनूर
ਪ੍ਰਭਪਰ੍ਵਾਨ	प्रभपर्वान
ਪ੍ਰਭਬੋਧ	प्रभबोध
ਪ੍ਰਭਮਿਤ	प्रभमित
ਪ੍ਰਭਮੇਹਾਰ	प्रभमेहार
ਪ੍ਰਭਲੀਨ	प्रभलीन
ਪ੍ਰਭਵਿਚਾਰ	प्रभविचार
ਪ੍ਰਭਸਂਗਤ	प्रभसंगत
ਪ੍ਰਭਸਿਤਾਲ	प्रभसिताल
ਪ੍ਰਭਾਤਕੀਰਣ	प्रभातकीरण
ਪ੍ਰਭ੍ਰਮਣ	प्रभ्रमण
ਪ੍ਰਭ੍ਰਾਤਨ	प्रभ्रातन
ਪ੍ਰਭ੍ਰੂਪ	प्रभ्रूप
ਪ੍ਰਸ਼ਾਰਨਬੀਰ	प्रशारनबीर
ਪ੍ਰਿਤਮੋਹਨ	प्रितमोहन
ਪ੍ਰਿਤੀਨ੍ਦੇਰ	प्रितीन्देर
ਪ੍ਰਿਤ੍ਵੀਰ	प्रित्वीर
ਪ੍ਰੀਤਪਾਲ	प्रीतपाल
ਪ੍ਰੀਤਮ੍ਹਾਰੀ	प्रीतम्हारी
ਪ੍ਰੀਤਾਮਜਿਤ	प्रीतामजित
ਪ੍ਰੀਥਾਮ੍ਦੀਪ	प्रीथाम्दीप
ਪ੍ਰੀਥੀਪਾਲ	प्रीथीपाल
ਪ੍ਰੀਥ੍ਵੀਪਾਲ	प्रीथ्वीपाल
ਪ੍ਰੇਮਜਿਤ	प्रेमजित
ਪ੍ਰੇਮਤੇਕ	प्रेमतेक
ਪ੍ਰੇਮਪਾਲ	प्रेमपाल
ਪ੍ਰੇਮਬਂਸ	प्रेमबंस
ਪ੍ਰੇਮਭਾਗਤ	प्रेमभागत
ਪ੍ਰੇਮਰਂਗ	प्रेमरंग
ਪ੍ਰੇਮਰਮਣ	प्रेमरमण
ਪ੍ਰੇਮਰਸ	प्रेमरस
ਪ੍ਰੇਮਲੀਨ	प्रेमलीन
ਪ੍ਰੇਮਵਾਂਤ	प्रेमवांत
ਪ੍ਰੇਮਸੀਰੀ	प्रेमसीरी
ਪ੍ਰੇਮਸੁਖ	प्रेमसुख
ਪ੍ਰੇਮ੍ਵੀਰ	प्रेम्वीर
ਫਕੀਰ	फकीर
ਫਤੇਹਕਾਰਾਮ	फतेहकाराम
ਫਤੇਹਪ੍ਰਿਤ	फतेहप्रित
ਫਤੇਹਬੀਰ	फतेहबीर
ਫਤੇਹ੍ਵਂਤ	फतेह्वंत
ਫਾਜਲ	फाजल
ਫੁਲਵਂਤ	फुलवंत
ਫੋਜੀਨਦੇਰ	फोजीनदेर
ਬਂਸਮਿਤ	बंसमित
ਬਕ੍ਸ਼ੀ	बक्शी
ਬਚਾਨਬੀਰ	बचानबीर
ਬਚੀਨ੍ਤ	बचीन्त
ਬਨੀਤ	बनीत
ਬਨੀਨਦੇਰ	बनीनदेर
ਬਰਿਨ੍ਦ੍ਰ	बरिन्द्र
ਬਰੀਨ੍ਦੇਰ	बरीन्देर
ਬਲਤੇਜ	बलतेज
ਬਲਦੀਪ	बलदीप
ਬਲਦੇਵ	बलदेव
ਬਲਮੋਹਨ	बलमोहन
ਬਲਰਾਜ	बलराज
ਬਲਵਿਂਦਰ	बलविंदर
ਬਲੀਨਦੇਰ	बलीनदेर
ਬਲੀਹਾਰ	बलीहार
ਬਲ੍ਵਿਨ੍ਦ੍ਰ	बल्विन्द्र
ਬਲ੍ਵੀਨ੍ਦੇਰ	बल्वीन्देर
ਬਹਾਦਰ	बहादर
ਬਾਲਮਿਤ	बालमित
ਬਿਸ਼ਨਪਾਲ	बिशनपाल
ਬਿਸ੍ਮੀਤ	बिस्मीत
ਬੀਨਦੇਰ	बीनदेर
ਬੀਨਾ	बीना
ਬੀਬੀਨਾਨਾਕੀ	बीबीनानाकी
ਬੀਮਾਂਲਜੋਤ	बीमांलजोत
ਬੀਰੀਨਦਾਰ	बीरीनदार
ਬੀਸਮਾਧ	बीसमाध
ਬੀਸ਼੍ਮਿਤ	बीश्मित
ਬੁਜੀ	बुजी
ਬੁਧ੍ਪ੍ਰਿਤ	बुध्प्रित
ਬੁਧ੍ਰੂਪ	बुध्रूप
ਬੇਂਤ	बेंत
ਬੇਨ੍ਨੀ	बेन्नी
ਬੇਬੇ	बेबे
ਬੈਰਾਗੀ	बैरागी
ਬ੍ਰਹਮਜੋਤ	ब्रहमजोत
ਬ੍ਰਹਾਮਲੀਨ	ब्रहामलीन
ਬ੍ਰਹਾਮ੍ਜੀਤ	ब्रहाम्जीत
ਬ੍ਰਹ੍ਮਲੀਨ	ब्रह्मलीन
ਬ੍ਰਹ੍ਮਵੀਰ	ब्रह्मवीर
ਬ੍ਰਿਜੇਂਦਰ	ब्रिजेंदर
ਬ੍ਰੀਜੋਧ	ब्रीजोध
ਭਗਤ	भगत
ਭਗਵਾਨ	भगवान
ਭਜਨਿਕ	भजनिक
ਭਰਪੂਰ	भरपूर
ਭਾਘਵੀਨ੍ਦੇਰ	भाघवीन्देर
ਭਾਜ੍ਨਾਮ	भाज्नाम
ਭਾਜ੍ਨਿਤ	भाज्नित
ਭਾਵਜਿਤ	भावजित
ਭਾਵਜੀਨ੍ਦੇਰ	भावजीन्देर
ਭਾਵਨਦੀਪ	भावनदीप
ਭਾਵਨੀਤ	भावनीत
ਭਾਵਪਾਲ	भावपाल
ਭਾਵਪ੍ਰੇਮ	भावप्रेम
ਭਾਵਲੀਨ	भावलीन
ਭੀਨਦੇਰ੍ਪਾਲ	भीनदेर्पाल
ਭੁਪੀਨ੍ਦੇਰ	भुपीन्देर
ਮਂਗਲਾ	मंगला
ਮਂਤੇਕ	मंतेक
ਮਜਾਲ	मजाल
ਮਣਿਪਾਲ	मणिपाल
ਮਧੁਪ੍ਰਿਤ	मधुप्रित
ਮਧੁਰਬੀਨ	मधुरबीन
ਮਧੁਵਂਤ	मधुवंत
ਮਨਵਂਤ	मनवंत
ਮਰਦੁਲਾ	मरदुला
ਮਸ੍ਤਪ੍ਰੇਮ	मस्तप्रेम
ਮਸ੍ਤਾਨ	मस्तान
ਮਸ੍ਤੁਕ	मस्तुक
ਮਸ੍ਤ੍ਵੀਰ	मस्त्वीर
ਮਹਨਬੀਰ	महनबीर
ਮਹਾਜਿਤ	महाजित
ਮਹਾਨਗਿਯਨ	महानगियन
ਮਹਾਨਗੀਤ	महानगीत
ਮਹਾਨਗੁਨ	महानगुन
ਮਹਾਨਜਿਤ	महानजित
ਮਹਾਨਜੀਵਨ	महानजीवन
ਮਹਾਨਜੋਤ	महानजोत
ਮਹਾਨਤੇਕ	महानतेक
ਮਹਾਨਤ੍ਰੀਪਾਤ	महानत्रीपात
ਮਹਾਨਦੀਪ	महानदीप
ਮਹਾਨਪਾਲ	महानपाल
ਮਹਾਨਪ੍ਰੇਮ	महानप्रेम
ਮਹਾਨਭਗਤ	महानभगत
ਮਹਿਨਦੇਰ੍ਪ੍ਰਿਤ	महिनदेर्प्रित
ਮਹੀਨਗਾ	महीनगा
ਮਹੀਨਦੇਰ੍ਪਾਲ	महीनदेर्पाल
ਮਹੇਕਪ੍ਰਿਤ	महेकप्रित
ਮਹੇਨਦੇਰ	महेनदेर
ਮਹੇਰਬਾਨੀ	महेरबानी
ਮਹੇਸ਼ੀਨਦੇਰ	महेशीनदेर
ਮਾਂਨਕਰਣ	मांनकरण
ਮਾਂਨਗਲ੍ਪ੍ਰਿਤ	मांनगल्प्रित
ਮਾਂਨਵਾਨ੍ਤ੍ਬੀਰ	मांनवान्त्बीर
ਮਾਂਨਸੀਰਤ	मांनसीरत
ਮਾਂਨਾਵੀਨਦੇਰ	मांनावीनदेर
ਮਾਂਨਾਸਪ੍ਰੇਮ	मांनासप्रेम
ਮਾਂਨੀਨਦੇਰ੍ਬੀਰ	मांनीनदेर्बीर
ਮਾਂਨੋਹਾਰਜੋਤ	मांनोहारजोत
ਮਾਂਨੋਹਾਰਦੀਪ	मांनोहारदीप
ਮਾਂਨੋਹਾਰ੍ਜੀਤ	मांनोहार्जीत
ਮਾਂਨੋਹਾਰ੍ਪਲ	मांनोहार्पल
ਮਾਂਨ੍ਗਲ੍ਜੀਤ	मांन्गल्जीत
ਮਾਂਨ੍ਗਲ੍ਪ੍ਰੇਮ	मांन्गल्प्रेम
ਮਾਂਨ੍ਸ਼ਿਤਾਲ	मांन्शिताल
ਮਾਦਨਬੀਰ	मादनबीर
ਮਾਦਾਨਕੀਰ੍ਪਾਲ	मादानकीर्पाल
ਮਾਦਾਨਪਾਲ	मादानपाल
ਮਾਨਤੇਜ	मानतेज
ਮਾਨਦੇਵ	मानदेव
ਮਾਨਪੁਲ	मानपुल
ਮਾਨਬੀਰ	मानबीर
ਮਾਨਰਿਤ	मानरित
ਮਾਨਾਸਦੀਪ	मानासदीप
ਮਾਨ੍ਕੀਰਣ	मान्कीरण
ਮਾਨ੍ਗਲ੍ਜੋਤ	मान्गल्जोत
ਮਾਨ੍ਪ੍ਰੀਯਾ	मान्प्रीया
ਮਾਯ੍ਰਾਯ	माय्राय
ਮਿਤ੍ਰਾ	मित्रा
ਮਿਤ੍ਰਾਜ	मित्राज
ਮੀਰਾ	मीरा
ਮੁਕੁਂਦਾ	मुकुंदा
ਮੁਕੁਨਦ੍ਪ੍ਰਿਤ	मुकुनद्प्रित
ਮੁਖ੍ਤਯਾਰ	मुख्तयार
ਮੁਦ੍ਰਾ	मुद्रा
ਮੁਨਦੀਪ	मुनदीप
ਮੁਨਲੇਨੇ	मुनलेने
ਮੇਸ਼	मेश
ਮੇਹਰ	मेहर
ਮੇਹਾਰਤੇਕ	मेहारतेक
ਮੇਹਾਰਪਲ	मेहारपल
ਮੇਹਾਰਪ੍ਰਿਤ	मेहारप्रित
ਮੇਹਾਰਭੂਪ	मेहारभूप
ਮੇਹਾਰਮਿਤ	मेहारमित
ਮੇਹੇਰ	मेहेर
ਮੇਹੇਰਬਾਨੀ	मेहेरबानी
ਮੋਨੀਨ੍ਦੇਰ	मोनीन्देर
ਮੋਹਨਤੇਕ	मोहनतेक
ਮੋਹਨਮਿਤ	मोहनमित
ਮੋਹਨਲੀਨ	मोहनलीन
ਮੋਹਨਵਂਤ	मोहनवंत
ਮੋਹਨਵੀਰ	मोहनवीर
ਮੋਹਿਨ੍ਦੇਰਪਾਲ	मोहिन्देरपाल
ਮੋਹੇਨਪਲ	मोहेनपल
ਮੋਹੇਨਪ੍ਰਿਤ	मोहेनप्रित
ਯਕਿਨ	यकिन
ਯਸ਼ਜੋਤ	यशजोत
ਯਸ਼ਨੂਰ	यशनूर
ਯਸ਼ਪਾਲ	यशपाल
ਯਸ਼ਵਂਤ	यशवंत
ਯਸ਼੍ਦੀਪ	यश्दीप
ਯਾਤੀਨਪਾਲ	यातीनपाल
ਯਾਦਲੀਨ	यादलीन
ਯਾਦਵੀਰ	यादवीर
ਯਾਦ੍ਬੀਰ	याद्बीर
ਯਾਸ੍ਮੀਨੇ	यास्मीने
ਯੁਵਰਾਨੀ	युवरानी
ਯੋਗੇਸ਼ਪਾਲ	योगेशपाल
ਰਂਗ ਰਮਨ	रंग रमन
ਰਂਗਜੋਤ	रंगजोत
ਰਂਗਪ੍ਰਿਤ	रंगप्रित
ਰਂਗਾਤਮ	रंगातम
ਰਂਗੀਵਨ	रंगीवन
ਰਂਜੀਤ	रंजीत
ਰਘੁਜਿਤ	रघुजित
ਰਘੁਬਂਸ	रघुबंस
ਰਚਨਜਿਤ	रचनजित
ਰਚਨਜੋਤ	रचनजोत
ਰਚ੍ਪੀਨਦੇਰ੍ਜਿਤ	रच्पीनदेर्जित
ਰਜੀਨਦਾਰ	रजीनदार
ਰਣਦੀਪ	रणदीप
ਰਣਬੀਰ	रणबीर
ਰਤਨ੍ਕਾਰਾਮ	रतन्काराम
ਰਤ੍ਤਾਨਜੋਤ	रत्तानजोत
ਰਤ੍ਤਾਨਦੀਪ	रत्तानदीप
ਰਨਗ੍ਰਤ੍ਤੀ	रनग्रत्ती
ਰਨਪ੍ਰਿਤ	रनप्रित
ਰਪੀਨਦੇਰ	रपीनदेर
ਰਮਚੇਤਨ	रमचेतन
ਰਮਣੀਕ	रमणीक
ਰਮਨਜਿਤ	रमनजित
ਰਮਨਦੀਪ	रमनदीप
ਰਮਨਿਤ	रमनित
ਰਮਨੀਵਾਸ	रमनीवास
ਰਮਲੀਨ	रमलीन
ਰਮਾਂਨਜੋਤ	रमांनजोत
ਰਮਾਂਨਰੂਪ	रमांनरूप
ਰਮਾਂਨਸੁਖ	रमांनसुख
ਰਮਿਤ	रमित
ਰਮਿਨਾਜੀਤ	रमिनाजीत
ਰਮੀਨਦੇਰ੍ਜਿਤ	रमीनदेर्जित
ਰਮੀਨਦੇਰ੍ਪਾਲ	रमीनदेर्पाल
ਰਮੀਨਦੇਰ੍ਪ੍ਰਿਤ	रमीनदेर्प्रित
ਰਮੀਨਦੇਰ੍ਬੀਰ	रमीनदेर्बीर
ਰਮੇਸ਼ਪਲ	रमेशपल
ਰਮੇਸ਼ਮਿਤ	रमेशमित
ਰਵਜੋਤ	रवजोत
ਰਵਨੀਤ	रवनीत
ਰਵਿਨ੍ਦਰ	रविन्दर
ਰਵਿਰਾਜ	रविराज
ਰਵੀਦੀਪ	रवीदीप
ਰਵੀਨਦੇਰ੍ਦੀਪ	रवीनदेर्दीप
ਰਵੀਨਦੇਰ੍ਮਿਤ	रवीनदेर्मित
ਰਸਂਜਿਤ	रसंजित
ਰਸਂਜੋਤ	रसंजोत
ਰਸਂਮਿਤ	रसंमित
ਰਸਗੁਨ	रसगुन
ਰਸਜੋਤ	रसजोत
ਰਸਧਾਰਮ	रसधारम
ਰਸਨਂਦ	रसनंद
ਰਸਪ੍ਰਿਤ	रसप्रित
ਰਸਬੀਰ	रसबीर
ਰਸਭਾਗਤ	रसभागत
ਰਸਮ	रसम
ਰਸਮ੍ਰਿਤ	रसम्रित
ਰਸਲੀਨ	रसलीन
ਰਸਵਂਤ	रसवंत
ਰਸ਼ਾਨ੍ਪ੍ਰਿਤ	रशान्प्रित
ਰਸੁਤ੍ਤਮ	रसुत्तम
ਰਹੁਲਜੀਤ	रहुलजीत
ਰਹੁਲਦੀਪ	रहुलदीप
ਰਾਖਨਾਂ	राखनां
ਰਾਖਬੀਰ	राखबीर
ਰਾਜਕਿਰਣ	राजकिरण
ਰਾਜਦੀਪ	राजदीप
ਰਾਜਨਾਰੀਨ੍ਦ	राजनारीन्द
ਰਾਜਪਰਾਮ	राजपराम
ਰਾਜਪਾਲ	राजपाल
ਰਾਜਪ੍ਰਤਾਪ	राजप्रताप
ਰਾਜਮਂਦਰ	राजमंदर
ਰਾਜਮਿਤ	राजमित
ਰਾਜਸ਼ਰਣ	राजशरण
ਰਾਜਸੁਖ	राजसुख
ਰਾਜਾਨਜਿਤ	राजानजित
ਰਾਜਾਨਮਿਤ	राजानमित
ਰਾਜਾਨ੍ਦੀਪ	राजान्दीप
ਰਾਤਾਨਗੀਤ	रातानगीत
ਰਾਤਾਨਚੇਤਨ	रातानचेतन
ਰਾਤਾਨਜੀਵਨ	रातानजीवन
ਰਾਤਾਨਪ੍ਰਿਤ	रातानप्रित
ਰਾਤਾਨਮਿਤ	रातानमित
ਰਾਤਾਨਵਂਤ	रातानवंत
ਰਾਤਾਨਾਤਮ	रातानातम
ਰਾਮਦਾਸ	रामदास
ਰਾਮਪਾਲ	रामपाल
ਰਾਮਰਂਗ	रामरंग
ਰਾਮਰਤ੍ਤਨ	रामरत्तन
ਰਾਮਸੁਖ	रामसुख
ਰਾਸਰਮਣ	रासरमण
ਰਾਸ਼੍ਪਲ	राश्पल
ਰਾਸ਼੍ਮੀਨਦੇਰ	राश्मीनदेर
ਰਿਧਿਮਾ	रिधिमा
ਰੀਜਕ	रीजक
ਰੀਤੀਨਦੇਰ	रीतीनदेर
ਰੀਪਨ੍ਜੋਤ	रीपन्जोत
ਰੀਪੁਦਮ	रीपुदम
ਰੂਂਗ / ਰਂਗ	रूंग / रंग
ਰੂਪਦੀਪ	रूपदीप
ਰੂਪਦੇਵ	रूपदेव
ਰੂਪਵਂਤ	रूपवंत
ਰੇਗੇਨਦਰ	रेगेनदर
ਰੋਸ਼ਨਦੀਪ	रोशनदीप
ਰੌਸ਼ਾਨਪ੍ਰੇਮ	रौशानप्रेम
ਰੌਸ਼ਾਨਬੀਰ	रौशानबीर
ਲਕ੍ਸ਼੍ਮੀ	लक्श्मी
ਲਖਪ੍ਰਿਤ	लखप्रित
ਲਖਮਿਤ	लखमित
ਲਖਰੂਪ	लखरूप
ਲਖਵੀਰ	लखवीर
ਲਵੇਨਿਤ	लवेनित
ਲਾਜਵਂਤ	लाजवंत
ਲਾਵਪ੍ਰਿਤ	लावप्रित
ਲਾਵਿਨਦੀਪ	लाविनदीप
ਲੀਵਗੀਆਨ	लीवगीआन
ਲੀਵਚਿਤ	लीवचित
ਲੀਵਚੇਤ	लीवचेत
ਲੀਵਜੋਤ	लीवजोत
ਲੀਵਨਾਮ	लीवनाम
ਲੀਵਸ਼ਰਣ	लीवशरण
ਲੀਵਾਵਤਰ	लीवावतर
ਲੋਕਪਾਲ	लोकपाल
ਲੋਕਪ੍ਰਿਤ	लोकप्रित
ਲੋਕਰੂਪ	लोकरूप
ਲੋਕ੍ਪ੍ਰੇਮ	लोक्प्रेम
ਲੋਵਪ੍ਰੇਮ	लोवप्रेम
ਲੋਵੇਦੀਪ	लोवेदीप
ਵਰੀਨਦੇਰ੍ਪਾਲ	वरीनदेर्पाल
ਵਰੁਨਜਿਤ	वरुनजित
ਵਰੁਨਦੀਪ	वरुनदीप
ਵਸਂਤਪ੍ਰਿਤ	वसंतप्रित
ਵਸੁਂਧਰਾ	वसुंधरा
ਵਾਦਭਾਗ	वादभाग
ਵਾਮਾਂਨਜੀਤ	वामांनजीत
ਵਾਰੀਨਦੇਰ	वारीनदेर
ਵਾਸੀਮਬੀਰ	वासीमबीर
ਵਾਹੀਦਪ੍ਰਿਤ	वाहीदप्रित
ਵਾਹੇਗੁਰੁ	वाहेगुरु
ਵਿਕ੍ਰਮਜੀਤ	विक्रमजीत
ਵਿਕ੍ਰਮਜੋਤ	विक्रमजोत
ਵਿਚਾਰ੍ਚੇਤਨ	विचार्चेतन
ਵਿਚਾਰ੍ਦੀਪ	विचार्दीप
ਵਿਚਾਰ੍ਲੀਨ	विचार्लीन
ਵਿਜਯਪ੍ਰਤਾਪ	विजयप्रताप
ਵਿਜਯਪ੍ਰਿਤ	विजयप्रित
ਵਿਜੇਂਦਰ	विजेंदर
ਵਿਨਾਯਦੀਪ	विनायदीप
ਵਿਨਾਯਪੁਲ	विनायपुल
ਵਿਨਾਯ੍ਬਿਰ	विनाय्बिर
ਵਿਮਾਂਲਜਿਤ	विमांलजित
ਵਿਮਾਂਲਜੋਤ	विमांलजोत
ਵਿਮਾਂਲਪ੍ਰੇਮ	विमांलप्रेम
ਵਿਰੀਨਦਾਰ ; ਵਿਰੀਨਦੇਰ	विरीनदार ; विरीनदेर
ਵਿਰੀਨਦੇਰ	विरीनदेर
ਵਿਸਮਦ	विसमद
ਵਿਸ਼ਾਲਦੀਪ	विशालदीप
ਵਿਸ਼ਾਲਪ੍ਰਿਤ	विशालप्रित
ਵਿਸ਼੍ਵਰ੍ਪ੍ਰਿਤ	विश्वर्प्रित
ਵਿਸ਼੍ਵਾਤਮ	विश्वातम
ਵਿਸਾਹ	विसाह
ਵੀਜਯਮਿਤ	वीजयमित
ਵੀਰ	वीर
ਵੀਰ /ਵੀਰ	वीर /वीर
ਵੀਰਪਾਲ	वीरपाल
ਵੀਵੇਕ੍ਬੀਰ	वीवेक्बीर
ਵੀਸ੍ਰਮਣ	वीस्रमण
ਵੇਰਾਜ	वेराज
ਵੈਭਵ	वैभव
ਸਂਗਜਾਪ	संगजाप
ਸਂਗਤਪ੍ਰਿਤ	संगतप्रित
ਸਂਗਤਰੂਪ	संगतरूप
ਸਂਗਤ੍ਰਸ	संगत्रस
ਸਂਗੀਤਾ	संगीता
ਸਂਗ੍ਰਾਮ	संग्राम
ਸਂਜੀਤ	संजीत
ਸਂਜੋਗ	संजोग
ਸਂਤਕੀਰੀਨ	संतकीरीन
ਸਂਤਪ੍ਰਕਾਸ਼	संतप्रकाश
ਸਂਤਪ੍ਰੇਮ	संतप्रेम
ਸਂਤਬੀਰ	संतबीर
ਸਂਤੋਖਜੀਤ	संतोखजीत
ਸਂਤੋਖਜੋਤ	संतोखजोत
ਸਂਤੋਖਪ੍ਰਿਤ	संतोखप्रित
ਸਂਤੋਖਬੀਰ	संतोखबीर
ਸਂਦੀਪ	संदीप
ਸਗਲਜੋਤ	सगलजोत
ਸਚਕਿਰਤ	सचकिरत
ਸਚਜੋਗ	सचजोग
ਸਚਪਾਲ	सचपाल
ਸਚਪ੍ਰਧਾਨ	सचप्रधान
ਸਚਭਾਗਤ	सचभागत
ਸਚਮਾਨ	सचमान
ਸਚਰੂਪ	सचरूप
ਸਚਵੀਰ	सचवीर
ਸਚਸੁਖ	सचसुख
ਸਚਸੇਵਕ	सचसेवक
ਸਚਾਮ੍ਰਿਤ	सचाम्रित
ਸਚ੍ਦੀਪ	सच्दीप
ਸਜੀਨਦੇਰ	सजीनदेर
ਸਤਕਿਰਤ	सतकिरत
ਸਤਕੀਰਤ	सतकीरत
ਸਤਕੀਰ੍ਤਨ	सतकीर्तन
ਸਤਗੁਨ	सतगुन
ਸਤਗੁਰ	सतगुर
ਸਤਜੋਤ	सतजोत
ਸਤਨਾਮ	सतनाम
ਸਤਪਾਲ	सतपाल
ਸਤਪ੍ਰਕਾਸ਼	सतप्रकाश
ਸਤਪ੍ਰਿਤ	सतप्रित
ਸਤਪ੍ਰੇਮ	सतप्रेम
ਸਤਬਚਨ	सतबचन
ਸਤਮਿਤ	सतमित
ਸਤਰਜਿਤ	सतरजित
ਸਤਰਾਜ	सतराज
ਸਤਲੀਨ	सतलीन
ਸਤਵਂਤ	सतवंत
ਸਤਸਂਗਤ	सतसंगत
ਸਤਸਂਤੋਖ	सतसंतोख
ਸਤਸਰਂਗ	सतसरंग
ਸਤਸੁਖ	सतसुख
ਸਤੀਨਦੇਰ੍ਜਿਤ	सतीनदेर्जित
ਸਤ੍ਯਜਿਤ	सत्यजित
ਸਤ੍ਯਪ੍ਰੇਮ	सत्यप्रेम
ਸਥਿਨ੍ਦਰ	सथिन्दर
ਸਦਜੀਵਨ	सदजीवन
ਸਦਸੁਖ	सदसुख
ਸਨਮੁਖ	सनमुख
ਸਨਾਨਤਨ	सनानतन
ਸਪਨਦੀਪ	सपनदीप
ਸਪਾਹੀ	सपाही
ਸਬੂਰੀ	सबूरी
ਸਭਾਜੀਤ	सभाजीत
ਸਮਰਜੀਤ	समरजीत
ਸਮਰਣ	समरण
ਸਮਰਵੀਰ	समरवीर
ਸਮਰ੍ਥ	समर्थ
ਸਮਾਂਰਬੀਰ	समांरबीर
ਸਮਾਂਰ੍ਜੋਤ	समांर्जोत
ਸਮਾਈ	समाई
ਸਮੀਨਦੀਪ	समीनदीप
ਸਮੀਰ	समीर
ਸਰਦਾਰ	सरदार
ਸਰਨਦਾਯਲ	सरनदायल
ਸਰਨਦੀਪ	सरनदीप
ਸਰਨਾਗਤ	सरनागत
ਸਰਬਜੀਤ / ਸਰਬਜੀਤ	सरबजीत / सरबजीत
ਸਰਬਨੀਵਾਸ	सरबनीवास
ਸਰਬਪ੍ਰਿਤ	सरबप्रित
ਸਰਬਸੁਖ	सरबसुख
ਸਰਬੁਤ੍ਤਮ	सरबुत्तम
ਸਰਬ੍ਗਿਆਨ	सरब्गिआन
ਸਰਬ੍ਜਿਤ	सरब्जित
ਸਰਬ੍ਦਾਯਲ	सरब्दायल
ਸਰਬ੍ਦੀਪ	सरब्दीप
ਸਰਬ੍ਦੇਵ	सरब्देव
ਸਰਬ੍ਧਾਰਾਮ	सरब्धाराम
ਸਰਲਜਿਤ	सरलजित
ਸਰਲਬੀਰ	सरलबीर
ਸਰਾਬ੍ਰਜ	सराब्रज
ਸਰੂਪ	सरूप
ਸਰੂਰ	सरूर
ਸਰ੍ਜਿਤ	सर्जित
ਸਰ੍ਮੀਨਦੇਰ	सर्मीनदेर
ਸਵਾਨਪ੍ਰਿਤ	सवानप्रित
ਸਵਾਰਜਦੀਪ	सवारजदीप
ਸਵਾਰਜਬੀਰ	सवारजबीर
ਸਵਾਰਨਜੋਤ	सवारनजोत
ਸਵਾਰਨਪ੍ਰਿਤ	सवारनप्रित
ਸਵੀਤੀਨਦੇਰ	सवीतीनदेर
ਸਵੀਤੋਜ	सवीतोज
ਸਵੀਨਦੇਰ	सवीनदेर
ਸਹੀਲਮਿਤ	सहीलमित
ਸ਼ਯ੍ਮ੍ਸੁਨ੍ਦਾਰ	शय्म्सुन्दार
ਸ਼ਰਨਪਾਲ	शरनपाल
ਸ਼ਰਨਬੀਰ	शरनबीर
ਸ਼ਰਨ੍ਜੀਤ੍ਕੌਰ	शरन्जीत्कौर
ਸ਼ਾਂਤਚਿਤ	शांतचित
ਸ਼ਾਂਤਦੀਪ	शांतदीप
ਸ਼ਾਂਤਪ੍ਰਕਾਸ਼	शांतप्रकाश
ਸ਼ਾਂਤਪ੍ਰਿਤ	शांतप्रित
ਸ਼ਾਂਤਬੀਰ	शांतबीर
ਸ਼ਾਂਤਲੀਨ	शांतलीन
ਸ਼ਾਨਤ੍ਨੀਵਾਸ	शानत्नीवास
ਸ਼ਾਬਦਚੇਤ	शाबदचेत
ਸ਼ਾਬਦਤੇਕ	शाबदतेक
ਸ਼ਾਬਦ੍ਰਾਸ	शाबद्रास
ਸ਼ਾਬਾਦ੍ਦੀਪ	शाबाद्दीप
ਸ਼ਾਲੀਨ	शालीन
ਸ਼ਾਸ਼ੀਪ੍ਰਿਤ	शाशीप्रित
ਸ਼ਿਵਚਰਣ	शिवचरण
ਸ਼ਿਵ੍ਚਾਰਨ੍ਜੀਤ	शिव्चारन्जीत
ਸ਼ੁਕਾਰਿਯਨ	शुकारियन
ਸ਼ੁਭਦੀਪ	शुभदीप
ਸ਼ੂਰਵੀਰ	शूरवीर
ਸ਼ੇਰ	शेर
ਸ਼ੇਰਪੁਲ	शेरपुल
ਸ਼ੇਰਬਹਾਦੁਰ	शेरबहादुर
ਸ਼ੇਹ੍ਬਾਝ	शेह्बाझ
ਸਾਕਰਥ	साकरथ
ਸਾਖ	साख
ਸਾਗਰ	सागर
ਸਾਜ	साज
ਸਾਤਪੁਲ	सातपुल
ਸਾਧਨਾਹ	साधनाह
ਸਾਧਿਕਾ	साधिका
ਸਾਬਰ	साबर
ਸਾਰ	सार
ਸਿਂਦਾ	सिंदा
ਸਿਓਪਰਿਤ	सिओपरित
ਸਿਤਾਲਜੀਤ	सितालजीत
ਸਿਤਾਲਜੋਤ	सितालजोत
ਸਿਮਰਨ	सिमरन
ਸੀਖਲ	सीखल
ਸੀਮਾਂਰ੍ਜਿਤ	सीमांर्जित
ਸੀਮਾਂਰ੍ਨਾਮ	सीमांर्नाम
ਸੀਮਾਂਰ੍ਪ੍ਰਿਤ	सीमांर्प्रित
ਸੀਮਾਂਰ੍ਲੀਨ	सीमांर्लीन
ਸੀਮ੍ਰਤ	सीम्रत
ਸੀਮ੍ਰਨਪਾਲ	सीम्रनपाल
ਸੀਮ੍ਰਨਪ੍ਰਿਤ	सीम्रनप्रित
ਸੀਮ੍ਰਨ੍ਕੌਰ	सीम्रन्कौर
ਸੀਮ੍ਰਨ੍ਜੀਤ	सीम्रन्जीत
ਸੀਮ੍ਰੀਤਾ	सीम्रीता
ਸੀਰਤ	सीरत
ਸੀਰੀਪ੍ਰੀਤਮ	सीरीप्रीतम
ਸੀਰੀਵੇਦ੍ਯਾ	सीरीवेद्या
ਸੀਰੀਸੀਮ੍ਰਣ	सीरीसीम्रण
ਸੀਰੀਸੇਵਾ	सीरीसेवा
ਸੁਖਚੈਨ	सुखचैन
ਸੁਖਜੀਵਨ	सुखजीवन
ਸੁਖਜੋਤ	सुखजोत
ਸੁਖਜੋਧ	सुखजोध
ਸੁਖਦਾਯਲ	सुखदायल
ਸੁਖਦੀਪ	सुखदीप
ਸੁਖਦੇਵ	सुखदेव
ਸੁਖਬੀਰ	सुखबीर
ਸੁਖਮਾਂ	सुखमां
ਸੁਖਰੂਪ	सुखरूप
ਸੁਖਸਿਤਾਲ	सुखसिताल
ਸੁਖਸੀਮ੍ਰਣ	सुखसीम्रण
ਸੁਖਾਨਂਦ	सुखानंद
ਸੁਖਿਤ	सुखित
ਸੁਖੀਨ	सुखीन
ਸੁਖੀਨ੍ਦੇਰ	सुखीन्देर
ਸੁਖ੍ਚਾਰਨ੍ਜੀਤ	सुख्चारन्जीत
ਸੁਖ੍ਜਿਤ	सुख्जित
ਸੁਚਦੀਪ	सुचदीप
ਸੁਚਦੇਵ	सुचदेव
ਸੁਚਮ	सुचम
ਸੁਜਨਰੂਪ	सुजनरूप
ਸੁਜਨ੍ਬੀਰ	सुजन्बीर
ਸੁਜ੍ਜਨ	सुज्जन
ਸੁਧਬੁਧ	सुधबुध
ਸੁਧਸੁਰਤ	सुधसुरत
ਸੁਭਪ੍ਰਿਤ	सुभप्रित
ਸੁਹੇਜਦੀਪ	सुहेजदीप
ਸੇਵਾਕਪ੍ਰਿਤ	सेवाकप्रित
ਸੇਵਾਕਪ੍ਰੇਮ	सेवाकप्रेम
ਸੇਵਾਕਰਣ	सेवाकरण
ਸੇਵਾਪ੍ਰੀਤ	सेवाप्रीत
ਸੇਹਜ	सेहज
ਸੇਹੇਜਬੀਰ	सेहेजबीर
ਸੈਲੇਸ਼ਦੀਪ	सैलेशदीप
ਸੈਹਜ	सैहज
ਸੈਹਾਜਨੀਵਾਸ	सैहाजनीवास
ਸੈਹਾਜਲੀਨ	सैहाजलीन
ਸੈਹਾਜਾਧਾਰ	सैहाजाधार
ਸੋਚੀ	सोची
ਸੋਨਹਨ	सोनहन
ਸੋਭਾਵਂਤ	सोभावंत
ਸੋਹੀਨਦੇਰ	सोहीनदेर
ਸੋਹੁਨ	सोहुन
ਸ੍ਵਰ੍ਨ	स्वर्न
ਹਕਾਮਪ੍ਰਿਤ	हकामप्रित
ਹਨ੍ਸ੍ਪਾਲ	हन्स्पाल
ਹਰਕਾਨ੍ਵਾਲ	हरकान्वाल
ਹਰਕੀਰਣ	हरकीरण
ਹਰਗੀਤ	हरगीत
ਹਰਗੁਰ੍ਮਿਤ (ਮਿਤ )	हरगुर्मित (मित )
ਹਰਗੋਬੀਨ੍ਦ	हरगोबीन्द
ਹਰਚਰਣ	हरचरण
ਹਰਜਪ	हरजप
ਹਰਜੀ	हरजी
ਹਰਜੀਤ	हरजीत
ਹਰਜੀਨ੍ਦੇਰ	हरजीन्देर
ਹਰਜੀਵ	हरजीव
ਹਰਜੁਗਤ	हरजुगत
ਹਰਜੋਗ	हरजोग
ਹਰਜੋਧ	हरजोध
ਹਰਜ੍ਯੋਤ	हरज्योत
ਹਰਤਿਰਥ	हरतिरथ
ਹਰਤੇਜ੍ਪਾਲ	हरतेज्पाल
ਹਰਦਯਾਲ	हरदयाल
ਹਰਦਾਸ	हरदास
ਹਰਦਿਪਾ	हरदिपा
ਹਰਦੀਪ	हरदीप
ਹਰਧਨ	हरधन
ਹਰਨਾਮ	हरनाम
ਹਰਨਾਰਾਯਣ	हरनारायण
ਹਰਨਿਤ	हरनित
ਹਰਨੀਰ੍ਮਲ	हरनीर्मल
ਹਰਨੀਹਲ	हरनीहल
ਹਰਪਰ੍ਸਨ੍ਨ	हरपर्सन्न
ਹਰਪਾਲ	हरपाल
ਹਰਪ੍ਰੇਮ੍ਜੀਤ	हरप्रेम्जीत
ਹਰਬਿਂਦਰ	हरबिंदर
ਹਰਬਿਰ	हरबिर
ਹਰਭਗਤ	हरभगत
ਹਰਮਨਾਦ	हरमनाद
ਹਰਮਾਂਨ੍ਦੇਰ	हरमांन्देर
ਹਰਮੀਤ	हरमीत
ਹਰਮੀਲਨ	हरमीलन
ਹਰਮੂਰਤ	हरमूरत
ਹਰਰਾਈ	हरराई
ਹਰਰੂਪ	हररूप
ਹਰਵਂਤ	हरवंत
ਹਰਵਿਨ	हरविन
ਹਰਸ਼ਰਣ	हरशरण
ਹਰਸਿਤਾਲ	हरसिताल
ਹਰਸੀਮ੍ਰਣ	हरसीम्रण
ਹਰਸੀਮ੍ਰਨ੍ਜੋਤ	हरसीम्रन्जोत
ਹਰਸੀਮ੍ਰਿਤ	हरसीम्रित
ਹਰਸੁਖ	हरसुख
ਹਰਾਨੂਪ	हरानूप
ਹਰਾਮ੍ਰੀਤ	हराम्रीत
ਹਰਿਕੀਰ੍ਤਨ	हरिकीर्तन
ਹਰਿਦਰ੍ਸ਼ਨ	हरिदर्शन
ਹਰਿਨਾਰਾਯਣ	हरिनारायण
ਹਰਿਪ੍ਰੀਤ	हरिप्रीत
ਹਰੀਅਮ੍ਰਿਤ	हरीअम्रित
ਹਰੀਸਰੂਪ	हरीसरूप
ਹਰੀਸੀਮਾਂਰਣ	हरीसीमांरण
ਹਰ੍ਕਾਰਾਨ੍ਜੀਤ	हर्कारान्जीत
ਹਰ੍ਕੀਰਨ੍ਜੀਤ	हर्कीरन्जीत
ਹਰ੍ਕੀਰਪਾਲ	हर्कीरपाल
ਹਰ੍ਜਸ	हर्जस
ਹਰ੍ਤੇਇਜ	हर्तेइज
ਹਰ੍ਨੀਝ	हर्नीझ
ਹਰ੍ਬਂਸ	हर्बंस
ਹਰ੍ਮਾਂਨਜਿਤ	हर्मांनजित
ਹਰ੍ਮਾਂਨਪਾਲ	हर्मांनपाल
ਹਰ੍ਮੀਨ੍ਦੇਰ	हर्मीन्देर
ਹਰ੍ਮੇਂਦ੍ਰ	हर्मेंद्र
ਹਰ੍ਸ਼ਰ੍ਧਾ	हर्शर्धा
ਹਰ੍ਸ਼ਵਰ੍ਧਨ	हर्शवर्धन
ਹਰ੍ਸ਼ਾਗੁਨ	हर्शागुन
ਹਰ੍ਸਿਰਤ	हर्सिरत
ਹਸਨ	हसन
ਹਾਰਭਾਗ	हारभाग
ਹਿਤੀਨਦੇਰ	हितीनदेर
ਹਿਤੇਨਦੇਰ	हितेनदेर
ਹਿਮ੍ਮਤ	हिम्मत
ਹਿਰੀਸ਼	हिरीश
ਹੁਅਲੀਨਾ	हुअलीना
ਹੁਕੁਮਪਰਿਤ	हुकुमपरित
ਹੂਜਓਏ	हूजओए
ਹੇਤ	हेत
ਹੇਤਬੀਰ	हेतबीर
ਹੇਮੀਨਦੇਰ	हेमीनदेर
ਹੇਯ੍ਮਾਂਨ੍ਪ੍ਰਿਤ	हेय्मांन्प्रित
ਹੇਰਹੋ	हेरहो
#
#
# Territory names from CLDR
ਅਸੈਂਸ਼ਨ ਟਾਪੂ	असैंशन टापू
ਅੰਡੋਰਾ	अडोरा
ਸੰਯੁਕਤ ਅਰਬ ਅਮੀਰਾਤ	सयुकत अरब अमीरात
ਅਫ਼ਗਾਨਿਸਤਾਨ	अफ़गानिसतान
ਐਂਟੀਗੁਆ ਅਤੇ ਬਾਰਬੁਡਾ	ऐंटीगुआ अते बारबुडा
ਅੰਗੁਇਲਾ	अगुइला
ਅਲਬਾਨੀਆ	अलबानीआ
ਅਰਮੀਨੀਆ	अरमीनीआ
ਅੰਗੋਲਾ	अगोला
ਅੰਟਾਰਕਟਿਕਾ	अटारकटिका
ਅਰਜਨਟੀਨਾ	अरजनटीना
ਅਮੈਰੀਕਨ ਸਮੋਆ	अमैरीकन समोआ
ਆਸਟਰੀਆ	आसटरीआ
ਆਸਟ੍ਰੇਲੀਆ	आसट्रेलीआ
ਅਰੂਬਾ	अरूबा
ਅਲੈਂਡ ਟਾਪੂ	अलैंड टापू
ਅਜ਼ਰਬਾਈਜਾਨ	अज़रबाईजान
ਬੋਸਨੀਆ ਅਤੇ ਹਰਜ਼ੇਗੋਵੀਨਾ	बोसनीआ अते हरज़ेगोवीना
ਬਾਰਬਾਡੋਸ	बारबाडोस
ਬੰਗਲਾਦੇਸ਼	बगलादेश
ਬੈਲਜੀਅਮ	बैलजीअम
ਬੁਰਕੀਨਾ ਫ਼ਾਸੋ	बुरकीना फ़ासो
ਬੁਲਗਾਰੀਆ	बुलगारीआ
ਬਹਿਰੀਨ	बहिरीन
ਬੁਰੁੰਡੀ	बुरुडी
ਬੇਨਿਨ	बेनिन
ਸੇਂਟ ਬਾਰਥੇਲੇਮੀ	सेंट बारथेलेमी
ਬਰਮੂਡਾ	बरमूडा
ਬਰੂਨੇਈ	बरूनेई
ਬੋਲੀਵੀਆ	बोलीवीआ
ਕੈਰੇਬੀਆਈ ਨੀਦਰਲੈਂਡ	कैरेबीआई नीदरलैंड
ਬ੍ਰਾਜ਼ੀਲ	ब्राज़ील
ਬਹਾਮਾਸ	बहामास
ਭੂਟਾਨ	भूटान
ਬੌਵੇਟ ਟਾਪੂ	बौवेट टापू
ਬੋਟਸਵਾਨਾ	बोटसवाना
ਬੇਲਾਰੂਸ	बेलारूस
ਬੇਲੀਜ਼	बेलीज़
ਕੈਨੇਡਾ	कैनेडा
ਕੋਕੋਸ (ਕੀਲਿੰਗ) ਟਾਪੂ	कोकोस (कीलिग) टापू
ਕਾਂਗੋ - ਕਿੰਸ਼ਾਸਾ	कांगो - किशासा
ਕਾਂਗੋ ਲੋਕਤੰਤਰੀ ਗਣਰਾਜ	कांगो लोकततरी गणराज
ਕੇਂਦਰੀ ਅਫ਼ਰੀਕੀ ਗਣਰਾਜ	केंदरी अफ़रीकी गणराज
ਕਾਂਗੋ - ਬ੍ਰਾਜ਼ਾਵਿਲੇ	कांगो - ब्राज़ाविले
ਕਾਂਗੋ ਗਣਰਾਜ	कांगो गणराज
ਸਵਿਟਜ਼ਰਲੈਂਡ	सविटज़रलैंड
ਕੋਟ ਡੀਵੋਆਰ	कोट डीवोआर
ਆਇਵਰੀ ਕੋਸਟ	आइवरी कोसट
ਕੁੱਕ ਟਾਪੂ	कुक टापू
ਚਿਲੀ	चिली
ਕੈਮਰੂਨ	कैमरून
ਚੀਨ	चीन
ਕੋਲੰਬੀਆ	कोलबीआ
ਕਲਿੱਪਰਟਨ ਟਾਪੂ	कलिपरटन टापू
ਕੋਸਟਾ ਰੀਕਾ	कोसटा रीका
ਕਿਊਬਾ	किऊबा
ਕੇਪ ਵਰਡੇ	केप वरडे
ਕੁਰਾਕਾਓ	कुराकाओ
ਕ੍ਰਿਸਮਿਸ ਟਾਪੂ	क्रिसमिस टापू
ਸਾਇਪ੍ਰਸ	साइप्रस
ਚੈਕ ਗਣਰਾਜ	चैक गणराज
ਜਰਮਨੀ	जरमनी
ਡੀਇਗੋ ਗਾਰਸੀਆ	डीइगो गारसीआ
ਜ਼ੀਬੂਤੀ	ज़ीबूती
ਡੈਨਮਾਰਕ	डैनमारक
ਡੋਮੀਨਿਕਾ	डोमीनिका
ਡੋਮੀਨਿਕਾਈ ਗਣਰਾਜ	डोमीनिकाई गणराज
ਅਲਜੀਰੀਆ	अलजीरीआ
ਸਿਓਟਾ ਅਤੇ ਮੇਲਿੱਲਾ	सिओटा अते मेलिला
ਇਕਵੇਡੋਰ	इकवेडोर
ਇਸਟੋਨੀਆ	इसटोनीआ
ਮਿਸਰ	मिसर
ਪੱਛਮੀ ਸਹਾਰਾ	पछमी सहारा
ਇਰੀਟ੍ਰਿਆ	इरीट्रिआ
ਸਪੇਨ	सपेन
ਇਥੋਪੀਆ	इथोपीआ
ਯੂਰਪੀ ਯੂਨੀਅਨ	यूरपी यूनीअन
ਫਿਨਲੈਂਡ	फिनलैंड
ਫ਼ਿਜੀ	फ़िजी
ਫ਼ਾਕਲੈਂਡ ਟਾਪੂ	फ़ाकलैंड टापू
ਫ਼ਾਕਲੈਂਡ ਟਾਪੂ (ਆਈਲਾਸ ਮਾਲਵਿਨਾਸ)	फ़ाकलैंड टापू (आईलास मालविनास)
ਮਾਇਕ੍ਰੋਨੇਸ਼ੀਆ	माइक्रोनेशीआ
ਫੈਰੋ ਟਾਪੂ	फैरो टापू
ਫ਼ਰਾਂਸ	फ़रांस
ਗਬੋਨ	गबोन
ਯੂਨਾਈਟਡ ਕਿੰਗਡਮ	यूनाईटड किगडम
ਗ੍ਰੇਨਾਡਾ	ग्रेनाडा
ਜਾਰਜੀਆ	जारजीआ
ਫ਼ਰੈਂਚ ਗੁਆਨਾ	फ़रैंच गुआना
ਗਰਨਜੀ	गरनजी
ਘਾਨਾ	घाना
ਜਿਬਰਾਲਟਰ	जिबरालटर
ਗ੍ਰੀਨਲੈਂਡ	ग्रीनलैंड
ਗੈਂਬੀਆ	गैंबीआ
ਗਿਨੀ	गिनी
ਗੁਆਡੇਲੋਪ	गुआडेलोप
ਭੂ-ਖੰਡੀ ਗਿਨੀ	भू-खडी गिनी
ਗ੍ਰੀਸ	ग्रीस
ਦੱਖਣੀ ਜਾਰਜੀਆ ਅਤੇ ਦੱਖਣੀ ਸੈਂਡਵਿਚ ਟਾਪੂ	दखणी जारजीआ अते दखणी सैंडविच टापू
ਗੁਆਟੇਮਾਲਾ	गुआटेमाला
ਗੁਆਮ	गुआम
ਗਿਨੀ-ਬਿਸਾਉ	गिनी-बिसाउ
ਗੁਯਾਨਾ	गुयाना
ਹਾਂਗ ਕਾਂਗ ਐਸਏਆਰ ਚੀਨ	हांग कांग ऐसएआर चीन
ਹਾਂਗ ਕਾਂਗ	हांग कांग
ਹਰਡ ਤੇ ਮੈਕਡੋਨਾਲਡ ਟਾਪੂ	हरड ते मैकडोनालड टापू
ਹੋਂਡੁਰਸ	होंडुरस
ਕਰੋਏਸ਼ੀਆ	करोएशीआ
ਹੈਤੀ	हैती
ਹੰਗਰੀ	हगरी
ਕੇਨਾਰੀ ਟਾਪੂ	केनारी टापू
ਇੰਡੋਨੇਸ਼ੀਆ	इडोनेशीआ
ਆਇਰਲੈਂਡ	आइरलैंड
ਇਜ਼ਰਾਈਲ	इज़राईल
ਆਇਲ ਆਫ ਮੈਨ	आइल आफ मैन
ਭਾਰਤ	भारत
ਬਰਤਾਨਵੀ ਹਿੰਦ ਮਹਾਂਸਾਗਰ ਪ੍ਰਦੇਸ਼	बरतानवी हिद महांसागर प्रदेश
ਇਰਾਕ	इराक
ਈਰਾਨ	ईरान
ਆਈਸਲੈਂਡ	आईसलैंड
ਇਟਲੀ	इटली
ਜਰਸੀ	जरसी
ਜਮਾਇਕਾ	जमाइका
ਜਾਰਡਨ	जारडन
ਜਪਾਨ	जपान
ਕੀਨੀਆ	कीनीआ
ਕਿਰਗਿਜ਼ਸਤਾਨ	किरगिज़सतान
ਕੰਬੋਡੀਆ	कबोडीआ
ਕਿਰਬਾਤੀ	किरबाती
ਕੋਮੋਰੋਸ	कोमोरोस
ਸੈਂਟ ਕਿਟਸ ਐਂਡ ਨੇਵਿਸ	सैंट किटस ऐंड नेविस
ਉੱਤਰੀ ਕੋਰੀਆ	उतरी कोरीआ
ਦੱਖਣੀ ਕੋਰੀਆ	दखणी कोरीआ
ਕੁਵੈਤ	कुवैत
ਕੇਮੈਨ ਟਾਪੂ	केमैन टापू
ਕਜ਼ਾਖਸਤਾਨ	कज़ाखसतान
ਲਾਓਸ	लाओस
ਲੈਬਨਾਨ	लैबनान
ਸੇਂਟ ਲੂਸੀਆ	सेंट लूसीआ
ਲਿਚੇਂਸਟਾਇਨ	लिचेंसटाइन
ਸ੍ਰੀ ਲੰਕਾ	स्री लका
ਲਾਈਬੀਰੀਆ	लाईबीरीआ
ਲੇਸੋਥੋ	लेसोथो
ਲਿਥੁਆਨੀਆ	लिथुआनीआ
ਲਕਜ਼ਮਬਰਗ	लकज़मबरग
ਲਾਟਵੀਆ	लाटवीआ
ਲੀਬੀਆ	लीबीआ
ਮੋਰੱਕੋ	मोरको
ਮੋਨਾਕੋ	मोनाको
ਮੋਲਡੋਵਾ	मोलडोवा
ਮੋਂਟੇਨੇਗਰੋ	मोंटेनेगरो
ਸੇਂਟ ਮਾਰਟਿਨ	सेंट मारटिन
ਮੈਡਾਗਾਸਕਰ	मैडागासकर
ਮਾਰਸ਼ਲ ਟਾਪੂ	मारशल टापू
ਮੈਕਡੋਨੀਆ	मैकडोनीआ
ਮੈਕਡੋਨੀਆ (ਪੂਰਵ ਯੂਗੋਸਲਾਵ ਮੈਕਡੋਨੀਆਈ ਗਣਰਾਜ)	मैकडोनीआ (पूरव यूगोसलाव मैकडोनीआई गणराज)
ਮਾਲੀ	माली
ਮਿਆਂਮਾਰ (ਬਰਮਾ)	मिआंमार (बरमा)
ਮੰਗੋਲੀਆ	मगोलीआ
ਮਕਾਉ ਐਸਏਆਰ ਚੀਨ	मकाउ ऐसएआर चीन
ਮਕਾਉ	मकाउ
ਉੱਤਰੀ ਮਾਰੀਆਨਾ ਟਾਪੂ	उतरी मारीआना टापू
ਮਾਰਟੀਨਿਕ	मारटीनिक
ਮੋਰਿਟਾਨੀਆ	मोरिटानीआ
ਮੋਂਟਸੇਰਾਤ	मोंटसेरात
ਮਾਲਟਾ	मालटा
ਮੌਰਿਸ਼ਸ	मौरिशस
ਮਾਲਦੀਵ	मालदीव
ਮਲਾਵੀ	मलावी
ਮੈਕਸੀਕੋ	मैकसीको
ਮਲੇਸ਼ੀਆ	मलेशीआ
ਮੋਜ਼ਾਮਬੀਕ	मोज़ामबीक
ਨਾਮੀਬੀਆ	नामीबीआ
ਨਿਊ ਕੈਲੇਡੋਨੀਆ	निऊ कैलेडोनीआ
ਨਾਈਜਰ	नाईजर
ਨੋਰਫੌਕ ਟਾਪੂ	नोरफौक टापू
ਨਾਈਜੀਰੀਆ	नाईजीरीआ
ਨਿਕਾਰਾਗੁਆ	निकारागुआ
ਨੀਦਰਲੈਂਡ	नीदरलैंड
ਨਾਰਵੇ	नारवे
ਨੇਪਾਲ	नेपाल
ਨਾਉਰੂ	नाउरू
ਨਿਯੂ	नियू
ਨਿਊਜ਼ੀਲੈਂਡ	निऊज़ीलैंड
ਓਮਾਨ	ओमान
ਪਨਾਮਾ	पनामा
ਪੇਰੂ	पेरू
ਫਰੈਂਚ ਪੋਲੀਨੇਸ਼ੀਆ	फरैंच पोलीनेशीआ
ਪਾਪੂਆ ਨਿਊ ਗਿਨੀ	पापूआ निऊ गिनी
ਫਿਲੀਪੀਂਸ	फिलीपींस
ਪਾਕਿਸਤਾਨ	पाकिसतान
ਪੋਲੈਂਡ	पोलैंड
ਸੈਂਟ ਪੀਅਰੇ ਐਂਡ ਮਿਕੇਲਨ	सैंट पीअरे ऐंड मिकेलन
ਪਿਟਕੇਰਨ ਟਾਪੂ	पिटकेरन टापू
ਪਿਊਰਟੋ ਰਿਕੋ	पिऊरटो रिको
ਫਿਲੀਸਤੀਨੀ ਖੇਤਰ	फिलीसतीनी खेतर
ਫਿਲੀਸਤੀਨ	फिलीसतीन
ਪੁਰਤਗਾਲ	पुरतगाल
ਪਲਾਉ	पलाउ
ਪੈਰਾਗਵੇ	पैरागवे
ਕਤਰ	कतर
ਆਊਟਲਾਇੰਗ ਓਸ਼ੀਨੀਆ	आऊटलाइग ओशीनीआ
ਰਿਯੂਨੀਅਨ	रियूनीअन
ਰੋਮਾਨੀਆ	रोमानीआ
ਸਰਬੀਆ	सरबीआ
ਰੂਸ	रूस
ਰਵਾਂਡਾ	रवांडा
ਸਾਊਦੀ ਅਰਬ	साऊदी अरब
ਸੋਲੋਮਨ ਟਾਪੂ	सोलोमन टापू
ਸੇਸ਼ਲਸ	सेशलस
ਸੂਡਾਨ	सूडान
ਸਵੀਡਨ	सवीडन
ਸਿੰਗਾਪੁਰ	सिगापुर
ਸੇਂਟ ਹੇਲੇਨਾ	सेंट हेलेना
ਸਲੋਵੇਨੀਆ	सलोवेनीआ
ਸਵਾਲਬਰਡ ਅਤੇ ਜਾਨ ਮਾਯੇਨ	सवालबरड अते जान मायेन
ਸਲੋਵਾਕੀਆ	सलोवाकीआ
ਸਿਏਰਾ ਲਿਓਨ	सिएरा लिओन
ਸੈਨ ਮਰੀਨੋ	सैन मरीनो
ਸੇਨੇਗਲ	सेनेगल
ਸੋਮਾਲੀਆ	सोमालीआ
ਸੂਰੀਨਾਮ	सूरीनाम
ਦੱਖਣੀ ਸੂਡਾਨ	दखणी सूडान
ਸਾਓ ਟੋਮ ਅਤੇ ਪ੍ਰਿੰਸੀਪੇ	साओ टोम अते प्रिसीपे
ਅਲ ਸਲਵਾਡੋਰ	अल सलवाडोर
ਸਿੰਟ ਮਾਰਟੀਨ	सिट मारटीन
ਸੀਰੀਆ	सीरीआ
ਸਵਾਜ਼ੀਲੈਂਡ	सवाज़ीलैंड
ਟ੍ਰਿਸਟਾਨ ਦਾ ਕੁੰਹਾ	ट्रिसटान दा कुहा
ਟੁਰਕਸ ਅਤੇ ਕੈਕੋਸ ਟਾਪੂ	टुरकस अते कैकोस टापू
ਚਾਡ	चाड
ਫਰੈਂਚ ਦੱਖਣੀ ਪ੍ਰਦੇਸ਼	फरैंच दखणी प्रदेश
ਟੋਗੋ	टोगो
ਥਾਈਲੈਂਡ	थाईलैंड
ਤਾਜਿਕਿਸਤਾਨ	ताजिकिसतान
ਟੋਕੇਲਾਉ	टोकेलाउ
ਤਿਮੋਰ-ਲੇਸਤੇ	तिमोर-लेसते
ਪੂਰਬੀ ਤਿਮੋਰ	पूरबी तिमोर
ਤੁਰਕਮੇਨਿਸਤਾਨ	तुरकमेनिसतान
ਟਿਊਨੀਸ਼ੀਆ	टिऊनीशीआ
ਟੌਂਗਾ	टौंगा
ਤੁਰਕੀ	तुरकी
ਟ੍ਰਿਨੀਡਾਡ ਅਤੇ ਟੋਬਾਗੋ	ट्रिनीडाड अते टोबागो
ਟੁਵਾਲੂ	टुवालू
ਤਾਇਵਾਨ	ताइवान
ਤਨਜ਼ਾਨੀਆ	तनज़ानीआ
ਯੂਕਰੇਨ	यूकरेन
ਯੂਗਾਂਡਾ	यूगांडा
ਸੰਯੁਕਤ ਰਾਜ	सयुकत राज
ਉਰੂਗਵੇ	उरूगवे
ਉਜ਼ਬੇਕਿਸਤਾਨ	उज़बेकिसतान
ਵੈਟੀਕਨ ਸਿਟੀ	वैटीकन सिटी
ਸੇਂਟ ਵਿਨਸੈਂਟ ਐਂਡ ਗ੍ਰੇਨਾਡੀਨਸ	सेंट विनसैंट ऐंड ग्रेनाडीनस
ਵੇਨੇਜ਼ੂਏਲਾ	वेनेज़ूएला
ਬ੍ਰਿਟਿਸ਼ ਵਰਜਿਨ ਟਾਪੂ	ब्रिटिश वरजिन टापू
ਯੂ ਐਸ ਵਰਜਿਨ ਟਾਪੂ	यू ऐस वरजिन टापू
ਵੀਅਤਨਾਮ	वीअतनाम
ਵਾਨੂਆਟੂ	वानूआटू
ਵਾਲਿਸ ਅਤੇ ਫੂਟੂਨਾ	वालिस अते फूटूना
ਸਾਮੋਆ	सामोआ
ਕੋਸੋਵੋ	कोसोवो
ਯਮਨ	यमन
ਮਾਯੋਟੀ	मायोटी
ਦੱਖਣੀ ਅਫਰੀਕਾ	दखणी अफरीका
ਜ਼ਾਮਬੀਆ	ज़ामबीआ
ਜ਼ਿੰਬਾਬਵੇ	ज़िबाबवे
ਅਣਪਛਾਤਾ ਖੇਤਰ	अणपछाता खेतर
