# Baby names
அகஜா	অকজা
அகந்ய	অকন্য
அகர்ஷா	অকর্ষা
அகஷீதா	অকষীতা
அகஷீநீ	অকষীনী
அகிலா	অকিলা
அக்நிஜ்வாளா	অক্নিজ্বালা
அக்நிஷிகா	অক্নিষিকা
அக்ஷ்யா	অক্ষ্যা
அசிஂத்ய	অচিংত্য
அச்யுதாந	অচ্যুতান
அதரஷ	অতরষ
அதீதீய	অতীতীয
அதீஷா	অতীষা
அதோத்கா	অতোত্কা
அத்யயந	অত্যযন
அத்யுத	অত্যুত
அத்ரியந	অত্রিযন
அத்விக	অত্বিক
அத்விதேயா	অত্বিতেযা
அபரா	অপরা
அபிஜந	অপিজন
அபிஜித	অপিজিত
அபிஜ்ஞா	অপিজ্ঞা
அபிஜ்ஞாந	অপিজ্ঞান
அபிநபஸ	অপিনপস
அபிம	অপিম
அபிமாநீ	অপিমানী
அபிராஜ	অপিরাজ
அபிருசி	অপিরুচি
அபீஜ்நா	অপীজ্না
அபீத்யா	অপীত্যা
அபீநாவ	অপীনাব
அபீமாஂந்யுஂ	অপীমাংন্যুং
அபீராம	অপীরাম
அபீரூபா	অপীরূপা
அபீஷ்ரேய	অপীষ্রেয
அபீஹேஷாந	অপীহেষান
அபேல	অপেল
அப்ஜாயோநீ	অপ্জাযোনী
அலாம்க்ரீதா	অলাম্ক্রীতা
அஹலாதிதா	অহলাতিতা
அஹில்யா	অহিল্যা
அஹீநா	অহীনা
அஹீந்ஜீதா	অহীন্জীতা
அஹ்லாதாஜநநீ	অহ্লাতাজননী
ஆகர்ஷக	আকর্ষক
ஆதிதேய	আতিতেয
ஆதித்வ	আতিত্ব
ஆதிபுருஷ	আতিপুরুষ
ஆதியா	আতিযা
ஆதீதேய	আতীতেয
ஆதீஷ்ரீ	আতীষ্রী
ஆத்மஜா	আত্মজা
ஆத்மய	আত্ময
ஆத்மாநஂத	আত্মানংত
ஆத்வாய	আত্বায
ஆநஂத்யா	আনংত্যা
ஆநதாலீப	আনতালীপ
ஆநாயா	আনাযা
ஆபாஸ	আপাস
ஆயநா	আযনা
ஆயாஂஷ	আযাংষ
ஆரஸீ	আরসী
ஆராயநா	আরাযনা
ஆரித்ர	আরিত্র
ஆரீ	আরী
ஆரீஷ	আরীষ
ஆருபா	আরুপা
ஆருல	আরুল
ஆரோசந	আরোচন
ஆர்த	আর্ত
ஆர்யவீர	আর্যবীর
ஆவாநீ	আবানী
ஆவீஷ	আবীষ
ஆஷ்கா	আষ্কা
ஆஷ்மீந	আষ্মীন
ஆஷ்ரித	আষ্রিত
ஆஷ்லேஷ	আষ্লেষ
இஂதுலால	ইংতুলাল
இஂதுஷேகர	ইংতুষেকর
இஂத்ரா	ইংত্রা
இஂபநாதந	ইংপনাতন
இநோதய	ইনোতয
இந்தாருபீநீ	ইন্তারুপীনী
இந்தாலீ	ইন্তালী
இந்துமத	ইন্তুমত
இந்த்ரதநுஷ	ইন্ত্রতনুষ
இந்த்ரதயும்ந	ইন্ত্রতযুম্ন
இந்த்ரந	ইন্ত্রন
இந்த்ரஸேநா	ইন্ত্রসেনা
இப்யா	ইপ্যা
இப்ஸா	ইপ্সা
இயலீஸாஈ	ইযলীসাঈ
இய்யாப்பந	ইয্যাপ্পন
இரித	ইরিত
இலாஷ்பஸ்தீ	ইলাষ্পস্তী
இலேஷ	ইলেষ
இஷாந	ইষান
இஷாந்வீ	ইষান্বী
இஷ்ய	ইষ্য
இஸகீ	ইসকী
ஈதீ	ঈতী
ஈந்துஸ	ঈন্তুস
ஈபா	ঈপা
ஈப்ஷா	ঈপ্ষা
ஈர்ஷீதா	ঈর্ষীতা
ஈலமாஂ	ঈলমাং
ஈலாபதாயே	ঈলাপতাযে
ஈலில	ঈলিল
ஈல்வாகா	ঈল্বাকা
ஈஷ்தர	ঈষ্তর
ஈஸீஃ	ঈসীঃ
ஈஸைவலந	ঈসৈবলন
ஈஹம	ঈহম
உக்ரஸ்ரவாஸ	উক্রস্রবাস
உசீமாஂகலீ	উচীমাংকলী
உஜாயந	উজাযন
உஜேஷ	উজেষ
உஜ்ஜவல	উজ্জবল
உஜ்வலீதா	উজ্বলীতা
உதஂகா	উতংকা
உதஂதா	উতংতা
உதாய	উতায
உதார	উতার
உத்கர்ஷ்ராஜ	উত্কর্ষ্রাজ
உத்கஷாநா	উত্কষানা
உத்காலிகா	উত্কালিকা
உத்கிதா	উত্কিতা
உத்தர	উত্তর
உத்தரக	উত্তরক
உத்தரா	উত্তরা
உத்தீயந	উত্তীযন
உத்பர	উত্পর
உத்யத	উত্যত
உத்வஹ	উত্বহ
உத்ஸர்க	উত্সর্ক
உத்ஸா	উত্সা
உநமாஇவீலஂபீ	উনমাইবীলংপী
உபசீத்ரா	উপচীত্রা
உபநாயிக	উপনাযিক
உபமா	উপমা
உப்ஜஸ	উপ্জস
உப்தம	উপ্তম
உப்பாஸ	উপ্পাস
உமஂகீ	উমংকী
உமாஂபுத்ர	উমাংপুত্র
உமாகாஂத	উমাকাংত
உரவஷீ	উরবষী
உரிஷிதா	উরিষিতা
உர்மீ	উর্মী
உர்வ	উর্ব
உர்வஂக	উর্বংক
உர்வா	উর্বা
உர்ஷிதா	উর্ষিতা
உஷாகிரண	উষাকিরণ
உஷாநா	উষানা
உஷீக	উষীক
உஸரீ	উসরী
ஏகலிஂக	একলিংক
ஏகாதநா	একাতনা
ஏகாத்யுஂ	একাত্যুং
ஏகாம்பர	একাম্পর
ஏகிஷா	একিষা
ஏக்ஷித	এক্ষিত
ஏதா	এতা
ஏதாஸ	এতাস
ஏதோம	এতোম
ஏமா	এমা
ஏலாந்த்ர	এলান্ত্র
ஏலுமலாஈ	এলুমলাঈ
ஏவாஂஷீ	এবাংষী
ஏஷஂகா	এষংকা
ஐஷா	ঐষা
ஐஷீ	ঐষী
ஐஷீநீ	ঐষীনী
ஓஏஷீ	ওএষী
ஓஜஸ்விநீ	ওজস্বিনী
ஓஜஸ்வீத	ওজস্বীত
ஓஜீஸ	ওজীস
ஓதிதீ	ওতিতী
ஓநிஷ	ওনিষ
ஓநீ	ওনী
ஓநீஸ	ওনীস
ஓப்பிலமணி	ওপ্পিলমণি
ஓமகாரீ	ওমকারী
ஓமநா	ওমনা
ஓமாஂஷ	ওমাংষ
ஓம்ஜா	ওম্জা
ஓவீஏ	ওবীএ
ஓவைஸ	ওবৈস
கஂகவார	কংকবার
கஂகா	কংকা
கஂகாதுத்த	কংকাতুত্ত
கஂகேஷ	কংকেষ
கஂஜரீ	কংজরী
கஂதரஜ	কংতরজ
கஂதர்ப	কংতর্প
கஂதாரா	কংতারা
கஂதிமோய	কংতিমোয
கஂதிரா	কংতিরা
கஂவர	কংবর
கஜபாஹூ	কজপাহূ
கஜாதர	কজাতর
கஜாநந	কজানন
கஜாநநந	কজাননন
கணநாத	কণনাত
கணபத	কণপত
கதஂபீ	কতংপী
கதித	কতিত
கதீர	কতীর
கநக்ஷா	কনক্ষা
கநாதந	কনাতন
கநிக	কনিক
கநீரா	কনীরা
கநேஷ	কনেষ
கநைய்யா	কনৈয্যা
கந்தாரவ	কন্তারব
கந்தாரீந	কন্তারীন
கந்மாநீ	কন্মানী
கந்வந	কন্বন
கந்வீ	কন্বী
கபாலீந	কপালীন
கமலாகர	কমলাকর
கமீத	কমীত
கமோத	কমোত
கயாலிகா	কযালিকা
கரமஷீ	করমষী
கருநேஷ	করুনেষ
கருல	করুল
கர்ண	কর্ণ
கர்வ	কর্ব
கர்ஷீந	কর্ষীন
கலாநீதீ	কলানীতী
கலாவதீ	কলাবতী
கலீபா	কলীপা
கலீல	কলীল
கல்யாணீ	কল্যাণী
கல்ஹார	কল্হার
கவீநயா	কবীনযা
கவேஷண	কবেষণ
கவ்ய	কব্য
கஷீக	কষীক
கஷ்விகா	কষ্বিকা
கஷ்விநீ	কষ্বিনী
கஸ்துர	কস্তুর
கஹதா	কহতা
கஹுலீகா	কহুলীকা
காஂதவ	কাংতব
காஂதிக	কাংতিক
காஂதீ	কাংতী
காஂவ	কাংব
காஜீஷ	কাজীষ
காதம்பரீ	কাতম্পরী
காதிரோலீ	কাতিরোলী
காதீத	কাতীত
காதீர அமத்துஇகந	কাতীর অমত্তুইকন
காதீராவண	কাতীরাবণ
காத்யயாநீ	কাত্যযানী
காத்யாயந	কাত্যাযন
காநகலதா	কানকলতা
காநாய	কানায
காநீத	কানীত
காநீமோஜ்ஹீ	কানীমোজ্হী
காந்ஜாநா	কান্জানা
காந்தா	কান্তা
காந்ஷீகா	কান্ষীকা
காமஜ	কামজ
காமராஜ	কামরাজ
காமிய	কামিয
காமுநா	কামুনা
காயல	কাযল
காயலே	কাযলে
காரடீ	কারটী
கார்திகா	কার্তিকা
கார்திகேயந	কার্তিকেযন
காலகா	কালকা
காலராத்ரீ	কালরাত্রী
காலீதா	কালীতা
காவேரீ	কাবেরী
காவ்யஷ்ரீ	কাব্যষ্রী
காஷீ	কাষী
காஸநீ	কাসনী
கிஂஜல	কিংজল
கிதிகா	কিতিকা
கிநாரீ	কিনারী
கிரிக	কিরিক
கிரீந்த்ர	কিরীন্ত্র
கீதிகா	কীতিকা
கீநாரீ	কীনারী
கீந்ஜு	কীন্জু
கீப்ஸோந	কীপ্সোন
கீவீதா	কীবীতা
குகந	কুকন
குடடூ	কুটটূ
குணித	কুণিত
குதாகேஷ	কুতাকেষ
குநாதிர	কুনাতির
குநாயூக்த	কুনাযূক্ত
குநாரத்நா	কুনারত্না
குநாஸேகரண	কুনাসেকরণ
குநித	কুনিত
குநிநா	কুনিনা
குநீந	কুনীন
குரதயால	কুরতযাল
குரு குகந	কুরু কুকন
குருநாத	কুরুনাত
குருப்ரஸாத	কুরুপ্রসাত
குர்ஜரீ	কুর্জরী
குலஜாரீலால	কুলজারীলাল
கூஂஜீகா	কূংজীকা
கூஹாரீ	কূহারী
கேஂகா	কেংকা
கேஓஷா	কেওষা
கேதீத	কেতীত
கேது	কেতু
கேநீகா	কেনীকা
கேயுரா	কেযুরা
கேவத	কেবত
கேவாஂஷீ	কেবাংষী
கேஷிநீ	কেষিনী
கேஷீ	কেষী
கேஷோரீ	কেষোরী
கேஸர	কেসর
கேஸரீ	কেসরী
கேஸவ	কেসব
கேஸவார்தீநீ	কেসবার্তীনী
கேஸவாளுஂ	কেসবালুং
கைரவ	কৈরব
கோஉஂஷிக	কোউংষিক
கோகீலாவாநீ	কোকীলাবানী
கோரல	কোরল
கோவ்தமீ	কোব্তমী
கோஷீதா	কোষীতা
கௌதிர்ய	কৌতির্য
கௌராஂஷ	কৌরাংষ
கௌரீமநோஹரீ	কৌরীমনোহরী
கௌஷாலீ	কৌষালী
கௌஷ்லேந்தர	কৌষ্লেন্তর
க்நாபீகா	ক্নাপীকা
க்யாநாவீ	ক্যানাবী
க்ரஂதநா	ক্রংতনা
க்ராமாநீ	ক্রামানী
க்ரீதேஷ	ক্রীতেষ
க்ரீஷா	ক্রীষা
சஂசாரீ	চংচারী
சஂதாலிநீ	চংতালিনী
சஂதாவர்மந	চংতাবর্মন
சஂத்ர பாந	চংত্র পান
சஂத்ரந	চংত্রন
சஂத்ரபால	চংত্রপাল
சஂத்ரயாந	চংত্রযান
சஂத்ரவாதி	চংত্রবাতি
சஂத்ராநீ	চংত্রানী
சஂத்ராமாஸீ	চংত্রামাসী
சஂத்ரிகா	চংত্রিকা
சஂபா	চংপা
சஂபாகலீ	চংপাকলী
சக்ரவர்தீ	চক্রবর্তী
சக்ரிகா	চক্রিকা
சதுர்புஜா	চতুর্পুজা
சந்த்ரவதந	চন্ত্রবতন
சரந்தேவ	চরন্তেব
சர்வாகா	চর্বাকা
சர்வீகேஷ	চর্বীকেষ
சவி	চবি
சாதீமாஂ	চাতীমাং
சாத்விக	চাত্বিক
சாநக்ய	চানক্য
சாருந	চারুন
சாருவிந்தா	চারুবিন্তা
சாருவீ	চারুবী
சார்வீ	চার্বী
சாவீஷ்கா	চাবীষ্কা
சிஂதந	চিংতন
சிஂதமாணீ	চিংতমাণী
சித்தப்ரஸாத	চিত্তপ্রসাত
சித்ரஂஷீ	চিত্রংষী
சித்ரக்ஷீ	চিত্রক্ষী
சித்ரா	চিত্রা
சித்ராமநீ	চিত্রামনী
சித்ரிகா	চিত্রিকা
சிந்மயாநஂதா	চিন্মযানংতা
சிரஂஜீவீ	চিরংজীবী
சுஂபந	চুংপন
சேஜியந	চেজিযন
சேரந்ராஜ	চেরন্রাজ
சேலுவா	চেলুবা
சைதந்யா	চৈতন্যা
சைநீகா	চৈনীকা
ஜஂகரத	জংকরত
ஜகஂமோஹந	জকংমোহন
ஜகதகுரு	জকতকুরু
ஜகதபால	জকতপাল
ஜகதம்பிகா	জকতম্পিকা
ஜகமாதா	জকমাতা
ஜக்ஸநா	জক্সনা
ஜத்யா	জত্যা
ஜநாதார்ண	জনাতার্ণ
ஜநாதேவ	জনাতেব
ஜநித	জনিত
ஜநீதா	জনীতা
ஜநீஷா	জনীষা
ஜந்மயா	জন্মযা
ஜய ஸகாந	জয সকান
ஜய  ப்ரகாஷ	জয  প্রকাষ
ஜய  ப்ரதிக	জয  প্রতিক
ஜயஂதாஸேநா	জযংতাসেনা
ஜயகோபால	জযকোপাল
ஜயநா	জযনা
ஜயவஂத	জযবংত
ஜயஸூர்யா	জযসূর্যা
ஜயாப்ரதா	জযাপ্রতা
ஜயாலக்ஷ்மீ	জযালক্ষ্মী
ஜயீ	জযী
ஜலாகஂதா	জলাকংতা
ஜலோதரீ	জলোতরী
ஜஷஂக	জষংক
ஜஷோதா	জষোতা
ஜஷ்மீநா	জষ্মীনা
ஜஷ்லந	জষ্লন
ஜஸ்வந்தீ	জস্বন্তী
ஜாஂபுவந	জাংপুবন
ஜாக்ராவீ	জাক্রাবী
ஜாநகீபூஷண	জানকীপূষণ
ஜாநா	জানা
ஜாஹீ	জাহী
ஜிதேந்த்ரிய	জিতেন্ত্রিয
ஜீக்யாஂஷ	জীক্যাংষ
ஜீக்யாஂஷு	জীক্যাংষু
ஜீஜீத	জীজীত
ஜீதீஷா	জীতীষা
ஜீதேஷீ	জীতেষী
ஜீமீ	জীমী
ஜீமீஷ	জীমীষ
ஜீரல	জীরল
ஜீவநகலா	জীবনকলা
ஜீவநலதா	জীবনলতা
ஜீவநஷ	জীবনষ
ஜீவந்தீநீ	জীবন্তীনী
ஜீவாநாந்தாம	জীবানান্তাম
ஜேதல	জেতল
ஜேதாஷ்ரீ	জেতাষ্রী
ஜேநீஷா	জেনীষা
ஜேராம	জেরাম
ஜேர்ரீஷ	জের্রীষ
ஜேர்ஷீகா	জের্ষীকা
ஜேஸ்வஂத	জেস্বংত
ஜேஸ்வீதா	জেস্বীতা
ஜைகரத	জৈকরত
ஜைதாஷ்ரீ	জৈতাষ্রী
ஜைதீ	জৈতী
ஜைப்ரித	জৈপ্রিত
ஜைமில	জৈমিল
ஜைமேஷ	জৈমেষ
ஜைலேஷ	জৈলেষ
ஜைவஂதீ	জৈবংতী
ஜைவத	জৈবত
ஜைவல	জৈবল
ஜைவீந	জৈবীন
ஜைஸுதந	জৈসুতন
ஜோதா	জোতা
ஜோயஷ்ரீ	জোযষ্রী
ஜ்ஞாந	জ্ঞান
ஜ்ஞாநதேவ	জ্ঞানতেব
ஜ்யோஷநா	জ্যোষনা
ஜ்ஹில	জ্হিল
ஜ்ஹீதீந	জ্হীতীন
டாகோர	টাকোর
டீம்பீல	টীম্পীল
தஂஷ	তংষ
தஃந்யத	তঃন্যত
தக்ஷ	তক্ষ
தக்ஷீண	তক্ষীণ
தக்ஷேஷ	তক্ষেষ
தணீ	তণী
தநதாந்யகீ	তনতান্যকী
தநலக்ஷ்மீ	তনলক্ষ্মী
தநவதீ	তনবতী
தநஸிகா	তনসিকা
தநாவர்ஷ	তনাবর্ষ
தநிப	তনিপ
தநீஷ	তনীষ
தநுஂ ப்ரவா	তনুং প্রবা
தநுஂந்ஜய	তনুংন্জয
தநுஂஷ்கா	তনুংষ্কা
தநுஂஷ்ரீ	তনুংষ্রী
தநுபா	তনুপা
தநுல	তনুল
தநுஷீ	তনুষী
தந்மாயா	তন্মাযা
தந்வந்தரீ	তন্বন্তরী
தபீஷ	তপীষ
தபேஷ	তপেষ
தப்த	তপ্ত
தமஸீ	তমসী
தமாலிகா	তমালিকা
தமிரா	তমিরা
தமிலந	তমিলন
தமிலா	তমিলা
தமேஷ	তমেষ
தயஸரா	তযসরা
தயாகர	তযাকর
தயாதா	তযাতা
தயாஷ்ரீ	তযাষ্রী
தரநீதர	তরনীতর
தரலீ	তরলী
தராஷா	তরাষা
தராஹாஸீ	তরাহাসী
தரீநந	তরীনন
தருலதா	তরুলতা
தர்பண	তর্পণ
தர்பித	তর্পিত
தர்மகீர்தி	তর্মকীর্তি
தர்மதித்ய	তর্মতিত্য
தர்ஷத	তর্ষত
தர்ஷா	তর্ষা
தர்ஷாநேயா	তর্ষানেযা
தர்ஷீத	তর্ষীত
தர்ஷீநீகா	তর্ষীনীকা
தர்ஷீல	তর্ষীল
தலஜீத	তলজীত
தலாபதீ	তলাপতী
தஸ்ம்யா	তস্ম্যা
தாதாகா	তাতাকা
தாநஸ	তানস
தாநாஸ்வீ	তানাস্বী
தாநுஂரீகியா	তানুংরীকিযা
தாமா	তামা
தாமிநீ	তামিনী
தாரகேஷ்வர	তারকেষ্বর
தாரீக	তারীক
தாரூ	তারূ
தாஷாரதீ	তাষারতী
தாஸ	তাস
திக்ஷாந்ய	তিক্ষান্য
திக்ஷீ	তিক্ষী
திநாத	তিনাত
திபஂஷீ	তিপংষী
திபஷ்ரீ	তিপষ্রী
திபஸரீ	তিপসরী
திப்ஜ்யோதீ	তিপ্জ্যোতী
திப்தீக்ஷா	তিপ্তীক্ষা
திப்யா	তিপ্যা
திப்யோக	তিপ্যোক
திருமாலா	তিরুমালা
திரூமாலாஈ	তিরূমালাঈ
திவேநா	তিবেনা
திஸ்யா	তিস্যা
தீதா	তীতা
தீநபஂது	তীনপংতু
தீநா நாத	তীনা নাত
தீநோஷா	তীনোষা
தீபாஂஷ	তীপাংষ
தீபாவதீ	তীপাবতী
தீப்தாந்ஷு	তীপ্তান্ষু
தீமித	তীমিত
தீமிலா	তীমিলা
தீரந	তীরন
தீர்தஂகர	তীর্তংকর
தீர்தீகா	তীর্তীকা
தீவாஷீநீ	তীবাষীনী
துஂகபத்ரா	তুংকপত্রা
துகாராம	তুকারাম
துந்கார	তুন্কার
துந்தா	তুন্তা
துரக	তুরক
துஷஂத	তুষংত
துஷார காஂதி	তুষার কাংতি
துஷாரா	তুষারা
துஷார்ஸுவரா	তুষার্সুবরা
தூந	তূন
தேஜ	তেজ
தேஜஸூர்ய	তেজসূর্য
தேஜாஂஷ	তেজাংষ
தேதீப்ய	তেতীপ্য
தேநாப்பந	তেনাপ্পন
தேபஂஜந	তেপংজন
தேபதாத்தா	তেপতাত্তা
தேப்ஜாநீ	তেপ্জানী
தேய்ரியா	তেয্রিযা
தேவகீ	তেবকী
தேவதத	তেবতত
தேவதத்த	তেবতত্ত
தேவதாஸ	তেবতাস
தேவந	তেবন
தேவமாஂதா	তেবমাংতা
தேவர்ஷி	তেবর্ষি
தேவாஂகநா	তেবাংকনা
தேவாதார்ஸ	তেবাতার্স
தேவாத்யுமநா	তেবাত্যুমনা
தேவாந	তেবান
தேவாநஂதா	তেবানংতা
தேவாப்ரியா	তেবাপ্রিযা
தேவாரீஷீ	তেবারীষী
தேவிநா	তেবিনা
தேவிஷீ	তেবিষী
தேவீ ப்ரிய	তেবী প্রিয
தேவேந	তেবেন
தேவேந்த்ர	তেবেন্ত্র
தேவேந்த்ரநாத	তেবেন্ত্রনাত
தேவேஷீ	তেবেষী
தேவேஷ்வர	তেবেষ্বর
தேஷநா	তেষনা
தேஷா	তেষা
தேஸநா	তেসনা
தேஸ்பீநா	তেস্পীনা
தோலாக்ஷீ	তোলাক্ষী
தோஷண	তোষণ
தௌருஸ	তৌরুস
தௌஷீநீ	তৌষীনী
த்ராயக்ஷ	ত্রাযক্ষ
த்ரிதேவ	ত্রিতেব
த்ரிநேத்ர	ত্রিনেত্র
த்ரிமாந	ত্রিমান
த்ரிலோகேஷ	ত্রিলোকেষ
த்ரிலோசந	ত্রিলোচন
த்ரிவேணீ	ত্রিবেণী
த்ரீஜ்யா	ত্রীজ্যা
த்ரீதேஷ	ত্রীতেষ
த்ரீஷ	ত্রীষ
த்ரீஷஂட	ত্রীষংট
த்ரீஷ்தீகா	ত্রীষ্তীকা
த்ருவிகா	ত্রুবিকা
நஂத	নংত
நஂதந	নংতন
நஂதிதா	নংতিতা
நஂதிநீ	নংতিনী
நகுலா	নকুলা
நக்ஷத்ர	নক্ষত্র
நக்ஷத்ரா	নক্ষত্রা
நதாலீஏ	নতালীএ
நதீஷ	নতীষ
நதுந	নতুন
நபீந	নপীন
நமஸ்தேதுஂ	নমস্তেতুং
நரபதி	নরপতি
நலிந	নলিন
நவநீத	নবনীত
நவநீத விலீப்தஂகா	নবনীত বিলীপ্তংকা
நவம	নবম
நவாஜ	নবাজ
நவால	নবাল
நாகஜோதீ	নাকজোতী
நாகபுஷண	নাকপুষণ
நாகாஂஜலீ	নাকাংজলী
நாகிநீ	নাকিনী
நாகீஸகா	নাকীসকা
நாகேஷ	নাকেষ
நாகேஷ்வர	নাকেষ্বর
நாதாரஂஜநீ	নাতারংজনী
நாதீநீ	নাতীনী
நாதேஸந	নাতেসন
நாபநீதா	নাপনীতা
நாபாயண	নাপাযণ
நாபித	নাপিত
நாமாஂஹா	নামাংহা
நாம்ராதா	নাম্রাতা
நாராப	নারাপ
நாராயணஸ்வாமீ	নারাযণস্বামী
நாரீநே	নারীনে
நாவில்லா	নাবিল্লা
நாவீல	নাবীল
நாவ்கீரண	নাব্কীরণ
நாவ்யா	নাব্যা
நாஷால	নাষাল
நாஹுல	নাহুল
நிகாரா	নিকারা
நிகேஷ	নিকেষ
நிஜு	নিজু
நிதல	নিতল
நிமிதா	নিমিতা
நிரமஈ	নিরমঈ
நிராமஈ	নিরামঈ
நிராலீ	নিরালী
நிர்மளா	নির্মলা
நில்ல	নিল্ল
நிவேஷ	নিবেষ
நீகீத்ஸா	নীকীত্সা
நீகுல	নীকুল
நீகேத	নীকেত
நீக்குஂ	নীক্কুং
நீக்ஷா	নীক্ষা
நீஜய	নীজয
நீதார்ஸநா	নীতার্সনা
நீதீகா	নীতীকা
நீபீஷ	নীপীষ
நீபுநா	নীপুনা
நீமிலீதா	নীমিলীতা
நீரமாஂ	নীরমাং
நீராலிகா	নীরালিকা
நீருஈமீ	নীরুঈমী
நீருதீ	নীরুতী
நீலஂஜந	নীলংজন
நீலகஂட	নীলকংট
நீலக்ரீவ	নীলক্রীব
நீலக்ஷ	নীলক্ষ
நீலயா	নীলযা
நீலாஂஜந	নীলাংজন
நீலாயந	নীলাযন
நீல்ப்ரப்பா	নীল্প্রপ্পা
நீஷாலீ	নীষালী
நீஸிதீநீ	নীসিতীনী
நீஸ்சலா	নীস্চলা
நீஹீதா	নীহীতা
நீஹீரா	নীহীরা
நேத்ரா	নেত্রা
நேய்ஸா	নেয্সা
நேர்யா	নের্যা
நேவில	নেবিল
நேஷுஂ	নেষুং
நேஹல	নেহল
நேஹா ஷ்ரீ	নেহা ষ্রী
நைத்விக	নৈত্বিক
நைமிஷ	নৈমিষ
நைருதீ	নৈরুতী
நைவாதயா	নৈবাতযা
நைஷத	নৈষত
நைஷால	নৈষাল
நௌபஹார	নৌপহার
பஂகிதா	পংকিতা
பஂகிமசஂத்ர	পংকিমচংত্র
பஂசபூதாத்மிகா	পংচপূতাত্মিকা
பஂசவடீ	পংচবটী
பஂசாஜநா	পংচাজনা
பஂடிதா	পংটিতা
பஂதாந	পংতান
பஂது	পংতু
பகீரா	পকীরা
பகு	পকু
பகுலா	পকুলা
பக்தாவர	পক্তাবর
பக்தாவாத்ஸலா	পক্তাবাত্সলা
பக்தி	পক্তি
பக்யாராஜ	পক্যারাজ
பதக	পতক
பதமாஂக்ஷ்ய	পতমাংক্ষ্য
பதமேஷ	পতমেষ
பதாலா	পতালা
பத்மக்ரிஹா	পত্মক্রিহা
பத்மரேகா	পত্মরেকা
பத்மவாஸா	পত্মবাসা
பத்மஷ்ரீ	পত্মষ্রী
பத்மாஂகல்யாநீ	পত্মাংকল্যানী
பத்மிநிஷ	পত্মিনিষ
பத்ரக்ஷ	পত্রক্ষ
பந்குரீ	পন্কুরী
பந்தீநீ	পন্তীনী
பந்நா	পন্না
பந்யஷ்ரீ	পন্যষ্রী
பந்ஹீ	পন্হী
பபலா	পপলা
பயோஷ்நீகா	পযোষ্নীকা
பரகா	পরকা
பரதாப ; பரதாப	পরতাপ ; পরতাপ
பரப்ரஹ்மநா	পরপ্রহ্মনা
பரப்ரஹ்மா	পরপ্রহ্মা
பரம	পরম
பரம ஜ்யோதி	পরম জ্যোতি
பரமா	পরমা
பரமாஂந்த்ர	পরমাংন্ত্র
பரமேஷ்வரீ	পরমেষ্বরী
பரவீந	পরবীন
பராகதீ	পরাকতী
பராமாஂ	পরামাং
பராஸரா	পরাসরা
பரித	পরিত
பரிஷீ	পরিষী
பரீகா	পরীকা
பரீஜாதாபா ஹராகாயா	পরীজাতাপা হরাকাযা
பரீநுத	পরীনুত
பரோமீதா	পরোমীতা
பர்தாத்வாஜாக்ரஸஂவாஸீநே	পর্তাত্বাজাক্রসংবাসীনে
பலப்ரதா	পলপ্রতা
பலராம	পলরাম
பலாகஸீ	পলাকসী
பலாநிகுமார	পলানিকুমার
பலோமீ	পলোমী
பல்மாநீ	পল্মানী
பல்லப	পল্লপ
பல்வித	পল্বিত
பவாநாஜ	পবানাজ
பவாநிதாஸ	পবানিতাস
பவியா	পবিযা
பவீந	পবীন
பஸுந்தாரா	পসুন্তারা
பஹவாஸ்ய	পহবাস্য
பஹுல	পহুল
பாஂகே	পাংকে
பாஂகேபிஹாரீ	পাংকেপিহারী
பாஂசாலீ	পাংচালী
பாஓலா	পাওলা
பாகாவாதி	পাকাবাতি
பாகீரத	পাকীরত
பாக்ய	পাক্য
பாக்யலக்ஷ்மீ	পাক্যলক্ষ্মী
பாதாலவதீ	পাতালবতী
பாத்ரஷ்ரீ	পাত্রষ্রী
பாநபாத்த	পানপাত্ত
பாநீக	পানীক
பாரூநா	পারূনা
பார்திஹாரீ	পার্তিহারী
பார்நாயுஂ	পার্নাযুং
பார்வதீ	পার্বতী
பார்ஷந	পার্ষন
பார்ஷ்வ	পার্ষ্ব
பார்ஹீ பர்ஹாவாதாம்ஸகா	পার্হী পর্হাবাতাম্সকা
பால கோபால	পাল কোপাল
பாலசஂத்ர	পালচংত্র
பாலநஹார	পালনহার
பாலாமுருகந	পালামুরুকন
பாலாராம	পালারাম
பால்குந	পাল্কুন
பாவதீ	পাবতী
பாவாகீ	পাবাকী
பாவிகா	পাবিকা
பாவீ	পাবী
பாவேஷ	পাবেষ
பாவேஷ்வாரீ	পাবেষ্বারী
பாவ்யஂஷ	পাব্যংষ
பாஸ்கர	পাস্কর
பாஸ்வர	পাস্বর
பாஹுலேயா	পাহুলেযা
பிஂகா	পিংকা
பிதா வாஸஸே	পিতা বাসসে
பிபிந	পিপিন
பிபுல	পিপুল
பிமல	পিমল
பிம்பா	পিম্পা
பியாலீ	পিযালী
பிரவா	পিরবা
பீஂகாய	পীংকায
பீஜயா	পীজযা
பீநுஂ	পীনুং
பீபத்ஸுஂ	পীপত্সুং
பீப்லோஜீத	পীপ্লোজীত
பீமஸேந	পীমসেন
பீர	পীর
பீர்நாவ	পীর্নাব
பீலாக்ஷ்யேந	পীলাক্ষ্যেন
பீல்பா ஷ்ரீ	পীল্পা ষ্রী
பீல்வாநீ	পীল্বানী
பீஹுநா	পীহুনা
பீஹூ	পীহূ
புதிகா	পুতিকা
புபத	পুপত
புமந	পুমন
புல்கேஷ	পুল্কেষ
புல்லந	পুল্লন
புவ்நேந்த்ர	পুব্নেন্ত্র
பூதநாதந	পূতনাতন
பூதேவீ	পূতেবী
பூபத	পূপত
பூபாலீ	পূপালী
பூரதீ	পূরতী
பூர்ணமாஸீ	পূর্ণমাসী
பூர்நாகமலா	পূর্নাকমলা
பூர்நாந	পূর্নান
பூர்வஂஸ	পূর্বংস
பூர்வித	পূর্বিত
பூலமாலா	পূলমালা
பூலேஂது	পূলেংতু
பூலோகாநாதாந	পূলোকানাতান
பேநுஂ	পেনুং
பேரவீ	পেরবী
பேலுரமீ	পেলুরমী
பேல்லீ	পেল্লী
பேஹுலா	পেহুলা
பைரவ	পৈরব
பைஸாகீ	পৈসাকী
போஂநந	পোংনন
போஉர்நீமாஂ	পোউর্নীমাং
போநநீ	পোননী
போஷீதா	পোষীতা
பௌலோஈநீ	পৌলোঈনী
பௌலோமீ	পৌলোমী
ப்ரகல்பா	প্রকল্পা
ப்ரகல்யா	প্রকল্যা
ப்ரகாலபா	প্রকালপা
ப்ரக்ரீதீ	প্রক্রীতী
ப்ரநீதீகா	প্রনীতীকা
ப்ரபா	প্রপা
ப்ரபாந	প্রপান
ப்ரபாஹரண	প্রপাহরণ
ப்ரஹார்ஷீநீ	প্রহার্ষীনী
ப்ராஂஷு	প্রাংষু
ப்ராக்ரீதீ	প্রাক্রীতী
ப்ராக்ஷீ	প্রাক্ষী
ப்ராணமய	প্রাণময
ப்ராத்ந்ய	প্রাত্ন্য
ப்ராநல	প্রানল
ப்ரீஜ	প্রীজ
ப்ரீந்தாவாநீ	প্রীন্তাবানী
ப்ரீஹதீ	প্রীহতী
ப்லேஸ்ஸீ	প্লেস্সী
மஂகலா	মংকলা
மஂகாஈ	মংকাঈ
மஂஜு ப்ரஸாத	মংজু প্রসাত
மஂடித	মংটিত
மஂதர	মংতর
மஂதாகிநீ	মংতাকিনী
மஂத்ரீந	মংত্রীন
மகந	মকন
மகநா	মকনা
மகரஂத	মকরংত
மணிரத்நா	মণিরত্না
மதிரா	মতিরা
மதுகாரீ	মতুকারী
மதுதீப	মতুতীপ
மதுராநீ	মতুরানী
மதுலந	মতুলন
மதுவஂதீ	মতুবংতী
மதேரூ	মতেরূ
மநஜ்யோத	মনজ্যোত
மநிதீபா	মনিতীপা
மநிமேகலா	মনিমেকলা
மநீகாரநீ	মনীকারনী
மநீதீப	মনীতীপ
மநீபலந	মনীপলন
மநோமய	মনোময
மநோரஂஜநா	মনোরংজনা
மநோரமா	মনোরমা
மந்மத	মন্মত
மந்யு	মন্যু
மம்தா	মম্তা
மயூர	মযূর
மரேஷ	মরেষ
மஹாஜ	মহাজ
மஹாதீ	মহাতী
மஹாதேஜ	মহাতেজ
மஹாதேஜஸ	মহাতেজস
மஹாத்மா	মহাত্মা
மஹாத்யுதா	মহাত্যুতা
மஹாந்தேஷ	মহান্তেষ
மஹாந்ய	মহান্য
மஹாபாலா	মহাপালা
மஹாபுத்தி	মহাপুত্তি
மஹாமாநீ	মহামানী
மஹாயோகீ	মহাযোকী
மஹால்யா	মহাল্যা
மஹாவித்யா	মহাবিত্যা
மஹிஷா	মহিষা
மஹீபதி	মহীপতি
மஹேஂத்ரா	মহেংত্রা
மஹேக	মহেক
மஹேஷநீ	মহেষনী
மாஂகா	মাংকা
மாஂதிக	মাংতিক
மாஂநாஷ்யுஂ	মাংনাষ্যুং
மாஂநீமாஂரண	মাংনীমাংরণ
மாஂநீமோஜ்ஹீ	মাংনীমোজ্হী
மாஂநீஷ்கா	মাংনীষ্কা
மாஂநுஸரீ	মাংনুসরী
மாஂநோரீதா	মাংনোরীতা
மாஂந்ஜுநாதா	মাংন্জুনাতা
மாஂரீஸ்வாரீ	মাংরীস্বারী
மாஂர்தஂதா	মাংর্তংতা
மாஂல்லீயா	মাংল্লীযা
மாதவ தாஸ	মাতব তাস
மாதுஜ	মাতুজ
மாதுவேமந	মাতুবেমন
மாத்ருதேவ	মাত্রুতেব
மாத்ரே	মাত্রে
மாந	মান
மாநகா	মানকা
மாநதந	মানতন
மாநவ	মানব
மாநீஏ	মানীএ
மாந்தாதா	মান্তাতা
மாந்தாரீ	মান্তারী
மாந்வீர	মান্বীর
மாரகாதம	মারকাতম
மாருதி	মারুতি
மார்கீத	মার্কীত
மார்ஷக	মার্ষক
மால மரகந	মাল মরকন
மாலிநீ	মালিনী
மாலு	মালু
மால்லேஷா	মাল্লেষা
மாஹிதா	মাহিতা
மாஹீப	মাহীপ
மிக்ஷா	মিক্ষা
மேத	মেত
மேதிநீ	মেতিনী
மேதுநா	মেতুনা
மைத்ரா	মৈত্রা
மைத்ரீ	মৈত্রী
மைமத	মৈমত
மௌலிகா	মৌলিকা
மௌலீஷா	মৌলীষা
யஜநேஷ	যজনেষ
யஜுர	যজুর
யஜ்நேஷ	যজ্নেষ
யது	যতু
யதுநஂதந	যতুনংতন
யதுராஜ	যতুরাজ
யவநா	যবনা
யஷராஜ	যষরাজ
யஷஸ்விந	যষস্বিন
யஷாஸ்காராம	যষাস্কারাম
யஷு	যষু
யஷோதா	যষোতা
யஷோதேவ	যষোতেব
யஸ்மீநீ	যস্মীনী
யாக்நீதா	যাক্নীতা
யாசந	যাচন
யாஜ்நா	যাজ্না
யாஜ்ஹீநீ	যাজ্হীনী
யாதவ	যাতব
யாதாவந	যাতাবন
யாதுதாநீ	যাতুতানী
யார	যার
யாஸ்தீகா	যাস্তীকা
யாஹ்வீ	যাহ্বী
யுஂகலராஜ	যুংকলরাজ
யுகல	যুকল
யுதாஜீத	যুতাজীত
யுநாய	যুনায
யுவநாத	যুবনাত
யுவராநீ	যুবরানী
யுவாநவ	যুবানব
யேதாஂத	যেতাংত
யேநாக்ஷீ	যেনাক্ষী
யேஷ்வீ	যেষ্বী
யோகதீபா	যোকতীপা
யோகாஷ்ரீ	যোকাষ্রী
யோகீந	যোকীন
யோகீஷ	যোকীষ
யோகேஷ்வரந	যোকেষ্বরন
யோஜித	যোজিত
யோஜீதா	যোজীতা
யோதீந	যোতীন
யோஷா	যোষা
யோஷாநா	যোষানা
யௌஷா	যৌষা
ரஂகிதா	রংকিতা
ரஂகீத	রংকীত
ரஂஜநீ	রংজনী
ரஂஜீநா	রংজীনা
ரகவா	রকবা
ரகஷ்ந்டா	রকষ্ন্টা
ரகு	রকু
ரகுரமண	রকুরমণ
ரகுவர	রকুবর
ரக்தாகமல	রক্তাকমল
ரக்தீமாஂ	রক্তীমাং
ரக்ஷாதீ	রক্ষাতী
ரணஜீ	রণজী
ரதாஂக	রতাংক
ரத்நாநிதி	রত্নানিতি
ரத்நாபலீ	রত্নাপলী
ரத்நாவலீ	রত্নাবলী
ரந்கௌரவ	রন্কৌরব
ரந்ஜீக	রন্জীক
ரந்வித	রন্বিত
ரமாகாஂத	রমাকাংত
ரமாயா	রমাযা
ரம்பேஷ	রম্পেষ
ரம்யக	রম্যক
ரவீந்தார	রবীন্তার
ரவ்யஂகீ	রব্যংকী
ரஷ்மீல	রষ্মীল
ரஸநா	রসনা
ரஸவிஹாரீ	রসবিহারী
ரஸிக	রসিক
ரஸ்லுஂநீ	রস্লুংনী
ரஹஸ	রহস
ராகவீ	রাকবী
ராகிநீ	রাকিনী
ராக்வீநதார	রাক্বীনতার
ராஜ  கிரண	রাজ  কিরণ
ராஜாப்ரதா	রাজাপ্রতা
ராஜார்ஷீ	রাজার্ষী
ராஜாவேல	রাজাবেল
ராஜாவேலுஂ	রাজাবেলুং
ராஜிகா	রাজিকা
ராஜீதா	রাজীতা
ராஜ்யலக்ஷ்மீ	রাজ্যলক্ষ্মী
ராதா	রাতা
ராதா வல்லப	রাতা বল্লপ
ராதாராநீ	রাতারানী
ராதிக	রাতিক
ராதிகா	রাতিকা
ராத்நாநீதீ	রাত্নানীতী
ராத்ரி	রাত্রি
ராம  ஸேவக	রাম  সেবক
ராமப்ரீய	রামপ্রীয
ராமாநஂத	রামানংত
ராமிநீ	রামিনী
ராமேஷ்வர	রামেষ্বর
ராவநா	রাবনা
ராஷி	রাষি
ராஹீந்ய	রাহীন্য
ரிஷ்மிதா	রিষ্মিতা
ரிஹா	রিহা
ரீகீதா	রীকীতা
ரீக்வீதா	রীক্বীতা
ரீதாநா	রীতানা
ரீதி	রীতি
ரீதூ	রীতূ
ரீத்திதா	রীত্তিতা
ரீத்யாஂஷ	রীত্যাংষ
ரீநீ	রীনী
ரீப்யா	রীপ্যা
ரீமநா	রীমনা
ரீம்பீ	রীম্পী
ரீஷ்மேதா	রীষ্মেতা
ரேஜீஷ	রেজীষ
ரேணு	রেণু
ரேநுக	রেনুক
ரேநேஷ	রেনেষ
ரேந்ஜீநீ	রেন্জীনী
ரேவா	রেবা
ரேஹாஂஷீ	রেহাংষী
ரேஹேஈலா	রেহেঈলা
ரைவத	রৈবত
ரௌஷந	রৌষন
லகஸித	লকসিত
லக்ஷ்மீ ஷ்ரீநிவாஸ	লক্ষ্মী ষ্রীনিবাস
லக்ஷ்மீகோபால	লক্ষ্মীকোপাল
லக்ஷ்மீநாராயநா	লক্ষ্মীনারাযনা
லஜ்ஜா	লজ্জা
லஜ்ஜாகா	লজ্জাকা
லஜ்ஜீதா	লজ্জীতা
லலித	ললিত
லலிதகிஷோரே	ললিতকিষোরে
லலிதசஂத்ரா	ললিতচংত্রা
லலீதாமபிகா	ললীতামপিকা
லலீத்யா	ললীত্যা
லவலீ	লবলী
லாச்மந	লাচ্মন
லாதாநகீ	লাতানকী
லாதீகா	লাতীকা
லாதேஷ	লাতেষ
லாத்வீகா	লাত্বীকা
லாபந்ய	লাপন্য
லாராந	লারান
லாரீநா	লারীনা
லாலநா	লালনা
லாலமணி	লালমণি
லாவந	লাবন
லாவிக	লাবিক
லாவீத்ர	লাবীত্র
லாவீஷ	লাবীষ
லாவ்நாய	লাব্নায
லாஸக	লাসক
லாஸ்ய	লাস্য
லீதீகா	লীতীকা
லீநா	লীনা
லீநுஂ	লীনুং
லீந்கபஂடீ	লীন্কপংটী
லீந்கம	লীন্কম
லீந்கஸம்ய	লীন্কসম্য
லீந்கேஸ்வரண	লীন্কেস্বরণ
லீபஷீதா	লীপষীতা
லீபாக்ஷீ	লীপাক্ষী
லீப்ஸீகா	লীপ্সীকা
லுகேஷ	লুকেষ
லூநீ	লূনী
லேஈவீநா	লেঈবীনা
லேக	লেক
லேகீஷா	লেকীষা
லேக்ஷாநா	লেক্ষানা
லேமாஂ	লেমাং
லேமாஂநா	লেমাংনা
லோகநாயாகீ	লোকনাযাকী
லோகாஜநாநீ	লোকাজনানী
லோகாபுஜ்ய	লোকাপুজ্য
லோகேந்தீரண	লোকেন্তীরণ
லோகேஷ்வாரீ	লোকেষ্বারী
லோக்யா	লোক্যা
லோலா	লোলা
லோவ்யம	লোব্যম
லோஸீ	লোসী
லோஹிதாஷ்வா	লোহিতাষ্বা
லோஹீத	লোহীত
லௌஹித்ய	লৌহিত্য
வஂசித	বংচিত
வஂஷ	বংষ
வஂஷிகா	বংষিকা
வஂஷீ	বংষী
வஂஹிஷிகா	বংহিষিকা
வக்ரதுஂட	বক্রতুংট
வஜ்ரக்ஷா	বজ্রক্ষা
வஜ்ராஜித	বজ্রাজিত
வதநா	বতনা
வத்ஸிந	বত্সিন
வநாநீ	বনানী
வநித	বনিত
வநிதா	বনিতা
வநீத	বনীত
வயுநஂத	বযুনংত
வரஜோத்தாமாஂ	বরজোত্তামাং
வரப்ரதா	বরপ্রতা
வரரோஹா	বররোহা
வருநாப்ரியா	বরুনাপ্রিযা
வருந்ய	বরুন্য
வருந்ஸாஈ	বরুন্সাঈ
வரேஷ	বরেষ
வர்ணித	বর্ণিত
வர்ஷ	বর্ষ
வர்ஷநேயா	বর্ষনেযা
வர்ஷாந	বর্ষান
வர்ஷால	বর্ষাল
வர்ஷீதா	বর্ষীতা
வர்ஷீல	বর্ষীল
வலாக	বলাক
வல்லபா	বল্লপা
வல்லவ	বল্লব
வஷீகரண	বষীকরণ
வஷீஷ்கா	বষীষ্কা
வஸஂதீ	বসংতী
வஸதிகா	বসতিকা
வஸீ	বসী
வஸுல	বসুল
வஸ்தாவீ	বস্তাবী
வஸ்மீஹா	বস্মীহা
வாகீஷ	বাকীষ
வாஜ்ரநாகா	বাজ্রনাকা
வாதஷா	বাতষা
வாதிவேலந	বাতিবেলন
வாத்ஸக	বাত্সক
வாநுஂ	বানুং
வாந்யா	বান্যা
வாமா	বামা
வாரநா	বারনা
வாஸஂதாமாலிகா	বাসংতামালিকা
வாஸுந்தரா	বাসুন্তরা
வாஸுமந	বাসুমন
வாஸுமாஂதா	বাসুমাংতা
வாஸுராதா	বাসুরাতা
விஜயாஸ்ரீ	বিজযাস্রী
விதாஸ்ரீ	বিতাস্রী
விதுலா	বিতুলা
வித்யாலக்ஷ்மீ	বিত্যালক্ষ্মী
விநாம்ப்ரா	বিনাম্প্রা
விநாயிகா	বিনাযিকা
விபாத	বিপাত
விமலா	বিমলা
விரமாஂநீகாநதா	বিরমাংনীকানতা
விராமநீ	বিরামনী
விஹாநா	বিহানা
வீஆந	বীআন
வீநாவாநீ	বীনাবানী
வீர்யவாந	বীর্যবান
வேக்ஷநா	বেক্ষনা
வேணு	বেণু
வேதவித்யா	বেতবিত্যা
வேதவ்ரதா	বেতব্রতা
வேதாஂக	বেতাংক
வேதாஂகா	বেতাংকা
வேதாந்த	বেতান্ত
வேதார்த	বেতার্ত
வேதாஷ்ரீ	বেতাষ্রী
வேதீமாஂ	বেতীমাং
வேத்ரிவால	বেত্রিবাল
வேத்ரீவேல	বেত্রীবেল
வேத்வியந	বেত্বিযন
வேநிமாதவ	বেনিমাতব
வேநீ	বেনী
வேநீஷா	বেনীষা
வேந்காதேஷ்வாரா	বেন্কাতেষ্বারা
வேந்மதீ	বেন্মতী
வேம்பரஸீ	বেম্পরসী
வைகுஂட	বৈকুংট
வைஜயஂதீ	বৈজযংতী
வைதுர்யா	বৈতুর্যা
வைத்யாத	বৈত্যাত
வைஷாக	বৈষাক
வைஷித	বৈষিত
ஷக்திதார்ய	ষক্তিতার্য
ஸஂகத  தலீவந	সংকত  তলীবন
ஸஂகவீ	সংকবী
ஸஂகீநீ	সংকীনী
ஸஂகேத	সংকেত
ஸஂக்ராஂதி	সংক্রাংতি
ஸஂசயீதா	সংচযীতা
ஸஂசாநா	সংচানা
ஸஂசீதீ	সংচীতী
ஸஂஜய	সংজয
ஸஂஜாலீ	সংজালী
ஸஂஜீவநீ	সংজীবনী
ஸஂஜீவீ	সংজীবী
ஸஂஜோலீ	সংজোলী
ஸஂததா	সংততা
ஸஂதீதீ	সংতীতী
ஸஂதீப	সংতীপ
ஸஂதோக	সংতোক
ஸஂதோஷீதா	সংতোষীতা
ஸஂரகதா	সংরকতা
ஸஂஸிதா	সংসিতা
ஸகா	সকা
ஸகுண	সকুণ
ஸக்ஷண	সক্ষণ
ஸசிதா	সচিতা
ஸசிதாநஂத விக்ரஹ	সচিতানংত বিক্রহ
ஸசிநதேவ	সচিনতেব
ஸசீதந	সচীতন
ஸசீநா	সচীনা
ஸசீந்தேஓ	সচীন্তেও
ஸதநாந்தம	সতনান্তম
ஸதபிஂது	সতপিংতু
ஸதிஷ	সতিষ
ஸநாவ்ய	সনাব্য
ஸந்நிதி	সন্নিতি
ஸபரஂக	সপরংক
ஸபரீநாத	সপরীনাত
ஸப்தாபீ	সপ্তাপী
ஸமக	সমক
ஸமாஂநவீ	সমাংনবী
ஸமாஜஸ	সমাজস
ஸமீர	সমীর
ஸமீரந	সমীরন
ஸமீரா	সমীরা
ஸமுத்ரா	সমুত্রা
ஸம்மோத	সম্মোত
ஸம்யுஂக்தா	সম্যুংক্তা
ஸம்ரீத்தீ	সম্রীত্তী
ஸரஜா	সরজা
ஸரஸா	সরসা
ஸரிஷா	সরিষা
ஸர்பாநீ	সর্পানী
ஸலஜ	সলজ
ஸஹரதய	সহরতয
ஸஹஷ்ரத	সহষ্রত
ஸஹஸ்வீநீ	সহস্বীনী
ஸஹிகா	সহিকা
ஸஹீத	সহীত
ஸஹீராம	সহীরাম
ஸஹேஜ	সহেজ
ஸாஂபா	সাংপা
ஸாஇ ஆநஂத	সাই আনংত
ஸாஇ ராம	সাই রাম
ஸாஈ லதா	সাঈ লতা
ஸாஈநாத	সাঈনাত
ஸாஈப்ரதாப	সাঈপ্রতাপ
ஸாகரிகா	সাকরিকা
ஸாக்நீகா	সাক্নীকা
ஸாசீ	সাচী
ஸாதரீ	সাতরী
ஸாதவிக	সাতবিক
ஸாநியா	সানিযা
ஸாமர	সামর
ஸாமலீ	সামলী
ஸாயக	সাযক
ஸாரஂகீ	সারংকী
ஸாவஂத	সাবংত
ஸாவித்ரீ	সাবিত্রী
ஸாஹத	সাহত
ஸாஹஸ	সাহস
ஸாஹிதீ	সাহিতী
ஸுப்ரியா	সুপ্রিযা
ஸைகரா	সৈকরা
ஹஂஷல	হংষল
ஹஂஸராஜ	হংসরাজ
ஹயாதீ	হযাতী
ஹரஜீத	হরজীত
ஹரம்யா	হরম্যা
ஹரஷீகேஷ	হরষীকেষ
ஹரிகரஷ்ண	হরিকরষ্ণ
ஹரித	হরিত
ஹரிநாராயண	হরিনারাযণ
ஹரிந்த்ரநாத	হরিন্ত্রনাত
ஹரிப்ரீத	হরিপ্রীত
ஹரிமஂதீ	হরিমংতী
ஹரீதாம	হরীতাম
ஹரீநாதா	হরীনাতা
ஹரீபேஅஸாத	হরীপেঅসাত
ஹரீவல்லப	হরীবল্লপ
ஹரீஷ்ரீ	হরীষ্রী
ஹரீஷ்வ	হরীষ্ব
ஹரேந்த்ர	হরেন্ত্র
ஹரேஹாந	হরেহান
ஹர்ஜஸ	হর্জস
ஹர்திக	হর্তিক
ஹர்பீதா	হর্পীতা
ஹர்யக்ஷ	হর্যক্ষ
ஹர்ஷதா	হর্ষতা
ஹர்ஷாலா	হর্ষালা
ஹர்ஷிகா	হর্ষিকা
ஹர்ஷீநீ	হর্ষীনী
ஹர்ஷீயா	হর্ষীযা
ஹர்ஸிகா	হর্সিকা
ஹவிஷ	হবিষ
ஹவீந்தா	হবীন্তা
ஹவ்யா	হব্যা
ஹஸமுக	হসমুক
ஹஸித	হসিত
ஹாரிகா	হারিকা
ஹாரீஜ	হারীজ
ஹிதீஷீந	হিতীষীন
ஹிதைஷ	হিতৈষ
ஹிந்தீ	হিন্তী
ஹிமாசல	হিমাচল
ஹிமாந	হিমান
ஹிரேந	হিরেন
ஹிஷால	হিষাল
ஹிஷீதா	হিষীতা
ஹீரா	হীরা
ஹீராந்யாப்பா	হীরান্যাপ্পা
ஹுமீஷா	হুমীষা
ஹும்ஸீகா	হুম্সীকা
ஹுர்தித்யா	হুর্তিত্যা
ஹுவீஷ்கா	হুবীষ্কা
ஹுவேந்த்ர	হুবেন্ত্র
ஹேஇஅந	হেইঅন
ஹேதார்த	হেতার্ত
ஹேதீநீ	হেতীনী
ஹேது	হেতু
ஹேநா	হেনা
ஹேமதேவ	হেমতেব
ஹேமா லாதீ	হেমা লাতী
ஹேமாஂம்பரீ	হেমাংম্পরী
ஹேமாஂவாநீ	হেমাংবানী
ஹேமாநீ	হেমানী
ஹேமாவாதிநஂதந	হেমাবাতিনংতন
ஹேமீத்ரா	হেমীত্রা
ஹேம்க்ரீஷ	হেম্ক্রীষ
ஹேரீத	হেরীত
ஹைமாஂ	হৈমাং
ஹோநஹார	হোনহার
ஹ்ரீகீந	হ্রীকীন
ஹ்ரீதித	হ্রীতিত
ஹ்ரீஷாப	হ্রীষাপ
#
#
# Territory names from CLDR
அஷன்ஷியன் தீவு	অষন়্ষিযন়্ তীবু
அன்டோரா	অন়্টোরা
ஐக்கிய அரபு எமிரேட்ஸ்	ঐক্কিয অরপু এমিরেট্স্
ஆப்கானிஸ்தான்	আপ্কান়িস্তান়্
ஆண்டிகுவா மற்றும் பார்புடா	আণ্টিকুবা মর্রুম্ পার্পুটা
அங்குய்லா	অঙ্কুয্লা
அல்பேனியா	অল্পেন়িযা
அர்மேனியா	অর্মেন়িযা
அங்கோலா	অঙ্কোলা
அண்டார்டிகா	অণ্টার্টিকা
அர்ஜென்டினா	অর্জেন়্টিন়া
அமெரிக்க சமோவா	অমেরিক্ক চমোবা
ஆஸ்திரியா	আস্তিরিযা
ஆஸ்திரேலியா	আস্তিরেলিযা
அரூபா	অরূপা
ஆலந்து தீவுகள்	আলন্তু তীবুকল্
அசர்பைஜான்	অচর্পৈজান়্
போஸ்னியா &amp; ஹெர்ஸகோவினா	পোস্ন়িযা &amp; হের্সকোবিন়া
பார்படோஸ்	পার্পটোস্
பங்களாதேஷ்	পঙ্কলাতেষ্
பெல்ஜியம்	পেল্জিযম্
புர்கினா ஃபாஸோ	পুর্কিন়া ঃপাসো
பல்கேரியா	পল্কেরিযা
பஹ்ரைன்	পহ্রৈন়্
புருண்டி	পুরুণ্টি
பெனின்	পেন়িন়্
செயின்ட் பார்தேலெமி	চেযিন়্ট্ পার্তেলেমি
பெர்முடா	পের্মুটা
புரூனேய்	পুরূন়েয্
பொலிவியா	পোলিবিযা
கரீபியன் நெதர்லாந்து	করীপিযন়্ নেতর্লান্তু
பிரேசில்	পিরেচিল্
பஹாமாஸ்	পহামাস্
பூடான்	পূটান়্
பொவேட் தீவுகள்	পোবেট্ তীবুকল্
போட்ஸ்வானா	পোট্স্বান়া
பெலாரூஸ்	পেলারূস্
பெலிஸ்	পেলিস্
கனடா	কন়টা
கோகோஸ் (கீலிங்) தீவுகள்	কোকোস্ (কীলিঙ্) তীবুকল্
காங்கோ - கின்ஷாசா	কাঙ্কো - কিন়্ষাচা
காங்கோ (டிஆர்சி)	কাঙ্কো (টিআর্চি)
மத்திய ஆப்ரிக்கக் குடியரசு	মত্তিয আপ্রিক্কক্ কুটিযরচু
காங்கோ - ப்ராஸாவில்லே	কাঙ্কো - প্রাসাবিল্লে
காங்கோ (குடியரசு)	কাঙ্কো (কুটিযরচু)
ஸ்விட்சர்லாந்து	স্বিট্চর্লান্তু
கோட் தி’வாயர்	কোট্ তি’বাযর্
ஐவரி கோஸ்ட்	ঐবরি কোস্ট্
குக் தீவுகள்	কুক্ তীবুকল্
சிலி	চিলি
கேமரூன்	কেমরূন়্
சீனா	চীন়া
கொலம்பியா	কোলম্পিযা
கிலிப்பர்டன் தீவு	কিলিপ্পর্টন়্ তীবু
கோஸ்டாரிகா	কোস্টারিকা
கியூபா	কিযূপা
கேப் வெர்டே	কেপ্ বের্টে
குராகவ்	কুরাকব্
கிறிஸ்துமஸ் தீவு	কিরিস্তুমস্ তীবু
சைப்ரஸ்	চৈপ্রস্
செக் குடியரசு	চেক্ কুটিযরচু
ஜெர்மனி	জের্মন়ি
டியகோ கார்ஷியா	টিযকো কার্ষিযা
ஜிபௌட்டி	জিপৌট্টি
டென்மார்க்	টেন়্মার্ক্
டொமினிகா	টোমিন়িকা
டொமினிகன் குடியரசு	টোমিন়িকন়্ কুটিযরচু
அல்ஜீரியா	অল্জীরিযা
சியூடா &amp; மெலில்லா	চিযূটা &amp; মেলিল্লা
ஈக்வடார்	ঈক্বটার্
எஸ்டோனியா	এস্টোন়িযা
எகிப்து	একিপ্তু
மேற்கு சஹாரா	মের্কু চহারা
எரிட்ரியா	এরিট্রিযা
ஸ்பெயின்	স্পেযিন়্
எதியோப்பியா	এতিযোপ্পিযা
ஐரோப்பிய யூனியன்	ঐরোপ্পিয যূন়িযন়্
பின்லாந்து	পিন়্লান্তু
ஃபிஜி	ঃপিজি
ஃபாக்லாந்து தீவுகள்	ঃপাক্লান্তু তীবুকল্
ஃபாக்லாந்து தீவுகள் (இஸ்லாஸ் மால்வினஸ்)	ঃপাক্লান্তু তীবুকল্ (ইস্লাস্ মাল্বিন়স্)
மைக்ரோனேஷியா	মৈক্রোন়েষিযা
ஃபாரோ தீவுகள்	ঃপারো তীবুকল্
பிரான்ஸ்	পিরান়্স্
கேபான்	কেপান়্
ஐக்கிய பேரரசு	ঐক্কিয পেররচু
யூகே	যূকে
கிரனெடா	কিরন়েটা
ஜார்ஜியா	জার্জিযা
பிரெஞ்சு கயானா	পিরেঞ্চু কযান়া
கெர்ன்சி	কের্ন়্চি
கானா	কান়া
ஜிப்ரால்டர்	জিপ্রাল্টর্
கிரீன்லாந்து	কিরীন়্লান্তু
காம்பியா	কাম্পিযা
கினியா	কিন়িযা
க்வாதேலோப்	ক্বাতেলোপ্
ஈக்வடோரியல் கினியா	ঈক্বটোরিযল্ কিন়িযা
கிரீஸ்	কিরীস্
தென் ஜியார்ஜியா மற்றும் தென் சான்ட்விச் தீவுகள்	তেন়্ জিযার্জিযা মর্রুম্ তেন়্ চান়্ট্বিচ্ তীবুকল্
கவுதமாலா	কবুতমালা
குவாம்	কুবাম্
கினியா-பிஸ்ஸாவ்	কিন়িযা-পিস্সাব্
கயானா	কযান়া
ஹாங்காங் எஸ்ஏஆர் சீனா	হাঙ্কাঙ্ এস্এআর্ চীন়া
ஹாங்காங்	হাঙ্কাঙ্
ஹேர்ட் மற்றும் மெக்டொனால்டு தீவுகள்	হের্ট্ মর্রুম্ মেক্টোন়াল্টু তীবুকল্
ஹோண்டூராஸ்	হোণ্টূরাস্
குரேஷியா	কুরেষিযা
ஹைட்டி	হৈট্টি
ஹங்கேரி	হঙ্কেরি
கேனரி தீவுகள்	কেন়রি তীবুকল্
இந்தோனேசியா	ইন্তোন়েচিযা
அயர்லாந்து	অযর্লান্তু
இஸ்ரேல்	ইস্রেল্
ஐல் ஆஃப் மேன்	ঐল্ আঃপ্ মেন়্
இந்தியா	ইন্তিযা
பிரிட்டிஷ் இந்தியப் பெருங்கடல் பிரதேசம்	পিরিট্টিষ্ ইন্তিযপ্ পেরুঙ্কটল্ পিরতেচম্
ஈராக்	ঈরাক্
ஈரான்	ঈরান়্
ஐஸ்லாந்து	ঐস্লান্তু
இத்தாலி	ইত্তালি
ஜெர்சி	জের্চি
ஜமைகா	জমৈকা
ஜோர்டான்	জোর্টান়্
ஜப்பான்	জপ্পান়্
கென்யா	কেন়্যা
கிர்கிஸ்தான்	কির্কিস্তান়্
கம்போடியா	কম্পোটিযা
கிரிபடி	কিরিপটি
கோமரோஸ்	কোমরোস্
செயின்ட் கிட்ஸ் &amp; நெவிஸ்	চেযিন়্ট্ কিট্স্ &amp; নেবিস্
வட கொரியா	বট কোরিযা
தென் கொரியா	তেন়্ কোরিযা
குவைத்	কুবৈত্
கெய்மென் தீவுகள்	কেয্মেন়্ তীবুকল্
கஸகஸ்தான்	কসকস্তান়্
லாவோஸ்	লাবোস্
லெபனான்	লেপন়ান়্
செயின்ட் லூசியா	চেযিন়্ট্ লূচিযা
லிச்செண்ஸ்டெய்ன்	লিচ্চেণ্স্টেয্ন়্
இலங்கை	ইলঙ্কৈ
லைபீரியா	লৈপীরিযা
லெசோதோ	লেচোতো
லிதுவேனியா	লিতুবেন়িযা
லக்ஸ்சம்பர்க்	লক্স্চম্পর্ক্
லாட்வியா	লাট্বিযা
லிபியா	লিপিযা
மொராக்கோ	মোরাক্কো
மொனாக்கோ	মোন়াক্কো
மால்டோவா	মাল্টোবা
மான்டேனெக்ரோ	মান়্টেন়েক্রো
செயின்ட் மார்ட்டீன்	চেযিন়্ট্ মার্ট্টীন়্
மடகாஸ்கர்	মটকাস্কর্
மார்ஷல் தீவுகள்	মার্ষল্ তীবুকল্
மாசிடோனியா	মাচিটোন়িযা
மாசிடோனியா (ஃபைரோம்)	মাচিটোন়িযা (ঃপৈরোম্)
மாலி	মালি
மியான்மார் (பர்மா)	মিযান়্মার্ (পর্মা)
மங்கோலியா	মঙ্কোলিযা
மகாவ் எஸ்ஏஆர் சீனா	মকাব্ এস্এআর্ চীন়া
மகாவ்	মকাব্
வடக்கு மரியானா தீவுகள்	বটক্কু মরিযান়া তীবুকল্
மார்டினிக்	মার্টিন়িক্
மௌரிடானியா	মৌরিটান়িযা
மாண்ட்செராட்	মাণ্ট্চেরাট্
மால்டா	মাল্টা
மொரிசியஸ்	মোরিচিযস্
மாலத்தீவு	মালত্তীবু
மலாவி	মলাবি
மெக்சிகோ	মেক্চিকো
மலேசியா	মলেচিযা
மொசாம்பிக்	মোচাম্পিক্
நமீபியா	নমীপিযা
நியூ கேலிடோனியா	নিযূ কেলিটোন়িযা
நைஜர்	নৈজর্
நார்ஃபோக் தீவுகள்	নার্ঃপোক্ তীবুকল্
நைஜீரியா	নৈজীরিযা
நிகரகுவா	নিকরকুবা
நெதர்லாந்து	নেতর্লান্তু
நார்வே	নার্বে
நேபாளம்	নেপালম্
நௌரு	নৌরু
நியூ	নিযূ
நியூசிலாந்து	নিযূচিলান্তু
ஓமன்	ওমন়্
பனாமா	পন়ামা
பெரு	পেরু
பிரெஞ்சு பாலினேஷியா	পিরেঞ্চু পালিন়েষিযা
பப்புவா நியூ கினியா	পপ্পুবা নিযূ কিন়িযা
பிலிப்பைன்ஸ்	পিলিপ্পৈন়্স্
பாகிஸ்தான்	পাকিস্তান়্
போலந்து	পোলন্তু
செயின்ட் பியர் &amp; மிக்வேலான்	চেযিন়্ট্ পিযর্ &amp; মিক্বেলান়্
பிட்கெய்ர்ன் தீவுகள்	পিট্কেয্র্ন়্ তীবুকল্
பியூர்டோ ரிகோ	পিযূর্টো রিকো
பாலஸ்தீனிய பிரதேசங்கள்	পালস্তীন়িয পিরতেচঙ্কল্
பாலஸ்தீனம்	পালস্তীন়ম্
போர்ச்சுக்கல்	পোর্চ্চুক্কল্
பாலோ	পালো
பராகுவே	পরাকুবে
கத்தார்	কত্তার্
வெளிப்புற ஓஷியானியா	বেলিপ্পুর ওষিযান়িযা
ரீயூனியன்	রীযূন়িযন়্
ருமேனியா	রুমেন়িযা
செர்பியா	চের্পিযা
ரஷ்யா	রষ্যা
ருவான்டா	রুবান়্টা
சவூதி அரேபியா	চবূতি অরেপিযা
சாலமன் தீவுகள்	চালমন়্ তীবুকল্
சீஷெல்ஸ்	চীষেল্স্
சூடான்	চূটান়্
ஸ்வீடன்	স্বীটন়্
சிங்கப்பூர்	চিঙ্কপ্পূর্
செயின்ட் ஹெலெனா	চেযিন়্ট্ হেলেন়া
ஸ்லோவேனியா	স্লোবেন়িযা
ஸ்வல்பார்டு &amp; ஜான் மேயன்	স্বল্পার্টু &amp; জান়্ মেযন়্
ஸ்லோவாகியா	স্লোবাকিযা
சியாரா லியோன்	চিযারা লিযোন়্
சான் மரினோ	চান়্ মরিন়ো
செனெகல்	চেন়েকল্
சோமாலியா	চোমালিযা
சுரினாம்	চুরিন়াম্
தெற்கு சூடான்	তের্কু চূটান়্
சாவ் தோம் &amp; ப்ரின்சிபி	চাব্ তোম্ &amp; প্রিন়্চিপি
எல் சால்வடார்	এল্ চাল্বটার্
சின்ட் மார்டென்	চিন়্ট্ মার্টেন়্
சிரியா	চিরিযা
ஸ்வாஸிலாந்து	স্বাসিলান্তু
டிரிஸ்டன் டா குன்ஹா	টিরিস্টন়্ টা কুন়্হা
டர்க்ஸ் &amp; கைகோஸ் தீவுகள்	টর্ক্স্ &amp; কৈকোস্ তীবুকল্
சாட்	চাট্
பிரெஞ்சு தெற்கு பிரதேசங்கள்	পিরেঞ্চু তের্কু পিরতেচঙ্কল্
டோகோ	টোকো
தாய்லாந்து	তায্লান্তু
தாஜிகிஸ்தான்	তাজিকিস্তান়্
டோகேலோ	টোকেলো
தைமூர்-லெஸ்தே	তৈমূর্-লেস্তে
கிழக்கு தைமூர்	কিলক্কু তৈমূর্
துர்க்மெனிஸ்தான்	তুর্ক্মেন়িস্তান়্
டுனிசியா	টুন়িচিযা
டோங்கா	টোঙ্কা
துருக்கி	তুরুক্কি
ட்ரினிடாட் &amp; டொபாகோ	ট্রিন়িটাট্ &amp; টোপাকো
துவாலூ	তুবালূ
தைவான்	তৈবান়্
தான்சானியா	তান়্চান়িযা
உக்ரைன்	উক্রৈন়্
உகாண்டா	উকাণ্টা
அமெரிக்கா	অমেরিক্কা
யூஎஸ்	যূএস্
உருகுவே	উরুকুবে
உஸ்பெகிஸ்தான்	উস্পেকিস্তান়্
வாடிகன் நகரம்	বাটিকন়্ নকরম্
செயின்ட் வின்சென்ட் &amp; கிரெனடைன்ஸ்	চেযিন়্ট্ বিন়্চেন়্ট্ &amp; কিরেন়টৈন়্স্
வெனிசுலா	বেন়িচুলা
பிரிட்டீஷ் கன்னித் தீவுகள்	পিরিট্টীষ্ কন়্ন়িত্ তীবুকল্
வியட்நாம்	বিযট্নাম্
வனுவாட்டு	বন়ুবাট্টু
வாலிஸ் மற்றும் ஃபுடுனா	বালিস্ মর্রুম্ ঃপুটুন়া
சமோவா	চমোবা
கொசோவோ	কোচোবো
ஏமன்	এমন়্
மயோட்	মযোট্
தென் ஆப்பிரிக்கா	তেন়্ আপ্পিরিক্কা
ஜாம்பியா	জাম্পিযা
ஜிம்பாப்வே	জিম্পাপ্বে
அறியப்படாத பிரதேசம்	অরিযপ্পটাত পিরতেচম্
