# Baby names
അകര്ശാനാ	અકર્શાના
അക്ശൈനീഏ	અક્શૈનીએ
അഗജാ	અગજા
അചിംത	અચિંત
അചിത	અચિત
അച്ചിന്ദ്ര	અચ્ચિન્દ્ર
അഡ്യാദവൈതാ	અડ્યાદવૈતા
അദഭുതഃ	અદભુતઃ
അദേന്യ	અદેન્ય
അദേല	અદેલ
അദ്രിതീ	અદ્રિતી
അദ്രീഥീ	અદ્રીથી
അദ്രീമാം	અદ્રીમાં
അദ്വൈയാ	અદ્વૈયા
അധര്ഷ	અધર્ષ
അധിപാ	અધિપા
അധീരതാ	અધીરતા
അധ്യുത	અધ્યુત
അനംതാമായാ	અનંતામાયા
അബരനാ	અબરના
അബിനയ	અબિનય
അബിനാ	અબિના
അബീനംദാ	અબીનંદા
അബീശാ	અબીશા
അഭയ	અભય
അഭയന	અભયન
അഭിഗ്ന്യാ	અભિગ્ન્યા
അഭിജീതാ	અભિજીતા
അഭിനിവേശ	અભિનિવેશ
അഭിമ	અભિમ
അഭിമാനീ	અભિમાની
അഭിമോദാ	અભિમોદા
അഭിരാ	અભિરા
അഭിരാത	અભિરાત
അഭീരല	અભીરલ
അഭീശ്രേയ	અભીશ્રેય
അഭീസുമത	અભીસુમત
അഭ്യപ്സീത	અભ્યપ્સીત
അഭ്യുദയാ	અભ્યુદયા
അമൃതാ	અમૃતા
അലകനംദാ	અલકનંદા
അലക്ഷാ	અલક્ષા
അല്കാ	અલ્કા
അശവ	અશવ
അശ്നേഇല	અશ્નેઇલ
ആകാശലീനാ	આકાશલીના
ആകൃഥീ	આકૃથી
ആക്ഷ്യാ	આક્ષ્યા
ആചാര്യ	આચાર્ય
ആത്മയ	આત્મય
ആദി	આદિ
ആദിമ	આદિમ
ആദീവ	આદીવ
ആധീരേന	આધીરેન
ആധ്യാ	આધ્યા
ആനംദീനീ	આનંદીની
ആനീകാ	આનીકા
ആന്തീകാ	આન્તીકા
ആന്വീ	આન્વી
ആപ്ത	આપ્ત
ആപ്തി	આપ્તિ
ആമാംനീ	આમાંની
ആമിഷ	આમિષ
ആമുക്ഥാ	આમુક્થા
ആയുസ	આયુસ
ആയോദ	આયોદ
ആരംഭീ	આરંભી
ആരതീ	આરતી
ആരസീ	આરસી
ആര്യ	આર્ય
ആര്യക	આર્યક
ആര്യനാ	આર્યના
ആര്യമാനീ	આર્યમાની
ആലേഃയാ	આલેઃયા
ആവംശ	આવંશ
ആവേശ	આવેશ
ആശകാ	આશકા
ആശിയാനാ	આશિયાના
ആശുതോഷ	આશુતોષ
ആശ്മീന	આશ્મીન
ആശ്വിത	આશ્વિત
ആസവ	આસવ
ആസ്തിക	આસ્તિક
ഇക്ശാനാ	ઇક્શાના
ഇജയാ	ઇજયા
ഇനീയന	ઇનીયન
ഇനോദയ	ઇનોદય
ഇന്ദരകാന്ത	ઇન્દરકાન્ત
ഇന്ദിവാരസ	ઇન્દિવારસ
ഇന്ദുശിതാലാ	ઇન્દુશિતાલા
ഇന്ദ്രജാ	ઇન્દ્રજા
ഇന്ദ്രതന	ઇન્દ્રતન
ഇന്ദ്രദയുമ്ന	ઇન્દ્રદયુમ્ન
ഇന്ദ്രവദന	ઇન્દ્રવદન
ഇന്ദ്രാണീ	ઇન્દ્રાણી
ഇബ്ബാനീ	ઇબ્બાની
ഇയുരേശ	ઇયુરેશ
ഇയേനഗര	ઇયેનગર
ഇരാജ	ઇરાજ
ഇരിത	ઇરિત
ഇരേശ	ઇરેશ
ഇലിസാ	ઇલિસા
ഇശിതാ	ઇશિતા
ഇശ്വാര്യ	ઇશ્વાર્ય
ഇഷ്ടാ	ઇષ્ટા
ഇഷ്ടി	ઇષ્ટિ
ഇസാര	ઇસાર
ഇസ്ശും	ઇસ્શું
ഈതന	ઈતન
ഈതികാ	ઈતિકા
ഈരേന്പ്രിത	ઈરેન્પ્રિત
ഈര്ശീതാ	ઈર્શીતા
ഈലാക്കീയാ	ઈલાક્કીયા
ഈലികാ	ઈલિકા
ഈലേശാ	ઈલેશા
ഈശാര	ઈશાર
ഈശിക	ઈશિક
ഈശ്വരദത്ത	ઈશ્વરદત્ત
ഈഹാ	ઈહા
ഉഗ്രസ്രവാസ	ઉગ્રસ્રવાસ
ഉജവണീ	ઉજવણી
ഉജേശാ	ઉજેશા
ഉജ്ജന	ઉજ્જન
ഉജ്ജവല	ઉજ્જવલ
ഉജ്ജവാലാ	ઉજ્જવાલા
ഉജ്ജ്വലാ /ഉജ്വലാ	ઉજ્જ્વલા /ઉજ્વલા
ഉജ്ജ്വാലാ	ઉજ્જ્વાલા
ഉത്കര്ഷ	ઉત્કર્ષ
ഉത്കലാ	ઉત્કલા
ഉത്തര	ઉત્તર
ഉത്പര	ઉત્પર
ഉത്സര്ഗ	ઉત્સર્ગ
ഉദയ കുമാര	ઉદય કુમાર
ഉദരഥീ	ઉદરથી
ഉദാന്തികാ	ઉદાન્તિકા
ഉദേയ	ઉદેય
ഉദ്ധാര	ઉદ્ધાર
ഉദ്യത	ઉદ્યત
ഉദ്യമീ	ઉદ્યમી
ഉദ്യോത	ઉદ્યોત
ഉധവ	ઉધવ
ഉപംഗ	ઉપંગ
ഉപദാ	ઉપદા
ഉപാധ്രീതീ	ઉપાધ્રીતી
ഉപ്പാസ	ઉપ્પાસ
ഉമാ	ઉમા
ഉമേശ്വര	ઉમેશ્વર
ഉരിശിതാ	ઉરિશિતા
ഉര്ജാ	ઉર્જા
ഉര്ജീകാ	ઉર્જીકા
ഉര്ജീതാ	ઉર્જીતા
ഉര്ദാഹാവ	ઉર્દાહાવ
ഉര്മികാ	ઉર્મિકા
ഉര്മിമാലാ	ઉર્મિમાલા
ഉര്വീനാഥ	ઉર્વીનાથ
ഉല്പേശ	ઉલ્પેશ
ഉശേന്യ	ઉશેન્ય
ഉഷാശി	ઉષાશિ
ഉഷ്മാ	ઉષ્મા
ഉസരീ	ઉસરી
ഊതരാ	ઊતરા
ഊര്വേശ	ઊર્વેશ
ഏകംശീ	એકંશી
ഏകക്ഷരപരാ	એકક્ષરપરા
ഏകതന	એકતન
ഏകതാ	એકતા
ഏകാംശ	એકાંશ
ഏകാകാന്യ	એકાકાન્ય
ഏകാനീ	એકાની
ഏകാപര്നികാ	એકાપર્નિકા
ഏകേസ്വാര	એકેસ્વાર
ഏത്തന	એત્તન
ഏധിത	એધિત
ഏമാ	એમા
ഏലനാ	એલના
ഏലാ	એલા
ഏലീലവേംദന	એલીલવેંદન
ഏലീലീ	એલીલી
ഓഈസീന	ઓઈસીન
ഓജസ്വീ	ઓજસ્વી
ഓജാ	ઓજા
ഓജീസ	ઓજીસ
ഓനിശ	ઓનિશ
ഓമപ്രകാശ	ઓમપ્રકાશ
ഓവീന	ઓવીન
ഓവൈസ	ઓવૈસ
കംജ	કંજ
കംജന	કંજન
കംഠന	કંઠન
കംദര്പ	કંદર્પ
കംപനാ	કંપના
കകോന	કકોન
കതകീ	કતકી
കതേല്യ്ന	કતેલ્ય્ન
കനക	કનક
കനദ	કનદ
കനാകംഗീ	કનાકંગી
കനീജാ	કનીજા
കനീരാ	કનીરા
കനീസാ	કનીસા
കനുഷ	કનુષ
കന്വക	કન્વક
കന്ശീകാ	કન્શીકા
കപാലീന	કપાલીન
കപിലാശ്വര	કપિલાશ્વર
കമലാപതി	કમલાપતિ
കമലിനീ	કમલિની
കമലേക്ഷണ	કમલેક્ષણ
കമ്നാ	કમ્ના
കരാലാ	કરાલા
കരീസമാം	કરીસમાં
കരുനാസ്രീ	કરુનાસ્રી
കരുപ്പസമ്യ	કરુપ્પસમ્ય
കര്ണ	કર્ણ
കര്തീഗാ	કર્તીગા
കര്മദീപ	કર્મદીપ
കര്മാശ	કર્માશ
കലരനീ	કલરની
കലശ	કલશ
കലാധര	કલાધર
കലാനിധി	કલાનિધિ
കലാപരണ	કલાપરણ
കലാപീന	કલાપીન
കലാപ്രിയാ	કલાપ્રિયા
കലൈസേലവീ	કલૈસેલવી
കവന	કવન
കവിപ  പ്രിയ	કવિપ  પ્રિય
കവീനാഥ	કવીનાથ
കശ്തീ	કશ્તી
കാജല	કાજલ
കാജീശ	કાજીશ
കാദമ്ബരീ	કાદમ્બરી
കാധിരോലീ	કાધિરોલી
കാനീ	કાની
കാന്ജീരാ	કાન્જીરા
കാന്തീ	કાન્તી
കാമത	કામત
കാമിഷാ	કામિષા
കാമേശ	કામેશ
കാരുണ്യ പ്രകാശ	કારુણ્ય પ્રકાશ
കാരൂകാ	કારૂકા
കാര്നിക	કાર્નિક
കാലിക	કાલિક
കാലിപദാ	કાલિપદા
കാലിയാ	કાલિયા
കാലീതാ	કાલીતા
കാവ്യ ശ്രീ	કાવ્ય શ્રી
കിന്നേരാ	કિન્નેરા
കീഅനാ	કીઅના
കീജല	કીજલ
കീനാരീ	કીનારી
കീന്ചനാ	કીન્ચના
കേകലാ	કેકલા
കേതന	કેતન
കേനിഷാ	કેનિષા
കേളവ്യ	કેળવ્ય
കൈരവീ	કૈરવી
കൈലാശ	કૈલાશ
കോശേല	કોશેલ
കൌശികാ	કૌશિકા
ഖഗേശ	ખગેશ
ഖമീശ	ખમીશ
ഖാതീരാവണ	ખાતીરાવણ
ഖാത്വന്ഗീന	ખાત્વન્ગીન
ഖീലതീ	ખીલતી
ഖുസീ	ખુસી
ഗംഗാ	ગંગા
ഗംദേശാ	ગંદેશા
ഗംധാര	ગંધાર
ഗംധാരാ	ગંધારા
ഗംധാലീ	ગંધાલી
ഗഗന	ગગન
ഗജവദന	ગજવદન
ഗജേന്ദ്ര	ગજેન્દ્ર
ഗണക	ગણક
ഗണനാ പംഡിതന	ગણના પંડિતન
ഗണനാഥ	ગણનાથ
ഗണ്യാ	ગણ્યા
ഗതി	ગતિ
ഗനേസന	ગનેસન
ഗന്ഗസീരുവന	ગન્ગસીરુવન
ഗയാലികാ	ગયાલિકા
ഗരിമാ	ગરિમા
ഗരിഷ്ട	ગરિષ્ટ
ഗരുല	ગરુલ
ഗാഇശ	ગાઇશ
ഗാന്ഗമൈന്ദന	ગાન્ગમૈન્દન
ഗാമിനീ	ગામિની
ഗായത്രീ	ગાયત્રી
ഗായലേ	ગાયલે
ഗിഅന	ગિઅન
ഗിയാ	ગિયા
ഗിരിവര	ગિરિવર
ഗീതി	ગીતિ
ഗീതീശാ	ગીતીશા
ഗുംജാ	ગુંજા
ഗുനാജാ	ગુનાજા
ഗുനാരത്നാ	ગુનારત્ના
ഗുനാശേകാര	ગુનાશેકાર
ഗുനീന	ગુનીન
ഗുന്ജീതാ	ગુન્જીતા
ഗുപ്തക	ગુપ્તક
ഗുരദയാല	ગુરદયાલ
ഗുരദേവ	ગુરદેવ
ഗുരബാനീ	ગુરબાની
ഗുരമാന	ગુરમાન
ഗുരുത്തമ	ગુરુત્તમ
ഗുര്നാന്ഡീശ	ગુર્નાન્ડીશ
ഗുലമോഹര	ગુલમોહર
ഗുവീദ	ગુવીદ
ഗൂംജീതാ	ગૂંજીતા
ഗൂഹാരീ	ગૂહારી
ഗേനേലിയാ	ગેનેલિયા
ഗേശനാ	ગેશના
ഗോപാല	ગોપાલ
ഗോപീ നാഥ	ગોપી નાથ
ഗോഭില	ગોભિલ
ഗോരഖ-നാഥ	ગોરખ-નાથ
ഗൌരവീ	ગૌરવી
ഗൌരീകാംത	ગૌરીકાંત
ഗൌരീശ	ગૌરીશ
ഗൌര്പ്രിയാ	ગૌર્પ્રિયા
ഗ്രീതേശ	ગ્રીતેશ
ഗ്രീവാ	ગ્રીવા
ഗ്രീശ്മീതാ	ગ્રીશ્મીતા
ഗ്രീഷ്മ	ગ્રીષ્મ
ഘടോതകത്ചാ	ઘટોતકત્ચા
ചംചലാ	ચંચલા
ചംദേര്ഭാന	ચંદેર્ભાન
ചംദ്രകാംത	ચંદ્રકાંત
ചംദ്രകാംതാ	ચંદ્રકાંતા
ചംദ്രചുര	ચંદ્રચુર
ചംദ്രപുശ്പാ	ચંદ્રપુશ્પા
ചംദ്രപ്രകാശ	ચંદ્રપ્રકાશ
ചംദ്രമതി	ચંદ્રમતિ
ചംദ്രലേഖാ	ચંદ્રલેખા
ചംദ്രഹാസ	ચંદ્રહાસ
ചംദ്രാനന	ચંદ્રાનન
ചംദ്രാഭാ	ચંદ્રાભા
ചംദ്രേശ	ચંદ્રેશ
ചകേശ	ચકેશ
ചകോര	ચકોર
ചക്ഷസ	ચક્ષસ
ചതുര	ચતુર
ചതുരാ	ચતુરા
ചതുര്ഭുജാ	ચતુર્ભુજા
ചതുര്വേദീ	ચતુર્વેદી
ചത്രീയാ	ચત્રીયા
ചന്ദ്രകേതു	ચન્દ્રકેતુ
ചരണ	ચરણ
ചരന്യാ	ચરન્યા
ചലാമാ	ચલામા
ചാംദ	ચાંદ
ചാനാസ്യാ	ચાનાસ્યા
ചാനേ	ચાને
ചാന്ദനികാ	ચાન્દનિકા
ചാരുന	ચારુન
ചാരുവീ	ચારુવી
ചാര്മീ	ચાર્મી
ചാര്വീ	ચાર્વી
ചാവ്രിക	ચાવ્રિક
ചിത്കലാ	ચિત્કલા
ചിത്ത	ચિત્ત
ചിത്തപ്രസാദ	ચિત્તપ્રસાદ
ചിത്തരംജന	ચિત્તરંજન
ചിത്തരംജനീ	ચિત્તરંજની
ചിത്രകുന്ധാലാ	ચિત્રકુન્ધાલા
ചിത്രകേതു	ચિત્રકેતુ
ചിത്രഗംധാ	ચિત્રગંધા
ചിത്രബാനാ	ચિત્રબાના
ചിത്രമാലാ	ચિત્રમાલા
ചിത്രര്ത	ચિત્રર્ત
ചിത്രല	ચિત્રલ
ചിത്രലേഖാ	ચિત્રલેખા
ചിത്രാദീപ	ચિત્રાદીપ
ചിത്രീനീ	ચિત્રીની
ചിദംബര	ચિદંબર
ചിദാനംദാ	ચિદાનંદા
ചിനാര	ચિનાર
ചിന്നാദുരാഈ	ચિન્નાદુરાઈ
ചിമന	ચિમન
ചീദാര്ത	ચીદાર્ત
ചീന്മയേ	ચીન્મયે
ചീരുഷ	ચીરુષ
ചേതന്ദീപ	ચેતન્દીપ
ചേതള	ચેતળ
ചേഥാസാ	ચેથાસા
ചേമ്മല	ચેમ્મલ
ചേര്വിക	ચેર્વિક
ചേലന	ચેલન
ചേലിയാഁ	ચેલિયાഁ
ചൈതന്യാ	ચૈતન્યા
ചൈത്രാ	ચૈત્રા
ചൈരാവലീ	ચૈરાવલી
ഛായാംക	છાયાંક
ജക്ഷ	જક્ષ
ജക്ഷാനീ	જક્ષાની
ജഗതപ്രകാശ	જગતપ્રકાશ
ജഗദഗുരു	જગદગુરુ
ജഗദമ്ബാ	જગદમ્બા
ജഗനമോഹിനീ	જગનમોહિની
ജഗന്മയീ	જગન્મયી
ജഗ്വീ	જગ્વી
ജഗ്വീര	જગ્વીર
ജജ്വാല്യാ	જજ્વાલ્યા
ജടായു	જટાયુ
ജനഹിതാ	જનહિતા
ജനാദേവ	જનાદેવ
ജനാവ	જનાવ
ജനിത	જનિત
ജമാംദാഗ്ന്യ മഹാദാര്പാ	જમાંદાગ્ન્ય મહાદાર્પા
ജമ്ബവതപ്രീതി	જમ્બવતપ્રીતિ
ജയംത	જયંત
ജയചംദ	જયચંદ
ജയപാല	જયપાલ
ജയമാലാ	જયમાલા
ജയശ്രീ	જયશ્રી
ജയാകീര്തന	જયાકીર્તન
ജയാകേതന	જયાકેતન
ജയാപാദമാം	જયાપાદમાં
ജയായ	જયાય
ജയിത	જયિત
ജയേശ	જયેશ
ജലദ	જલદ
ജല്പേശ	જલ્પેશ
ജശവംത	જશવંત
ജസീത്താ	જસીત્તા
ജസ്സീ	જસ્સી
ജാനകീ	જાનકી
ജാനകീദാസ	જાનકીદાસ
ജാനകീനാഥ	જાનકીનાથ
ജാനകീഭൂഷണ	જાનકીભૂષણ
ജാനഹിതാ	જાનહિતા
ജാപക	જાપક
ജായിത്രീ	જાયિત્રી
ജിനേശ്വര	જિનેશ્વર
ജിഹാന	જિહાન
ജീതേശ	જીતેશ
ജീന്ദാല	જીન્દાલ
ജീവനകലാ	જીવનકલા
ജീവനീ	જીવની
ജീവന്തീനീ	જીવન્તીની
ജുഷ്ടി	જુષ્ટિ
ജേനീശാ	જેનીશા
ജേര്ശീകാ	જેર્શીકા
ജൈകാപിശ	જૈકાપિશ
ജൈചരണ	જૈચરણ
ജൈനീശ	જૈનીશ
ജൈപ്രകാശ	જૈપ્રકાશ
ജൈവംത	જૈવંત
ജൈസല	જૈસલ
ജൈഹാസീനീ	જૈહાસીની
ജോംഫീ	જોંફી
ജോശനീകാ	જોશનીકા
ജോശീതാ	જોશીતા
ജ്വാലാ	જ્વાલા
ജ്ഹില	જ્હિલ
ജ്ഹീണൂക	જ્હીણૂક
ഝഹനവീ	ઝહનવી
ഝാനീശാ	ઝાનીશા
ഝാരാ	ઝારા
ഝീയാ	ઝીયા
ഝേനീശാ	ઝેનીશા
ഝ്യാനനീ	ઝ્યાનની
ടീംകു	ટીંકુ
ഠുമരീ	ઠુમરી
തക്ശീ	તક્શી
തക്ശീല	તક્શીલ
തജജ്ഞ	તજજ્ઞ
തനവീ	તનવી
തനിഷ്ക	તનિષ્ક
തനുംജാശ്രീ	તનુંજાશ્રી
തനുംശ്കാ	તનુંશ્કા
തനോജ	તનોજ
തപസ	તપસ
തപസ്വിനീ	તપસ્વિની
തമില  സേല്വീ	તમિલ  સેલ્વી
തമിശ	તમિશ
തമോഘ്നാ	તમોઘ્ના
തമോനഷ	તમોનષ
തരംജോത	તરંજોત
തരനീ	તરની
തരലാ	તરલા
തരീനീ	તરીની
തരുശ്രീ	તરુશ્રી
തരൂണീ	તરૂણી
തവലീന :	તવલીન :
തവിഷാ	તવિષા
തസ്യ	તસ્ય
താക്ഷ്യാ	તાક્ષ્યા
താജേന്ദര	તાજેન્દર
താനാരുപീ	તાનારુપી
താനിയാ	તાનિયા
താന്വീഥാ	તાન્વીથા
താപീ	તાપી
താരികാ	તારિકા
താരീനീ	તારીની
താരൂശ	તારૂશ
താലംക	તાલંક
താലീന	તાલીન
താലേശ	તાલેશ
താവന	તાવન
താവീശാ	તાવીશા
തിതലീ	તિતલી
തിനാശ	તિનાશ
തിലക	તિલક
തീഈവ്യേശ	તીઈવ્યેશ
തീര്ഥാ	તીર્થા
തീസ്ചാ	તીસ્ચા
തുത്തീ	તુત્તી
തുനാവാ	તુનાવા
തുന്ഗാര	તુન્ગાર
തുപമ	તુપમ
തുരഗ	તુરગ
തുശീഥാ	તુશીથા
തൃപേശ	તૃપેશ
തേജസ	તેજસ
തേജസ്വീ	તેજસ્વી
തേജസ്വീന	તેજસ્વીન
തേജേനദര	તેજેનદર
തേജോമയ	તેજોમય
തോയേശ	તોયેશ
തോശീകാ	તોશીકા
തൌരുസ	તૌરુસ
ത്രികായാ	ત્રિકાયા
ത്രിപുരസുംദരീ	ત્રિપુરસુંદરી
ത്രിഭുവന	ત્રિભુવન
ത്രിമാന	ત્રિમાન
ത്രിമൂര്തി	ત્રિમૂર્તિ
ത്രിവേണീ	ત્રિવેણી
ത്രിശല	ત્રિશલ
ത്രിശലാനാ	ત્રિશલાના
ത്രീഝ്യാ	ત્રીઝ્યા
ത്രീതിയാ	ત્રીતિયા
ത്രീനേശ	ત્રીનેશ
ത്രീപന	ત્રીપન
ത്രീപ്ത	ત્રીપ્ત
ത്രീവീദ	ત્રીવીદ
ത്വരിതാ	ત્વરિતા
ത്വീശീ	ત્વીશી
ത്വേസാ	ત્વેસા
ഥംസീ	થંસી
ഥനീരികാ	થનીરિકા
ഥാകാപ്പന്സ്വാമീ	થાકાપ્પન્સ્વામી
ഥാരികാ	થારિકા
ഥാവനീ	થાવની
ഥീരീശ്കാ	થીરીશ્કા
ഥുസീഥാ	થુસીથા
ഥ്രേശാ	થ્રેશા
ദംദാപാനീ	દંદાપાની
ദക്ഷാഹതാ	દક્ષાહતા
ദബീത	દબીત
ദബ്ന്ശും	દબ્ન્શું
ദയാദാ	દયાદા
ദയാനിതാ	દયાનિતા
ദരഹാസ	દરહાસ
ദര്ശ	દર્શ
ദര്ശക	દર્શક
ദര്ശികാ	દર્શિકા
ദര്ശീനീ	દર્શીની
ദര്സീകാ	દર્સીકા
ദശാഗ്രീവാ ശീരോഹരാ	દશાગ્રીવા શીરોહરા
ദശാഗ്രീവാകുലാന്താകാ	દશાગ્રીવાકુલાન્તાકા
ദശാനന	દશાનન
ദഹാ	દહા
ദാനാസ്വീ	દાનાસ્વી
ദാനുംശ്രീ	દાનુંશ્રી
ദാന്ദാകാരാന്യ പുന്യകൃതേ	દાન્દાકારાન્ય પુન્યકૃતે
ദാരുല	દારુલ
ദാഹക	દાહક
ദികീശംദ	દિકીશંદ
ദിഗീശാ	દિગીશા
ദിപംശീ	દિપંશી
ദിപശീകീ	દિપશીકી
ദിപേംദര	દિપેંદર
ദിപ്താ	દિપ્તા
ദിബസരീ	દિબસરી
ദിവീഥാ	દિવીથા
ദിവേനാ	દિવેના
ദീതാ	દીતા
ദീനബംധു	દીનબંધુ
ദീപഥീ	દીપથી
ദീപപ്രഭാ	દીપપ્રભા
ദീപമാലാ	દીપમાલા
ദീപശിഖാ	દીપશિખા
ദീപാംജലി	દીપાંજલિ
ദീപാശാ	દીપાશા
ദീപിത	દીપિત
ദീവാംശ	દીવાંશ
ദേജ	દેજ
ദേബജ്യോതീ	દેબજ્યોતી
ദേബദാത്താ	દેબદાત્તા
ദേബദ്രിതാ	દેબદ્રિતા
ദേബന്ശീ	દેબન્શી
ദേയ്വയാനാകാന്തന	દેય્વયાનાકાન્તન
ദേവഗര്ഭാ	દેવગર્ભા
ദേവജ്യോതി	દેવજ્યોતિ
ദേവദാന	દેવદાન
ദേവന്ദ്ര	દેવન્દ્ર
ദേവമദാനാ	દેવમદાના
ദേവരാജ	દેવરાજ
ദേവശ്രീ	દેવશ્રી
ദേവാംഗനാ	દેવાંગના
ദേവാംഗീ	દેવાંગી
ദേവാംശു	દેવાંશુ
ദേവാദീത്യാ	દેવાદીત્યા
ദേവാനീ	દેવાની
ദേവാന്ശാ	દેવાન્શા
ദേവാപ്രിയാ	દેવાપ્રિયા
ദേവാമനോഹാരീ	દેવામનોહારી
ദേവീന	દેવીન
ദേവീലാല	દેવીલાલ
ദേവേന	દેવેન
ദേവേശീ	દેવેશી
ദേവ്യഹ്നാന	દેવ્યહ્નાન
ദേശാവംത	દેશાવંત
ദൈത്യാകുലാന്താകാ	દૈત્યાકુલાન્તાકા
ദൈവ്യാ	દૈવ્યા
ധക്ശീന്യ	ધક્શીન્ય
ധനസുഖ	ધનસુખ
ധനാജീ	ધનાજી
ധനിഷ്ഠ	ધનિષ્ઠ
ധനു	ધનુ
ധനുജാ	ધનુજા
ധനേശീ	ધનેશી
ധന്വികാ	ધન્વિકા
ധരമനിഷ്ഠ	ધરમનિષ્ઠ
ധരാമാം	ધરામાં
ധരാഹാസീനീ	ધરાહાસીની
ധരീശ	ધરીશ
ധര്മ  ദുത്ത	ધર્મ  દુત્ત
ധര്മഅധ്യക്ഷ	ધર્મઅધ્યક્ષ
ധര്മദിത്യ	ધર્મદિત્ય
ധര്മദേവ	ધર્મદેવ
ധര്ശീതാ	ધર્શીતા
ധര്ശീനീ	ધર્શીની
ധാമീനീ	ધામીની
ധാരാനീ	ધારાની
ധിതി	ધિતિ
ധിതീ	ધિતી
ധീപ്ത്ഹാ	ધીપ્ત્હા
ധീമാഹീ	ધીમાહી
ധീര്ഥാ	ધીર્થા
ധേയാംശീ	ધેયાંશી
ധൈര്യ്യാ	ધૈર્ય્યા
ധ്യുഥീ	ધ્યુથી
ധ്രുമീ	ધ્રુમી
നംദക	નંદક
നംദു	નંદુ
നക്ശ	નક્શ
നക്സത്രരാജാ	નક્સત્રરાજા
നഗമാനീ	નગમાની
നടവര	નટવર
നത്രീശാ	નત્રીશા
നദീപ	નદીપ
നഭാ	નભા
നഭോമാനീ	નભોમાની
നമന	નમન
നമനാ	નમના
നയന	નયન
നരേന്ദ്രന	નરેન્દ્રન
നരേന്ദ്രനാഥ	નરેન્દ્રનાથ
നരേശ	નરેશ
നവനീത വിലീപ്തംഗാ	નવનીત વિલીપ્તંગા
നവമ	નવમ
നവരംഗ	નવરંગ
നസീബ	નસીબ
നാംബീ	નાંબી
നാഗനാഥ	નાગનાથ
നാഗപാല	નાગપાલ
നാഗേശ്വരണ	નાગેશ્વરણ
നാഗൈഃ	નાગૈઃ
നാതാഭൈരവീ	નાતાભૈરવી
നാതിന	નાતિન
നാന്ധീനീ	નાન્ધીની
നാന്നാന	નાન્નાન
നാഭിതാ	નાભિતા
നാഭേംദു	નાભેંદુ
നാമത	નામત
നായകീ	નાયકી
നായാനീ	નાયાની
നായാനീകാ	નાયાનીકા
നാലിനികാംത	નાલિનિકાંત
നാലീനേശയ	નાલીનેશય
നാവീന്യ	નાવીન્ય
നാവീല	નાવીલ
നാവ്യാ ദുര്ഗാ	નાવ્યા દુર્ગા
നാവ്രീതാ	નાવ્રીતા
നികാരാ	નિકારા
നിഖിതാ	નિખિતા
നിഖില	નિખિલ
നിജു	નિજુ
നിധി	નિધિ
നിധിപാ	નિધિપા
നിപാ	નિપા
നിരംജനാ	નિરંજના
നിരമഈ	નિરમઈ
നിരുപമാ	નિરુપમા
നിര്മളാ	નિર્મળા
നിര്മിതി	નિર્મિતિ
നിലാശാ	નિલાશા
നിശാനഥീ	નિશાનથી
നീഗീഥാ	નીગીથા
നീതു	નીતુ
നീഥീകാ	નીથીકા
നീധാ	નીધા
നീധാര്സനാ	નીધાર્સના
നീമാംലന	નીમાંલન
നീരാലികാ	નીરાલિકા
നീരൈമാംഥീ	નીરૈમાંથી
നീര്മുകതാ	નીર્મુકતા
നീല മാധവ	નીલ માધવ
നീലംജന	નીલંજન
നീലക്ഷ	નીલક્ષ
നീല്ജാ	નીલ્જા
നീശാലീ	નીશાલી
നീശീതീ	નીશીતી
നീശ്മീഥാ	નીશ્મીથા
നീസ്ചീഥാ	નીસ્ચીથા
നീഹാ	નીહા
നേമീശാ	નેમીશા
നേയ്സാ	નેય્સા
നേരീശാ	નેરીશા
നൈജാ	નૈજા
നൈരീതീ	નૈરીતી
നൈവേധീ	નૈવેધી
നൌസദ	નૌસદ
പംകജന	પંકજન
പംചഭൂതാത്മികാ	પંચભૂતાત્મિકા
പംഥീനീ	પંથીની
പഝ്ഹേനീ	પઝ્હેની
പത്താമ്ബരാപരീധാനാ	પત્તામ્બરાપરીધાના
പത്ര	પત્ર
പന്ദാലാവാസന	પન્દાલાવાસન
പമ്പാ	પમ્પા
പമ്ഫാ	પમ્ફા
പയാസ	પયાસ
പയോധീ	પયોધી
പരംതാപാ	પરંતાપા
പരമാംത്മികാ	પરમાંત્મિકા
പരമാംന്ത്ര	પરમાંન્ત્ર
പരമിലാ	પરમિલા
പരമേശ്വരീ	પરમેશ્વરી
പരമ്വാര്ദാന	પરમ્વાર્દાન
പരവാനീ	પરવાની
പരവിംദര	પરવિંદર
പരാകാഷ	પરાકાષ
പരാവീ	પરાવી
പരിഹാ	પરિહા
പര്തീബന	પર્તીબન
പര്ലീ	પર્લી
പര്വ	પર્વ
പലാക്ഷ	પલાક્ષ
പലാശീനീ	પલાશીની
പവന	પવન
പവനസുത	પવનસુત
പശുപതി	પશુપતિ
പഹലാജ	પહલાજ
പാടലാ	પાટલા
പാന്ദുരംഗാ	પાન્દુરંગા
പായല	પાયલ
പാരു	પારુ
പാര്ഥിക	પાર્થિક
പാര്ഥീവീ	પાર્થીવી
പാര്ഥോ	પાર્થો
പാളവീ	પાળવી
പാവകീ	પાવકી
പാവനാ	પાવના
പാവാനാ	પાવાના
പാഹീ	પાહી
പിവാല	પિવાલ
പൂജന	પૂજન
പൂരതീ	પૂરતી
പൂരികാ	પૂરિકા
പൂര്വജാ	પૂર્વજા
പൂര്വികാ	પૂર્વિકા
പേഖമ	પેખમ
പേത്ചീ	પેત્ચી
പേരാരസീ	પેરારસી
പ്രകൃഥീ	પ્રકૃથી
പ്രഗന്യാ	પ્રગન્યા
പ്രഗ്യപരാമിതാ	પ્રગ્યપરામિતા
പ്രജാനാ	પ્રજાના
പ്രനാദാ	પ્રનાદા
പ്രനീധാനാ	પ્રનીધાના
പ്രബകരണ	પ્રબકરણ
പ്രഭാകര	પ્રભાકર
പ്രഭാകരന	પ્રભાકરન
പ്രഭാത	પ્રભાત
പ്രഭാവ	પ્રભાવ
പ്രാതീകാ	પ્રાતીકા
ഫനീ	ફની
ഫനീഭുഷണ	ફનીભુષણ
ഫാല്ഗുനീ	ફાલ્ગુની
ഫൂലന	ફૂલન
ഫ്രാന്ചീസ	ફ્રાન્ચીસ
ബംദിശ	બંદિશ
ബംധൂല	બંધૂલ
ബംശീ	બંશી
ബംസീധര	બંસીધર
ബകുലാ	બકુલા
ബകൂല	બકૂલ
ബദ്രീ	બદ્રી
ബനജ	બનજ
ബനവാരീ	બનવારી
ബബന	બબન
ബബിശ	બબિશ
ബര്ഹന	બર્હન
ബലബീര	બલબીર
ബഹവാസ്യ	બહવાસ્ય
ബാബു	બાબુ
ബാബുല	બાબુલ
ബാല മുകുന്ദ	બાલ મુકુન્દ
ബാലധി	બાલધિ
ബാലാമോഹന	બાલામોહન
ബാലാരാജ	બાલારાજ
ബാലാശംകര	બાલાશંકર
ബാലു	બાલુ
ബാലേന്ദു	બાલેન્દુ
ബാസ്കാര	બાસ્કાર
ബിനീതാ	બિનીતા
ബീനും	બીનું
ബീന്ദുശ്രീ	બીન્દુશ્રી
ബീന്നീകേര	બીન્નીકેર
ബീപുല	બીપુલ
ബീബീന	બીબીન
ബീരത	બીરત
ബീഹാന	બીહાન
ബേനീതാ	બેનીતા
ബേനും	બેનું
ബേലുരമീ	બેલુરમી
ബേല്ലീ	બેલ્લી
ബൈവാവീ	બૈવાવી
ബൈസാഖീ	બૈસાખી
ബ്രീഥ്ഹീ	બ્રીથ્હી
ബ്ലേസ്സീ	બ્લેસ્સી
ഭഗവാന	ભગવાન
ഭദ്രക്ഷ	ભદ્રક્ષ
ഭദ്രനിധി	ભદ્રનિધિ
ഭദ്രപ്രിയാ	ભદ્રપ્રિયા
ഭദ്രിക	ભદ્રિક
ഭദ്രീശാ	ભદ્રીશા
ഭവാനീ	ભવાની
ഭവ്യരാജ	ભવ્યરાજ
ഭാഗവംതീ	ભાગવંતી
ഭാദരന	ભાદરન
ഭാനുമിത്ര	ભાનુમિત્ર
ഭാരഥീ	ભારથી
ഭാര്ഗവന	ભાર્ગવન
ഭാര്ഗവാ	ભાર્ગવા
ഭാര്ഘവീ	ભાર્ઘવી
ഭാര്ദ്ദ്വാജ	ભાર્દ્દ્વાજ
ഭാലേംദ്ര	ભાલેંદ્ર
ഭാവതീ	ભાવતી
ഭാവീഗുരും	ભાવીગુરું
ഭാവ്യമ	ભાવ્યમ
ഭാശ്വീനീ	ભાશ્વીની
ഭാസു	ભાસુ
ഭാസ്കാരീ	ભાસ્કારી
ഭാസ്കേര	ભાસ્કેર
ഭീമശംകര	ભીમશંકર
ഭൂദേവ	ભૂદેવ
ഭൂപത	ભૂપત
ഭൂപാല	ભૂપાલ
ഭൂമാ	ભૂમા
ഭൂമാം	ભૂમાં
ഭേരേശ	ભેરેશ
ഭൈരവീ	ભૈરવી
മംഗലമ	મંગલમ
മംഗേശ	મંગેશ
മംജു  പ്രസന്ന	મંજુ  પ્રસન્ન
മംജുനാഥ	મંજુનાથ
മംജുലാ	મંજુલા
മംത	મંત
മംതോഷ	મંતોષ
മംദിഥാ	મંદિથા
മംദിരാ	મંદિરા
മകാലീ	મકાલી
മകുര	મકુર
മഗന	મગન
മണികാംത	મણિકાંત
മദുരാ	મદુરા
മധുനിഷാ	મધુનિષા
മധുമാംലീ	મધુમાંલી
മധുരിമാ	મધુરિમા
മധുവംതീ	મધુવંતી
മനജീത	મનજીત
മനപ	મનપ
മനസ്വിന	મનસ્વિન
മനാല്പ	મનાલ્પ
മനീതാ	મનીતા
മനീഷ	મનીષ
മനോജ	મનોજ
മനോരനജനീ	મનોરનજની
മനോരിഥാ	મનોરિથા
മന്നത	મન્નત
മന്മായീ	મન્માયી
മല്ലികാ	મલ્લિકા
മഹംത	મહંત
മഹാതപസ്വീ	મહાતપસ્વી
മഹാദുര്ഗാ	મહાદુર્ગા
മഹാദേവാ	મહાદેવા
മഹാദേവാദീപുജീതാ	મહાદેવાદીપુજીતા
മഹാന്തേശ	મહાન્તેશ
മഹാബാലാ	મહાબાલા
മഹാസ്വേതാ	મહાસ્વેતા
മഹിപതി	મહિપતિ
മഹിഷാസുരമര്ദിനീ	મહિષાસુરમર્દિની
മഹീജിത	મહીજિત
മഹേംദ്രാ	મહેંદ્રા
മഹേശ	મહેશ
മഹേശനീ	મહેશની
മഹേശീ	મહેશી
മാംതിക	માંતિક
മാംനീമോഝ്ഹീ	માંનીમોઝ્હી
മാംനുസരീ	માંનુસરી
മാംന്ക്ഷ	માંન્ક્ષ
മാംന്ഗീരീ	માંન્ગીરી
മാംന്താവ്യാഹ	માંન્તાવ્યાહ
മാംന്തീകാ	માંન્તીકા
മാംന്ദീതാ	માંન્દીતા
മാംലാമാംകാല മകാന	માંલામાંકાલ મકાન
മാഇല	માઇલ
മാനകാ	માનકા
മാനജ	માનજ
മാനശ	માનશ
മാനിക	માનિક
മാനീശീന	માનીશીન
മാനോരിത	માનોરિત
മാന്കന	માન્કન
മാന്ദാവിക	માન્દાવિક
മായാ	માયા
മാര്ഗശീ	માર્ગશી
മാര്ഗീ	માર્ગી
മാര്തംദ	માર્તંદ
മാര്ഥീകാ	માર્થીકા
മാര്യ	માર્ય
മാര്യാ	માર્યા
മാര്ഷാ	માર્ષા
മാലാര്കോഡീ	માલાર્કોડી
മാലിനീ	માલિની
മാല്ലേശാ	માલ્લેશા
മാസൂമ	માસૂમ
മാസൂമീ	માસૂમી
മാഹിയാ	માહિયા
മാഹിരാജ	માહિરાજ
മാഹുലീ	માહુલી
മിലീ	મિલી
മിഹീകാ	મિહીકા
മീനാ	મીના
മേധ	મેધ
മേധീനീ	મેધીની
മൈത്രായ	મૈત્રાય
മൌലീശാ	મૌલીશા
മ്യ്ഥിലീ	મ્ય્થિલી
യംശ	યંશ
യക്ഷ	યક્ષ
യജും	યજું
യജുസ	યજુસ
യജ്നേശ	યજ્નેશ
യഥാര്ഥ	યથાર્થ
യദുനംദന	યદુનંદન
യശസ്വിനീ	યશસ્વિની
യശാശ്രീ	યશાશ્રી
യശ്ദീപ	યશ્દીપ
യശ്മിത	યશ્મિત
യശ്മിതാ	યશ્મિતા
യശ്വാര്ധാനാ	યશ્વાર્ધાના
യശ്വീന	યશ્વીન
യശ്വീനീ	યશ્વીની
യസ്വംഥ	યસ્વંથ
യാക്സീനീ	યાક્સીની
യാഗ്നാകായാ	યાગ્નાકાયા
യാഗ്നീഥാ	યાગ્નીથા
യാചന	યાચન
യാതീരാജു	યાતીરાજુ
യാദവീ	યાદવી
യാദവേന്ദ്ര	યાદવેન્દ્ર
യാന്തി	યાન્તિ
യാശ്രീഥാ	યાશ્રીથા
യാഷ്ക	યાષ્ક
യാസസ്വീ	યાસસ્વી
യുഗന്തീകാ	યુગન્તીકા
യുഗപ	યુગપ
യുഗാന്ധര	યુગાન્ધર
യുതി	યુતિ
യുവംശ	યુવંશ
യുവനാഥ	યુવનાથ
യുവല	યુવલ
യുവാഥീ	યુવાથી
യുവാന  സൂര്യ	યુવાન  સૂર્ય
യുവ്നീക	યુવ્નીક
യേര്രപ്പാ	યેર્રપ્પા
യേശനാ	યેશના
യേശാസ്വീനീ	યેશાસ્વીની
യേസസരീ	યેસસરી
യോഗദേവാ	યોગદેવા
യോഗരാജ	યોગરાજ
യോഗാനംദ	યોગાનંદ
യോഗിത	યોગિત
യോഗിതാ	યોગિતા
യോഗിഥ	યોગિથ
യോഗേശ്വര	યોગેશ્વર
യോഗ്ദീപ	યોગ્દીપ
യോത്ശനാ	યોત્શના
യോനേന്ദ്ര	યોનેન્દ્ર
യോഹ്ശീനീ	યોહ્શીની
യൌവാനീ	યૌવાની
രംഗനാഥ	રંગનાથ
രംജന	રંજન
രംജികാ	રંજિકા
രംജീവ	રંજીવ
രഈര്ഥ	રઈર્થ
രക്ത	રક્ત
രക്തകമള	રક્તકમળ
രക്ഷികാ	રક્ષિકા
രക്ഷിത	રક્ષિત
രഘവാ	રઘવા
രഘവേന്ദര	રઘવેન્દર
രഘുനാഥ	રઘુનાથ
രജത	રજત
രജനീശ	રજનીશ
രജനേശ	રજનેશ
രജീത	રજીત
രതന	રતન
രതാംജലി	રતાંજલિ
രതീക	રતીક
രതുല	રતુલ
രത്നാകര	રત્નાકર
രത്നാബലീ	રત્નાબલી
രഥനാ	રથના
രന്യ	રન્ય
രന്വിഥാ	રન્વિથા
രബേക	રબેક
രമാംസ്വമ്യ	રમાંસ્વમ્ય
രമ്ബേശ	રમ્બેશ
രയാന	રયાન
രര്ശ്മീതാ	રર્શ્મીતા
രവി കാന്ത	રવિ કાન્ત
രവികാംത	રવિકાંત
രവിത	રવિત
രവീജാ	રવીજા
രവീനാ	રવીના
രവ്യംകീ	રવ્યંકી
രശീലാ	રશીલા
രസവംത	રસવંત
രസ്മീന	રસ્મીન
രാഈ കുമാര	રાઈ કુમાર
രാഖീ	રાખી
രാഗാവ	રાગાવ
രാഗിനീ	રાગિની
രാഗേശ	રાગેશ
രാഗ്വേദ	રાગ્વેદ
രാജക	રાજક
രാജകന്യാ	રાજકન્યા
രാജഗോപാല	રાજગોપાલ
രാജയവര്ദന	રાજયવર્દન
രാജാ	રાજા
രാജാര്ശീ	રાજાર્શી
രാജികാ	રાજિકા
രാജീവ	રાજીવ
രാജേംദ്രമോഹന	રાજેંદ્રમોહન
രാജേശ്വര	રાજેશ્વર
രാജ്യശ്രീ	રાજ્યશ્રી
രാധാനീ	રાધાની
രാനീ	રાની
രാമ  കീന്കാര	રામ  કીન્કાર
രാമഗോപാല	રામગોપાલ
രാമചന്ദ്രന	રામચન્દ્રન
രാമനാരായണ	રામનારાયણ
രാമരാ	રામરા
രാമരാജ	રામરાજ
രാമാംസുഗ്രീവാ	રામાંસુગ્રીવા
രാമാനംദ	રામાનંદ
രാമാനുജമ	રામાનુજમ
രാമോജീ	રામોજી
രാഹിത്യ	રાહિત્ય
രാഹീന്യ	રાહીન્ય
രാഹുലരാജ	રાહુલરાજ
രിദ്ധി	રિદ્ધિ
രീചികാ	રીચિકા
രീതൂ	રીતૂ
രീഥേകാ	રીથેકા
രീദേവ	રીદેવ
രീധമാം	રીધમાં
രീഭ്യാ	રીભ્યા
രീശും	રીશું
രീശ്മേഥാ	રીશ્મેથા
രേഖാ	રેખા
രേത്വിക	રેત્વિક
രേധാ	રેધા
രേനാ	રેના
രേനേശ	રેનેશ
രേമാംനീകാ	રેમાંનીકા
രേമീ	રેમી
രേവാതീ	રેવાતી
രേവീഥാ	રેવીથા
രേശമീ	રેશમી
രേശ്വീന	રેશ્વીન
രേഹാംശീ	રેહાંશી
രേഹാനാ	રેહાના
രേഹേഈലാ	રેહેઈલા
രേഹ്നുഘാ	રેહ્નુઘા
രൈവത	રૈવત
രൈവതാ	રૈવતા
ലംഗീത	લંગીત
ലക്ഷ	લક્ષ
ലക്ഷാകീ	લક્ષાકી
ലക്ഷിതാ	લક્ષિતા
ലക്ഷ്മീകാനതമ	લક્ષ્મીકાનતમ
ലജ്ജാ	લજ્જા
ലജ്ജാകാ	લજ્જાકા
ലതാ	લતા
ലതേശ	લતેશ
ലവപാല	લવપાલ
ലവലീന	લવલીન
ലഹരീ	લહરી
ലാക്ശേതാ	લાક્શેતા
ലാജവംതീ	લાજવંતી
ലാതീശ	લાતીશ
ലാനീബന	લાનીબન
ലാഭാ	લાભા
ലാമ്ബോധാര	લામ્બોધાર
ലാരീനാ	લારીના
ലാര്മികാ	લાર્મિકા
ലാര്രാജ	લાર્રાજ
ലാര്ശന	લાર્શન
ലാവനീ	લાવની
ലാവിനാ	લાવિના
ലീകേശ	લીકેશ
ലീത്സാ	લીત્સા
ലീനാശാ	લીનાશા
ലീനീത	લીનીત
ലീപാക്ഷീ	લીપાક્ષી
ലീപ്സീകാ	લીપ્સીકા
ലീമനാ	લીમના
ലീലാമഈ	લીલામઈ
ലീശാംത	લીશાંત
ലുസിയാ	લુસિયા
ലേഈവീനാ	લેઈવીના
ലേഖീശാ	લેખીશા
ലേമാര	લેમાર
ലോകനേത്ര	લોકનેત્ર
ലോകാജനാനീ	લોકાજનાની
ലോകാമാത്രീ	લોકામાત્રી
ലോകീഥാ	લોકીથા
ലോകേന്ദ്ര	લોકેન્દ્ર
ലോഗീനീ	લોગીની
ലോഗേശ്വരണ	લોગેશ્વરણ
ലോചനാ	લોચના
ലോനാ	લોના
ലോമാംകേശ	લોમાંકેશ
ലോഹിത	લોહિત
ലോഹിതാശ്വാ	લોહિતાશ્વા
ലൌക്യ	લૌક્ય
വംദിതാ	વંદિતા
വംസികൃഷ്ണ	વંસિકૃષ્ણ
വനദ	વનદ
വനമാംഥീ	વનમાંથી
വനസ	વનસ
വനിനാധ	વનિનાધ
വന്ജുല	વન્જુલ
വപുസ	વપુસ
വയദീശ	વયદીશ
വരലീ	વરલી
വരിന	વરિન
വരിയാസ	વરિયાસ
വരുന	વરુન
വരുനികാ	વરુનિકા
വര്ണിത	વર્ણિત
വര്ധമാന	વર્ધમાન
വര്ധാനീ	વર્ધાની
വര്ധീമൈനകാപുജീതാ	વર્ધીમૈનકાપુજીતા
വര്നീശാ	વર્નીશા
വര്ശനേയാ	વર્શનેયા
വര്ശീകാ	વર્શીકા
വര്ശീതാ	વર્શીતા
വര്ശീദ	વર્શીદ
വര്ഷനീ	વર્ષની
വല്ലികാ	વલ્લિકા
വസംതാ	વસંતા
വസംതീ	વસંતી
വസീസതാ	વસીસતા
വസുമിത്ര	વસુમિત્ર
വസുസേന	વસુસેન
വാക്പതി	વાક્પતિ
വാക്ഷു	વાક્ષુ
വാച്യ	વાચ્ય
വാജ്രക്ഷ	વાજ્રક્ષ
വാതത്മാജ	વાતત્માજ
വാത്സല്യ	વાત્સલ્ય
വാദിവേലും	વાદિવેલું
വാനര	વાનર
വാന്ശുല	વાન્શુલ
വാമന	વામન
വാമാംക്ഷീ	વામાંક્ષી
വാമീല	વામીલ
വാരനാ	વારના
വാരുനീ	વારુની
വാലാരമാംഥീ	વાલારમાંથી
വാല്ല്മാംനാലന	વાલ્લ્માંનાલન
വാശു	વાશુ
വാസുമന	વાસુમન
വാഹിനീ	વાહિની
വികീശാ	વિકીશા
വിക്ഷിത	વિક્ષિત
വിജയാലക്ഷ്മീ	વિજયાલક્ષ્મી
വിജയാശാനഥീ	વિજયાશાનથી
വിജീതാ	વિજીતા
വിദിശാ	વિદિશા
വിദ്യാ	વિદ્યા
വിദ്യുല	વિદ્યુલ
വിധാഥരീ	વિધાથરી
വിന്ധുജാ	વિન્ધુજા
വിബാലീ	વિબાલી
വിഭാവാ	વિભાવા
വിഭൂതി	વિભૂતિ
വിഭൂഷ	વિભૂષ
വിയാമര്ശ	વિયામર્શ
വിരഗനാപതീ	વિરગનાપતી
വിരഭാദ്രപ്പാ	વિરભાદ્રપ્પા
വിരാജ	વિરાજ
വിലാശീനീ	વિલાશીની
വീണാ	વીણા
വീണാധാരീ	વીણાધારી
വേക്രാംത	વેક્રાંત
വേഗ	વેગ
വേഗവാഹീനീ	વેગવાહીની
വേഗീ	વેગી
വേണു	વેણુ
വേത്ത്രീ	વેત્ત્રી
വേത്രിവാല	વેત્રિવાલ
വേത്രീവേല	વેત્રીવેલ
വേദകാര്തിക	વેદકાર્તિક
വേദവല്ലീ	વેદવલ્લી
വേദാ	વેદા
വേദാ ശ്രീ	વેદા શ્રી
വേധാംത	વેધાંત
വേന്കാത്രമണ	વેન્કાત્રમણ
വേന്തന	વેન્તન
വേന്നേലാ	વેન્નેલા
വേന്മതീ	વેન્મતી
വേലു	વેલુ
വേഹംത	વેહંત
വൈകുംഠ	વૈકુંઠ
വൈജീനാഥ	વૈજીનાથ
വൈദത	વૈદત
വൈദേഹീ	વૈદેહી
വൈദ്യുംത	વૈદ્યુંત
വൈധേ	વૈધે
വൈധ്യാത	વૈધ્યાત
വൈരാഗ	વૈરાગ
വൈരോചന	વૈરોચન
വൈശാലീ	વૈશાલી
വൈശ്വീ	વૈશ્વી
വൈഷ്ണവീ	વૈષ્ણવી
വൈസകാ	વૈસકા
സംക്രാംതി	સંક્રાંતિ
സംഗമിത്ര	સંગમિત્ર
സംഗമീധീരാ	સંગમીધીરા
സംചയ	સંચય
സംചീതീ	સંચીતી
സംജേനാ	સંજેના
സംജോലീ	સંજોલી
സംതോക	સંતોક
സംദിപോന	સંદિપોન
സംദീപ	સંદીપ
സംദേശ	સંદેશ
സംധരാ	સંધરા
സംധ്യാ	સંધ્યા
സംബീതാ	સંબીતા
സംമീതാ	સંમીતા
സംയുക്ത	સંયુક્ત
സംവിധാ	સંવિધા
സംവീഥാ	સંવીથા
സംസ്കൃതി	સંસ્કૃતિ
സംഹിത	સંહિત
സക്ശീന്യാ	સક્શીન્યા
സഖ്യാ	સખ્યા
സഗന	સગન
സഗുനാ	સગુના
സചിതാ	સચિતા
സചിദാനംദ വിഗ്രഹ	સચિદાનંદ વિગ્રહ
സചേതന	સચેતન
സച്ചിദാനംദാ	સચ્ચિદાનંદા
സജീത	સજીત
സജീലീ	સજીલી
സദഗതി	સદગતિ
സദഗുനാ	સદગુના
സദാശിവ	સદાશિવ
സദിശ	સદિશ
സപനാ	સપના
സപുഷ്പാ	સપુષ્પા
സപ്താബീ	સપ્તાબી
സപ്തോര്ശീ	સપ્તોર્શી
സമജാ	સમજા
സമദര്ശീ	સમદર્શી
സമഭ്ദ്ധാ	સમભ્દ્ધા
സമരേശ	સમરેશ
സമാംദ്രിതാ	સમાંદ્રિતા
സമാംര്ധ	સમાંર્ધ
സമാജസ	સમાજસ
സമാരാസ്യാ	સમારાસ્યા
സമിക	સમિક
സമിരന	સમિરન
സമേംദ്ര	સમેંદ્ર
സമേശ	સમેશ
സമ്പൂര്ണ	સમ્પૂર્ણ
സമ്പ്രഥ്യ	સમ્પ્રથ્ય
സമ്പ്രീതീ	સમ્પ્રીતી
സമ്രാട	સમ્રાટ
സമ്രീധ	સમ્રીધ
സരസംഗീ	સરસંગી
സലീജ	સલીજ
സഹര്സീതാ	સહર્સીતા
സഹശ്രദ	સહશ્રદ
സഹസ്ത്രജീത	સહસ્ત્રજીત
സഹസ്ത്രബാഹു	સહસ્ત્રબાહુ
സഹീത	સહીત
സഹീരാമ	સહીરામ
സഹ്യ	સહ્ય
സാംജ	સાંજ
സാഇ രാമ	સાઇ રામ
സാഈനാഥ	સાઈનાથ
സാചീ	સાચી
സാജന	સાજન
സാദ്രീശീ	સાદ્રીશી
സാദ്വിഥാ	સાદ્વિથા
സാധന	સાધન
സാധ്യാ	સાધ્યા
സാനിധ്യ	સાનિધ્ય
സാമംതാ	સામંતા
സാമ്ഭാ	સામ્ભા
സാരണീ	સારણી
സാരഥീ	સારથી
സാരികാ	સારિકા
സാലവീ	સાલવી
സാലസാ	સાલસા
സൈകത	સૈકત
സൈനീത്യ	સૈનીત્ય
സൈന്ധന്യ	સૈન્ધન્ય
സൈലീ	સૈલી
സൈഹാര്സന	સૈહાર્સન
ഹംസമാലാ	હંસમાલા
ഹംസാവാഥ്യ	હંસાવાથ્ય
ഹനാര്വീന	હનાર્વીન
ഹനീതാ	હનીતા
ഹനുപ	હનુપ
ഹനുമാന	હનુમાન
ഹബീതാ	હબીતા
ഹമസാദീപികാ	હમસાદીપિકા
ഹമസാനംദീനീ	હમસાનંદીની
ഹമീര	હમીર
ഹരജീത	હરજીત
ഹരജീവന	હરજીવન
ഹരനാധ	હરનાધ
ഹരശും	હરશું
ഹരികിശന	હરિકિશન
ഹരിഗംഗാ	હરિગંગા
ഹരിഗോപാല	હરિગોપાલ
ഹരിദാസ	હરિદાસ
ഹരിദ്വാര	હરિદ્વાર
ഹരിപ്രീത	હરિપ્રીત
ഹരിമംതീ	હરિમંતી
ഹരീ	હરી
ഹരേശ്വര	હરેશ્વર
ഹര്മീന	હર્મીન
ഹര്ഷണ	હર્ષણ
ഹര്സികാ	હર્સિકા
ഹശ്മീതാ	હશ્મીતા
ഹസമുഖ	હસમુખ
ഹസീതാ	હસીતા
ഹസ്വീഥാ	હસ્વીથા
ഹാര്ദീനീ	હાર્દીની
ഹാര്ശീനീ	હાર્શીની
ഹാലിക	હાલિક
ഹിംഡോള	હિંડોળ
ഹിംദോലാ	હિંદોલા
ഹിതാക്ഷീ	હિતાક્ષી
ഹിതീ	હિતી
ഹിഥീക്സാ	હિથીક્સા
ഹിമാംശു	હિમાંશુ
ഹിമാക്ഷ	હિમાક્ષ
ഹിമാലയ	હિમાલય
ഹിരംയക	હિરંયક
ഹിരവ	હિરવ
ഹിരവാ	હિરવા
ഹിരുധായാ	હિરુધાયા
ഹിവാ	હિવા
ഹീരാനമാം	હીરાનમાં
ഹീരാന്യാപ്രകാഈ	હીરાન્યાપ્રકાઈ
ഹീര്നാക്ഷീ	હીર્નાક્ષી
ഹുവീശ്കാ	હુવીશ્કા
ഹൃദയനാഥ	હૃદયનાથ
ഹേഈദീ	હેઈદી
ഹേജല	હેજલ
ഹേതാ	હેતા
ഹേതാശ	હેતાશ
ഹേത്ശ്രീ	હેત્શ્રી
ഹേഥാന്ശ്രീ	હેથાન્શ્રી
ഹേനീത	હેનીત
ഹേനീല	હેનીલ
ഹേമനാഥ	હેમનાથ
ഹേമലതാ	હેમલતા
ഹേമാ	હેમા
ഹേമാംദ്രികാ	હેમાંદ્રિકા
ഹേമാഗൌരീ	હેમાગૌરી
ഹേമാനംദ	હેમાનંદ
ഹേമാലാ	હેમાલા
ഹേമാവതീ	હેમાવતી
ഹേമാവാതിനംദന	હેમાવાતિનંદન
ഹേമേംദു	હેમેંદુ
ഹേയന	હેયન
ഹേയാംശ	હેયાંશ
ഹേരീത	હેરીત
ഹേലീ	હેલી
ഹോന്നേശാ	હોન્નેશા
ഹോമാ	હોમા
ഹ്രീത്വിക	હ્રીત્વિક
ഹ്രീദാന്ക്ഷ	હ્રીદાન્ક્ષ
ഹ്രീധാന	હ્રીધાન
ഹ്രീശന	હ્રીશન
ഹ്രീശാംത	હ્રીશાંત
ഹ്രീഷിത	હ્રીષિત
ഹ്രുദയ	હ્રુદય
ഹ്രുശാല	હ્રુશાલ
ഹ്രേയാംശ	હ્રેયાંશ
ഹ്ര്യ്ദയേശ	હ્ર્ય્દયેશ
#
#
# Territory names from CLDR
അസൻഷൻ ദ്വീപ്	અસન્ષન્ દ્વીપ્
അന്റോറ	અન્ર઼ોર઼
യുണൈറ്റഡ് അറബ് എമിറൈറ്റ്‌സ്	યુણૈર઼્ર઼ડ્ અર઼બ્ એમિર઼ૈર઼્ર઼્‌સ્
അഫ്‌ഗാനിസ്ഥാൻ	અફ્‌ગાનિસ્થાન્
ആൻറിഗ്വയും ബർബുഡയും	આન્ર઼િગ્વયું બર્બુડયું
ആൻഗ്വില്ല	આન્ગ્વિલ્લ
അൽബേനിയ	અલ્બેનિય
അർമേനിയ	અર્મેનિય
അംഗോള	અંગોળ
അൻറാർട്ടിക്ക	અન્ર઼ાર્ટ્ટિક્ક
അർജൻറീന	અર્જન્ર઼ીન
അമേരിക്കൻ സമോവ	અમેરિક્કન્ સમોવ
ഓസ്ട്രിയ	ઓસ્ટ્રિય
ഓസ്‌ട്രേലിയ	ઓસ્‌ટ્રેલિય
അറൂബ	અર઼ૂબ
അലൻഡ് ദ്വീപുകൾ	અલન્ડ્ દ્વીપુકળ્
അസർബൈജാൻ	અસર્બૈજાન્
ബോസ്നിയയും ഹെർസഗോവിനയും	બોસ્નિયયું હેર્સગોવિનયું
ബാർബഡോസ്	બાર્બડોસ્
ബംഗ്ലാദേശ്	બંગ્લાદેશ્
ബെൽജിയം	બેલ્જિયં
ബുർക്കിനാ ഫാസോ	બુર્ક્કિના ફાસો
ബൾഗേറിയ	બળ્ગેર઼િય
ബഹ്റിൻ	બહ્ર઼િન્
ബറുണ്ടി	બર઼ુણ્ટિ
ബെനിൻ	બેનિન્
സെന്റ് ബാർത്തലമി	સેન્ર઼્ બાર્ત્તલમિ
ബർമുഡ	બર્મુડ
ബ്രൂണൈ	બ્રૂણૈ
ബൊളീവിയ	બોળીવિય
ബൊണെയ്ർ, സിന്റ് യുസ്റ്റേഷ്യസ്, സാബ എന്നിവ	બોણેય્ર્, સિન્ર઼્ યુસ્ર઼્ર઼ેષ્યસ્, સાબ એન્નિવ
ബ്രസീൽ	બ્રસીલ્
ബഹാമാസ്	બહામાસ્
ഭൂട്ടാൻ	ભૂટ્ટાન્
ബൗവെട്ട് ദ്വീപ്	બૌવેટ્ટ્ દ્વીપ્
ബോട്സ്വാന	બોટ્સ્વાન
ബെലറൂസ്	બેલર઼ૂસ્
ബെലീസ്	બેલીસ્
കാനഡ	કાનડ
കോക്കസ് (കീലിംഗ്) ദ്വീപുകൾ	કોક્કસ્ (કીલિંગ્) દ્વીપુકળ્
കോംഗോ - കിൻഷാസ	કોંગો - કિન્ષાસ
കോംഗോ (DRC)	કોંગો (DRC)
സെൻട്രൽ ആഫ്രിക്കൻ റിപ്പബ്ലിക്	સેન્ટ્રલ્ આફ્રિક્કન્ ર઼િપ્પબ્લિક્
കോംഗോ - ബ്രാസവില്ലി	કોંગો - બ્રાસવિલ્લિ
കോംഗോ (റിപ്പബ്ലിക്ക്)	કોંગો (ર઼િપ્પબ્લિક્ક્)
സ്വിറ്റ്സർലാൻഡ്	સ્વિર઼્ર઼્સર્લાન્ડ્
കോട്ട് ഡി വാർ	કોટ્ટ્ ડિ વાર્
ഐവറി കോസ്റ്റ്	ઐવર઼િ કોસ્ર઼્ર઼્
കുക്ക് ദ്വീപുകൾ	કુક્ક્ દ્વીપુકળ્
ചിലി	ચિલિ
കാമറൂൺ	કામર઼ૂણ્
ചൈന	ચૈન
കൊളംബിയ	કોળંબિય
ക്ലിപ്പെർട്ടൻ ദ്വീപ്	ક્લિપ્પેર્ટ્ટન્ દ્વીપ્
കോസ്റ്ററിക്ക	કોસ્ર઼્ર઼ર઼િક્ક
ക്യൂബ	ક્યૂબ
കേപ്പ് വെർദെ	કેપ્પ્ વેર્દે
കുറാകാവോ	કુર઼ાકાવો
ക്രിസ്മസ് ദ്വീപ്	ક્રિસ્મસ્ દ્વીપ્
സൈപ്രസ്	સૈપ્રસ્
ചെക്ക് റിപ്പബ്ലിക്	ચેક્ક્ ર઼િપ્પબ્લિક્
ജർമനി	જર્મનિ
ഡീഗോ ഗ്രാഷ്യ	ડીગો ગ્રાષ્ય
ദിജിബൗട്ടി	દિજિબૌટ્ટિ
ഡെൻമാർക്ക്	ડેન્માર્ક્ક્
ഡൊമിനിക്ക	ડોમિનિક્ક
ഡൊമിനിക്കൻ റിപ്പബ്ലിക്	ડોમિનિક્કન્ ર઼િપ્પબ્લિક્
അൾജീരിയ	અળ્જીરિય
സെയൂത്ത ആൻഡ് മെലിയ	સેયૂત્ત આન્ડ્ મેલિય
ഇക്വഡോർ	ઇક્વડોર્
എസ്റ്റോണിയ	એસ્ર઼્ર઼ોણિય
ഈജിപ്ത്	ઈજિપ્ત્
പശ്ചിമ സഹാറ	પશ્ચિમ સહાર઼
എറിത്രിയ	એર઼િત્રિય
സ്‌പെയിൻ	સ્‌પેયિન્
എത്യോപ്യ	એત્યોપ્ય
യൂറോപ്യൻ യൂണിയൻ	યૂર઼ોપ્યન્ યૂણિયન્
ഫിൻലാൻഡ്	ફિન્લાન્ડ્
ഫിജി	ફિજિ
ഫാക്ക്‌ലാന്റ് ദ്വീപുകൾ	ફાક્ક્‌લાન્ર઼્ દ્વીપુકળ્
ഫോക്ക്‌ലാൻഡ് ദ്വീപുകൾ (ഐലാസ് മാൽവിനാസ്)	ફોક્ક્‌લાન્ડ્ દ્વીપુકળ્ (ઐલાસ્ માલ્વિનાસ્)
മൈക്രോനേഷ്യ	મૈક્રોનેષ્ય
ഫറോ ദ്വീപുകൾ	ફર઼ો દ્વીપુકળ્
ഫ്രാൻസ്	ફ્રાન્સ્
ഗാബൺ	ગાબણ્
യുണൈറ്റഡ് കിംഗ്ഡം	યુણૈર઼્ર઼ડ્ કિંગ્ડં
ഗ്രനേഡ	ગ્રનેડ
ജോർജ്ജിയ	જોર્જ્જિય
ഫ്രഞ്ച് ഗയാന	ફ્રઞ્ચ્ ગયાન
ഗേൺസി	ગેણ્સિ
ഘാന	ઘાન
ജിബ്രാൾട്ടർ	જિબ્રાળ્ટ્ટર્
ഗ്രീൻലാൻറ്	ગ્રીન્લાન્ર઼્
ഗാംബിയ	ગાંબિય
ഗിനിയ	ગિનિય
ഗ്വാഡലൂപ്പ്	ગ્વાડલૂપ્પ્
ഇക്വറ്റോറിയൽ ഗിനിയ	ઇક્વર઼્ર઼ોર઼િયલ્ ગિનિય
ഗ്രീസ്	ગ્રીસ્
ദക്ഷിണ ജോർജ്ജിയയും ദക്ഷിണ സാൻഡ്‌വിച്ച് ദ്വീപുകളും	દક્ષિણ જોર્જ્જિયયું દક્ષિણ સાન્ડ્‌વિચ્ચ્ દ્વીપુકળું
ഗ്വാട്ടിമാല	ગ્વાટ્ટિમાલ
ഗ്വാം	ગ્વાં
ഗിനിയ-ബിസൗ	ગિનિય-બિસૌ
ഗയാന	ગયાન
ഹോങ്കോങ്ങ് (SAR) ചൈന	હોઙ્કોઙ્ઙ્ (SAR) ચૈન
ഹോങ്കോങ്ങ്	હોઙ્કોઙ્ઙ્
ഹിയേർഡും മക്‌ഡൊണാൾഡ് ദ്വീപുകളും	હિયેર્ડું મક્‌ડોણાળ્ડ્ દ્વીપુકળું
ഹോണ്ടുറാസ്	હોણ્ટુર઼ાસ્
ക്രൊയേഷ്യ	ક્રોયેષ્ય
ഹെയ്തി	હેય્તિ
ഹംഗറി	હંગર઼િ
കാനറി ദ്വീപുകൾ	કાનર઼િ દ્વીપુકળ્
ഇന്തോനേഷ്യ	ઇન્તોનેષ્ય
അയർലാൻഡ്	અયર્લાન્ડ્
ഇസ്രായേൽ	ઇસ્રાયેલ્
ഐൽ ഓഫ് മാൻ	ઐલ્ ઓફ્ માન્
ഇന്ത്യ	ઇન્ત્ય
ബ്രിട്ടീഷ് ഇന്ത്യൻ മഹാസമുദ്ര പ്രദേശം	બ્રિટ્ટીષ્ ઇન્ત્યન્ મહાસમુદ્ર પ્રદેશં
ഇറാഖ്	ઇર઼ાખ્
ഇറാൻ	ઇર઼ાન્
ഐസ്‌ലാന്റ്	ઐસ્‌લાન્ર઼્
ഇറ്റലി	ઇર઼્ર઼લિ
ജേഴ്സി	જેળ઼્સિ
ജമൈക്ക	જમૈક્ક
ജോർദ്ദാൻ	જોર્દ્દાન્
ജപ്പാൻ	જપ્પાન્
കെനിയ	કેનિય
കിർഗിസ്ഥാൻ	કિર્ગિસ્થાન્
കംബോഡിയ	કંબોડિય
കിരിബാട്ടി	કિરિબાટ્ટિ
കോമൊറോസ്	કોમોર઼ોસ્
സെന്റ് കിറ്റ്‌സും നെവിസും	સેન્ર઼્ કિર઼્ર઼્‌સું નેવિસું
ഉത്തരകൊറിയ	ઉત્તરકોર઼િય
ദക്ഷിണകൊറിയ	દક્ષિણકોર઼િય
കുവൈറ്റ്	કુવૈર઼્ર઼્
കേമാൻ ദ്വീപുകൾ	કેમાન્ દ્વીપુકળ્
കസാഖിസ്ഥാൻ	કસાખિસ્થાન્
ലാവോസ്	લાવોસ્
ലെബനൻ	લેબનન્
സെൻറ് ലൂസിയ	સેન્ર઼્ લૂસિય
ലിച്ചൺസ്റ്റൈൻ	લિચ્ચણ્સ્ર઼્ર઼ૈન્
ശ്രീലങ്ക	શ્રીલઙ્ક
ലൈബീരിയ	લૈબીરિય
ലെസോതോ	લેસોતો
ലിത്വാനിയ	લિત્વાનિય
ലക്സംബർഗ്	લક્સંબર્ગ્
ലാറ്റ്വിയ	લાર઼્ર઼્વિય
ലിബിയ	લિબિય
മൊറോക്കൊ	મોર઼ોક્કો
മൊണാക്കോ	મોણાક્કો
മൾഡോവ	મળ્ડોવ
മോണ്ടെനെഗ്രോ	મોણ્ટેનેગ્રો
സെൻറ് മാർട്ടിൻ	સેન્ર઼્ માર્ટ્ટિન્
മഡഗാസ്കർ	મડગાસ્કર્
മാർഷൽ ദ്വീപുകൾ	માર્ષલ્ દ્વીપુકળ્
മാസിഡോണിയ	માસિડોણિય
മാസിഡോണിയ (FYROM)	માસિડોણિય (FYROM)
മാലി	માલિ
മ്യാൻമാർ (ബർമ്മ)	મ્યાન્માર્ (બર્મ્મ)
മംഗോളിയ	મંગોળિય
മക്കാവു (SAR) ചൈന	મક્કાવુ (SAR) ચૈન
മക്കാവു	મક્કાવુ
ഉത്തര മറിയാനാ ദ്വീപുകൾ	ઉત્તર મર઼િયાના દ્વીપુકળ્
മാർട്ടിനിക്ക്	માર્ટ્ટિનિક્ક્
മൗറിറ്റാനിയ	મૌર઼િર઼્ર઼ાનિય
മൊണ്ടെസരത്ത്	મોણ્ટેસરત્ત્
മാൾട്ട	માળ્ટ્ટ
മൗറീഷ്യസ്	મૌર઼ીષ્યસ્
മാലിദ്വീപ്	માલિદ્વીપ્
മലാവി	મલાવિ
മെക്സിക്കോ	મેક્સિક્કો
മലേഷ്യ	મલેષ્ય
മൊസാംബിക്ക്	મોસાંબિક્ક્
നമീബിയ	નમીબિય
പുതിയ കാലിഡോണിയ	પુતિય કાલિડોણિય
നൈജർ	નૈજર્
നോർഫോക് ദ്വീപ്	નોર્ફોક્ દ્વીપ્
നൈജീരിയ	નૈજીરિય
നിക്കരാഗ്വ	નિક્કરાગ્વ
നെതർലാൻഡ്‌സ്	નેતર્લાન્ડ્‌સ્
നോർവെ	નોર્વે
നേപ്പാൾ	નેપ્પાળ્
നൗറു	નૌર઼ુ
ന്യൂയി	ન્યૂયિ
ന്യൂസിലാൻറ്	ન્યૂસિલાન્ર઼્
ഒമാൻ	ઓમાન્
പനാമ	પનામ
പെറു	પેર઼ુ
ഫ്രഞ്ച് പോളിനേഷ്യ	ફ્રઞ્ચ્ પોળિનેષ્ય
പാപ്പുവ ന്യൂ ഗിനിയ	પાપ્પુવ ન્યૂ ગિનિય
ഫിലിപ്പൈൻസ്	ફિલિપ્પૈન્સ્
പാക്കിസ്ഥാൻ	પાક્કિસ્થાન્
പോളണ്ട്	પોળણ્ટ્
സെന്റ് പിയറിയും മിക്കലണും	સેન્ર઼્ પિયર઼િયું મિક્કલણું
പിറ്റ്‌കെയ്‌ൻ ദ്വീപുകൾ	પિર઼્ર઼્‌કેય્‌ન્ દ્વીપુકળ્
പ്യൂർട്ടോ റിക്കോ	પ્યૂર્ટ્ટો ર઼િક્કો
പാലസ്‌തീൻ പ്രദേശങ്ങൾ	પાલસ્‌તીન્ પ્રદેશઙ્ઙળ્
പലസ്‌തീൻ	પલસ્‌તીન્
പോർച്ചുഗൽ	પોર્ચ્ચુગલ્
പലാവു	પલાવુ
പരാഗ്വേ	પરાગ્વે
ഖത്തർ	ખત્તર્
ദ്വീപസമൂഹം	દ્વીપસમૂહં
റീയൂണിയൻ	ર઼ીયૂણિયન્
റൊമാനിയ	ર઼ોમાનિય
സെർബിയ	સેર્બિય
റഷ്യ	ર઼ષ્ય
റുവാണ്ട	ર઼ુવાણ્ટ
സൗദി അറേബ്യ	સૌદિ અર઼ેબ્ય
സോളമൻ ദ്വീപുകൾ	સોળમન્ દ્વીપુકળ્
സെയ്‌ഷെൽസ്	સેય્‌ષેલ્સ્
സുഡാൻ	સુડાન્
സ്വീഡൻ	સ્વીડન્
സിംഗപ്പുർ	સિંગપ્પુર્
സെൻറ് ഹെലീന	સેન્ર઼્ હેલીન
സ്ലോവേനിയ	સ્લોવેનિય
സ്വാൽബാഡും ജാൻ മായേനും	સ્વાલ્બાડું જાન્ માયેનું
സ്ലോവാക്യ	સ્લોવાક્ય
സിയെറ ലിയോൺ	સિયેર઼ લિયોણ્
സാൻ മറിനോ	સાન્ મર઼િનો
സെനഗൽ	સેનગલ્
സോമാലിയ	સોમાલિય
സുരിനെയിം	સુરિનેયિં
ദക്ഷിണ സുഡാൻ	દક્ષિણ સુડાન્
സാവോ ടോമും പ്രിൻസിപെയും	સાવો ટોમું પ્રિન્સિપેયું
എൽ സാൽവദോർ	એલ્ સાલ્વદોર્
സിന്റ് മാർട്ടെൻ	સિન્ર઼્ માર્ટ્ટેન્
സിറിയ	સિર઼િય
സ്വാസിലാൻറ്	સ્વાસિલાન્ર઼્
ട്രസ്റ്റൻ ഡ കൂന	ટ્રસ્ર઼્ર઼ન્ ડ કૂન
ടർക്ക്‌സും കെയ്‌ക്കോ ദ്വീപുകളും	ટર્ક્ક્‌સું કેય્‌ક્કો દ્વીપુકળું
ഛാഡ്	છાડ્
ഫ്രഞ്ച് ദക്ഷിണ ഭൂപ്രദേശം	ફ્રઞ્ચ્ દક્ષિણ ભૂપ્રદેશં
ടോഗോ	ટોગો
തായ്‌ലാൻഡ്	તાય્‌લાન્ડ્
താജിക്കിസ്ഥാൻ	તાજિક્કિસ્થાન્
ടോക്കെലൂ	ટોક્કેલૂ
തിമോർ-ലെസ്റ്റെ	તિમોર્-લેસ્ર઼્ર઼ે
കിഴക്കൻ തിമോർ	કિળ઼ક્કન્ તિમોર્
തുർക്ക്മെനിസ്ഥാൻ	તુર્ક્ક્મેનિસ્થાન્
ടുണീഷ്യ	ટુણીષ્ય
ടോംഗ	ટોંગ
തുർക്കി	તુર્ક્કિ
ട്രിനിഡാഡും ടുബാഗോയും	ટ્રિનિડાડું ટુબાગોયું
ടുവാലു	ટુવાલુ
തായ്‌വാൻ	તાય્‌વાન્
ടാൻസാനിയ	ટાન્સાનિય
ഉക്രെയ്‌ൻ	ઉક્રેય્‌ન્
ഉഗാണ്ട	ઉગાણ્ટ
അമേരിക്കൻ ഐക്യനാടുകൾ	અમેરિક્કન્ ઐક્યનાટુકળ્
ഉറുഗ്വേ	ઉર઼ુગ્વે
ഉസ്‌ബെക്കിസ്ഥാൻ	ઉસ્‌બેક્કિસ્થાન્
വത്തിക്കാൻ	વત્તિક્કાન્
സെന്റ് വിൻസെന്റും ഗ്രനെഡൈൻസും	સેન્ર઼્ વિન્સેન્ર઼ું ગ્રનેડૈન્સું
വെനിസ്വേല	વેનિસ્વેલ
ബ്രിട്ടീഷ് വെർജിൻ ദ്വീപുകൾ	બ્રિટ્ટીષ્ વેર્જિન્ દ્વીપુકળ્
വിയറ്റ്നാം	વિયર઼્ર઼્નાં
വന്വാതു	વન્વાતુ
വാലിസ് ആന്റ് ഫ്യൂച്യുന	વાલિસ્ આન્ર઼્ ફ્યૂચ્યુન
സമോവ	સમોવ
കൊസോവൊ	કોસોવો
യെമൻ	યેમન્
മയോട്ടി	મયોટ્ટિ
ദക്ഷിണാഫ്രിക്ക	દક્ષિણાફ્રિક્ક
സാംബിയ	સાંબિય
സിംബാബ്‌വേ	સિંબાબ્‌વે
അജ്ഞാത പ്രദേശം	અજ્ઞાત પ્રદેશં
#
#
# Miscellaneous
എഩ്ഩാൽ	એન઼્ન઼ાલ્
പതിറ്റുപ്പത്തു	પતિર઼્ર઼ુપ્પત્તુ
തമിഴ്	તમિળ઼્
ആലപ്പുഴ	આલપ્પુળ઼
ദുഃഖം	દુઃખં
ഊഃ	ઊઃ
ഗൌതമ	ગૌતમ
ഗൗതമ	ગૌતમ
ശിവോഽഹം	શિવોઽહં
നിൎവാണം	નિર્વાણં
സൂര്യൻ	સૂર્યન્
ഋഷി	ઋષિ
൦൧൨൩൪൫൬൭൮൯	૦૧૨૩૪૫૬૭૮૯
൰	૧૦
൱	૧૦૦
൲	૧૦૦૦
