# Baby names
ਅਂਗਦ	অংগদ
ਅਂਗਦ ਦੇਵ	অংগদ দেব
ਅਂਗਾਰਿਕਾ	অংগারিকা
ਅਂਤਰਜੋਤ	অংতরজোত
ਅਂਤਰਪ੍ਰਿਤ	অংতরপ্রিত
ਅਂਤਰਾ	অংতরা
ਅਕਲਤਟ	অকলতট
ਅਕਲਰੂਪ	অকলরূপ
ਅਕਲਸ਼ਰਣ	অকলশরণ
ਅਕਲਸੀਮਾਰ	অকলসীমার
ਅਕਾਲਜੋਗ	অকালজোগ
ਅਕਾਲਦੀਪ	অকালদীপ
ਅਕਾਲਪ੍ਰੀਤ	অকালপ্রীত
ਅਕਾਲਬੀਰ	অকালবীর
ਅਗਮਜੀਤ	অগমজীত
ਅਗਮਜੋਤ	অগমজোত
ਅਗਮ੍ਪਾਲ	অগম্পাল
ਅਗਮ੍ਪ੍ਰੀਤ	অগম্প্রীত
ਅਜ੍ਮੀਨ੍ਦੇਰ	অজ্মীন্দের
ਅਝਾਦਬੀਰ	অঝাদবীর
ਅਝੀਝ	অঝীঝ
ਅਤੀਨਦੇਰ੍ਜਿਤ	অতীনদের্জিত
ਅਤੀਨ੍ਦੇਰ	অতীন্দের
ਅਤ੍ਤਾਮਜਿਤ	অত্তামজিত
ਅਨਂਤਦੇਵ	অনংতদেব
ਅਨਂਤਰ	অনংতর
ਅਨਂਤਵੀਰ	অনংতবীর
ਅਨਂਤ੍ਜੀਤ	অনংত্জীত
ਅਨਾਹਤ	অনাহত
ਅਨਿਂਦਿਤਾ	অনিংদিতা
ਅਨਿਸ਼ਾ	অনিশা
ਅਨੀਲਜੋਤ	অনীলজোত
ਅਨੀਸ਼੍ਕੋਉਂਰ	অনীশ্কোউংর
ਅਨੁਂਜਪਾਲ	অনুংজপাল
ਅਨੁਂਪਜੋਤ	অনুংপজোত
ਅਨੁਰਾਧਾ	অনুরাধা
ਅਨੁਸ਼੍ਕਾ	অনুশ্কা
ਅਨੂਪਜੋਤ	অনূপজোত
ਅਨੂਪਬੀਰ	অনূপবীর
ਅਨੂਪਲੋਕ	অনূপলোক
ਅਪੂਰ੍ਵਾ	অপূর্বা
ਅਪ੍ਰੀਨਦੇਰ	অপ্রীনদের
ਅਬਨੀ	অবনী
ਅਬਿਚਾਲ	অবিচাল
ਅਬਿਨਾਸ਼	অবিনাশ
ਅਭਿਜੀਤ	অভিজীত
ਅਭਿਰੂਪ	অভিরূপ
ਅਮਨਜੀਤ	অমনজীত
ਅਮਰਜੋਤ	অমরজোত
ਅਮਰਤ	অমরত
ਅਮਰਿਂਦਰ	অমরিংদর
ਅਮਰਿਤ	অমরিত
ਅਮਲਜੋਤ	অমলজোত
ਅਮਾਨਜੀਵਨ	অমানজীবন
ਅਮਾਨੀਨ੍ਦੇਰ	অমানীন্দের
ਅਮਾਨ੍ਰੂਪ	অমান্রূপ
ਅਮਾਰ੍ਪਾਲ	অমার্পাল
ਅਮਾਰ੍ਬੀਰ	অমার্বীর
ਅਮਿਕ	অমিক
ਅਮਿਤ	অমিত
ਅਮਿਤੋਜ	অমিতোজ
ਅਮੀਤਪਾਲ	অমীতপাল
ਅਮੀਤ੍ਬੀਰ	অমীত্বীর
ਅਮੋਲ੍ਰਸ	অমোল্রস
ਅਮ੍ਨੀਨ੍ਦੇਰ	অম্নীন্দের
ਅਮ੍ਰੀਤਬਾਨ	অম্রীতবান
ਅਮ੍ਰੀਤ੍ਪ੍ਰਿਤ	অম্রীত্প্রিত
ਅਮ੍ਰੀਤ੍ਵਾਨੀ	অম্রীত্বানী
ਅਰਮਾਨੀ	অরমানী
ਅਰਵਜੋਤ	অরবজোত
ਅਰੀਨਾਜੇਤ	অরীনাজেত
ਅਰੀਨ੍ਦੇਰ੍ਜੀਤ	অরীন্দের্জীত
ਅਰੁਨਜੀਤ	অরুনজীত
ਅਰੁਨਜੋਤ	অরুনজোত
ਅਰ੍ਚਨਾ	অর্চনা
ਅਰ੍ਦਮਨ	অর্দমন
ਅਰ੍ਨਾਲੀਨ੍ਦੇਰ	অর্নালীন্দের
ਅਰ੍ਸ਼੍ਦੀਪ	অর্শ্দীপ
ਅਲੋਕ੍ਪਾਲ	অলোক্পাল
ਅਲ੍ਪਨਾ	অল্পনা
ਅਵਨੀਨਦੇਰ	অবনীনদের
ਅਵਿਰ	অবির
ਅਵ੍ਲੀਨ	অব্লীন
ਅਸਂਖ	অসংখ
ਅਸ਼ਮਿਤ	অশমিত
ਅਸ਼ਰ੍ਨਾਮ	অশর্নাম
ਅਸ਼ਰ੍ਪ੍ਰੀਤ	অশর্প্রীত
ਅਸ਼ਰ੍ਪ੍ਰੇਮ	অশর্প্রেম
ਅਸ਼ਰ੍ਵੀਰ	অশর্বীর
ਅਸ਼ਿਮਾ	অশিমা
ਅਸੀਮ	অসীম
ਅਸੀਸ	অসীস
ਅਸ੍ਨੇਹ	অস্নেহ
ਆਖਰੀ	আখরী
ਆਤ੍ਮਜਾ	আত্মজা
ਆਨਂਦਮਯੀ	আনংদমযী
ਆਨਂਦਰੂਪ	আনংদরূপ
ਆਯਕਾਰ	আযকার
ਆਯਾਤਪ੍ਰਿਤ	আযাতপ্রিত
ਆਯੁਸ਼੍ਮਤਿ	আযুশ্মতি
ਆਰਮਾਨ	আরমান
ਆਰਾਧ	আরাধ
ਆਰਾਧਨਾ	আরাধনা
ਆਰ੍ਯਨ	আর্যন
ਇਂਦਰਬੀਰ	ইংদরবীর
ਇਂਦਿਵਰ	ইংদিবর
ਇਕਪ੍ਰਿਤ	ইকপ্রিত
ਇਕਬਾਲ	ইকবাল
ਇਕਰੂਪ	ইকরূপ
ਇਕ੍ਪੂਜ	ইক্পূজ
ਇਕ੍ਮਾਨ	ইক্মান
ਇਚ੍ਕਜਿਤ	ইচ্কজিত
ਇਨ੍ਦਾਰਤੇਜ	ইন্দারতেজ
ਇਨ੍ਦਾਰਮਿਤ	ইন্দারমিত
ਇਨ੍ਦਾਰ੍ਦੀਪ	ইন্দার্দীপ
ਇਨ੍ਦਾਰ੍ਪ੍ਰਿਤ	ইন্দার্প্রিত
ਇਨ੍ਦਾਰ੍ਪ੍ਰੇਮ	ইন্দার্প্রেম
ਇਨ੍ਦੇਰ	ইন্দের
ਇਨ੍ਦੇਰਪਲ	ইন্দেরপল
ਇਨ੍ਦੇਰਮਾਨ	ইন্দেরমান
ਇਨ੍ਦੇਰਹਾਰ੍ਜਿਤ	ইন্দেরহার্জিত
ਇਮਰਾਤ	ইমরাত
ਈਖ੍ਤਿਅਰ	ঈখ্তিঅর
ਈਨ੍ਦਰ੍ਜੀਏਤ	ঈন্দর্জীএত
ਈਨ੍ਦੇਰਤੇਕ	ঈন্দেরতেক
ਈਨ੍ਦੇਰਵੀਰ	ঈন্দেরবীর
ਈਬਾਦਤ	ঈবাদত
ਈਸ਼ਪਾਲ	ঈশপাল
ਈਸ਼ਲੀਨ	ঈশলীন
ਈਸ਼ਾਰਤੇਕ	ঈশারতেক
ਈਸ਼ਾਰਪਾਲ	ঈশারপাল
ਈਸ਼੍ਤ੍ਵਰ੍ਜਿਤ	ঈশ্ত্বর্জিত
ਈਸ਼੍ਪ੍ਰਿਤ	ঈশ্প্রিত
ਈਸ਼੍ਵਾਰ੍ਜਿਤ	ঈশ্বার্জিত
ਈਸ਼੍ਵੀਨਦੇਰ	ঈশ্বীনদের
ਉਖ੍ਤਿਅਰ	উখ্তিঅর
ਉਚਪਾਲ	উচপাল
ਉਚਪ੍ਰਿਤ	উচপ্রিত
ਉਚੀਤਦੀਪ	উচীতদীপ
ਉਚੀਤਪ੍ਰਿਤ	উচীতপ্রিত
ਉਚੀਤਬੀਰ	উচীতবীর
ਉਚੀਤਰੂਪ	উচীতরূপ
ਉਚੀਤਲੋਕ	উচীতলোক
ਉਚੀਤਵਂਤ	উচীতবংত
ਉਜਗਰ੍ਜੋਤ	উজগর্জোত
ਉਜਗਰ੍ਦੀਪ	উজগর্দীপ
ਉਜਗਰ੍ਬੀਰ	উজগর্বীর
ਉਜਾਗਰ	উজাগর
ਉਜਾਲਾ	উজালা
ਉਜ੍ਜਲਜੋਤ	উজ্জলজোত
ਉਤ੍ਤਮ	উত্তম
ਉਤ੍ਤਮਪਾਲ	উত্তমপাল
ਉਤ੍ਤਮਲੀਵ	উত্তমলীব
ਉਤ੍ਤਾਮਕਾਰਾਮ	উত্তামকারাম
ਉਤ੍ਤਾਮਜੋਧ	উত্তামজোধ
ਉਤ੍ਤਾਮਤਿਰਥ	উত্তামতিরথ
ਉਤ੍ਤਾਮਤੇਕ	উত্তামতেক
ਉਤ੍ਤਾਮਦੀਪ	উত্তামদীপ
ਉਤ੍ਤਾਮਪਦ	উত্তামপদ
ਉਤ੍ਤਾਮ੍ਰਸ	উত্তাম্রস
ਉਤ੍ਤਾਮ੍ਰੂਪ	উত্তাম্রূপ
ਉਤ੍ਰਕ੍ਸ਼	উত্রক্শ
ਉਦੀਤਦੀਪ	উদীতদীপ
ਉਦੀਤਪ੍ਰਿਤ	উদীতপ্রিত
ਉਦੀਤਬੀਰ	উদীতবীর
ਉਦੈਬੀਰ	উদৈবীর
ਉਦੈਭਗਤ	উদৈভগত
ਉਦ੍ਦਾਮਜੀਤ	উদ্দামজীত
ਉਪਕਰਮ	উপকরম
ਉਪਕਿਰਤ	উপকিরত
ਉਪਜਿਤ	উপজিত
ਉਪਨਿਤ	উপনিত
ਉਪੀਨਦੇਰ੍ਪ੍ਰਿਤ	উপীনদের্প্রিত
ਉਪੇਨ੍ਦੇਰ	উপেন্দের
ਉਮੀਦ	উমীদ
ਊਤ੍ਤਮ੍ਗਿਆਨ	ঊত্তম্গিআন
ਏਕਂਕਰ	একংকর
ਏਕਬੀਰ	একবীর
ਏਕਮ	একম
ਏਕਮਪੂਜ	একমপূজ
ਏਕਮਬੀਰ	একমবীর
ਏਕਮ੍ਜੋਤ	একম্জোত
ਏਕਮ੍ਰੂਪ	একম্রূপ
ਏਕਾਨਪ੍ਰੀਤ	একানপ্রীত
ਏਕ੍ਕਾਮ	এক্কাম
ਏਤੀਬਾਰ	এতীবার
ਏਤ੍ਤਲੀਨ	এত্তলীন
ਏਰਸ਼ੀਨ	এরশীন
ਏਵੇਨਿਤ	এবেনিত
ਏਸ਼ਨਾ	এশনা
ਏਸ਼੍ਵਰ	এশ্বর
ਓਨਕਾਰ੍ਜਿਤ	ওনকার্জিত
ਓਨਕਾਰ੍ਜੀਤ	ওনকার্জীত
ਓਨਕਾਰ੍ਪ੍ਰਿਤ	ওনকার্প্রিত
ਓਮਪ੍ਰਿਤ	ওমপ্রিত
ਕਂਵਲ	কংবল
ਕਂਵਲਜੀਤ	কংবলজীত
ਕਨਵਾਰ੍ਜਾਗਤ	কনবার্জাগত
ਕਨਵਾਰ੍ਜਿਤ	কনবার্জিত
ਕਨਵਾਰ੍ਪ੍ਰੇਮ	কনবার্প্রেম
ਕਨਵਾਲ੍ਜੋਤ	কনবাল্জোত
ਕਨਵਾਲ੍ਨੈਨ	কনবাল্নৈন
ਕਨਵਾਲ੍ਪਾਲ	কনবাল্পাল
ਕਨਵਾਲ੍ਪ੍ਰੇਮ	কনবাল্প্রেম
ਕਨਵਾਲ੍ਬੀਰ	কনবাল্বীর
ਕਨਵਾਲ੍ਰੂਪ	কনবাল্রূপ
ਕਨ੍ਚਨ੍ਦੀਪ	কন্চন্দীপ
ਕਨ੍ਚਾਨ੍ਪਾਲ	কন্চান্পাল
ਕਨ੍ਵਾਰਪਾਲ	কন্বারপাল
ਕਮਾਲ੍ਲਾ	কমাল্লা
ਕਰਨਦੀਪ	করনদীপ
ਕਰਨਪਾਲ	করনপাল
ਕਰਨਪ੍ਰਿਤ	করনপ্রিত
ਕਰਨਰੂਪ	করনরূপ
ਕਰਮਪਲ	করমপল
ਕਰਮਪੁਲ	করমপুল
ਕਰਮ੍ਜੋਤ	করম্জোত
ਕਰੁਨ੍ਯਾ	করুন্যা
ਕਲਬੀਰ	কলবীর
ਕਲਾਜੋਤ	কলাজোত
ਕਲਾਪ੍ਰੇਮ	কলাপ্রেম
ਕਵਨਿਤ	কবনিত
ਕਵਨੀਰ	কবনীর
ਕਵਾਲ੍ਨਾਨ	কবাল্নান
ਕਵਿਰਾਜ	কবিরাজ
ਕਸਮ	কসম
ਕਾਨਵਾਲੀਨ੍ਦੇਰ	কানবালীন্দের
ਕਾਮਾਂਲਜੋਤ	কামাংলজোত
ਕਾਮਾਂਲਮਿਤ	কামাংলমিত
ਕਾਮਾਂਲਮੋਹਨ	কামাংলমোহন
ਕਾਮਾਂਲ੍ਪਤਿ	কামাংল্পতি
ਕਾਰਮਨ	কারমন
ਕਾਵਾਲਪ੍ਰਿਤ	কাবালপ্রিত
ਕਿਰਣਜੀਤ	কিরণজীত
ਕਿਰਨਰੂਪ	কিরনরূপ
ਕਿਰਨਸੁਖ	কিরনসুখ
ਕਿਸ਼ੇਨ	কিশেন
ਕੁਂਵਰਜੀਤ	কুংবরজীত
ਕੁਲ	কুল
ਕੁਲਜੋਤ	কুলজোত
ਕੁਲਮਿਤ	কুলমিত
ਕੁਲਰਾਤਨ	কুলরাতন
ਕੁਲਰੂਪ	কুলরূপ
ਕੁਲਵਂਠ	কুলবংঠ
ਕੁਸ਼ਪ੍ਰਿਤ	কুশপ্রিত
ਕੇਵਾਲਦੀਪ	কেবালদীপ
ਕੇਵਾਲਬੀਰ	কেবালবীর
ਕੋਉਰ	কোউর
ਕੋਮਾਂਲਜੀਤ	কোমাংলজীত
ਕੋਮਾਂਲਪ੍ਰੇਮ	কোমাংলপ্রেম
ਕੋਮਾਲਦੀਪ	কোমালদীপ
ਕੋਮਾਲਮਿਤ	কোমালমিত
ਕੌਰ	কৌর
ਕ੍ਰਿਸ਼੍ਦੀਪ	ক্রিশ্দীপ
ਕ੍ਸ਼ਾਗਨ	ক্শাগন
ਕ੍ਸ਼ਾਗਰ	ক্শাগর
ਕ੍ਸ਼ਿਤਿਜ	ক্শিতিজ
ਕ੍ਸ਼੍ਹੀਮ	ক্শ্হীম
ਖਰਗ	খরগ
ਖਾਲਾਕ੍ਵੀਰ	খালাক্বীর
ਖੁਂਸ਼ਜੋਤ	খুংশজোত
ਖੁਸ	খুস
ਖੁਸ਼	খুশ
ਖੁਸ਼ਜੀਤ	খুশজীত
ਖੇਮਵਂਤ	খেমবংত
ਗਗਨ	গগন
ਗਗਨਜੀਵ	গগনজীব
ਗਗਨਜੋਤ	গগনজোত
ਗਗਨਪ੍ਰਿਤ	গগনপ্রিত
ਗਗਨਮਿਤ	গগনমিত
ਗਤਲੀਨ	গতলীন
ਗਤਸ਼ਰਣ	গতশরণ
ਗਤਸੀਮਾਰ	গতসীমার
ਗਰੀਨ੍ਦੇਰ	গরীন্দের
ਗਰ੍ਗੋਤ	গর্গোত
ਗਾਤਨੀਵਾਸ	গাতনীবাস
ਗਿਅਨ	গিঅন
ਗੀਂਜੀਵਨ	গীংজীবন
ਗੀਂਰਾਤਨ	গীংরাতন
ਗੀਂਲੀਨ	গীংলীন
ਗੀਅਂਗੀਤ	গীঅংগীত
ਗੀਅਂਚੇਤਨ	গীঅংচেতন
ਗੀਅਂਜੋਤ	গীঅংজোত
ਗੀਅਂਪ੍ਰਿਤ	গীঅংপ্রিত
ਗੀਅਂਰੂਪ	গীঅংরূপ
ਗੀਅਨੀਨਦੇਰ	গীঅনীনদের
ਗੀਅਨ੍ਬੀਰ	গীঅন্বীর
ਗੀਆਨਪ੍ਰਿਤ	গীআনপ্রিত
ਗੀਆਨਲੀਨ	গীআনলীন
ਗੀਤ	গীত
ਗੀਤਲੀਨ	গীতলীন
ਗੀਤੀਨਦੇਰ	গীতীনদের
ਗੁਣਿਤ	গুণিত
ਗੁਨ ਦਾਤ	গুন দাত
ਗੁਨਕਿਰਤ	গুনকিরত
ਗੁਨਜਸ	গুনজস
ਗੁਨਜਿਤ	গুনজিত
ਗੁਨਜੀਵਨ	গুনজীবন
ਗੁਨਜੁਨ	গুনজুন
ਗੁਨਜੋਤ	গুনজোত
ਗੁਨਪ੍ਰਿਤ	গুনপ্রিত
ਗੁਨਮਿਤ	গুনমিত
ਗੁਨਰਾਜ	গুনরাজ
ਗੁਨਸ਼ਾਂਤ	গুনশাংত
ਗੁਨਾਤਮ	গুনাতম
ਗੁਨਿਤਪੁਲ	গুনিতপুল
ਗੁਨਿਤਪ੍ਰਿਤ	গুনিতপ্রিত
ਗੁਨ੍ਰਿਤ	গুন্রিত
ਗੁਰਕਮਲ਼	গুরকমল়
ਗੁਰਗਿਯਨ	গুরগিযন
ਗੁਰਜਾਸ	গুরজাস
ਗੁਰਜੀਵਨ	গুরজীবন
ਗੁਰਜੋਗ	গুরজোগ
ਗੁਰਜੋਤ	গুরজোত
ਗੁਰਝੀਲ	গুরঝীল
ਗੁਰਤਰਣ	গুরতরণ
ਗੁਰਤਿਰਥ	গুরতিরথ
ਗੁਰਦਰ੍ਸ਼ਨ	গুরদর্শন
ਗੁਰਦਿਤ	গুরদিত
ਗੁਰਦੀਤ੍ਤਾ	গুরদীত্তা
ਗੁਰਦ੍ਵੀਪ	গুরদ্বীপ
ਗੁਰਨਾਦ	গুরনাদ
ਗੁਰਨਾਮਾਸ੍ਕਾਰ	গুরনামাস্কার
ਗੁਰਨੀਧ	গুরনীধ
ਗੁਰਨੀਰ੍ਮਾਲ	গুরনীর্মাল
ਗੁਰਨੀਸ਼ਾਨ	গুরনীশান
ਗੁਰਨ੍ਯਮ	গুরন্যম
ਗੁਰਪਰ੍ਵਿਨ	গুরপর্বিন
ਗੁਰਪੀਨਦੇਰ	গুরপীনদের
ਗੁਰਪ੍ਰੀਤਮ	গুরপ্রীতম
ਗੁਰਬਕ੍ਸ਼	গুরবক্শ
ਗੁਰਬਲੀਹਾਰ	গুরবলীহার
ਗੁਰਬੀਨ੍ਦੇਰ	গুরবীন্দের
ਗੁਰਬੀਰ	গুরবীর
ਗੁਰਭਜਨ	গুরভজন
ਗੁਰਭਾਗਤ	গুরভাগত
ਗੁਰਮਾਰ	গুরমার
ਗੁਰਮਾਹੇਰ	গুরমাহের
ਗੁਰਮੁਖ	গুরমুখ
ਗੁਰਮੇਹਾਰ	গুরমেহার
ਗੁਰਮੈਲ	গুরমৈল
ਗੁਰਮ੍ਰਿਤ	গুরম্রিত
ਗੁਰਲੋਚਨ	গুরলোচন
ਗੁਰਵਿਂਦਰ	গুরবিংদর
ਗੁਰਵੀਨ੍ਦੇਰ	গুরবীন্দের
ਗੁਰਵੀਰ	গুরবীর
ਗੁਰਸਨ੍ਦੀਪ	গুরসন্দীপ
ਗੁਰਸ਼ਾਨ	গুরশান
ਗੁਰਸੁਖ	গুরসুখ
ਗੁਰਸੇਵ	গুরসেব
ਗੁਰਹਾਰ੍ਪਾਲ	গুরহার্পাল
ਗੁਰਿਂਦਰ	গুরিংদর
ਗੁਰੀਨਦੇਰ੍ਪਾਲ	গুরীনদের্পাল
ਗੁਰੁਕਾਰ	গুরুকার
ਗੁਰੁਗੁਲ੍ਝਾਰ	গুরুগুল্ঝার
ਗੁਰੁਚਰਣ	গুরুচরণ
ਗੁਰੁਦਰ੍ਸ਼ਨ	গুরুদর্শন
ਗੁਰੁਦਾਸ	গুরুদাস
ਗੁਰੁਦੀਪ	গুরুদীপ
ਗੁਰੁਪ੍ਰੇਮ	গুরুপ্রেম
ਗੁਰੁਬੀਰ	গুরুবীর
ਗੁਰੁਮਾਂਨ੍ਦੀਰ	গুরুমাংন্দীর
ਗੁਰੁਸੀਮ੍ਰਣ	গুরুসীম্রণ
ਗੁਰ੍ਕੀਰਣ	গুর্কীরণ
ਗੁਰ੍ਕੀਰਪਾਲ	গুর্কীরপাল
ਗੁਰ੍ਚਾਰਾਨ੍ਜੋਤ	গুর্চারান্জোত
ਗੁਰ੍ਜਨਪਾਲ	গুর্জনপাল
ਗੁਰ੍ਜੁ	গুর্জু
ਗੁਰ੍ਤੇਜ	গুর্তেজ
ਗੁਰ੍ਨੀਵਾਝ	গুর্নীবাঝ
ਗੁਰ੍ਨੂਰ	গুর্নূর
ਗੁਰ੍ਪ੍ਰਿਤੀ	গুর্প্রিতী
ਗੁਰ੍ਮੀਤ	গুর্মীত
ਗੁਰ੍ਮੀਨਦੇਰ	গুর্মীনদের
ਗੁਰ੍ਮੁਖਨੀਹਲ	গুর্মুখনীহল
ਗੁਰ੍ਸ਼ਣ	গুর্শণ
ਗੁਰ੍ਸ਼ਾਂਤ	গুর্শাংত
ਗੁਰ੍ਸ਼ੀਲ	গুর্শীল
ਗੁਰ੍ਸਾਹੇਬ	গুর্সাহেব
ਗੁਲਦੀਪ	গুলদীপ
ਗੁਲਵਂਤ	গুলবংত
ਗੁਲਸ਼ਾਨ੍ਰੂਪ	গুলশান্রূপ
ਗੁਲ੍ਵਾਨ੍ਤਪ੍ਰਿਤ	গুল্বান্তপ্রিত
ਗੁਲ੍ਸ਼ਾਨਪ੍ਰਿਤ	গুল্শানপ্রিত
ਗੁਲ੍ਸ਼ਾਨਮਿਤ	গুল্শানমিত
ਗੋਪਲਪ੍ਰਿਤ	গোপলপ্রিত
ਗੋਬਿਂਦ	গোবিংদ
ਗੋਬੀਨਦੇਰ	গোবীনদের
ਗੋਬੀਨਦੇਰ੍ਜਿਤ	গোবীনদের্জিত
ਗੋਬੀਨ੍ਦਰਾਈ	গোবীন্দরাঈ
ਗੌਰਵ੍ਪ੍ਰਿਤ	গৌরব্প্রিত
ਘਮਾਂਨਦ੍ਜਿਤ	ঘমাংনদ্জিত
ਘਮਾਂਨਦ੍ਪਾਲ	ঘমাংনদ্পাল
ਚਂਚਲਜਿਤ	চংচলজিত
ਚਂਚਲ੍ਪ੍ਰੀਤ	চংচল্প্রীত
ਚਂਦਨ	চংদন
ਚਂਦਨਦੀਪ	চংদনদীপ
ਚਮਕੌਰ	চমকৌর
ਚਮਨਜਿਤ	চমনজিত
ਚਮਨਪ੍ਰਿਤ	চমনপ্রিত
ਚਮਨਰੂਪ	চমনরূপ
ਚਰਨਕਾਨ੍ਵਾਲ	চরনকান্বাল
ਚਰਨਜੋਤ /ਚਰਨਜ੍ਯੋਤ	চরনজোত /চরনজ্যোত
ਚਰਨਪ੍ਰੇਮ	চরনপ্রেম
ਚਾਂਦ	চাংদ
ਚਿਤਰਾਮਣ	চিতরামণ
ਚਿਤਸਰੂਪ	চিতসরূপ
ਚੀਤਪ੍ਰਿਤ	চীতপ্রিত
ਚੇਤਨ੍ਦੀਪ	চেতন্দীপ
ਜਗਜੀਤ	জগজীত
ਜਗਜੀਵ	জগজীব
ਜਗਜੀਵਨ	জগজীবন
ਜਗਤਜੀਤ	জগতজীত
ਜਗਤਪ੍ਰੇਮ	জগতপ্রেম
ਜਗਤਰਣ	জগতরণ
ਜਗਤਰੂਪ	জগতরূপ
ਜਗਨ	জগন
ਜਗਪਾਲ	জগপাল
ਜਗਪ੍ਰਿਤ	জগপ্রিত
ਜਗਪ੍ਰੇਮ	জগপ্রেম
ਜਗਮਿਤ	জগমিত
ਜਗਮੇਹਾਰ	জগমেহার
ਜਗਮੋਹਨ	জগমোহন
ਜਗਰਾਜ	জগরাজ
ਜਗਰੂਪ	জগরূপ
ਜਗਵੀਨ੍ਦੇਰ	জগবীন্দের
ਜਗਵੀਰ	জগবীর
ਜਗੀਨਦੇਰ	জগীনদের
ਜਗੀਨ੍ਦੇਰਪਾਲ	জগীন্দেরপাল
ਜਗ੍ਵੀਰ	জগ্বীর
ਜਘ੍ਰ	জঘ্র
ਜਤੀਨਦੇਰ੍ਜਿਤ	জতীনদের্জিত
ਜਤੀਨਦੇਰ੍ਬੀਰ	জতীনদের্বীর
ਜਤੀਨਦੇਰ੍ਮਿਤ	জতীনদের্মিত
ਜਨਜਿਤ	জনজিত
ਜਨਜੋਤ	জনজোত
ਜਨਪ੍ਰਿਤ	জনপ্রিত
ਜਨਰਾਜ	জনরাজ
ਜਨਿਸ਼	জনিশ
ਜਪਜਿਤ	জপজিত
ਜਪਧਾਰਾਮ	জপধারাম
ਜਪਧਿਰ	জপধির
ਜਪਨਾਮ	জপনাম
ਜਪਸ਼ੇਰ	জপশের
ਜਪੁਜੀ	জপুজী
ਜਬਰਜਂਗ	জবরজংগ
ਜਮੀਲ	জমীল
ਜਯਂਸ਼	জযংশ
ਜਯਪਾਲ	জযপাল
ਜਰ੍ਨੈਲ	জর্নৈল
ਜਲਿਨ੍ਦ੍ਰ	জলিন্দ্র
ਜਲ੍ਬੀਰ	জল্বীর
ਜਸਂਜੋਤ	জসংজোত
ਜਸਂਪਾਲ	জসংপাল
ਜਸਂਮਿਤ	জসংমিত
ਜਸਕੀਰਣ	জসকীরণ
ਜਸਗੁਰ੍ਕੀਰ੍ਤਤ	জসগুর্কীর্তত
ਜਸਜੀਨ੍ਦੇਰ	জসজীন্দের
ਜਸਜੀਵਨ	জসজীবন
ਜਸਜੋਤ	জসজোত
ਜਸਤਰਣ	জসতরণ
ਜਸਨਾਮ	জসনাম
ਜਸਪਾਲ (ਪੁਲ )	জসপাল (পুল )
ਜਸਬੀਰ	জসবীর
ਜਸਭੂਪ	জসভূপ
ਜਸਮਿਂਦਰ	জসমিংদর
ਜਸਮੋਹਨ	জসমোহন
ਜਸਰੂਪ	জসরূপ
ਜਸ੍ਕਰਣ	জস্করণ
ਜਸ੍ਕੀਰਿਤ	জস্কীরিত
ਜਸ੍ਕੀਰ੍ਪਲ	জস্কীর্পল
ਜਸ੍ਗੁਨ	জস্গুন
ਜਸ੍ਮਿਤ	জস্মিত
ਜਸ੍ਮੀਨਪ੍ਰਿਤ	জস্মীনপ্রিত
ਜਸ੍ਰਜਪ੍ਰਿਤ	জস্রজপ্রিত
ਜਸ੍ਸੀ	জস্সী
ਜਾਗ	জাগ
ਜਾਗਰੀਤ	জাগরীত
ਜਾਤਵਂਤ	জাতবংত
ਜਾਤਿਨਦੇਰ੍ਦੀਪ	জাতিনদের্দীপ
ਜਾਨਾਕਪ੍ਰਿਤ	জানাকপ্রিত
ਜਾਪਮਾਨ	জাপমান
ਜਾਸਨਿਤ	জাসনিত
ਜਾਸ਼ਾਨਪ੍ਰਿਤ	জাশানপ্রিত
ਜਾਸ੍ਮੀਲ	জাস্মীল
ਜੀਵਨਦੀਪ ; ਜੀਵਨਦੀਪ ; ਜੀਵਨਦੀਪ	জীবনদীপ ; জীবনদীপ ; জীবনদীপ
ਜੀਵਨਪਲ	জীবনপল
ਜੀਵਨਪ੍ਰਿਤ	জীবনপ্রিত
ਜੀਵਾਨਬੀਰ	জীবানবীর
ਜੁਗਦ	জুগদ
ਜੁਪੀਨਦੇਰਦੀਪ	জুপীনদেরদীপ
ਜੁਪੀਨਦੇਰ੍ਬੀਰ	জুপীনদের্বীর
ਜੁਸਜਿਤ	জুসজিত
ਜੁਸਪੁਲ	জুসপুল
ਜੁਸਮੈਲ	জুসমৈল
ਜੇਬਾ	জেবা
ਜੇਸਪਾਲ	জেসপাল
ਜੈਕਾਰ	জৈকার
ਜੈਪ੍ਰਜ	জৈপ্রজ
ਜੈਪ੍ਰਤਨ	জৈপ্রতন
ਜੈਬੀਰ	জৈবীর
ਜੈਸਂਗਤ	জৈসংগত
ਜੈਸੁਖਬੀਰ	জৈসুখবীর
ਜੋਗਧੀਆਨ	জোগধীআন
ਜੋਗਪ੍ਰਕਾਸ਼	জোগপ্রকাশ
ਜੋਗੀਨਦੇਰ੍ਬੀਰ	জোগীনদের্বীর
ਜੋਗੀਨਦੇਰ੍ਮਿਤ	জোগীনদের্মিত
ਜੋਗੇਨਦੇਰ	জোগেনদের
ਜੋਤਪ੍ਰਕਾਸ਼	জোতপ্রকাশ
ਜੋਬਨਰੂਪ	জোবনরূপ
ਜੋਹਾਰ	জোহার
ਜ੍ਞਾਨਜਿਤ	জ্ঞানজিত
ਜ੍ਞਾਨਜੋਤ	জ্ঞানজোত
ਜ੍ਞਾਨਪ੍ਰਿਤ	জ্ঞানপ্রিত
ਜ੍ਞਾਨਰੂਪ	জ্ঞানরূপ
ਜ੍ਞਾਨਵੀਰ	জ্ঞানবীর
ਜ੍ਞਾਨੇਨ੍ਦੇਰ	জ্ঞানেন্দের
ਜ੍ਹਮਕ	জ্হমক
ਜ੍ਹਾਗਰ	জ্হাগর
ਝਈਤੂਨ	ঝঈতূন
ਝਹਾਗਨ	ঝহাগন
ਝਾਮੀਨਾਹ	ঝামীনাহ
ਝੀਤੁਨ	ঝীতুন
ਝੀਲ	ঝীল
ਝੁਲਾਖਾ	ঝুলাখা
ਝੁਲ੍ਫਾ	ঝুল্ফা
ਝੇਬਵਂਤ	ঝেববংত
ਝੋਰਾਵਾਰ	ঝোরাবার
ਟੇਇਜਿਨ੍ਦੇਰ	টেইজিন্দের
ਤਕਦੀਰ	তকদীর
ਤਖਤ	তখত
ਤਤਜੋਗ	ততজোগ
ਤਤਬੀਰ	ততবীর
ਤਤਵਿਚਾਰ	ততবিচার
ਤਤ੍ਰਾਤਨ	তত্রাতন
ਤਦਬੀਰ	তদবীর
ਤਨਦੀਪ	তনদীপ
ਤਨਵੀਰ	তনবীর
ਤਮਨ੍ਪ੍ਰਿਤ	তমন্প্রিত
ਤਰਣਵੀਰ	তরণবীর
ਤਰਲੋਚਨ	তরলোচন
ਤਰਸੇਮ	তরসেম
ਤਰੁਨਜਿਤ	তরুনজিত
ਤਲਵਿਨ	তলবিন
ਤਾਜਦਾਰ	তাজদার
ਤਾਜੀਨਦੇਰ੍ਦੀਪ	তাজীনদের্দীপ
ਤਾਜੀਨਦੇਰ੍ਪ੍ਰੇਮ	তাজীনদের্প্রেম
ਤਾਨੁਪ੍ਰਿਤ	তানুপ্রিত
ਤਾਪਨਪਾਲ	তাপনপাল
ਤੀਰਨ /ਤਿਹ੍ਰਣ /ਤੇਯ੍ਰੁਣ	তীরন /তিহ্রণ /তেয্রুণ
ਤੀਰਾਥ੍ਰਾਮ	তীরাথ্রাম
ਤੁਵਿਜਾਤ	তুবিজাত
ਤੇਕਜੀਤ	তেকজীত
ਤੇਕਦੀਪ	তেকদীপ
ਤੇਕਪ੍ਰਿਤ	তেকপ্রিত
ਤੇਕ੍ਪਾਲ	তেক্পাল
ਤੇਘਬਹਾਦੁਰ	তেঘবহাদুর
ਤੇਜਧਾਰਾਮ	তেজধারাম
ਤੇਜਨਾਮ	তেজনাম
ਤੇਜਪ੍ਰਤਾਪ	তেজপ্রতাপ
ਤੇਜ਼	তেজ়
ਤੇਜਾਸਵੀਰ	তেজাসবীর
ਤੇਜੀਨਦੇਰ੍ਜੀਤ	তেজীনদের্জীত
ਤੇਜੀਨਦੇਰ੍ਪਾਲ	তেজীনদের্পাল
ਤੋਤਾਸਿਂਹ	তোতাসিংহ
ਤ੍ਰਿਪਲ	ত্রিপল
ਤ੍ਰਿਲੋਚਨ	ত্রিলোচন
ਤ੍ਰੀਭਾਵਾਨ	ত্রীভাবান
ਤ੍ਰੀਸ਼ਾਨਜੋਤ	ত্রীশানজোত
ਤ੍ਰੀਸ਼ਾਨਦੀਪ	ত্রীশানদীপ
ਤ੍ਰੀਸ਼ਾਨਬੀਰ	ত্রীশানবীর
ਥਾਕੁਰਨਾਮ	থাকুরনাম
ਥਾਲਭੂਪ	থালভূপ
ਥਾਲਰਾਜ	থালরাজ
ਥੀਰਮਾਨ	থীরমান
ਥੀਰ੍ਧੀਆਨ	থীর্ধীআন
ਦਮਨਜਿਤ	দমনজিত
ਦਮਨਜੋਤ	দমনজোত
ਦਯਾਜੋਤ	দযাজোত
ਦਯਾਦੀਪ	দযাদীপ
ਦਰਮੀਨ੍ਦੇਰ	দরমীন্দের
ਦਰ੍ਪ੍ਰਿਤ	দর্প্রিত
ਦਲਜੋਧ	দলজোধ
ਦਲਬੀਨਦੇਰ	দলবীনদের
ਦਲਬੀਨ੍ਦੇਰ੍ਜਿਤ	দলবীন্দের্জিত
ਦਲਰਾਜ	দলরাজ
ਦਲੇਰ	দলের
ਦਵੀਨ੍ਦੇਰ	দবীন্দের
ਦਿਦਾਰ	দিদার
ਦਿਨਤੇਕ	দিনতেক
ਦਿਪਲੀਨ	দিপলীন
ਦਿਲਜੋਤ	দিলজোত
ਦਿਲਨਿਤ	দিলনিত
ਦਿਲਪ੍ਰਿਤ	দিলপ্রিত
ਦਿਲਮਿਤ	দিলমিত
ਦਿਲਰਿਤ	দিলরিত
ਦਿਲਸ਼ਾਨ	দিলশান
ਦਿਲਸ਼ੇਰ	দিলশের
ਦਿਵ੍ਯਜ੍ਯੋਤ	দিব্যজ্যোত
ਦੀਲਜੀਤ	দীলজীত
ਦੀਲਬਾਘ	দীলবাঘ
ਦੀਲ੍ਜਿਤ	দীল্জিত
ਦੀਵ੍ਯਜੋਤ	দীব্যজোত
ਦੇਵਜੀਤ	দেবজীত
ਦੇਵਪ੍ਰਿਤ	দেবপ্রিত
ਦੇਵਾਤ੍ਮਾ	দেবাত্মা
ਦੇਵੀਨ੍ਦੇਰ	দেবীন্দের
ਧਰਮਜ੍ਯੋਤ	ধরমজ্যোত
ਧਰਮਪਾਲ	ধরমপাল
ਧਰਮਪ੍ਰੀਤ	ধরমপ্রীত
ਧਰਮਲੀਨ	ধরমলীন
ਧੀਅਨ੍ਜੋਗ	ধীঅন্জোগ
ਨਕ੍ਸ਼ਤ੍ਰਾ	নক্শত্রা
ਨਮ੍ਰੀਤਾਬੀਰ	নম্রীতাবীর
ਨਯਨਦੀਪ	নযনদীপ
ਨਰਿਨ੍ਦਰ	নরিন্দর
ਨਰੇਨ੍ਦ੍ਰ	নরেন্দ্র
ਨਵਜੀਤ	নবজীত
ਨਵਜੀਵਨ	নবজীবন
ਨਵਦੀਪ	নবদীপ
ਨਵਬੀਰ	নববীর
ਨਵਮਿਤ	নবমিত
ਨਵ੍ਜੀਨ੍ਦੇਰ	নব্জীন্দের
ਨਾਗਂਦਰ	নাগংদর
ਨਾਨਕੀ	নানকী
ਨਾਨਵੀਰ	নানবীর
ਨਾਨ੍ਦਾਨਜਿਤ	নান্দানজিত
ਨਾਨ੍ਦਾਨਪ੍ਰਿਤ	নান্দানপ্রিত
ਨਾਮਜੀਵ	নামজীব
ਨਾਮਜੋਗ	নামজোগ
ਨਾਮਜੋਤ	নামজোত
ਨਾਮਜੋਧ	নামজোধ
ਨਾਮਧਾਰ	নামধার
ਨਾਮਧਿਯਨ	নামধিযন
ਨਾਮਧਿਰ	নামধির
ਨਾਮਨੀਰ੍ਮਾਲ	নামনীর্মাল
ਨਾਮਨੀਵਾਸ	নামনীবাস
ਨਾਮਪ੍ਰਿਤ	নামপ্রিত
ਨਾਮਪ੍ਰੇਮ	নামপ্রেম
ਨਾਮਭਾਗਤ	নামভাগত
ਨਾਮਵਿਚਾਰ	নামবিচার
ਨਾਮਸ਼ਰਣ	নামশরণ
ਨਾਮਾਂਡੋਲ਼	নামাংডোল়
ਨਾਮਾਹਾਰ	নামাহার
ਨਾਮੁਤ੍ਤਮ	নামুত্তম
ਨਾਮ੍ਰਾਤਨ	নাম্রাতন
ਨਾਮ੍ਰਿਤਾ	নাম্রিতা
ਨਾਮ੍ਰੀਤਾਜੋਤ	নাম্রীতাজোত
ਨਾਮ੍ਰੀਤਾਦੀਪ	নাম্রীতাদীপ
ਨਾਮ੍ਰੀਤਾਪ੍ਰਿਤ	নাম্রীতাপ্রিত
ਨਾਰ	নার
ਨਾਰਂਜਨ	নারংজন
ਨਾਰੀਤਪਲ	নারীতপল
ਨਾਰੀਨਦੇਰਦੀਪ	নারীনদেরদীপ
ਨਾਰੈਨ	নারৈন
ਨਾਵਿਨਜਿਤ	নাবিনজিত
ਨਾਵ੍ਕੀਰਣ	নাব্কীরণ
ਨਾਵ੍ਕੀਰਨਜੋਤ	নাব্কীরনজোত
ਨਾਵ੍ਪ੍ਰਿਤ	নাব্প্রিত
ਨਿਮਾਈ	নিমাঈ
ਨਿਰਂਜਨ	নিরংজন
ਨਿਰਂਜਨਾ	নিরংজনা
ਨਿਰ੍ਮਲਜੀਤ	নির্মলজীত
ਨਿਲਾਮਜੋਤ	নিলামজোত
ਨਿਲਾਮਪੁਲ	নিলামপুল
ਨਿਲਾਮਪ੍ਰਿਤ	নিলামপ্রিত
ਨਿਲਾਮਬੇਰ	নিলামবের
ਨਿਸ਼ਾ	নিশা
ਨਿਹ੍ਚਾਲਤੇਕ	নিহ্চালতেক
ਨਿਹ੍ਚਾਲਮਿਤ	নিহ্চালমিত
ਨੀਤਨਾਮ	নীতনাম
ਨੀਨਦੇਰ੍ਬੀਰ	নীনদের্বীর
ਨੀਮਮਾਂਪ੍ਰਿਤ	নীমমাংপ্রিত
ਨੀਮਮਾਂਰ੍ਦੀਪ	নীমমাংর্দীপ
ਨੀਮ੍ਮਾਂਰਤਾ	নীম্মাংরতা
ਨੀਮ੍ਰਤ	নীম্রত
ਨੀਰਮਾਂਲਦੀਪ	নীরমাংলদীপ
ਨੀਰਮਾਂਲਬੀਰ	নীরমাংলবীর
ਨੀਰਮੋਲ	নীরমোল
ਨੀਰਵੈਰ	নীরবৈর
ਨੀਰ੍ਭਾਉ	নীর্ভাউ
ਨੀਰ੍ਮਾਂਲਕਾਰਾਮ	নীর্মাংলকারাম
ਨੀਰ੍ਮਾਂਲਜੀਵ	নীর্মাংলজীব
ਨੀਰ੍ਮਾਂਲਜੋਤ	নীর্মাংলজোত
ਨੀਰ੍ਮਾਂਲਤੇਕ	নীর্মাংলতেক
ਨੀਰ੍ਮਾਂਲਧਾਰਾਮ	নীর্মাংলধারাম
ਨੀਰ੍ਮਾਂਲਪ੍ਰਿਤ	নীর্মাংলপ্রিত
ਨੀਸ਼ਾਨ੍ਦੀਪ	নীশান্দীপ
ਨੀਹ੍ਚਾਲ੍ਪ੍ਰੇਮ	নীহ্চাল্প্রেম
ਨੂਰਦੇਵ	নূরদেব
ਨੂਰਨਿਤ	নূরনিত
ਨੂਰਪ੍ਰਿਤ	নূরপ্রিত
ਨੇਕਨਾਮ	নেকনাম
ਨੇਕੀਨਦੇਰ	নেকীনদের
ਨੇਕ੍ਦੀਪ	নেক্দীপ
ਨੇਕ੍ਪਾਲ	নেক্পাল
ਨੇਹ੍ਚਾਲਪ੍ਰਿਤ	নেহ্চালপ্রিত
ਨੈਨਤਾਰ	নৈনতার
ਨੈਨਦੀਪ	নৈনদীপ
ਨੈਨੀਨਦੇਰ	নৈনীনদের
ਨੋਉਲਖ	নোউলখ
ਨੌਹਨੀਹਲ	নৌহনীহল
ਨ੍ਰੀਪਜੋਤ	ন্রীপজোত
ਪਤਵਂਤ	পতবংত
ਪਤਵੀਰ	পতবীর
ਪਦਾਮਜਿਤ	পদামজিত
ਪਦਾਮਪ੍ਰੇਮ	পদামপ্রেম
ਪਦ੍ਮਸ਼੍ਰੀ	পদ্মশ্রী
ਪਰਤਾਪ ; ਪਰਤਾਪ	পরতাপ ; পরতাপ
ਪਰਤਾਪੀ	পরতাপী
ਪਰਦੀਪ	পরদীপ
ਪਰਬੀਨ	পরবীন
ਪਰਮਕਮਲ਼	পরমকমল়
ਪਰਮਕਿਰਤ	পরমকিরত
ਪਰਮਗੁਨ	পরমগুন
ਪਰਮਜਾਪ	পরমজাপ
ਪਰਮਜੀਤ ; ਪਰਮਜੀਤ	পরমজীত ; পরমজীত
ਪਰਮਜੁਗਤ	পরমজুগত
ਪਰਮਜੋਗ	পরমজোগ
ਪਰਮਜੋਧ	পরমজোধ
ਪਰਮਠਾਕਰ	পরমঠাকর
ਪਰਮਤੇਕ	পরমতেক
ਪਰਮਦੀਪ	পরমদীপ
ਪਰਮਧਾਰਾਮ	পরমধারাম
ਪਰਮਧਿਰ	পরমধির
ਪਰਮਪਾਲ	পরমপাল
ਪਰਮਪ੍ਰੇਮ	পরমপ্রেম
ਪਰਮਬੋਧ	পরমবোধ
ਪਰਮਯੋਗ	পরমযোগ
ਪਰਮਰਂਗ	পরমরংগ
ਪਰਮਲੀਨ	পরমলীন
ਪਰਮਸ਼ਾਂਤ	পরমশাংত
ਪਰਮਸਿਤਾਲ	পরমসিতাল
ਪਰਮਸੁਖ	পরমসুখ
ਪਰਮਸੇਵਕ	পরমসেবক
ਪਰਮਾਧਾਰ	পরমাধার
ਪਰਮਾਰ੍ਥ	পরমার্থ
ਪਰਮਿਂਦਰ	পরমিংদর
ਪਰਮੀਤ	পরমীত
ਪਰਮ੍ਦਯਾ	পরম্দযা
ਪਰਸਂਜੀਤ	পরসংজীত
ਪਰਸ਼ੋਤਮ	পরশোতম
ਪਰਾਮਨੀਵਾਸ	পরামনীবাস
ਪਰੀਦਰ੍ਸ਼ਨ	পরীদর্শন
ਪਰ੍ਗਤ	পর্গত
ਪਰ੍ਵੀਨ੍ਦੇਰ	পর্বীন্দের
ਪਲਬੀਨਦੇਰ	পলবীনদের
ਪਲਵੀਨ੍ਦੇਰ੍ਪਾਲ	পলবীন্দের্পাল
ਪਵਾਨਜੋਤ	পবানজোত
ਪਵਾਨਦੀਪ	পবানদীপ
ਪਵਾਨਪ੍ਰਿਤ	পবানপ্রিত
ਪਵਾਨਵੀਰ	পবানবীর
ਪਵੀਤ	পবীত
ਪਾਰਂਗਤ	পারংগত
ਪੁਨੀਤ	পুনীত
ਪੁਨੀਤਪਾਲ	পুনীতপাল
ਪੁਰਾਨਪ੍ਰੇਮ	পুরানপ্রেম
ਪੁਰਾਨ੍ਜੀਤ	পুরান্জীত
ਪੁਸ਼ਪ੍ਰਿਤ	পুশপ্রিত
ਪੁਸ਼੍ਪਿਤਾ	পুশ্পিতা
ਪੂਰਨਜੀਤ	পূরনজীত
ਪ੍ਰਗਿਤ	প্রগিত
ਪ੍ਰਜਨਾ	প্রজনা
ਪ੍ਰਣਿਤ	প্রণিত
ਪ੍ਰਨੀਤਾ	প্রনীতা
ਪ੍ਰਫੂਲਦੀਪ	প্রফূলদীপ
ਪ੍ਰਭਕੀਰਤ	প্রভকীরত
ਪ੍ਰਭਕੀਰ੍ਪਾਲ	প্রভকীর্পাল
ਪ੍ਰਭਗੀਤ	প্রভগীত
ਪ੍ਰਭਚਰਣ	প্রভচরণ
ਪ੍ਰਭਚੇਤਨ	প্রভচেতন
ਪ੍ਰਭਜਿਤ	প্রভজিত
ਪ੍ਰਭਜੀਤ	প্রভজীত
ਪ੍ਰਭਜੀਵਨ	প্রভজীবন
ਪ੍ਰਭਜੋਗ	প্রভজোগ
ਪ੍ਰਭਜੋਤੇ	প্রভজোতে
ਪ੍ਰਭਜੋਧ	প্রভজোধ
ਪ੍ਰਭਤਿਰਥ	প্রভতিরথ
ਪ੍ਰਭਦਾਸ	প্রভদাস
ਪ੍ਰਭਧਿਯਨ	প্রভধিযন
ਪ੍ਰਭਧਿਰਾਜ	প্রভধিরাজ
ਪ੍ਰਭਨਾਮ	প্রভনাম
ਪ੍ਰਭਨੂਰ	প্রভনূর
ਪ੍ਰਭਪਰ੍ਵਾਨ	প্রভপর্বান
ਪ੍ਰਭਬੋਧ	প্রভবোধ
ਪ੍ਰਭਮਿਤ	প্রভমিত
ਪ੍ਰਭਮੇਹਾਰ	প্রভমেহার
ਪ੍ਰਭਲੀਨ	প্রভলীন
ਪ੍ਰਭਵਿਚਾਰ	প্রভবিচার
ਪ੍ਰਭਸਂਗਤ	প্রভসংগত
ਪ੍ਰਭਸਿਤਾਲ	প্রভসিতাল
ਪ੍ਰਭਾਤਕੀਰਣ	প্রভাতকীরণ
ਪ੍ਰਭ੍ਰਮਣ	প্রভ্রমণ
ਪ੍ਰਭ੍ਰਾਤਨ	প্রভ্রাতন
ਪ੍ਰਭ੍ਰੂਪ	প্রভ্রূপ
ਪ੍ਰਸ਼ਾਰਨਬੀਰ	প্রশারনবীর
ਪ੍ਰਿਤਮੋਹਨ	প্রিতমোহন
ਪ੍ਰਿਤੀਨ੍ਦੇਰ	প্রিতীন্দের
ਪ੍ਰਿਤ੍ਵੀਰ	প্রিত্বীর
ਪ੍ਰੀਤਪਾਲ	প্রীতপাল
ਪ੍ਰੀਤਮ੍ਹਾਰੀ	প্রীতম্হারী
ਪ੍ਰੀਤਾਮਜਿਤ	প্রীতামজিত
ਪ੍ਰੀਥਾਮ੍ਦੀਪ	প্রীথাম্দীপ
ਪ੍ਰੀਥੀਪਾਲ	প্রীথীপাল
ਪ੍ਰੀਥ੍ਵੀਪਾਲ	প্রীথ্বীপাল
ਪ੍ਰੇਮਜਿਤ	প্রেমজিত
ਪ੍ਰੇਮਤੇਕ	প্রেমতেক
ਪ੍ਰੇਮਪਾਲ	প্রেমপাল
ਪ੍ਰੇਮਬਂਸ	প্রেমবংস
ਪ੍ਰੇਮਭਾਗਤ	প্রেমভাগত
ਪ੍ਰੇਮਰਂਗ	প্রেমরংগ
ਪ੍ਰੇਮਰਮਣ	প্রেমরমণ
ਪ੍ਰੇਮਰਸ	প্রেমরস
ਪ੍ਰੇਮਲੀਨ	প্রেমলীন
ਪ੍ਰੇਮਵਾਂਤ	প্রেমবাংত
ਪ੍ਰੇਮਸੀਰੀ	প্রেমসীরী
ਪ੍ਰੇਮਸੁਖ	প্রেমসুখ
ਪ੍ਰੇਮ੍ਵੀਰ	প্রেম্বীর
ਫਕੀਰ	ফকীর
ਫਤੇਹਕਾਰਾਮ	ফতেহকারাম
ਫਤੇਹਪ੍ਰਿਤ	ফতেহপ্রিত
ਫਤੇਹਬੀਰ	ফতেহবীর
ਫਤੇਹ੍ਵਂਤ	ফতেহ্বংত
ਫਾਜਲ	ফাজল
ਫੁਲਵਂਤ	ফুলবংত
ਫੋਜੀਨਦੇਰ	ফোজীনদের
ਬਂਸਮਿਤ	বংসমিত
ਬਕ੍ਸ਼ੀ	বক্শী
ਬਚਾਨਬੀਰ	বচানবীর
ਬਚੀਨ੍ਤ	বচীন্ত
ਬਨੀਤ	বনীত
ਬਨੀਨਦੇਰ	বনীনদের
ਬਰਿਨ੍ਦ੍ਰ	বরিন্দ্র
ਬਰੀਨ੍ਦੇਰ	বরীন্দের
ਬਲਤੇਜ	বলতেজ
ਬਲਦੀਪ	বলদীপ
ਬਲਦੇਵ	বলদেব
ਬਲਮੋਹਨ	বলমোহন
ਬਲਰਾਜ	বলরাজ
ਬਲਵਿਂਦਰ	বলবিংদর
ਬਲੀਨਦੇਰ	বলীনদের
ਬਲੀਹਾਰ	বলীহার
ਬਲ੍ਵਿਨ੍ਦ੍ਰ	বল্বিন্দ্র
ਬਲ੍ਵੀਨ੍ਦੇਰ	বল্বীন্দের
ਬਹਾਦਰ	বহাদর
ਬਾਲਮਿਤ	বালমিত
ਬਿਸ਼ਨਪਾਲ	বিশনপাল
ਬਿਸ੍ਮੀਤ	বিস্মীত
ਬੀਨਦੇਰ	বীনদের
ਬੀਨਾ	বীনা
ਬੀਬੀਨਾਨਾਕੀ	বীবীনানাকী
ਬੀਮਾਂਲਜੋਤ	বীমাংলজোত
ਬੀਰੀਨਦਾਰ	বীরীনদার
ਬੀਸਮਾਧ	বীসমাধ
ਬੀਸ਼੍ਮਿਤ	বীশ্মিত
ਬੁਜੀ	বুজী
ਬੁਧ੍ਪ੍ਰਿਤ	বুধ্প্রিত
ਬੁਧ੍ਰੂਪ	বুধ্রূপ
ਬੇਂਤ	বেংত
ਬੇਨ੍ਨੀ	বেন্নী
ਬੇਬੇ	বেবে
ਬੈਰਾਗੀ	বৈরাগী
ਬ੍ਰਹਮਜੋਤ	ব্রহমজোত
ਬ੍ਰਹਾਮਲੀਨ	ব্রহামলীন
ਬ੍ਰਹਾਮ੍ਜੀਤ	ব্রহাম্জীত
ਬ੍ਰਹ੍ਮਲੀਨ	ব্রহ্মলীন
ਬ੍ਰਹ੍ਮਵੀਰ	ব্রহ্মবীর
ਬ੍ਰਿਜੇਂਦਰ	ব্রিজেংদর
ਬ੍ਰੀਜੋਧ	ব্রীজোধ
ਭਗਤ	ভগত
ਭਗਵਾਨ	ভগবান
ਭਜਨਿਕ	ভজনিক
ਭਰਪੂਰ	ভরপূর
ਭਾਘਵੀਨ੍ਦੇਰ	ভাঘবীন্দের
ਭਾਜ੍ਨਾਮ	ভাজ্নাম
ਭਾਜ੍ਨਿਤ	ভাজ্নিত
ਭਾਵਜਿਤ	ভাবজিত
ਭਾਵਜੀਨ੍ਦੇਰ	ভাবজীন্দের
ਭਾਵਨਦੀਪ	ভাবনদীপ
ਭਾਵਨੀਤ	ভাবনীত
ਭਾਵਪਾਲ	ভাবপাল
ਭਾਵਪ੍ਰੇਮ	ভাবপ্রেম
ਭਾਵਲੀਨ	ভাবলীন
ਭੀਨਦੇਰ੍ਪਾਲ	ভীনদের্পাল
ਭੁਪੀਨ੍ਦੇਰ	ভুপীন্দের
ਮਂਗਲਾ	মংগলা
ਮਂਤੇਕ	মংতেক
ਮਜਾਲ	মজাল
ਮਣਿਪਾਲ	মণিপাল
ਮਧੁਪ੍ਰਿਤ	মধুপ্রিত
ਮਧੁਰਬੀਨ	মধুরবীন
ਮਧੁਵਂਤ	মধুবংত
ਮਨਵਂਤ	মনবংত
ਮਰਦੁਲਾ	মরদুলা
ਮਸ੍ਤਪ੍ਰੇਮ	মস্তপ্রেম
ਮਸ੍ਤਾਨ	মস্তান
ਮਸ੍ਤੁਕ	মস্তুক
ਮਸ੍ਤ੍ਵੀਰ	মস্ত্বীর
ਮਹਨਬੀਰ	মহনবীর
ਮਹਾਜਿਤ	মহাজিত
ਮਹਾਨਗਿਯਨ	মহানগিযন
ਮਹਾਨਗੀਤ	মহানগীত
ਮਹਾਨਗੁਨ	মহানগুন
ਮਹਾਨਜਿਤ	মহানজিত
ਮਹਾਨਜੀਵਨ	মহানজীবন
ਮਹਾਨਜੋਤ	মহানজোত
ਮਹਾਨਤੇਕ	মহানতেক
ਮਹਾਨਤ੍ਰੀਪਾਤ	মহানত্রীপাত
ਮਹਾਨਦੀਪ	মহানদীপ
ਮਹਾਨਪਾਲ	মহানপাল
ਮਹਾਨਪ੍ਰੇਮ	মহানপ্রেম
ਮਹਾਨਭਗਤ	মহানভগত
ਮਹਿਨਦੇਰ੍ਪ੍ਰਿਤ	মহিনদের্প্রিত
ਮਹੀਨਗਾ	মহীনগা
ਮਹੀਨਦੇਰ੍ਪਾਲ	মহীনদের্পাল
ਮਹੇਕਪ੍ਰਿਤ	মহেকপ্রিত
ਮਹੇਨਦੇਰ	মহেনদের
ਮਹੇਰਬਾਨੀ	মহেরবানী
ਮਹੇਸ਼ੀਨਦੇਰ	মহেশীনদের
ਮਾਂਨਕਰਣ	মাংনকরণ
ਮਾਂਨਗਲ੍ਪ੍ਰਿਤ	মাংনগল্প্রিত
ਮਾਂਨਵਾਨ੍ਤ੍ਬੀਰ	মাংনবান্ত্বীর
ਮਾਂਨਸੀਰਤ	মাংনসীরত
ਮਾਂਨਾਵੀਨਦੇਰ	মাংনাবীনদের
ਮਾਂਨਾਸਪ੍ਰੇਮ	মাংনাসপ্রেম
ਮਾਂਨੀਨਦੇਰ੍ਬੀਰ	মাংনীনদের্বীর
ਮਾਂਨੋਹਾਰਜੋਤ	মাংনোহারজোত
ਮਾਂਨੋਹਾਰਦੀਪ	মাংনোহারদীপ
ਮਾਂਨੋਹਾਰ੍ਜੀਤ	মাংনোহার্জীত
ਮਾਂਨੋਹਾਰ੍ਪਲ	মাংনোহার্পল
ਮਾਂਨ੍ਗਲ੍ਜੀਤ	মাংন্গল্জীত
ਮਾਂਨ੍ਗਲ੍ਪ੍ਰੇਮ	মাংন্গল্প্রেম
ਮਾਂਨ੍ਸ਼ਿਤਾਲ	মাংন্শিতাল
ਮਾਦਨਬੀਰ	মাদনবীর
ਮਾਦਾਨਕੀਰ੍ਪਾਲ	মাদানকীর্পাল
ਮਾਦਾਨਪਾਲ	মাদানপাল
ਮਾਨਤੇਜ	মানতেজ
ਮਾਨਦੇਵ	মানদেব
ਮਾਨਪੁਲ	মানপুল
ਮਾਨਬੀਰ	মানবীর
ਮਾਨਰਿਤ	মানরিত
ਮਾਨਾਸਦੀਪ	মানাসদীপ
ਮਾਨ੍ਕੀਰਣ	মান্কীরণ
ਮਾਨ੍ਗਲ੍ਜੋਤ	মান্গল্জোত
ਮਾਨ੍ਪ੍ਰੀਯਾ	মান্প্রীযা
ਮਾਯ੍ਰਾਯ	মায্রায
ਮਿਤ੍ਰਾ	মিত্রা
ਮਿਤ੍ਰਾਜ	মিত্রাজ
ਮੀਰਾ	মীরা
ਮੁਕੁਂਦਾ	মুকুংদা
ਮੁਕੁਨਦ੍ਪ੍ਰਿਤ	মুকুনদ্প্রিত
ਮੁਖ੍ਤਯਾਰ	মুখ্তযার
ਮੁਦ੍ਰਾ	মুদ্রা
ਮੁਨਦੀਪ	মুনদীপ
ਮੁਨਲੇਨੇ	মুনলেনে
ਮੇਸ਼	মেশ
ਮੇਹਰ	মেহর
ਮੇਹਾਰਤੇਕ	মেহারতেক
ਮੇਹਾਰਪਲ	মেহারপল
ਮੇਹਾਰਪ੍ਰਿਤ	মেহারপ্রিত
ਮੇਹਾਰਭੂਪ	মেহারভূপ
ਮੇਹਾਰਮਿਤ	মেহারমিত
ਮੇਹੇਰ	মেহের
ਮੇਹੇਰਬਾਨੀ	মেহেরবানী
ਮੋਨੀਨ੍ਦੇਰ	মোনীন্দের
ਮੋਹਨਤੇਕ	মোহনতেক
ਮੋਹਨਮਿਤ	মোহনমিত
ਮੋਹਨਲੀਨ	মোহনলীন
ਮੋਹਨਵਂਤ	মোহনবংত
ਮੋਹਨਵੀਰ	মোহনবীর
ਮੋਹਿਨ੍ਦੇਰਪਾਲ	মোহিন্দেরপাল
ਮੋਹੇਨਪਲ	মোহেনপল
ਮੋਹੇਨਪ੍ਰਿਤ	মোহেনপ্রিত
ਯਕਿਨ	যকিন
ਯਸ਼ਜੋਤ	যশজোত
ਯਸ਼ਨੂਰ	যশনূর
ਯਸ਼ਪਾਲ	যশপাল
ਯਸ਼ਵਂਤ	যশবংত
ਯਸ਼੍ਦੀਪ	যশ্দীপ
ਯਾਤੀਨਪਾਲ	যাতীনপাল
ਯਾਦਲੀਨ	যাদলীন
ਯਾਦਵੀਰ	যাদবীর
ਯਾਦ੍ਬੀਰ	যাদ্বীর
ਯਾਸ੍ਮੀਨੇ	যাস্মীনে
ਯੁਵਰਾਨੀ	যুবরানী
ਯੋਗੇਸ਼ਪਾਲ	যোগেশপাল
ਰਂਗ ਰਮਨ	রংগ রমন
ਰਂਗਜੋਤ	রংগজোত
ਰਂਗਪ੍ਰਿਤ	রংগপ্রিত
ਰਂਗਾਤਮ	রংগাতম
ਰਂਗੀਵਨ	রংগীবন
ਰਂਜੀਤ	রংজীত
ਰਘੁਜਿਤ	রঘুজিত
ਰਘੁਬਂਸ	রঘুবংস
ਰਚਨਜਿਤ	রচনজিত
ਰਚਨਜੋਤ	রচনজোত
ਰਚ੍ਪੀਨਦੇਰ੍ਜਿਤ	রচ্পীনদের্জিত
ਰਜੀਨਦਾਰ	রজীনদার
ਰਣਦੀਪ	রণদীপ
ਰਣਬੀਰ	রণবীর
ਰਤਨ੍ਕਾਰਾਮ	রতন্কারাম
ਰਤ੍ਤਾਨਜੋਤ	রত্তানজোত
ਰਤ੍ਤਾਨਦੀਪ	রত্তানদীপ
ਰਨਗ੍ਰਤ੍ਤੀ	রনগ্রত্তী
ਰਨਪ੍ਰਿਤ	রনপ্রিত
ਰਪੀਨਦੇਰ	রপীনদের
ਰਮਚੇਤਨ	রমচেতন
ਰਮਣੀਕ	রমণীক
ਰਮਨਜਿਤ	রমনজিত
ਰਮਨਦੀਪ	রমনদীপ
ਰਮਨਿਤ	রমনিত
ਰਮਨੀਵਾਸ	রমনীবাস
ਰਮਲੀਨ	রমলীন
ਰਮਾਂਨਜੋਤ	রমাংনজোত
ਰਮਾਂਨਰੂਪ	রমাংনরূপ
ਰਮਾਂਨਸੁਖ	রমাংনসুখ
ਰਮਿਤ	রমিত
ਰਮਿਨਾਜੀਤ	রমিনাজীত
ਰਮੀਨਦੇਰ੍ਜਿਤ	রমীনদের্জিত
ਰਮੀਨਦੇਰ੍ਪਾਲ	রমীনদের্পাল
ਰਮੀਨਦੇਰ੍ਪ੍ਰਿਤ	রমীনদের্প্রিত
ਰਮੀਨਦੇਰ੍ਬੀਰ	রমীনদের্বীর
ਰਮੇਸ਼ਪਲ	রমেশপল
ਰਮੇਸ਼ਮਿਤ	রমেশমিত
ਰਵਜੋਤ	রবজোত
ਰਵਨੀਤ	রবনীত
ਰਵਿਨ੍ਦਰ	রবিন্দর
ਰਵਿਰਾਜ	রবিরাজ
ਰਵੀਦੀਪ	রবীদীপ
ਰਵੀਨਦੇਰ੍ਦੀਪ	রবীনদের্দীপ
ਰਵੀਨਦੇਰ੍ਮਿਤ	রবীনদের্মিত
ਰਸਂਜਿਤ	রসংজিত
ਰਸਂਜੋਤ	রসংজোত
ਰਸਂਮਿਤ	রসংমিত
ਰਸਗੁਨ	রসগুন
ਰਸਜੋਤ	রসজোত
ਰਸਧਾਰਮ	রসধারম
ਰਸਨਂਦ	রসনংদ
ਰਸਪ੍ਰਿਤ	রসপ্রিত
ਰਸਬੀਰ	রসবীর
ਰਸਭਾਗਤ	রসভাগত
ਰਸਮ	রসম
ਰਸਮ੍ਰਿਤ	রসম্রিত
ਰਸਲੀਨ	রসলীন
ਰਸਵਂਤ	রসবংত
ਰਸ਼ਾਨ੍ਪ੍ਰਿਤ	রশান্প্রিত
ਰਸੁਤ੍ਤਮ	রসুত্তম
ਰਹੁਲਜੀਤ	রহুলজীত
ਰਹੁਲਦੀਪ	রহুলদীপ
ਰਾਖਨਾਂ	রাখনাং
ਰਾਖਬੀਰ	রাখবীর
ਰਾਜਕਿਰਣ	রাজকিরণ
ਰਾਜਦੀਪ	রাজদীপ
ਰਾਜਨਾਰੀਨ੍ਦ	রাজনারীন্দ
ਰਾਜਪਰਾਮ	রাজপরাম
ਰਾਜਪਾਲ	রাজপাল
ਰਾਜਪ੍ਰਤਾਪ	রাজপ্রতাপ
ਰਾਜਮਂਦਰ	রাজমংদর
ਰਾਜਮਿਤ	রাজমিত
ਰਾਜਸ਼ਰਣ	রাজশরণ
ਰਾਜਸੁਖ	রাজসুখ
ਰਾਜਾਨਜਿਤ	রাজানজিত
ਰਾਜਾਨਮਿਤ	রাজানমিত
ਰਾਜਾਨ੍ਦੀਪ	রাজান্দীপ
ਰਾਤਾਨਗੀਤ	রাতানগীত
ਰਾਤਾਨਚੇਤਨ	রাতানচেতন
ਰਾਤਾਨਜੀਵਨ	রাতানজীবন
ਰਾਤਾਨਪ੍ਰਿਤ	রাতানপ্রিত
ਰਾਤਾਨਮਿਤ	রাতানমিত
ਰਾਤਾਨਵਂਤ	রাতানবংত
ਰਾਤਾਨਾਤਮ	রাতানাতম
ਰਾਮਦਾਸ	রামদাস
ਰਾਮਪਾਲ	রামপাল
ਰਾਮਰਂਗ	রামরংগ
ਰਾਮਰਤ੍ਤਨ	রামরত্তন
ਰਾਮਸੁਖ	রামসুখ
ਰਾਸਰਮਣ	রাসরমণ
ਰਾਸ਼੍ਪਲ	রাশ্পল
ਰਾਸ਼੍ਮੀਨਦੇਰ	রাশ্মীনদের
ਰਿਧਿਮਾ	রিধিমা
ਰੀਜਕ	রীজক
ਰੀਤੀਨਦੇਰ	রীতীনদের
ਰੀਪਨ੍ਜੋਤ	রীপন্জোত
ਰੀਪੁਦਮ	রীপুদম
ਰੂਂਗ / ਰਂਗ	রূংগ / রংগ
ਰੂਪਦੀਪ	রূপদীপ
ਰੂਪਦੇਵ	রূপদেব
ਰੂਪਵਂਤ	রূপবংত
ਰੇਗੇਨਦਰ	রেগেনদর
ਰੋਸ਼ਨਦੀਪ	রোশনদীপ
ਰੌਸ਼ਾਨਪ੍ਰੇਮ	রৌশানপ্রেম
ਰੌਸ਼ਾਨਬੀਰ	রৌশানবীর
ਲਕ੍ਸ਼੍ਮੀ	লক্শ্মী
ਲਖਪ੍ਰਿਤ	লখপ্রিত
ਲਖਮਿਤ	লখমিত
ਲਖਰੂਪ	লখরূপ
ਲਖਵੀਰ	লখবীর
ਲਵੇਨਿਤ	লবেনিত
ਲਾਜਵਂਤ	লাজবংত
ਲਾਵਪ੍ਰਿਤ	লাবপ্রিত
ਲਾਵਿਨਦੀਪ	লাবিনদীপ
ਲੀਵਗੀਆਨ	লীবগীআন
ਲੀਵਚਿਤ	লীবচিত
ਲੀਵਚੇਤ	লীবচেত
ਲੀਵਜੋਤ	লীবজোত
ਲੀਵਨਾਮ	লীবনাম
ਲੀਵਸ਼ਰਣ	লীবশরণ
ਲੀਵਾਵਤਰ	লীবাবতর
ਲੋਕਪਾਲ	লোকপাল
ਲੋਕਪ੍ਰਿਤ	লোকপ্রিত
ਲੋਕਰੂਪ	লোকরূপ
ਲੋਕ੍ਪ੍ਰੇਮ	লোক্প্রেম
ਲੋਵਪ੍ਰੇਮ	লোবপ্রেম
ਲੋਵੇਦੀਪ	লোবেদীপ
ਵਰੀਨਦੇਰ੍ਪਾਲ	বরীনদের্পাল
ਵਰੁਨਜਿਤ	বরুনজিত
ਵਰੁਨਦੀਪ	বরুনদীপ
ਵਸਂਤਪ੍ਰਿਤ	বসংতপ্রিত
ਵਸੁਂਧਰਾ	বসুংধরা
ਵਾਦਭਾਗ	বাদভাগ
ਵਾਮਾਂਨਜੀਤ	বামাংনজীত
ਵਾਰੀਨਦੇਰ	বারীনদের
ਵਾਸੀਮਬੀਰ	বাসীমবীর
ਵਾਹੀਦਪ੍ਰਿਤ	বাহীদপ্রিত
ਵਾਹੇਗੁਰੁ	বাহেগুরু
ਵਿਕ੍ਰਮਜੀਤ	বিক্রমজীত
ਵਿਕ੍ਰਮਜੋਤ	বিক্রমজোত
ਵਿਚਾਰ੍ਚੇਤਨ	বিচার্চেতন
ਵਿਚਾਰ੍ਦੀਪ	বিচার্দীপ
ਵਿਚਾਰ੍ਲੀਨ	বিচার্লীন
ਵਿਜਯਪ੍ਰਤਾਪ	বিজযপ্রতাপ
ਵਿਜਯਪ੍ਰਿਤ	বিজযপ্রিত
ਵਿਜੇਂਦਰ	বিজেংদর
ਵਿਨਾਯਦੀਪ	বিনাযদীপ
ਵਿਨਾਯਪੁਲ	বিনাযপুল
ਵਿਨਾਯ੍ਬਿਰ	বিনায্বির
ਵਿਮਾਂਲਜਿਤ	বিমাংলজিত
ਵਿਮਾਂਲਜੋਤ	বিমাংলজোত
ਵਿਮਾਂਲਪ੍ਰੇਮ	বিমাংলপ্রেম
ਵਿਰੀਨਦਾਰ ; ਵਿਰੀਨਦੇਰ	বিরীনদার ; বিরীনদের
ਵਿਰੀਨਦੇਰ	বিরীনদের
ਵਿਸਮਦ	বিসমদ
ਵਿਸ਼ਾਲਦੀਪ	বিশালদীপ
ਵਿਸ਼ਾਲਪ੍ਰਿਤ	বিশালপ্রিত
ਵਿਸ਼੍ਵਰ੍ਪ੍ਰਿਤ	বিশ্বর্প্রিত
ਵਿਸ਼੍ਵਾਤਮ	বিশ্বাতম
ਵਿਸਾਹ	বিসাহ
ਵੀਜਯਮਿਤ	বীজযমিত
ਵੀਰ	বীর
ਵੀਰ /ਵੀਰ	বীর /বীর
ਵੀਰਪਾਲ	বীরপাল
ਵੀਵੇਕ੍ਬੀਰ	বীবেক্বীর
ਵੀਸ੍ਰਮਣ	বীস্রমণ
ਵੇਰਾਜ	বেরাজ
ਵੈਭਵ	বৈভব
ਸਂਗਜਾਪ	সংগজাপ
ਸਂਗਤਪ੍ਰਿਤ	সংগতপ্রিত
ਸਂਗਤਰੂਪ	সংগতরূপ
ਸਂਗਤ੍ਰਸ	সংগত্রস
ਸਂਗੀਤਾ	সংগীতা
ਸਂਗ੍ਰਾਮ	সংগ্রাম
ਸਂਜੀਤ	সংজীত
ਸਂਜੋਗ	সংজোগ
ਸਂਤਕੀਰੀਨ	সংতকীরীন
ਸਂਤਪ੍ਰਕਾਸ਼	সংতপ্রকাশ
ਸਂਤਪ੍ਰੇਮ	সংতপ্রেম
ਸਂਤਬੀਰ	সংতবীর
ਸਂਤੋਖਜੀਤ	সংতোখজীত
ਸਂਤੋਖਜੋਤ	সংতোখজোত
ਸਂਤੋਖਪ੍ਰਿਤ	সংতোখপ্রিত
ਸਂਤੋਖਬੀਰ	সংতোখবীর
ਸਂਦੀਪ	সংদীপ
ਸਗਲਜੋਤ	সগলজোত
ਸਚਕਿਰਤ	সচকিরত
ਸਚਜੋਗ	সচজোগ
ਸਚਪਾਲ	সচপাল
ਸਚਪ੍ਰਧਾਨ	সচপ্রধান
ਸਚਭਾਗਤ	সচভাগত
ਸਚਮਾਨ	সচমান
ਸਚਰੂਪ	সচরূপ
ਸਚਵੀਰ	সচবীর
ਸਚਸੁਖ	সচসুখ
ਸਚਸੇਵਕ	সচসেবক
ਸਚਾਮ੍ਰਿਤ	সচাম্রিত
ਸਚ੍ਦੀਪ	সচ্দীপ
ਸਜੀਨਦੇਰ	সজীনদের
ਸਤਕਿਰਤ	সতকিরত
ਸਤਕੀਰਤ	সতকীরত
ਸਤਕੀਰ੍ਤਨ	সতকীর্তন
ਸਤਗੁਨ	সতগুন
ਸਤਗੁਰ	সতগুর
ਸਤਜੋਤ	সতজোত
ਸਤਨਾਮ	সতনাম
ਸਤਪਾਲ	সতপাল
ਸਤਪ੍ਰਕਾਸ਼	সতপ্রকাশ
ਸਤਪ੍ਰਿਤ	সতপ্রিত
ਸਤਪ੍ਰੇਮ	সতপ্রেম
ਸਤਬਚਨ	সতবচন
ਸਤਮਿਤ	সতমিত
ਸਤਰਜਿਤ	সতরজিত
ਸਤਰਾਜ	সতরাজ
ਸਤਲੀਨ	সতলীন
ਸਤਵਂਤ	সতবংত
ਸਤਸਂਗਤ	সতসংগত
ਸਤਸਂਤੋਖ	সতসংতোখ
ਸਤਸਰਂਗ	সতসরংগ
ਸਤਸੁਖ	সতসুখ
ਸਤੀਨਦੇਰ੍ਜਿਤ	সতীনদের্জিত
ਸਤ੍ਯਜਿਤ	সত্যজিত
ਸਤ੍ਯਪ੍ਰੇਮ	সত্যপ্রেম
ਸਥਿਨ੍ਦਰ	সথিন্দর
ਸਦਜੀਵਨ	সদজীবন
ਸਦਸੁਖ	সদসুখ
ਸਨਮੁਖ	সনমুখ
ਸਨਾਨਤਨ	সনানতন
ਸਪਨਦੀਪ	সপনদীপ
ਸਪਾਹੀ	সপাহী
ਸਬੂਰੀ	সবূরী
ਸਭਾਜੀਤ	সভাজীত
ਸਮਰਜੀਤ	সমরজীত
ਸਮਰਣ	সমরণ
ਸਮਰਵੀਰ	সমরবীর
ਸਮਰ੍ਥ	সমর্থ
ਸਮਾਂਰਬੀਰ	সমাংরবীর
ਸਮਾਂਰ੍ਜੋਤ	সমাংর্জোত
ਸਮਾਈ	সমাঈ
ਸਮੀਨਦੀਪ	সমীনদীপ
ਸਮੀਰ	সমীর
ਸਰਦਾਰ	সরদার
ਸਰਨਦਾਯਲ	সরনদাযল
ਸਰਨਦੀਪ	সরনদীপ
ਸਰਨਾਗਤ	সরনাগত
ਸਰਬਜੀਤ / ਸਰਬਜੀਤ	সরবজীত / সরবজীত
ਸਰਬਨੀਵਾਸ	সরবনীবাস
ਸਰਬਪ੍ਰਿਤ	সরবপ্রিত
ਸਰਬਸੁਖ	সরবসুখ
ਸਰਬੁਤ੍ਤਮ	সরবুত্তম
ਸਰਬ੍ਗਿਆਨ	সরব্গিআন
ਸਰਬ੍ਜਿਤ	সরব্জিত
ਸਰਬ੍ਦਾਯਲ	সরব্দাযল
ਸਰਬ੍ਦੀਪ	সরব্দীপ
ਸਰਬ੍ਦੇਵ	সরব্দেব
ਸਰਬ੍ਧਾਰਾਮ	সরব্ধারাম
ਸਰਲਜਿਤ	সরলজিত
ਸਰਲਬੀਰ	সরলবীর
ਸਰਾਬ੍ਰਜ	সরাব্রজ
ਸਰੂਪ	সরূপ
ਸਰੂਰ	সরূর
ਸਰ੍ਜਿਤ	সর্জিত
ਸਰ੍ਮੀਨਦੇਰ	সর্মীনদের
ਸਵਾਨਪ੍ਰਿਤ	সবানপ্রিত
ਸਵਾਰਜਦੀਪ	সবারজদীপ
ਸਵਾਰਜਬੀਰ	সবারজবীর
ਸਵਾਰਨਜੋਤ	সবারনজোত
ਸਵਾਰਨਪ੍ਰਿਤ	সবারনপ্রিত
ਸਵੀਤੀਨਦੇਰ	সবীতীনদের
ਸਵੀਤੋਜ	সবীতোজ
ਸਵੀਨਦੇਰ	সবীনদের
ਸਹੀਲਮਿਤ	সহীলমিত
ਸ਼ਯ੍ਮ੍ਸੁਨ੍ਦਾਰ	শয্ম্সুন্দার
ਸ਼ਰਨਪਾਲ	শরনপাল
ਸ਼ਰਨਬੀਰ	শরনবীর
ਸ਼ਰਨ੍ਜੀਤ੍ਕੌਰ	শরন্জীত্কৌর
ਸ਼ਾਂਤਚਿਤ	শাংতচিত
ਸ਼ਾਂਤਦੀਪ	শাংতদীপ
ਸ਼ਾਂਤਪ੍ਰਕਾਸ਼	শাংতপ্রকাশ
ਸ਼ਾਂਤਪ੍ਰਿਤ	শাংতপ্রিত
ਸ਼ਾਂਤਬੀਰ	শাংতবীর
ਸ਼ਾਂਤਲੀਨ	শাংতলীন
ਸ਼ਾਨਤ੍ਨੀਵਾਸ	শানত্নীবাস
ਸ਼ਾਬਦਚੇਤ	শাবদচেত
ਸ਼ਾਬਦਤੇਕ	শাবদতেক
ਸ਼ਾਬਦ੍ਰਾਸ	শাবদ্রাস
ਸ਼ਾਬਾਦ੍ਦੀਪ	শাবাদ্দীপ
ਸ਼ਾਲੀਨ	শালীন
ਸ਼ਾਸ਼ੀਪ੍ਰਿਤ	শাশীপ্রিত
ਸ਼ਿਵਚਰਣ	শিবচরণ
ਸ਼ਿਵ੍ਚਾਰਨ੍ਜੀਤ	শিব্চারন্জীত
ਸ਼ੁਕਾਰਿਯਨ	শুকারিযন
ਸ਼ੁਭਦੀਪ	শুভদীপ
ਸ਼ੂਰਵੀਰ	শূরবীর
ਸ਼ੇਰ	শের
ਸ਼ੇਰਪੁਲ	শেরপুল
ਸ਼ੇਰਬਹਾਦੁਰ	শেরবহাদুর
ਸ਼ੇਹ੍ਬਾਝ	শেহ্বাঝ
ਸਾਕਰਥ	সাকরথ
ਸਾਖ	সাখ
ਸਾਗਰ	সাগর
ਸਾਜ	সাজ
ਸਾਤਪੁਲ	সাতপুল
ਸਾਧਨਾਹ	সাধনাহ
ਸਾਧਿਕਾ	সাধিকা
ਸਾਬਰ	সাবর
ਸਾਰ	সার
ਸਿਂਦਾ	সিংদা
ਸਿਓਪਰਿਤ	সিওপরিত
ਸਿਤਾਲਜੀਤ	সিতালজীত
ਸਿਤਾਲਜੋਤ	সিতালজোত
ਸਿਮਰਨ	সিমরন
ਸੀਖਲ	সীখল
ਸੀਮਾਂਰ੍ਜਿਤ	সীমাংর্জিত
ਸੀਮਾਂਰ੍ਨਾਮ	সীমাংর্নাম
ਸੀਮਾਂਰ੍ਪ੍ਰਿਤ	সীমাংর্প্রিত
ਸੀਮਾਂਰ੍ਲੀਨ	সীমাংর্লীন
ਸੀਮ੍ਰਤ	সীম্রত
ਸੀਮ੍ਰਨਪਾਲ	সীম্রনপাল
ਸੀਮ੍ਰਨਪ੍ਰਿਤ	সীম্রনপ্রিত
ਸੀਮ੍ਰਨ੍ਕੌਰ	সীম্রন্কৌর
ਸੀਮ੍ਰਨ੍ਜੀਤ	সীম্রন্জীত
ਸੀਮ੍ਰੀਤਾ	সীম্রীতা
ਸੀਰਤ	সীরত
ਸੀਰੀਪ੍ਰੀਤਮ	সীরীপ্রীতম
ਸੀਰੀਵੇਦ੍ਯਾ	সীরীবেদ্যা
ਸੀਰੀਸੀਮ੍ਰਣ	সীরীসীম্রণ
ਸੀਰੀਸੇਵਾ	সীরীসেবা
ਸੁਖਚੈਨ	সুখচৈন
ਸੁਖਜੀਵਨ	সুখজীবন
ਸੁਖਜੋਤ	সুখজোত
ਸੁਖਜੋਧ	সুখজোধ
ਸੁਖਦਾਯਲ	সুখদাযল
ਸੁਖਦੀਪ	সুখদীপ
ਸੁਖਦੇਵ	সুখদেব
ਸੁਖਬੀਰ	সুখবীর
ਸੁਖਮਾਂ	সুখমাং
ਸੁਖਰੂਪ	সুখরূপ
ਸੁਖਸਿਤਾਲ	সুখসিতাল
ਸੁਖਸੀਮ੍ਰਣ	সুখসীম্রণ
ਸੁਖਾਨਂਦ	সুখানংদ
ਸੁਖਿਤ	সুখিত
ਸੁਖੀਨ	সুখীন
ਸੁਖੀਨ੍ਦੇਰ	সুখীন্দের
ਸੁਖ੍ਚਾਰਨ੍ਜੀਤ	সুখ্চারন্জীত
ਸੁਖ੍ਜਿਤ	সুখ্জিত
ਸੁਚਦੀਪ	সুচদীপ
ਸੁਚਦੇਵ	সুচদেব
ਸੁਚਮ	সুচম
ਸੁਜਨਰੂਪ	সুজনরূপ
ਸੁਜਨ੍ਬੀਰ	সুজন্বীর
ਸੁਜ੍ਜਨ	সুজ্জন
ਸੁਧਬੁਧ	সুধবুধ
ਸੁਧਸੁਰਤ	সুধসুরত
ਸੁਭਪ੍ਰਿਤ	সুভপ্রিত
ਸੁਹੇਜਦੀਪ	সুহেজদীপ
ਸੇਵਾਕਪ੍ਰਿਤ	সেবাকপ্রিত
ਸੇਵਾਕਪ੍ਰੇਮ	সেবাকপ্রেম
ਸੇਵਾਕਰਣ	সেবাকরণ
ਸੇਵਾਪ੍ਰੀਤ	সেবাপ্রীত
ਸੇਹਜ	সেহজ
ਸੇਹੇਜਬੀਰ	সেহেজবীর
ਸੈਲੇਸ਼ਦੀਪ	সৈলেশদীপ
ਸੈਹਜ	সৈহজ
ਸੈਹਾਜਨੀਵਾਸ	সৈহাজনীবাস
ਸੈਹਾਜਲੀਨ	সৈহাজলীন
ਸੈਹਾਜਾਧਾਰ	সৈহাজাধার
ਸੋਚੀ	সোচী
ਸੋਨਹਨ	সোনহন
ਸੋਭਾਵਂਤ	সোভাবংত
ਸੋਹੀਨਦੇਰ	সোহীনদের
ਸੋਹੁਨ	সোহুন
ਸ੍ਵਰ੍ਨ	স্বর্ন
ਹਕਾਮਪ੍ਰਿਤ	হকামপ্রিত
ਹਨ੍ਸ੍ਪਾਲ	হন্স্পাল
ਹਰਕਾਨ੍ਵਾਲ	হরকান্বাল
ਹਰਕੀਰਣ	হরকীরণ
ਹਰਗੀਤ	হরগীত
ਹਰਗੁਰ੍ਮਿਤ (ਮਿਤ )	হরগুর্মিত (মিত )
ਹਰਗੋਬੀਨ੍ਦ	হরগোবীন্দ
ਹਰਚਰਣ	হরচরণ
ਹਰਜਪ	হরজপ
ਹਰਜੀ	হরজী
ਹਰਜੀਤ	হরজীত
ਹਰਜੀਨ੍ਦੇਰ	হরজীন্দের
ਹਰਜੀਵ	হরজীব
ਹਰਜੁਗਤ	হরজুগত
ਹਰਜੋਗ	হরজোগ
ਹਰਜੋਧ	হরজোধ
ਹਰਜ੍ਯੋਤ	হরজ্যোত
ਹਰਤਿਰਥ	হরতিরথ
ਹਰਤੇਜ੍ਪਾਲ	হরতেজ্পাল
ਹਰਦਯਾਲ	হরদযাল
ਹਰਦਾਸ	হরদাস
ਹਰਦਿਪਾ	হরদিপা
ਹਰਦੀਪ	হরদীপ
ਹਰਧਨ	হরধন
ਹਰਨਾਮ	হরনাম
ਹਰਨਾਰਾਯਣ	হরনারাযণ
ਹਰਨਿਤ	হরনিত
ਹਰਨੀਰ੍ਮਲ	হরনীর্মল
ਹਰਨੀਹਲ	হরনীহল
ਹਰਪਰ੍ਸਨ੍ਨ	হরপর্সন্ন
ਹਰਪਾਲ	হরপাল
ਹਰਪ੍ਰੇਮ੍ਜੀਤ	হরপ্রেম্জীত
ਹਰਬਿਂਦਰ	হরবিংদর
ਹਰਬਿਰ	হরবির
ਹਰਭਗਤ	হরভগত
ਹਰਮਨਾਦ	হরমনাদ
ਹਰਮਾਂਨ੍ਦੇਰ	হরমাংন্দের
ਹਰਮੀਤ	হরমীত
ਹਰਮੀਲਨ	হরমীলন
ਹਰਮੂਰਤ	হরমূরত
ਹਰਰਾਈ	হররাঈ
ਹਰਰੂਪ	হররূপ
ਹਰਵਂਤ	হরবংত
ਹਰਵਿਨ	হরবিন
ਹਰਸ਼ਰਣ	হরশরণ
ਹਰਸਿਤਾਲ	হরসিতাল
ਹਰਸੀਮ੍ਰਣ	হরসীম্রণ
ਹਰਸੀਮ੍ਰਨ੍ਜੋਤ	হরসীম্রন্জোত
ਹਰਸੀਮ੍ਰਿਤ	হরসীম্রিত
ਹਰਸੁਖ	হরসুখ
ਹਰਾਨੂਪ	হরানূপ
ਹਰਾਮ੍ਰੀਤ	হরাম্রীত
ਹਰਿਕੀਰ੍ਤਨ	হরিকীর্তন
ਹਰਿਦਰ੍ਸ਼ਨ	হরিদর্শন
ਹਰਿਨਾਰਾਯਣ	হরিনারাযণ
ਹਰਿਪ੍ਰੀਤ	হরিপ্রীত
ਹਰੀਅਮ੍ਰਿਤ	হরীঅম্রিত
ਹਰੀਸਰੂਪ	হরীসরূপ
ਹਰੀਸੀਮਾਂਰਣ	হরীসীমাংরণ
ਹਰ੍ਕਾਰਾਨ੍ਜੀਤ	হর্কারান্জীত
ਹਰ੍ਕੀਰਨ੍ਜੀਤ	হর্কীরন্জীত
ਹਰ੍ਕੀਰਪਾਲ	হর্কীরপাল
ਹਰ੍ਜਸ	হর্জস
ਹਰ੍ਤੇਇਜ	হর্তেইজ
ਹਰ੍ਨੀਝ	হর্নীঝ
ਹਰ੍ਬਂਸ	হর্বংস
ਹਰ੍ਮਾਂਨਜਿਤ	হর্মাংনজিত
ਹਰ੍ਮਾਂਨਪਾਲ	হর্মাংনপাল
ਹਰ੍ਮੀਨ੍ਦੇਰ	হর্মীন্দের
ਹਰ੍ਮੇਂਦ੍ਰ	হর্মেংদ্র
ਹਰ੍ਸ਼ਰ੍ਧਾ	হর্শর্ধা
ਹਰ੍ਸ਼ਵਰ੍ਧਨ	হর্শবর্ধন
ਹਰ੍ਸ਼ਾਗੁਨ	হর্শাগুন
ਹਰ੍ਸਿਰਤ	হর্সিরত
ਹਸਨ	হসন
ਹਾਰਭਾਗ	হারভাগ
ਹਿਤੀਨਦੇਰ	হিতীনদের
ਹਿਤੇਨਦੇਰ	হিতেনদের
ਹਿਮ੍ਮਤ	হিম্মত
ਹਿਰੀਸ਼	হিরীশ
ਹੁਅਲੀਨਾ	হুঅলীনা
ਹੁਕੁਮਪਰਿਤ	হুকুমপরিত
ਹੂਜਓਏ	হূজওএ
ਹੇਤ	হেত
ਹੇਤਬੀਰ	হেতবীর
ਹੇਮੀਨਦੇਰ	হেমীনদের
ਹੇਯ੍ਮਾਂਨ੍ਪ੍ਰਿਤ	হেয্মাংন্প্রিত
ਹੇਰਹੋ	হেরহো
#
#
# Territory names from CLDR
ਅਸੈਂਸ਼ਨ ਟਾਪੂ	অসৈংশন টাপূ
ਅੰਡੋਰਾ	অডোরা
ਸੰਯੁਕਤ ਅਰਬ ਅਮੀਰਾਤ	সযুকত অরব অমীরাত
ਅਫ਼ਗਾਨਿਸਤਾਨ	অফ়গানিসতান
ਐਂਟੀਗੁਆ ਅਤੇ ਬਾਰਬੁਡਾ	ঐংটীগুআ অতে বারবুডা
ਅੰਗੁਇਲਾ	অগুইলা
ਅਲਬਾਨੀਆ	অলবানীআ
ਅਰਮੀਨੀਆ	অরমীনীআ
ਅੰਗੋਲਾ	অগোলা
ਅੰਟਾਰਕਟਿਕਾ	অটারকটিকা
ਅਰਜਨਟੀਨਾ	অরজনটীনা
ਅਮੈਰੀਕਨ ਸਮੋਆ	অমৈরীকন সমোআ
ਆਸਟਰੀਆ	আসটরীআ
ਆਸਟ੍ਰੇਲੀਆ	আসট্রেলীআ
ਅਰੂਬਾ	অরূবা
ਅਲੈਂਡ ਟਾਪੂ	অলৈংড টাপূ
ਅਜ਼ਰਬਾਈਜਾਨ	অজ়রবাঈজান
ਬੋਸਨੀਆ ਅਤੇ ਹਰਜ਼ੇਗੋਵੀਨਾ	বোসনীআ অতে হরজ়েগোবীনা
ਬਾਰਬਾਡੋਸ	বারবাডোস
ਬੰਗਲਾਦੇਸ਼	বগলাদেশ
ਬੈਲਜੀਅਮ	বৈলজীঅম
ਬੁਰਕੀਨਾ ਫ਼ਾਸੋ	বুরকীনা ফ়াসো
ਬੁਲਗਾਰੀਆ	বুলগারীআ
ਬਹਿਰੀਨ	বহিরীন
ਬੁਰੁੰਡੀ	বুরুডী
ਬੇਨਿਨ	বেনিন
ਸੇਂਟ ਬਾਰਥੇਲੇਮੀ	সেংট বারথেলেমী
ਬਰਮੂਡਾ	বরমূডা
ਬਰੂਨੇਈ	বরূনেঈ
ਬੋਲੀਵੀਆ	বোলীবীআ
ਕੈਰੇਬੀਆਈ ਨੀਦਰਲੈਂਡ	কৈরেবীআঈ নীদরলৈংড
ਬ੍ਰਾਜ਼ੀਲ	ব্রাজ়ীল
ਬਹਾਮਾਸ	বহামাস
ਭੂਟਾਨ	ভূটান
ਬੌਵੇਟ ਟਾਪੂ	বৌবেট টাপূ
ਬੋਟਸਵਾਨਾ	বোটসবানা
ਬੇਲਾਰੂਸ	বেলারূস
ਬੇਲੀਜ਼	বেলীজ়
ਕੈਨੇਡਾ	কৈনেডা
ਕੋਕੋਸ (ਕੀਲਿੰਗ) ਟਾਪੂ	কোকোস (কীলিগ) টাপূ
ਕਾਂਗੋ - ਕਿੰਸ਼ਾਸਾ	কাংগো - কিশাসা
ਕਾਂਗੋ ਲੋਕਤੰਤਰੀ ਗਣਰਾਜ	কাংগো লোকততরী গণরাজ
ਕੇਂਦਰੀ ਅਫ਼ਰੀਕੀ ਗਣਰਾਜ	কেংদরী অফ়রীকী গণরাজ
ਕਾਂਗੋ - ਬ੍ਰਾਜ਼ਾਵਿਲੇ	কাংগো - ব্রাজ়াবিলে
ਕਾਂਗੋ ਗਣਰਾਜ	কাংগো গণরাজ
ਸਵਿਟਜ਼ਰਲੈਂਡ	সবিটজ়রলৈংড
ਕੋਟ ਡੀਵੋਆਰ	কোট ডীবোআর
ਆਇਵਰੀ ਕੋਸਟ	আইবরী কোসট
ਕੁੱਕ ਟਾਪੂ	কুক টাপূ
ਚਿਲੀ	চিলী
ਕੈਮਰੂਨ	কৈমরূন
ਚੀਨ	চীন
ਕੋਲੰਬੀਆ	কোলবীআ
ਕਲਿੱਪਰਟਨ ਟਾਪੂ	কলিপরটন টাপূ
ਕੋਸਟਾ ਰੀਕਾ	কোসটা রীকা
ਕਿਊਬਾ	কিঊবা
ਕੇਪ ਵਰਡੇ	কেপ বরডে
ਕੁਰਾਕਾਓ	কুরাকাও
ਕ੍ਰਿਸਮਿਸ ਟਾਪੂ	ক্রিসমিস টাপূ
ਸਾਇਪ੍ਰਸ	সাইপ্রস
ਚੈਕ ਗਣਰਾਜ	চৈক গণরাজ
ਜਰਮਨੀ	জরমনী
ਡੀਇਗੋ ਗਾਰਸੀਆ	ডীইগো গারসীআ
ਜ਼ੀਬੂਤੀ	জ়ীবূতী
ਡੈਨਮਾਰਕ	ডৈনমারক
ਡੋਮੀਨਿਕਾ	ডোমীনিকা
ਡੋਮੀਨਿਕਾਈ ਗਣਰਾਜ	ডোমীনিকাঈ গণরাজ
ਅਲਜੀਰੀਆ	অলজীরীআ
ਸਿਓਟਾ ਅਤੇ ਮੇਲਿੱਲਾ	সিওটা অতে মেলিলা
ਇਕਵੇਡੋਰ	ইকবেডোর
ਇਸਟੋਨੀਆ	ইসটোনীআ
ਮਿਸਰ	মিসর
ਪੱਛਮੀ ਸਹਾਰਾ	পছমী সহারা
ਇਰੀਟ੍ਰਿਆ	ইরীট্রিআ
ਸਪੇਨ	সপেন
ਇਥੋਪੀਆ	ইথোপীআ
ਯੂਰਪੀ ਯੂਨੀਅਨ	যূরপী যূনীঅন
ਫਿਨਲੈਂਡ	ফিনলৈংড
ਫ਼ਿਜੀ	ফ়িজী
ਫ਼ਾਕਲੈਂਡ ਟਾਪੂ	ফ়াকলৈংড টাপূ
ਫ਼ਾਕਲੈਂਡ ਟਾਪੂ (ਆਈਲਾਸ ਮਾਲਵਿਨਾਸ)	ফ়াকলৈংড টাপূ (আঈলাস মালবিনাস)
ਮਾਇਕ੍ਰੋਨੇਸ਼ੀਆ	মাইক্রোনেশীআ
ਫੈਰੋ ਟਾਪੂ	ফৈরো টাপূ
ਫ਼ਰਾਂਸ	ফ়রাংস
ਗਬੋਨ	গবোন
ਯੂਨਾਈਟਡ ਕਿੰਗਡਮ	যূনাঈটড কিগডম
ਗ੍ਰੇਨਾਡਾ	গ্রেনাডা
ਜਾਰਜੀਆ	জারজীআ
ਫ਼ਰੈਂਚ ਗੁਆਨਾ	ফ়রৈংচ গুআনা
ਗਰਨਜੀ	গরনজী
ਘਾਨਾ	ঘানা
ਜਿਬਰਾਲਟਰ	জিবরালটর
ਗ੍ਰੀਨਲੈਂਡ	গ্রীনলৈংড
ਗੈਂਬੀਆ	গৈংবীআ
ਗਿਨੀ	গিনী
ਗੁਆਡੇਲੋਪ	গুআডেলোপ
ਭੂ-ਖੰਡੀ ਗਿਨੀ	ভূ-খডী গিনী
ਗ੍ਰੀਸ	গ্রীস
ਦੱਖਣੀ ਜਾਰਜੀਆ ਅਤੇ ਦੱਖਣੀ ਸੈਂਡਵਿਚ ਟਾਪੂ	দখণী জারজীআ অতে দখণী সৈংডবিচ টাপূ
ਗੁਆਟੇਮਾਲਾ	গুআটেমালা
ਗੁਆਮ	গুআম
ਗਿਨੀ-ਬਿਸਾਉ	গিনী-বিসাউ
ਗੁਯਾਨਾ	গুযানা
ਹਾਂਗ ਕਾਂਗ ਐਸਏਆਰ ਚੀਨ	হাংগ কাংগ ঐসএআর চীন
ਹਾਂਗ ਕਾਂਗ	হাংগ কাংগ
ਹਰਡ ਤੇ ਮੈਕਡੋਨਾਲਡ ਟਾਪੂ	হরড তে মৈকডোনালড টাপূ
ਹੋਂਡੁਰਸ	হোংডুরস
ਕਰੋਏਸ਼ੀਆ	করোএশীআ
ਹੈਤੀ	হৈতী
ਹੰਗਰੀ	হগরী
ਕੇਨਾਰੀ ਟਾਪੂ	কেনারী টাপূ
ਇੰਡੋਨੇਸ਼ੀਆ	ইডোনেশীআ
ਆਇਰਲੈਂਡ	আইরলৈংড
ਇਜ਼ਰਾਈਲ	ইজ়রাঈল
ਆਇਲ ਆਫ ਮੈਨ	আইল আফ মৈন
ਭਾਰਤ	ভারত
ਬਰਤਾਨਵੀ ਹਿੰਦ ਮਹਾਂਸਾਗਰ ਪ੍ਰਦੇਸ਼	বরতানবী হিদ মহাংসাগর প্রদেশ
ਇਰਾਕ	ইরাক
ਈਰਾਨ	ঈরান
ਆਈਸਲੈਂਡ	আঈসলৈংড
ਇਟਲੀ	ইটলী
ਜਰਸੀ	জরসী
ਜਮਾਇਕਾ	জমাইকা
ਜਾਰਡਨ	জারডন
ਜਪਾਨ	জপান
ਕੀਨੀਆ	কীনীআ
ਕਿਰਗਿਜ਼ਸਤਾਨ	কিরগিজ়সতান
ਕੰਬੋਡੀਆ	কবোডীআ
ਕਿਰਬਾਤੀ	কিরবাতী
ਕੋਮੋਰੋਸ	কোমোরোস
ਸੈਂਟ ਕਿਟਸ ਐਂਡ ਨੇਵਿਸ	সৈংট কিটস ঐংড নেবিস
ਉੱਤਰੀ ਕੋਰੀਆ	উতরী কোরীআ
ਦੱਖਣੀ ਕੋਰੀਆ	দখণী কোরীআ
ਕੁਵੈਤ	কুবৈত
ਕੇਮੈਨ ਟਾਪੂ	কেমৈন টাপূ
ਕਜ਼ਾਖਸਤਾਨ	কজ়াখসতান
ਲਾਓਸ	লাওস
ਲੈਬਨਾਨ	লৈবনান
ਸੇਂਟ ਲੂਸੀਆ	সেংট লূসীআ
ਲਿਚੇਂਸਟਾਇਨ	লিচেংসটাইন
ਸ੍ਰੀ ਲੰਕਾ	স্রী লকা
ਲਾਈਬੀਰੀਆ	লাঈবীরীআ
ਲੇਸੋਥੋ	লেসোথো
ਲਿਥੁਆਨੀਆ	লিথুআনীআ
ਲਕਜ਼ਮਬਰਗ	লকজ়মবরগ
ਲਾਟਵੀਆ	লাটবীআ
ਲੀਬੀਆ	লীবীআ
ਮੋਰੱਕੋ	মোরকো
ਮੋਨਾਕੋ	মোনাকো
ਮੋਲਡੋਵਾ	মোলডোবা
ਮੋਂਟੇਨੇਗਰੋ	মোংটেনেগরো
ਸੇਂਟ ਮਾਰਟਿਨ	সেংট মারটিন
ਮੈਡਾਗਾਸਕਰ	মৈডাগাসকর
ਮਾਰਸ਼ਲ ਟਾਪੂ	মারশল টাপূ
ਮੈਕਡੋਨੀਆ	মৈকডোনীআ
ਮੈਕਡੋਨੀਆ (ਪੂਰਵ ਯੂਗੋਸਲਾਵ ਮੈਕਡੋਨੀਆਈ ਗਣਰਾਜ)	মৈকডোনীআ (পূরব যূগোসলাব মৈকডোনীআঈ গণরাজ)
ਮਾਲੀ	মালী
ਮਿਆਂਮਾਰ (ਬਰਮਾ)	মিআংমার (বরমা)
ਮੰਗੋਲੀਆ	মগোলীআ
ਮਕਾਉ ਐਸਏਆਰ ਚੀਨ	মকাউ ঐসএআর চীন
ਮਕਾਉ	মকাউ
ਉੱਤਰੀ ਮਾਰੀਆਨਾ ਟਾਪੂ	উতরী মারীআনা টাপূ
ਮਾਰਟੀਨਿਕ	মারটীনিক
ਮੋਰਿਟਾਨੀਆ	মোরিটানীআ
ਮੋਂਟਸੇਰਾਤ	মোংটসেরাত
ਮਾਲਟਾ	মালটা
ਮੌਰਿਸ਼ਸ	মৌরিশস
ਮਾਲਦੀਵ	মালদীব
ਮਲਾਵੀ	মলাবী
ਮੈਕਸੀਕੋ	মৈকসীকো
ਮਲੇਸ਼ੀਆ	মলেশীআ
ਮੋਜ਼ਾਮਬੀਕ	মোজ়ামবীক
ਨਾਮੀਬੀਆ	নামীবীআ
ਨਿਊ ਕੈਲੇਡੋਨੀਆ	নিঊ কৈলেডোনীআ
ਨਾਈਜਰ	নাঈজর
ਨੋਰਫੌਕ ਟਾਪੂ	নোরফৌক টাপূ
ਨਾਈਜੀਰੀਆ	নাঈজীরীআ
ਨਿਕਾਰਾਗੁਆ	নিকারাগুআ
ਨੀਦਰਲੈਂਡ	নীদরলৈংড
ਨਾਰਵੇ	নারবে
ਨੇਪਾਲ	নেপাল
ਨਾਉਰੂ	নাউরূ
ਨਿਯੂ	নিযূ
ਨਿਊਜ਼ੀਲੈਂਡ	নিঊজ়ীলৈংড
ਓਮਾਨ	ওমান
ਪਨਾਮਾ	পনামা
ਪੇਰੂ	পেরূ
ਫਰੈਂਚ ਪੋਲੀਨੇਸ਼ੀਆ	ফরৈংচ পোলীনেশীআ
ਪਾਪੂਆ ਨਿਊ ਗਿਨੀ	পাপূআ নিঊ গিনী
ਫਿਲੀਪੀਂਸ	ফিলীপীংস
ਪਾਕਿਸਤਾਨ	পাকিসতান
ਪੋਲੈਂਡ	পোলৈংড
ਸੈਂਟ ਪੀਅਰੇ ਐਂਡ ਮਿਕੇਲਨ	সৈংট পীঅরে ঐংড মিকেলন
ਪਿਟਕੇਰਨ ਟਾਪੂ	পিটকেরন টাপূ
ਪਿਊਰਟੋ ਰਿਕੋ	পিঊরটো রিকো
ਫਿਲੀਸਤੀਨੀ ਖੇਤਰ	ফিলীসতীনী খেতর
ਫਿਲੀਸਤੀਨ	ফিলীসতীন
ਪੁਰਤਗਾਲ	পুরতগাল
ਪਲਾਉ	পলাউ
ਪੈਰਾਗਵੇ	পৈরাগবে
ਕਤਰ	কতর
ਆਊਟਲਾਇੰਗ ਓਸ਼ੀਨੀਆ	আঊটলাইগ ওশীনীআ
ਰਿਯੂਨੀਅਨ	রিযূনীঅন
ਰੋਮਾਨੀਆ	রোমানীআ
ਸਰਬੀਆ	সরবীআ
ਰੂਸ	রূস
ਰਵਾਂਡਾ	রবাংডা
ਸਾਊਦੀ ਅਰਬ	সাঊদী অরব
ਸੋਲੋਮਨ ਟਾਪੂ	সোলোমন টাপূ
ਸੇਸ਼ਲਸ	সেশলস
ਸੂਡਾਨ	সূডান
ਸਵੀਡਨ	সবীডন
ਸਿੰਗਾਪੁਰ	সিগাপুর
ਸੇਂਟ ਹੇਲੇਨਾ	সেংট হেলেনা
ਸਲੋਵੇਨੀਆ	সলোবেনীআ
ਸਵਾਲਬਰਡ ਅਤੇ ਜਾਨ ਮਾਯੇਨ	সবালবরড অতে জান মাযেন
ਸਲੋਵਾਕੀਆ	সলোবাকীআ
ਸਿਏਰਾ ਲਿਓਨ	সিএরা লিওন
ਸੈਨ ਮਰੀਨੋ	সৈন মরীনো
ਸੇਨੇਗਲ	সেনেগল
ਸੋਮਾਲੀਆ	সোমালীআ
ਸੂਰੀਨਾਮ	সূরীনাম
ਦੱਖਣੀ ਸੂਡਾਨ	দখণী সূডান
ਸਾਓ ਟੋਮ ਅਤੇ ਪ੍ਰਿੰਸੀਪੇ	সাও টোম অতে প্রিসীপে
ਅਲ ਸਲਵਾਡੋਰ	অল সলবাডোর
ਸਿੰਟ ਮਾਰਟੀਨ	সিট মারটীন
ਸੀਰੀਆ	সীরীআ
ਸਵਾਜ਼ੀਲੈਂਡ	সবাজ়ীলৈংড
ਟ੍ਰਿਸਟਾਨ ਦਾ ਕੁੰਹਾ	ট্রিসটান দা কুহা
ਟੁਰਕਸ ਅਤੇ ਕੈਕੋਸ ਟਾਪੂ	টুরকস অতে কৈকোস টাপূ
ਚਾਡ	চাড
ਫਰੈਂਚ ਦੱਖਣੀ ਪ੍ਰਦੇਸ਼	ফরৈংচ দখণী প্রদেশ
ਟੋਗੋ	টোগো
ਥਾਈਲੈਂਡ	থাঈলৈংড
ਤਾਜਿਕਿਸਤਾਨ	তাজিকিসতান
ਟੋਕੇਲਾਉ	টোকেলাউ
ਤਿਮੋਰ-ਲੇਸਤੇ	তিমোর-লেসতে
ਪੂਰਬੀ ਤਿਮੋਰ	পূরবী তিমোর
ਤੁਰਕਮੇਨਿਸਤਾਨ	তুরকমেনিসতান
ਟਿਊਨੀਸ਼ੀਆ	টিঊনীশীআ
ਟੌਂਗਾ	টৌংগা
ਤੁਰਕੀ	তুরকী
ਟ੍ਰਿਨੀਡਾਡ ਅਤੇ ਟੋਬਾਗੋ	ট্রিনীডাড অতে টোবাগো
ਟੁਵਾਲੂ	টুবালূ
ਤਾਇਵਾਨ	তাইবান
ਤਨਜ਼ਾਨੀਆ	তনজ়ানীআ
ਯੂਕਰੇਨ	যূকরেন
ਯੂਗਾਂਡਾ	যূগাংডা
ਸੰਯੁਕਤ ਰਾਜ	সযুকত রাজ
ਉਰੂਗਵੇ	উরূগবে
ਉਜ਼ਬੇਕਿਸਤਾਨ	উজ়বেকিসতান
ਵੈਟੀਕਨ ਸਿਟੀ	বৈটীকন সিটী
ਸੇਂਟ ਵਿਨਸੈਂਟ ਐਂਡ ਗ੍ਰੇਨਾਡੀਨਸ	সেংট বিনসৈংট ঐংড গ্রেনাডীনস
ਵੇਨੇਜ਼ੂਏਲਾ	বেনেজ়ূএলা
ਬ੍ਰਿਟਿਸ਼ ਵਰਜਿਨ ਟਾਪੂ	ব্রিটিশ বরজিন টাপূ
ਯੂ ਐਸ ਵਰਜਿਨ ਟਾਪੂ	যূ ঐস বরজিন টাপূ
ਵੀਅਤਨਾਮ	বীঅতনাম
ਵਾਨੂਆਟੂ	বানূআটূ
ਵਾਲਿਸ ਅਤੇ ਫੂਟੂਨਾ	বালিস অতে ফূটূনা
ਸਾਮੋਆ	সামোআ
ਕੋਸੋਵੋ	কোসোবো
ਯਮਨ	যমন
ਮਾਯੋਟੀ	মাযোটী
ਦੱਖਣੀ ਅਫਰੀਕਾ	দখণী অফরীকা
ਜ਼ਾਮਬੀਆ	জ়ামবীআ
ਜ਼ਿੰਬਾਬਵੇ	জ়িবাববে
ਅਣਪਛਾਤਾ ਖੇਤਰ	অণপছাতা খেতর
