# Baby names
ਅਂਗਦ	ଅଂଗଦ
ਅਂਗਦ ਦੇਵ	ଅଂଗଦ ଦେଵ
ਅਂਗਾਰਿਕਾ	ଅଂଗାରିକା
ਅਂਤਰਜੋਤ	ଅଂତରଜୋତ
ਅਂਤਰਪ੍ਰਿਤ	ଅଂତରପ୍ରିତ
ਅਂਤਰਾ	ଅଂତରା
ਅਕਲਤਟ	ଅକଲତଟ
ਅਕਲਰੂਪ	ଅକଲରୂପ
ਅਕਲਸ਼ਰਣ	ଅକଲଶରଣ
ਅਕਲਸੀਮਾਰ	ଅକଲସୀମାର
ਅਕਾਲਜੋਗ	ଅକାଲଜୋଗ
ਅਕਾਲਦੀਪ	ଅକାଲଦୀପ
ਅਕਾਲਪ੍ਰੀਤ	ଅକାଲପ୍ରୀତ
ਅਕਾਲਬੀਰ	ଅକାଲବୀର
ਅਗਮਜੀਤ	ଅଗମଜୀତ
ਅਗਮਜੋਤ	ଅଗମଜୋତ
ਅਗਮ੍ਪਾਲ	ଅଗମ୍ପାଲ
ਅਗਮ੍ਪ੍ਰੀਤ	ଅଗମ୍ପ୍ରୀତ
ਅਜ੍ਮੀਨ੍ਦੇਰ	ଅଜ୍ମୀନ୍ଦେର
ਅਝਾਦਬੀਰ	ଅଝାଦବୀର
ਅਝੀਝ	ଅଝୀଝ
ਅਤੀਨਦੇਰ੍ਜਿਤ	ଅତୀନଦେର୍ଜିତ
ਅਤੀਨ੍ਦੇਰ	ଅତୀନ୍ଦେର
ਅਤ੍ਤਾਮਜਿਤ	ଅତ୍ତାମଜିତ
ਅਨਂਤਦੇਵ	ଅନଂତଦେଵ
ਅਨਂਤਰ	ଅନଂତର
ਅਨਂਤਵੀਰ	ଅନଂତଵୀର
ਅਨਂਤ੍ਜੀਤ	ଅନଂତ୍ଜୀତ
ਅਨਾਹਤ	ଅନାହତ
ਅਨਿਂਦਿਤਾ	ଅନିଂଦିତା
ਅਨਿਸ਼ਾ	ଅନିଶା
ਅਨੀਲਜੋਤ	ଅନୀଲଜୋତ
ਅਨੀਸ਼੍ਕੋਉਂਰ	ଅନୀଶ୍କୋଉଂର
ਅਨੁਂਜਪਾਲ	ଅନୁଂଜପାଲ
ਅਨੁਂਪਜੋਤ	ଅନୁଂପଜୋତ
ਅਨੁਰਾਧਾ	ଅନୁରାଧା
ਅਨੁਸ਼੍ਕਾ	ଅନୁଶ୍କା
ਅਨੂਪਜੋਤ	ଅନୂପଜୋତ
ਅਨੂਪਬੀਰ	ଅନୂପବୀର
ਅਨੂਪਲੋਕ	ଅନୂପଲୋକ
ਅਪੂਰ੍ਵਾ	ଅପୂର୍ଵା
ਅਪ੍ਰੀਨਦੇਰ	ଅପ୍ରୀନଦେର
ਅਬਨੀ	ଅବନୀ
ਅਬਿਚਾਲ	ଅବିଚାଲ
ਅਬਿਨਾਸ਼	ଅବିନାଶ
ਅਭਿਜੀਤ	ଅଭିଜୀତ
ਅਭਿਰੂਪ	ଅଭିରୂପ
ਅਮਨਜੀਤ	ଅମନଜୀତ
ਅਮਰਜੋਤ	ଅମରଜୋତ
ਅਮਰਤ	ଅମରତ
ਅਮਰਿਂਦਰ	ଅମରିଂଦର
ਅਮਰਿਤ	ଅମରିତ
ਅਮਲਜੋਤ	ଅମଲଜୋତ
ਅਮਾਨਜੀਵਨ	ଅମାନଜୀଵନ
ਅਮਾਨੀਨ੍ਦੇਰ	ଅମାନୀନ୍ଦେର
ਅਮਾਨ੍ਰੂਪ	ଅମାନ୍ରୂପ
ਅਮਾਰ੍ਪਾਲ	ଅମାର୍ପାଲ
ਅਮਾਰ੍ਬੀਰ	ଅମାର୍ବୀର
ਅਮਿਕ	ଅମିକ
ਅਮਿਤ	ଅମିତ
ਅਮਿਤੋਜ	ଅମିତୋଜ
ਅਮੀਤਪਾਲ	ଅମୀତପାଲ
ਅਮੀਤ੍ਬੀਰ	ଅମୀତ୍ବୀର
ਅਮੋਲ੍ਰਸ	ଅମୋଲ୍ରସ
ਅਮ੍ਨੀਨ੍ਦੇਰ	ଅମ୍ନୀନ୍ଦେର
ਅਮ੍ਰੀਤਬਾਨ	ଅମ୍ରୀତବାନ
ਅਮ੍ਰੀਤ੍ਪ੍ਰਿਤ	ଅମ୍ରୀତ୍ପ୍ରିତ
ਅਮ੍ਰੀਤ੍ਵਾਨੀ	ଅମ୍ରୀତ୍ଵାନୀ
ਅਰਮਾਨੀ	ଅରମାନୀ
ਅਰਵਜੋਤ	ଅରଵଜୋତ
ਅਰੀਨਾਜੇਤ	ଅରୀନାଜେତ
ਅਰੀਨ੍ਦੇਰ੍ਜੀਤ	ଅରୀନ୍ଦେର୍ଜୀତ
ਅਰੁਨਜੀਤ	ଅରୁନଜୀତ
ਅਰੁਨਜੋਤ	ଅରୁନଜୋତ
ਅਰ੍ਚਨਾ	ଅର୍ଚନା
ਅਰ੍ਦਮਨ	ଅର୍ଦମନ
ਅਰ੍ਨਾਲੀਨ੍ਦੇਰ	ଅର୍ନାଲୀନ୍ଦେର
ਅਰ੍ਸ਼੍ਦੀਪ	ଅର୍ଶ୍ଦୀପ
ਅਲੋਕ੍ਪਾਲ	ଅଲୋକ୍ପାଲ
ਅਲ੍ਪਨਾ	ଅଲ୍ପନା
ਅਵਨੀਨਦੇਰ	ଅଵନୀନଦେର
ਅਵਿਰ	ଅଵିର
ਅਵ੍ਲੀਨ	ଅଵ୍ଲୀନ
ਅਸਂਖ	ଅସଂଖ
ਅਸ਼ਮਿਤ	ଅଶମିତ
ਅਸ਼ਰ੍ਨਾਮ	ଅଶର୍ନାମ
ਅਸ਼ਰ੍ਪ੍ਰੀਤ	ଅଶର୍ପ୍ରୀତ
ਅਸ਼ਰ੍ਪ੍ਰੇਮ	ଅଶର୍ପ୍ରେମ
ਅਸ਼ਰ੍ਵੀਰ	ଅଶର୍ଵୀର
ਅਸ਼ਿਮਾ	ଅଶିମା
ਅਸੀਮ	ଅସୀମ
ਅਸੀਸ	ଅସୀସ
ਅਸ੍ਨੇਹ	ଅସ୍ନେହ
ਆਖਰੀ	ଆଖରୀ
ਆਤ੍ਮਜਾ	ଆତ୍ମଜା
ਆਨਂਦਮਯੀ	ଆନଂଦମଯୀ
ਆਨਂਦਰੂਪ	ଆନଂଦରୂପ
ਆਯਕਾਰ	ଆଯକାର
ਆਯਾਤਪ੍ਰਿਤ	ଆଯାତପ୍ରିତ
ਆਯੁਸ਼੍ਮਤਿ	ଆଯୁଶ୍ମତି
ਆਰਮਾਨ	ଆରମାନ
ਆਰਾਧ	ଆରାଧ
ਆਰਾਧਨਾ	ଆରାଧନା
ਆਰ੍ਯਨ	ଆର୍ଯନ
ਇਂਦਰਬੀਰ	ଇଂଦରବୀର
ਇਂਦਿਵਰ	ଇଂଦିଵର
ਇਕਪ੍ਰਿਤ	ଇକପ୍ରିତ
ਇਕਬਾਲ	ଇକବାଲ
ਇਕਰੂਪ	ଇକରୂପ
ਇਕ੍ਪੂਜ	ଇକ୍ପୂଜ
ਇਕ੍ਮਾਨ	ଇକ୍ମାନ
ਇਚ੍ਕਜਿਤ	ଇଚ୍କଜିତ
ਇਨ੍ਦਾਰਤੇਜ	ଇନ୍ଦାରତେଜ
ਇਨ੍ਦਾਰਮਿਤ	ଇନ୍ଦାରମିତ
ਇਨ੍ਦਾਰ੍ਦੀਪ	ଇନ୍ଦାର୍ଦୀପ
ਇਨ੍ਦਾਰ੍ਪ੍ਰਿਤ	ଇନ୍ଦାର୍ପ୍ରିତ
ਇਨ੍ਦਾਰ੍ਪ੍ਰੇਮ	ଇନ୍ଦାର୍ପ୍ରେମ
ਇਨ੍ਦੇਰ	ଇନ୍ଦେର
ਇਨ੍ਦੇਰਪਲ	ଇନ୍ଦେରପଲ
ਇਨ੍ਦੇਰਮਾਨ	ଇନ୍ଦେରମାନ
ਇਨ੍ਦੇਰਹਾਰ੍ਜਿਤ	ଇନ୍ଦେରହାର୍ଜିତ
ਇਮਰਾਤ	ଇମରାତ
ਈਖ੍ਤਿਅਰ	ଈଖ୍ତିଅର
ਈਨ੍ਦਰ੍ਜੀਏਤ	ଈନ୍ଦର୍ଜୀଏତ
ਈਨ੍ਦੇਰਤੇਕ	ଈନ୍ଦେରତେକ
ਈਨ੍ਦੇਰਵੀਰ	ଈନ୍ଦେରଵୀର
ਈਬਾਦਤ	ଈବାଦତ
ਈਸ਼ਪਾਲ	ଈଶପାଲ
ਈਸ਼ਲੀਨ	ଈଶଲୀନ
ਈਸ਼ਾਰਤੇਕ	ଈଶାରତେକ
ਈਸ਼ਾਰਪਾਲ	ଈଶାରପାଲ
ਈਸ਼੍ਤ੍ਵਰ੍ਜਿਤ	ଈଶ୍ତ୍ଵର୍ଜିତ
ਈਸ਼੍ਪ੍ਰਿਤ	ଈଶ୍ପ୍ରିତ
ਈਸ਼੍ਵਾਰ੍ਜਿਤ	ଈଶ୍ଵାର୍ଜିତ
ਈਸ਼੍ਵੀਨਦੇਰ	ଈଶ୍ଵୀନଦେର
ਉਖ੍ਤਿਅਰ	ଉଖ୍ତିଅର
ਉਚਪਾਲ	ଉଚପାଲ
ਉਚਪ੍ਰਿਤ	ଉଚପ୍ରିତ
ਉਚੀਤਦੀਪ	ଉଚୀତଦୀପ
ਉਚੀਤਪ੍ਰਿਤ	ଉଚୀତପ୍ରିତ
ਉਚੀਤਬੀਰ	ଉଚୀତବୀର
ਉਚੀਤਰੂਪ	ଉଚୀତରୂପ
ਉਚੀਤਲੋਕ	ଉଚୀତଲୋକ
ਉਚੀਤਵਂਤ	ଉଚୀତଵଂତ
ਉਜਗਰ੍ਜੋਤ	ଉଜଗର୍ଜୋତ
ਉਜਗਰ੍ਦੀਪ	ଉଜଗର୍ଦୀପ
ਉਜਗਰ੍ਬੀਰ	ଉଜଗର୍ବୀର
ਉਜਾਗਰ	ଉଜାଗର
ਉਜਾਲਾ	ଉଜାଲା
ਉਜ੍ਜਲਜੋਤ	ଉଜ୍ଜଲଜୋତ
ਉਤ੍ਤਮ	ଉତ୍ତମ
ਉਤ੍ਤਮਪਾਲ	ଉତ୍ତମପାଲ
ਉਤ੍ਤਮਲੀਵ	ଉତ୍ତମଲୀଵ
ਉਤ੍ਤਾਮਕਾਰਾਮ	ଉତ୍ତାମକାରାମ
ਉਤ੍ਤਾਮਜੋਧ	ଉତ୍ତାମଜୋଧ
ਉਤ੍ਤਾਮਤਿਰਥ	ଉତ୍ତାମତିରଥ
ਉਤ੍ਤਾਮਤੇਕ	ଉତ୍ତାମତେକ
ਉਤ੍ਤਾਮਦੀਪ	ଉତ୍ତାମଦୀପ
ਉਤ੍ਤਾਮਪਦ	ଉତ୍ତାମପଦ
ਉਤ੍ਤਾਮ੍ਰਸ	ଉତ୍ତାମ୍ରସ
ਉਤ੍ਤਾਮ੍ਰੂਪ	ଉତ୍ତାମ୍ରୂପ
ਉਤ੍ਰਕ੍ਸ਼	ଉତ୍ରକ୍ଶ
ਉਦੀਤਦੀਪ	ଉଦୀତଦୀପ
ਉਦੀਤਪ੍ਰਿਤ	ଉଦୀତପ୍ରିତ
ਉਦੀਤਬੀਰ	ଉଦୀତବୀର
ਉਦੈਬੀਰ	ଉଦୈବୀର
ਉਦੈਭਗਤ	ଉଦୈଭଗତ
ਉਦ੍ਦਾਮਜੀਤ	ଉଦ୍ଦାମଜୀତ
ਉਪਕਰਮ	ଉପକରମ
ਉਪਕਿਰਤ	ଉପକିରତ
ਉਪਜਿਤ	ଉପଜିତ
ਉਪਨਿਤ	ଉପନିତ
ਉਪੀਨਦੇਰ੍ਪ੍ਰਿਤ	ଉପୀନଦେର୍ପ୍ରିତ
ਉਪੇਨ੍ਦੇਰ	ଉପେନ୍ଦେର
ਉਮੀਦ	ଉମୀଦ
ਊਤ੍ਤਮ੍ਗਿਆਨ	ଊତ୍ତମ୍ଗିଆନ
ਏਕਂਕਰ	ଏକଂକର
ਏਕਬੀਰ	ଏକବୀର
ਏਕਮ	ଏକମ
ਏਕਮਪੂਜ	ଏକମପୂଜ
ਏਕਮਬੀਰ	ଏକମବୀର
ਏਕਮ੍ਜੋਤ	ଏକମ୍ଜୋତ
ਏਕਮ੍ਰੂਪ	ଏକମ୍ରୂପ
ਏਕਾਨਪ੍ਰੀਤ	ଏକାନପ୍ରୀତ
ਏਕ੍ਕਾਮ	ଏକ୍କାମ
ਏਤੀਬਾਰ	ଏତୀବାର
ਏਤ੍ਤਲੀਨ	ଏତ୍ତଲୀନ
ਏਰਸ਼ੀਨ	ଏରଶୀନ
ਏਵੇਨਿਤ	ଏଵେନିତ
ਏਸ਼ਨਾ	ଏଶନା
ਏਸ਼੍ਵਰ	ଏଶ୍ଵର
ਓਨਕਾਰ੍ਜਿਤ	ଓନକାର୍ଜିତ
ਓਨਕਾਰ੍ਜੀਤ	ଓନକାର୍ଜୀତ
ਓਨਕਾਰ੍ਪ੍ਰਿਤ	ଓନକାର୍ପ୍ରିତ
ਓਮਪ੍ਰਿਤ	ଓମପ୍ରିତ
ਕਂਵਲ	କଂଵଲ
ਕਂਵਲਜੀਤ	କଂଵଲଜୀତ
ਕਨਵਾਰ੍ਜਾਗਤ	କନଵାର୍ଜାଗତ
ਕਨਵਾਰ੍ਜਿਤ	କନଵାର୍ଜିତ
ਕਨਵਾਰ੍ਪ੍ਰੇਮ	କନଵାର୍ପ୍ରେମ
ਕਨਵਾਲ੍ਜੋਤ	କନଵାଲ୍ଜୋତ
ਕਨਵਾਲ੍ਨੈਨ	କନଵାଲ୍ନୈନ
ਕਨਵਾਲ੍ਪਾਲ	କନଵାଲ୍ପାଲ
ਕਨਵਾਲ੍ਪ੍ਰੇਮ	କନଵାଲ୍ପ୍ରେମ
ਕਨਵਾਲ੍ਬੀਰ	କନଵାଲ୍ବୀର
ਕਨਵਾਲ੍ਰੂਪ	କନଵାଲ୍ରୂପ
ਕਨ੍ਚਨ੍ਦੀਪ	କନ୍ଚନ୍ଦୀପ
ਕਨ੍ਚਾਨ੍ਪਾਲ	କନ୍ଚାନ୍ପାଲ
ਕਨ੍ਵਾਰਪਾਲ	କନ୍ଵାରପାଲ
ਕਮਾਲ੍ਲਾ	କମାଲ୍ଲା
ਕਰਨਦੀਪ	କରନଦୀପ
ਕਰਨਪਾਲ	କରନପାଲ
ਕਰਨਪ੍ਰਿਤ	କରନପ୍ରିତ
ਕਰਨਰੂਪ	କରନରୂପ
ਕਰਮਪਲ	କରମପଲ
ਕਰਮਪੁਲ	କରମପୁଲ
ਕਰਮ੍ਜੋਤ	କରମ୍ଜୋତ
ਕਰੁਨ੍ਯਾ	କରୁନ୍ଯା
ਕਲਬੀਰ	କଲବୀର
ਕਲਾਜੋਤ	କଲାଜୋତ
ਕਲਾਪ੍ਰੇਮ	କଲାପ୍ରେମ
ਕਵਨਿਤ	କଵନିତ
ਕਵਨੀਰ	କଵନୀର
ਕਵਾਲ੍ਨਾਨ	କଵାଲ୍ନାନ
ਕਵਿਰਾਜ	କଵିରାଜ
ਕਸਮ	କସମ
ਕਾਨਵਾਲੀਨ੍ਦੇਰ	କାନଵାଲୀନ୍ଦେର
ਕਾਮਾਂਲਜੋਤ	କାମାଂଲଜୋତ
ਕਾਮਾਂਲਮਿਤ	କାମାଂଲମିତ
ਕਾਮਾਂਲਮੋਹਨ	କାମାଂଲମୋହନ
ਕਾਮਾਂਲ੍ਪਤਿ	କାମାଂଲ୍ପତି
ਕਾਰਮਨ	କାରମନ
ਕਾਵਾਲਪ੍ਰਿਤ	କାଵାଲପ୍ରିତ
ਕਿਰਣਜੀਤ	କିରଣଜୀତ
ਕਿਰਨਰੂਪ	କିରନରୂପ
ਕਿਰਨਸੁਖ	କିରନସୁଖ
ਕਿਸ਼ੇਨ	କିଶେନ
ਕੁਂਵਰਜੀਤ	କୁଂଵରଜୀତ
ਕੁਲ	କୁଲ
ਕੁਲਜੋਤ	କୁଲଜୋତ
ਕੁਲਮਿਤ	କୁଲମିତ
ਕੁਲਰਾਤਨ	କୁଲରାତନ
ਕੁਲਰੂਪ	କୁଲରୂପ
ਕੁਲਵਂਠ	କୁଲଵଂଠ
ਕੁਸ਼ਪ੍ਰਿਤ	କୁଶପ୍ରିତ
ਕੇਵਾਲਦੀਪ	କେଵାଲଦୀପ
ਕੇਵਾਲਬੀਰ	କେଵାଲବୀର
ਕੋਉਰ	କୋଉର
ਕੋਮਾਂਲਜੀਤ	କୋମାଂଲଜୀତ
ਕੋਮਾਂਲਪ੍ਰੇਮ	କୋମାଂଲପ୍ରେମ
ਕੋਮਾਲਦੀਪ	କୋମାଲଦୀପ
ਕੋਮਾਲਮਿਤ	କୋମାଲମିତ
ਕੌਰ	କୌର
ਕ੍ਰਿਸ਼੍ਦੀਪ	କ୍ରିଶ୍ଦୀପ
ਕ੍ਸ਼ਾਗਨ	କ୍ଶାଗନ
ਕ੍ਸ਼ਾਗਰ	କ୍ଶାଗର
ਕ੍ਸ਼ਿਤਿਜ	କ୍ଶିତିଜ
ਕ੍ਸ਼੍ਹੀਮ	କ୍ଶ୍ହୀମ
ਖਰਗ	ଖରଗ
ਖਾਲਾਕ੍ਵੀਰ	ଖାଲାକ୍ଵୀର
ਖੁਂਸ਼ਜੋਤ	ଖୁଂଶଜୋତ
ਖੁਸ	ଖୁସ
ਖੁਸ਼	ଖୁଶ
ਖੁਸ਼ਜੀਤ	ଖୁଶଜୀତ
ਖੇਮਵਂਤ	ଖେମଵଂତ
ਗਗਨ	ଗଗନ
ਗਗਨਜੀਵ	ଗଗନଜୀଵ
ਗਗਨਜੋਤ	ଗଗନଜୋତ
ਗਗਨਪ੍ਰਿਤ	ଗଗନପ୍ରିତ
ਗਗਨਮਿਤ	ଗଗନମିତ
ਗਤਲੀਨ	ଗତଲୀନ
ਗਤਸ਼ਰਣ	ଗତଶରଣ
ਗਤਸੀਮਾਰ	ଗତସୀମାର
ਗਰੀਨ੍ਦੇਰ	ଗରୀନ୍ଦେର
ਗਰ੍ਗੋਤ	ଗର୍ଗୋତ
ਗਾਤਨੀਵਾਸ	ଗାତନୀଵାସ
ਗਿਅਨ	ଗିଅନ
ਗੀਂਜੀਵਨ	ଗୀଂଜୀଵନ
ਗੀਂਰਾਤਨ	ଗୀଂରାତନ
ਗੀਂਲੀਨ	ଗୀଂଲୀନ
ਗੀਅਂਗੀਤ	ଗୀଅଂଗୀତ
ਗੀਅਂਚੇਤਨ	ଗୀଅଂଚେତନ
ਗੀਅਂਜੋਤ	ଗୀଅଂଜୋତ
ਗੀਅਂਪ੍ਰਿਤ	ଗୀଅଂପ୍ରିତ
ਗੀਅਂਰੂਪ	ଗୀଅଂରୂପ
ਗੀਅਨੀਨਦੇਰ	ଗୀଅନୀନଦେର
ਗੀਅਨ੍ਬੀਰ	ଗୀଅନ୍ବୀର
ਗੀਆਨਪ੍ਰਿਤ	ଗୀଆନପ୍ରିତ
ਗੀਆਨਲੀਨ	ଗୀଆନଲୀନ
ਗੀਤ	ଗୀତ
ਗੀਤਲੀਨ	ଗୀତଲୀନ
ਗੀਤੀਨਦੇਰ	ଗୀତୀନଦେର
ਗੁਣਿਤ	ଗୁଣିତ
ਗੁਨ ਦਾਤ	ଗୁନ ଦାତ
ਗੁਨਕਿਰਤ	ଗୁନକିରତ
ਗੁਨਜਸ	ଗୁନଜସ
ਗੁਨਜਿਤ	ଗୁନଜିତ
ਗੁਨਜੀਵਨ	ଗୁନଜୀଵନ
ਗੁਨਜੁਨ	ଗୁନଜୁନ
ਗੁਨਜੋਤ	ଗୁନଜୋତ
ਗੁਨਪ੍ਰਿਤ	ଗୁନପ୍ରିତ
ਗੁਨਮਿਤ	ଗୁନମିତ
ਗੁਨਰਾਜ	ଗୁନରାଜ
ਗੁਨਸ਼ਾਂਤ	ଗୁନଶାଂତ
ਗੁਨਾਤਮ	ଗୁନାତମ
ਗੁਨਿਤਪੁਲ	ଗୁନିତପୁଲ
ਗੁਨਿਤਪ੍ਰਿਤ	ଗୁନିତପ୍ରିତ
ਗੁਨ੍ਰਿਤ	ଗୁନ୍ରିତ
ਗੁਰਕਮਲ਼	ଗୁରକମଲ଼
ਗੁਰਗਿਯਨ	ଗୁରଗିଯନ
ਗੁਰਜਾਸ	ଗୁରଜାସ
ਗੁਰਜੀਵਨ	ଗୁରଜୀଵନ
ਗੁਰਜੋਗ	ଗୁରଜୋଗ
ਗੁਰਜੋਤ	ଗୁରଜୋତ
ਗੁਰਝੀਲ	ଗୁରଝୀଲ
ਗੁਰਤਰਣ	ଗୁରତରଣ
ਗੁਰਤਿਰਥ	ଗୁରତିରଥ
ਗੁਰਦਰ੍ਸ਼ਨ	ଗୁରଦର୍ଶନ
ਗੁਰਦਿਤ	ଗୁରଦିତ
ਗੁਰਦੀਤ੍ਤਾ	ଗୁରଦୀତ୍ତା
ਗੁਰਦ੍ਵੀਪ	ଗୁରଦ୍ଵୀପ
ਗੁਰਨਾਦ	ଗୁରନାଦ
ਗੁਰਨਾਮਾਸ੍ਕਾਰ	ଗୁରନାମାସ୍କାର
ਗੁਰਨੀਧ	ଗୁରନୀଧ
ਗੁਰਨੀਰ੍ਮਾਲ	ଗୁରନୀର୍ମାଲ
ਗੁਰਨੀਸ਼ਾਨ	ଗୁରନୀଶାନ
ਗੁਰਨ੍ਯਮ	ଗୁରନ୍ଯମ
ਗੁਰਪਰ੍ਵਿਨ	ଗୁରପର୍ଵିନ
ਗੁਰਪੀਨਦੇਰ	ଗୁରପୀନଦେର
ਗੁਰਪ੍ਰੀਤਮ	ଗୁରପ୍ରୀତମ
ਗੁਰਬਕ੍ਸ਼	ଗୁରବକ୍ଶ
ਗੁਰਬਲੀਹਾਰ	ଗୁରବଲୀହାର
ਗੁਰਬੀਨ੍ਦੇਰ	ଗୁରବୀନ୍ଦେର
ਗੁਰਬੀਰ	ଗୁରବୀର
ਗੁਰਭਜਨ	ଗୁରଭଜନ
ਗੁਰਭਾਗਤ	ଗୁରଭାଗତ
ਗੁਰਮਾਰ	ଗୁରମାର
ਗੁਰਮਾਹੇਰ	ଗୁରମାହେର
ਗੁਰਮੁਖ	ଗୁରମୁଖ
ਗੁਰਮੇਹਾਰ	ଗୁରମେହାର
ਗੁਰਮੈਲ	ଗୁରମୈଲ
ਗੁਰਮ੍ਰਿਤ	ଗୁରମ୍ରିତ
ਗੁਰਲੋਚਨ	ଗୁରଲୋଚନ
ਗੁਰਵਿਂਦਰ	ଗୁରଵିଂଦର
ਗੁਰਵੀਨ੍ਦੇਰ	ଗୁରଵୀନ୍ଦେର
ਗੁਰਵੀਰ	ଗୁରଵୀର
ਗੁਰਸਨ੍ਦੀਪ	ଗୁରସନ୍ଦୀପ
ਗੁਰਸ਼ਾਨ	ଗୁରଶାନ
ਗੁਰਸੁਖ	ଗୁରସୁଖ
ਗੁਰਸੇਵ	ଗୁରସେଵ
ਗੁਰਹਾਰ੍ਪਾਲ	ଗୁରହାର୍ପାଲ
ਗੁਰਿਂਦਰ	ଗୁରିଂଦର
ਗੁਰੀਨਦੇਰ੍ਪਾਲ	ଗୁରୀନଦେର୍ପାଲ
ਗੁਰੁਕਾਰ	ଗୁରୁକାର
ਗੁਰੁਗੁਲ੍ਝਾਰ	ଗୁରୁଗୁଲ୍ଝାର
ਗੁਰੁਚਰਣ	ଗୁରୁଚରଣ
ਗੁਰੁਦਰ੍ਸ਼ਨ	ଗୁରୁଦର୍ଶନ
ਗੁਰੁਦਾਸ	ଗୁରୁଦାସ
ਗੁਰੁਦੀਪ	ଗୁରୁଦୀପ
ਗੁਰੁਪ੍ਰੇਮ	ଗୁରୁପ୍ରେମ
ਗੁਰੁਬੀਰ	ଗୁରୁବୀର
ਗੁਰੁਮਾਂਨ੍ਦੀਰ	ଗୁରୁମାଂନ୍ଦୀର
ਗੁਰੁਸੀਮ੍ਰਣ	ଗୁରୁସୀମ୍ରଣ
ਗੁਰ੍ਕੀਰਣ	ଗୁର୍କୀରଣ
ਗੁਰ੍ਕੀਰਪਾਲ	ଗୁର୍କୀରପାଲ
ਗੁਰ੍ਚਾਰਾਨ੍ਜੋਤ	ଗୁର୍ଚାରାନ୍ଜୋତ
ਗੁਰ੍ਜਨਪਾਲ	ଗୁର୍ଜନପାଲ
ਗੁਰ੍ਜੁ	ଗୁର୍ଜୁ
ਗੁਰ੍ਤੇਜ	ଗୁର୍ତେଜ
ਗੁਰ੍ਨੀਵਾਝ	ଗୁର୍ନୀଵାଝ
ਗੁਰ੍ਨੂਰ	ଗୁର୍ନୂର
ਗੁਰ੍ਪ੍ਰਿਤੀ	ଗୁର୍ପ୍ରିତୀ
ਗੁਰ੍ਮੀਤ	ଗୁର୍ମୀତ
ਗੁਰ੍ਮੀਨਦੇਰ	ଗୁର୍ମୀନଦେର
ਗੁਰ੍ਮੁਖਨੀਹਲ	ଗୁର୍ମୁଖନୀହଲ
ਗੁਰ੍ਸ਼ਣ	ଗୁର୍ଶଣ
ਗੁਰ੍ਸ਼ਾਂਤ	ଗୁର୍ଶାଂତ
ਗੁਰ੍ਸ਼ੀਲ	ଗୁର୍ଶୀଲ
ਗੁਰ੍ਸਾਹੇਬ	ଗୁର୍ସାହେବ
ਗੁਲਦੀਪ	ଗୁଲଦୀପ
ਗੁਲਵਂਤ	ଗୁଲଵଂତ
ਗੁਲਸ਼ਾਨ੍ਰੂਪ	ଗୁଲଶାନ୍ରୂପ
ਗੁਲ੍ਵਾਨ੍ਤਪ੍ਰਿਤ	ଗୁଲ୍ଵାନ୍ତପ୍ରିତ
ਗੁਲ੍ਸ਼ਾਨਪ੍ਰਿਤ	ଗୁଲ୍ଶାନପ୍ରିତ
ਗੁਲ੍ਸ਼ਾਨਮਿਤ	ଗୁଲ୍ଶାନମିତ
ਗੋਪਲਪ੍ਰਿਤ	ଗୋପଲପ୍ରିତ
ਗੋਬਿਂਦ	ଗୋବିଂଦ
ਗੋਬੀਨਦੇਰ	ଗୋବୀନଦେର
ਗੋਬੀਨਦੇਰ੍ਜਿਤ	ଗୋବୀନଦେର୍ଜିତ
ਗੋਬੀਨ੍ਦਰਾਈ	ଗୋବୀନ୍ଦରାଈ
ਗੌਰਵ੍ਪ੍ਰਿਤ	ଗୌରଵ୍ପ୍ରିତ
ਘਮਾਂਨਦ੍ਜਿਤ	ଘମାଂନଦ୍ଜିତ
ਘਮਾਂਨਦ੍ਪਾਲ	ଘମାଂନଦ୍ପାଲ
ਚਂਚਲਜਿਤ	ଚଂଚଲଜିତ
ਚਂਚਲ੍ਪ੍ਰੀਤ	ଚଂଚଲ୍ପ୍ରୀତ
ਚਂਦਨ	ଚଂଦନ
ਚਂਦਨਦੀਪ	ଚଂଦନଦୀପ
ਚਮਕੌਰ	ଚମକୌର
ਚਮਨਜਿਤ	ଚମନଜିତ
ਚਮਨਪ੍ਰਿਤ	ଚମନପ୍ରିତ
ਚਮਨਰੂਪ	ଚମନରୂପ
ਚਰਨਕਾਨ੍ਵਾਲ	ଚରନକାନ୍ଵାଲ
ਚਰਨਜੋਤ /ਚਰਨਜ੍ਯੋਤ	ଚରନଜୋତ /ଚରନଜ୍ଯୋତ
ਚਰਨਪ੍ਰੇਮ	ଚରନପ୍ରେମ
ਚਾਂਦ	ଚାଂଦ
ਚਿਤਰਾਮਣ	ଚିତରାମଣ
ਚਿਤਸਰੂਪ	ଚିତସରୂପ
ਚੀਤਪ੍ਰਿਤ	ଚୀତପ୍ରିତ
ਚੇਤਨ੍ਦੀਪ	ଚେତନ୍ଦୀପ
ਜਗਜੀਤ	ଜଗଜୀତ
ਜਗਜੀਵ	ଜଗଜୀଵ
ਜਗਜੀਵਨ	ଜଗଜୀଵନ
ਜਗਤਜੀਤ	ଜଗତଜୀତ
ਜਗਤਪ੍ਰੇਮ	ଜଗତପ୍ରେମ
ਜਗਤਰਣ	ଜଗତରଣ
ਜਗਤਰੂਪ	ଜଗତରୂପ
ਜਗਨ	ଜଗନ
ਜਗਪਾਲ	ଜଗପାଲ
ਜਗਪ੍ਰਿਤ	ଜଗପ୍ରିତ
ਜਗਪ੍ਰੇਮ	ଜଗପ୍ରେମ
ਜਗਮਿਤ	ଜଗମିତ
ਜਗਮੇਹਾਰ	ଜଗମେହାର
ਜਗਮੋਹਨ	ଜଗମୋହନ
ਜਗਰਾਜ	ଜଗରାଜ
ਜਗਰੂਪ	ଜଗରୂପ
ਜਗਵੀਨ੍ਦੇਰ	ଜଗଵୀନ୍ଦେର
ਜਗਵੀਰ	ଜଗଵୀର
ਜਗੀਨਦੇਰ	ଜଗୀନଦେର
ਜਗੀਨ੍ਦੇਰਪਾਲ	ଜଗୀନ୍ଦେରପାଲ
ਜਗ੍ਵੀਰ	ଜଗ୍ଵୀର
ਜਘ੍ਰ	ଜଘ୍ର
ਜਤੀਨਦੇਰ੍ਜਿਤ	ଜତୀନଦେର୍ଜିତ
ਜਤੀਨਦੇਰ੍ਬੀਰ	ଜତୀନଦେର୍ବୀର
ਜਤੀਨਦੇਰ੍ਮਿਤ	ଜତୀନଦେର୍ମିତ
ਜਨਜਿਤ	ଜନଜିତ
ਜਨਜੋਤ	ଜନଜୋତ
ਜਨਪ੍ਰਿਤ	ଜନପ୍ରିତ
ਜਨਰਾਜ	ଜନରାଜ
ਜਨਿਸ਼	ଜନିଶ
ਜਪਜਿਤ	ଜପଜିତ
ਜਪਧਾਰਾਮ	ଜପଧାରାମ
ਜਪਧਿਰ	ଜପଧିର
ਜਪਨਾਮ	ଜପନାମ
ਜਪਸ਼ੇਰ	ଜପଶେର
ਜਪੁਜੀ	ଜପୁଜୀ
ਜਬਰਜਂਗ	ଜବରଜଂଗ
ਜਮੀਲ	ଜମୀଲ
ਜਯਂਸ਼	ଜଯଂଶ
ਜਯਪਾਲ	ଜଯପାଲ
ਜਰ੍ਨੈਲ	ଜର୍ନୈଲ
ਜਲਿਨ੍ਦ੍ਰ	ଜଲିନ୍ଦ୍ର
ਜਲ੍ਬੀਰ	ଜଲ୍ବୀର
ਜਸਂਜੋਤ	ଜସଂଜୋତ
ਜਸਂਪਾਲ	ଜସଂପାଲ
ਜਸਂਮਿਤ	ଜସଂମିତ
ਜਸਕੀਰਣ	ଜସକୀରଣ
ਜਸਗੁਰ੍ਕੀਰ੍ਤਤ	ଜସଗୁର୍କୀର୍ତତ
ਜਸਜੀਨ੍ਦੇਰ	ଜସଜୀନ୍ଦେର
ਜਸਜੀਵਨ	ଜସଜୀଵନ
ਜਸਜੋਤ	ଜସଜୋତ
ਜਸਤਰਣ	ଜସତରଣ
ਜਸਨਾਮ	ଜସନାମ
ਜਸਪਾਲ (ਪੁਲ )	ଜସପାଲ (ପୁଲ )
ਜਸਬੀਰ	ଜସବୀର
ਜਸਭੂਪ	ଜସଭୂପ
ਜਸਮਿਂਦਰ	ଜସମିଂଦର
ਜਸਮੋਹਨ	ଜସମୋହନ
ਜਸਰੂਪ	ଜସରୂପ
ਜਸ੍ਕਰਣ	ଜସ୍କରଣ
ਜਸ੍ਕੀਰਿਤ	ଜସ୍କୀରିତ
ਜਸ੍ਕੀਰ੍ਪਲ	ଜସ୍କୀର୍ପଲ
ਜਸ੍ਗੁਨ	ଜସ୍ଗୁନ
ਜਸ੍ਮਿਤ	ଜସ୍ମିତ
ਜਸ੍ਮੀਨਪ੍ਰਿਤ	ଜସ୍ମୀନପ୍ରିତ
ਜਸ੍ਰਜਪ੍ਰਿਤ	ଜସ୍ରଜପ୍ରିତ
ਜਸ੍ਸੀ	ଜସ୍ସୀ
ਜਾਗ	ଜାଗ
ਜਾਗਰੀਤ	ଜାଗରୀତ
ਜਾਤਵਂਤ	ଜାତଵଂତ
ਜਾਤਿਨਦੇਰ੍ਦੀਪ	ଜାତିନଦେର୍ଦୀପ
ਜਾਨਾਕਪ੍ਰਿਤ	ଜାନାକପ୍ରିତ
ਜਾਪਮਾਨ	ଜାପମାନ
ਜਾਸਨਿਤ	ଜାସନିତ
ਜਾਸ਼ਾਨਪ੍ਰਿਤ	ଜାଶାନପ୍ରିତ
ਜਾਸ੍ਮੀਲ	ଜାସ୍ମୀଲ
ਜੀਵਨਦੀਪ ; ਜੀਵਨਦੀਪ ; ਜੀਵਨਦੀਪ	ଜୀଵନଦୀପ ; ଜୀଵନଦୀପ ; ଜୀଵନଦୀପ
ਜੀਵਨਪਲ	ଜୀଵନପଲ
ਜੀਵਨਪ੍ਰਿਤ	ଜୀଵନପ୍ରିତ
ਜੀਵਾਨਬੀਰ	ଜୀଵାନବୀର
ਜੁਗਦ	ଜୁଗଦ
ਜੁਪੀਨਦੇਰਦੀਪ	ଜୁପୀନଦେରଦୀପ
ਜੁਪੀਨਦੇਰ੍ਬੀਰ	ଜୁପୀନଦେର୍ବୀର
ਜੁਸਜਿਤ	ଜୁସଜିତ
ਜੁਸਪੁਲ	ଜୁସପୁଲ
ਜੁਸਮੈਲ	ଜୁସମୈଲ
ਜੇਬਾ	ଜେବା
ਜੇਸਪਾਲ	ଜେସପାଲ
ਜੈਕਾਰ	ଜୈକାର
ਜੈਪ੍ਰਜ	ଜୈପ୍ରଜ
ਜੈਪ੍ਰਤਨ	ଜୈପ୍ରତନ
ਜੈਬੀਰ	ଜୈବୀର
ਜੈਸਂਗਤ	ଜୈସଂଗତ
ਜੈਸੁਖਬੀਰ	ଜୈସୁଖବୀର
ਜੋਗਧੀਆਨ	ଜୋଗଧୀଆନ
ਜੋਗਪ੍ਰਕਾਸ਼	ଜୋଗପ୍ରକାଶ
ਜੋਗੀਨਦੇਰ੍ਬੀਰ	ଜୋଗୀନଦେର୍ବୀର
ਜੋਗੀਨਦੇਰ੍ਮਿਤ	ଜୋଗୀନଦେର୍ମିତ
ਜੋਗੇਨਦੇਰ	ଜୋଗେନଦେର
ਜੋਤਪ੍ਰਕਾਸ਼	ଜୋତପ୍ରକାଶ
ਜੋਬਨਰੂਪ	ଜୋବନରୂପ
ਜੋਹਾਰ	ଜୋହାର
ਜ੍ਞਾਨਜਿਤ	ଜ୍ଞାନଜିତ
ਜ੍ਞਾਨਜੋਤ	ଜ୍ଞାନଜୋତ
ਜ੍ਞਾਨਪ੍ਰਿਤ	ଜ୍ଞାନପ୍ରିତ
ਜ੍ਞਾਨਰੂਪ	ଜ୍ଞାନରୂପ
ਜ੍ਞਾਨਵੀਰ	ଜ୍ଞାନଵୀର
ਜ੍ਞਾਨੇਨ੍ਦੇਰ	ଜ୍ଞାନେନ୍ଦେର
ਜ੍ਹਮਕ	ଜ୍ହମକ
ਜ੍ਹਾਗਰ	ଜ୍ହାଗର
ਝਈਤੂਨ	ଝଈତୂନ
ਝਹਾਗਨ	ଝହାଗନ
ਝਾਮੀਨਾਹ	ଝାମୀନାହ
ਝੀਤੁਨ	ଝୀତୁନ
ਝੀਲ	ଝୀଲ
ਝੁਲਾਖਾ	ଝୁଲାଖା
ਝੁਲ੍ਫਾ	ଝୁଲ୍ଫା
ਝੇਬਵਂਤ	ଝେବଵଂତ
ਝੋਰਾਵਾਰ	ଝୋରାଵାର
ਟੇਇਜਿਨ੍ਦੇਰ	ଟେଇଜିନ୍ଦେର
ਤਕਦੀਰ	ତକଦୀର
ਤਖਤ	ତଖତ
ਤਤਜੋਗ	ତତଜୋଗ
ਤਤਬੀਰ	ତତବୀର
ਤਤਵਿਚਾਰ	ତତଵିଚାର
ਤਤ੍ਰਾਤਨ	ତତ୍ରାତନ
ਤਦਬੀਰ	ତଦବୀର
ਤਨਦੀਪ	ତନଦୀପ
ਤਨਵੀਰ	ତନଵୀର
ਤਮਨ੍ਪ੍ਰਿਤ	ତମନ୍ପ୍ରିତ
ਤਰਣਵੀਰ	ତରଣଵୀର
ਤਰਲੋਚਨ	ତରଲୋଚନ
ਤਰਸੇਮ	ତରସେମ
ਤਰੁਨਜਿਤ	ତରୁନଜିତ
ਤਲਵਿਨ	ତଲଵିନ
ਤਾਜਦਾਰ	ତାଜଦାର
ਤਾਜੀਨਦੇਰ੍ਦੀਪ	ତାଜୀନଦେର୍ଦୀପ
ਤਾਜੀਨਦੇਰ੍ਪ੍ਰੇਮ	ତାଜୀନଦେର୍ପ୍ରେମ
ਤਾਨੁਪ੍ਰਿਤ	ତାନୁପ୍ରିତ
ਤਾਪਨਪਾਲ	ତାପନପାଲ
ਤੀਰਨ /ਤਿਹ੍ਰਣ /ਤੇਯ੍ਰੁਣ	ତୀରନ /ତିହ୍ରଣ /ତେଯ୍ରୁଣ
ਤੀਰਾਥ੍ਰਾਮ	ତୀରାଥ୍ରାମ
ਤੁਵਿਜਾਤ	ତୁଵିଜାତ
ਤੇਕਜੀਤ	ତେକଜୀତ
ਤੇਕਦੀਪ	ତେକଦୀପ
ਤੇਕਪ੍ਰਿਤ	ତେକପ୍ରିତ
ਤੇਕ੍ਪਾਲ	ତେକ୍ପାଲ
ਤੇਘਬਹਾਦੁਰ	ତେଘବହାଦୁର
ਤੇਜਧਾਰਾਮ	ତେଜଧାରାମ
ਤੇਜਨਾਮ	ତେଜନାମ
ਤੇਜਪ੍ਰਤਾਪ	ତେଜପ୍ରତାପ
ਤੇਜ਼	ତେଜ଼
ਤੇਜਾਸਵੀਰ	ତେଜାସଵୀର
ਤੇਜੀਨਦੇਰ੍ਜੀਤ	ତେଜୀନଦେର୍ଜୀତ
ਤੇਜੀਨਦੇਰ੍ਪਾਲ	ତେଜୀନଦେର୍ପାଲ
ਤੋਤਾਸਿਂਹ	ତୋତାସିଂହ
ਤ੍ਰਿਪਲ	ତ୍ରିପଲ
ਤ੍ਰਿਲੋਚਨ	ତ୍ରିଲୋଚନ
ਤ੍ਰੀਭਾਵਾਨ	ତ୍ରୀଭାଵାନ
ਤ੍ਰੀਸ਼ਾਨਜੋਤ	ତ୍ରୀଶାନଜୋତ
ਤ੍ਰੀਸ਼ਾਨਦੀਪ	ତ୍ରୀଶାନଦୀପ
ਤ੍ਰੀਸ਼ਾਨਬੀਰ	ତ୍ରୀଶାନବୀର
ਥਾਕੁਰਨਾਮ	ଥାକୁରନାମ
ਥਾਲਭੂਪ	ଥାଲଭୂପ
ਥਾਲਰਾਜ	ଥାଲରାଜ
ਥੀਰਮਾਨ	ଥୀରମାନ
ਥੀਰ੍ਧੀਆਨ	ଥୀର୍ଧୀଆନ
ਦਮਨਜਿਤ	ଦମନଜିତ
ਦਮਨਜੋਤ	ଦମନଜୋତ
ਦਯਾਜੋਤ	ଦଯାଜୋତ
ਦਯਾਦੀਪ	ଦଯାଦୀପ
ਦਰਮੀਨ੍ਦੇਰ	ଦରମୀନ୍ଦେର
ਦਰ੍ਪ੍ਰਿਤ	ଦର୍ପ୍ରିତ
ਦਲਜੋਧ	ଦଲଜୋଧ
ਦਲਬੀਨਦੇਰ	ଦଲବୀନଦେର
ਦਲਬੀਨ੍ਦੇਰ੍ਜਿਤ	ଦଲବୀନ୍ଦେର୍ଜିତ
ਦਲਰਾਜ	ଦଲରାଜ
ਦਲੇਰ	ଦଲେର
ਦਵੀਨ੍ਦੇਰ	ଦଵୀନ୍ଦେର
ਦਿਦਾਰ	ଦିଦାର
ਦਿਨਤੇਕ	ଦିନତେକ
ਦਿਪਲੀਨ	ଦିପଲୀନ
ਦਿਲਜੋਤ	ଦିଲଜୋତ
ਦਿਲਨਿਤ	ଦିଲନିତ
ਦਿਲਪ੍ਰਿਤ	ଦିଲପ୍ରିତ
ਦਿਲਮਿਤ	ଦିଲମିତ
ਦਿਲਰਿਤ	ଦିଲରିତ
ਦਿਲਸ਼ਾਨ	ଦିଲଶାନ
ਦਿਲਸ਼ੇਰ	ଦିଲଶେର
ਦਿਵ੍ਯਜ੍ਯੋਤ	ଦିଵ୍ଯଜ୍ଯୋତ
ਦੀਲਜੀਤ	ଦୀଲଜୀତ
ਦੀਲਬਾਘ	ଦୀଲବାଘ
ਦੀਲ੍ਜਿਤ	ଦୀଲ୍ଜିତ
ਦੀਵ੍ਯਜੋਤ	ଦୀଵ୍ଯଜୋତ
ਦੇਵਜੀਤ	ଦେଵଜୀତ
ਦੇਵਪ੍ਰਿਤ	ଦେଵପ୍ରିତ
ਦੇਵਾਤ੍ਮਾ	ଦେଵାତ୍ମା
ਦੇਵੀਨ੍ਦੇਰ	ଦେଵୀନ୍ଦେର
ਧਰਮਜ੍ਯੋਤ	ଧରମଜ୍ଯୋତ
ਧਰਮਪਾਲ	ଧରମପାଲ
ਧਰਮਪ੍ਰੀਤ	ଧରମପ୍ରୀତ
ਧਰਮਲੀਨ	ଧରମଲୀନ
ਧੀਅਨ੍ਜੋਗ	ଧୀଅନ୍ଜୋଗ
ਨਕ੍ਸ਼ਤ੍ਰਾ	ନକ୍ଶତ୍ରା
ਨਮ੍ਰੀਤਾਬੀਰ	ନମ୍ରୀତାବୀର
ਨਯਨਦੀਪ	ନଯନଦୀପ
ਨਰਿਨ੍ਦਰ	ନରିନ୍ଦର
ਨਰੇਨ੍ਦ੍ਰ	ନରେନ୍ଦ୍ର
ਨਵਜੀਤ	ନଵଜୀତ
ਨਵਜੀਵਨ	ନଵଜୀଵନ
ਨਵਦੀਪ	ନଵଦୀପ
ਨਵਬੀਰ	ନଵବୀର
ਨਵਮਿਤ	ନଵମିତ
ਨਵ੍ਜੀਨ੍ਦੇਰ	ନଵ୍ଜୀନ୍ଦେର
ਨਾਗਂਦਰ	ନାଗଂଦର
ਨਾਨਕੀ	ନାନକୀ
ਨਾਨਵੀਰ	ନାନଵୀର
ਨਾਨ੍ਦਾਨਜਿਤ	ନାନ୍ଦାନଜିତ
ਨਾਨ੍ਦਾਨਪ੍ਰਿਤ	ନାନ୍ଦାନପ୍ରିତ
ਨਾਮਜੀਵ	ନାମଜୀଵ
ਨਾਮਜੋਗ	ନାମଜୋଗ
ਨਾਮਜੋਤ	ନାମଜୋତ
ਨਾਮਜੋਧ	ନାମଜୋଧ
ਨਾਮਧਾਰ	ନାମଧାର
ਨਾਮਧਿਯਨ	ନାମଧିଯନ
ਨਾਮਧਿਰ	ନାମଧିର
ਨਾਮਨੀਰ੍ਮਾਲ	ନାମନୀର୍ମାଲ
ਨਾਮਨੀਵਾਸ	ନାମନୀଵାସ
ਨਾਮਪ੍ਰਿਤ	ନାମପ୍ରିତ
ਨਾਮਪ੍ਰੇਮ	ନାମପ୍ରେମ
ਨਾਮਭਾਗਤ	ନାମଭାଗତ
ਨਾਮਵਿਚਾਰ	ନାମଵିଚାର
ਨਾਮਸ਼ਰਣ	ନାମଶରଣ
ਨਾਮਾਂਡੋਲ਼	ନାମାଂଡୋଲ଼
ਨਾਮਾਹਾਰ	ନାମାହାର
ਨਾਮੁਤ੍ਤਮ	ନାମୁତ୍ତମ
ਨਾਮ੍ਰਾਤਨ	ନାମ୍ରାତନ
ਨਾਮ੍ਰਿਤਾ	ନାମ୍ରିତା
ਨਾਮ੍ਰੀਤਾਜੋਤ	ନାମ୍ରୀତାଜୋତ
ਨਾਮ੍ਰੀਤਾਦੀਪ	ନାମ୍ରୀତାଦୀପ
ਨਾਮ੍ਰੀਤਾਪ੍ਰਿਤ	ନାମ୍ରୀତାପ୍ରିତ
ਨਾਰ	ନାର
ਨਾਰਂਜਨ	ନାରଂଜନ
ਨਾਰੀਤਪਲ	ନାରୀତପଲ
ਨਾਰੀਨਦੇਰਦੀਪ	ନାରୀନଦେରଦୀପ
ਨਾਰੈਨ	ନାରୈନ
ਨਾਵਿਨਜਿਤ	ନାଵିନଜିତ
ਨਾਵ੍ਕੀਰਣ	ନାଵ୍କୀରଣ
ਨਾਵ੍ਕੀਰਨਜੋਤ	ନାଵ୍କୀରନଜୋତ
ਨਾਵ੍ਪ੍ਰਿਤ	ନାଵ୍ପ୍ରିତ
ਨਿਮਾਈ	ନିମାଈ
ਨਿਰਂਜਨ	ନିରଂଜନ
ਨਿਰਂਜਨਾ	ନିରଂଜନା
ਨਿਰ੍ਮਲਜੀਤ	ନିର୍ମଲଜୀତ
ਨਿਲਾਮਜੋਤ	ନିଲାମଜୋତ
ਨਿਲਾਮਪੁਲ	ନିଲାମପୁଲ
ਨਿਲਾਮਪ੍ਰਿਤ	ନିଲାମପ୍ରିତ
ਨਿਲਾਮਬੇਰ	ନିଲାମବେର
ਨਿਸ਼ਾ	ନିଶା
ਨਿਹ੍ਚਾਲਤੇਕ	ନିହ୍ଚାଲତେକ
ਨਿਹ੍ਚਾਲਮਿਤ	ନିହ୍ଚାଲମିତ
ਨੀਤਨਾਮ	ନୀତନାମ
ਨੀਨਦੇਰ੍ਬੀਰ	ନୀନଦେର୍ବୀର
ਨੀਮਮਾਂਪ੍ਰਿਤ	ନୀମମାଂପ୍ରିତ
ਨੀਮਮਾਂਰ੍ਦੀਪ	ନୀମମାଂର୍ଦୀପ
ਨੀਮ੍ਮਾਂਰਤਾ	ନୀମ୍ମାଂରତା
ਨੀਮ੍ਰਤ	ନୀମ୍ରତ
ਨੀਰਮਾਂਲਦੀਪ	ନୀରମାଂଲଦୀପ
ਨੀਰਮਾਂਲਬੀਰ	ନୀରମାଂଲବୀର
ਨੀਰਮੋਲ	ନୀରମୋଲ
ਨੀਰਵੈਰ	ନୀରଵୈର
ਨੀਰ੍ਭਾਉ	ନୀର୍ଭାଉ
ਨੀਰ੍ਮਾਂਲਕਾਰਾਮ	ନୀର୍ମାଂଲକାରାମ
ਨੀਰ੍ਮਾਂਲਜੀਵ	ନୀର୍ମାଂଲଜୀଵ
ਨੀਰ੍ਮਾਂਲਜੋਤ	ନୀର୍ମାଂଲଜୋତ
ਨੀਰ੍ਮਾਂਲਤੇਕ	ନୀର୍ମାଂଲତେକ
ਨੀਰ੍ਮਾਂਲਧਾਰਾਮ	ନୀର୍ମାଂଲଧାରାମ
ਨੀਰ੍ਮਾਂਲਪ੍ਰਿਤ	ନୀର୍ମାଂଲପ୍ରିତ
ਨੀਸ਼ਾਨ੍ਦੀਪ	ନୀଶାନ୍ଦୀପ
ਨੀਹ੍ਚਾਲ੍ਪ੍ਰੇਮ	ନୀହ୍ଚାଲ୍ପ୍ରେମ
ਨੂਰਦੇਵ	ନୂରଦେଵ
ਨੂਰਨਿਤ	ନୂରନିତ
ਨੂਰਪ੍ਰਿਤ	ନୂରପ୍ରିତ
ਨੇਕਨਾਮ	ନେକନାମ
ਨੇਕੀਨਦੇਰ	ନେକୀନଦେର
ਨੇਕ੍ਦੀਪ	ନେକ୍ଦୀପ
ਨੇਕ੍ਪਾਲ	ନେକ୍ପାଲ
ਨੇਹ੍ਚਾਲਪ੍ਰਿਤ	ନେହ୍ଚାଲପ୍ରିତ
ਨੈਨਤਾਰ	ନୈନତାର
ਨੈਨਦੀਪ	ନୈନଦୀପ
ਨੈਨੀਨਦੇਰ	ନୈନୀନଦେର
ਨੋਉਲਖ	ନୋଉଲଖ
ਨੌਹਨੀਹਲ	ନୌହନୀହଲ
ਨ੍ਰੀਪਜੋਤ	ନ୍ରୀପଜୋତ
ਪਤਵਂਤ	ପତଵଂତ
ਪਤਵੀਰ	ପତଵୀର
ਪਦਾਮਜਿਤ	ପଦାମଜିତ
ਪਦਾਮਪ੍ਰੇਮ	ପଦାମପ୍ରେମ
ਪਦ੍ਮਸ਼੍ਰੀ	ପଦ୍ମଶ୍ରୀ
ਪਰਤਾਪ ; ਪਰਤਾਪ	ପରତାପ ; ପରତାପ
ਪਰਤਾਪੀ	ପରତାପୀ
ਪਰਦੀਪ	ପରଦୀପ
ਪਰਬੀਨ	ପରବୀନ
ਪਰਮਕਮਲ਼	ପରମକମଲ଼
ਪਰਮਕਿਰਤ	ପରମକିରତ
ਪਰਮਗੁਨ	ପରମଗୁନ
ਪਰਮਜਾਪ	ପରମଜାପ
ਪਰਮਜੀਤ ; ਪਰਮਜੀਤ	ପରମଜୀତ ; ପରମଜୀତ
ਪਰਮਜੁਗਤ	ପରମଜୁଗତ
ਪਰਮਜੋਗ	ପରମଜୋଗ
ਪਰਮਜੋਧ	ପରମଜୋଧ
ਪਰਮਠਾਕਰ	ପରମଠାକର
ਪਰਮਤੇਕ	ପରମତେକ
ਪਰਮਦੀਪ	ପରମଦୀପ
ਪਰਮਧਾਰਾਮ	ପରମଧାରାମ
ਪਰਮਧਿਰ	ପରମଧିର
ਪਰਮਪਾਲ	ପରମପାଲ
ਪਰਮਪ੍ਰੇਮ	ପରମପ୍ରେମ
ਪਰਮਬੋਧ	ପରମବୋଧ
ਪਰਮਯੋਗ	ପରମଯୋଗ
ਪਰਮਰਂਗ	ପରମରଂଗ
ਪਰਮਲੀਨ	ପରମଲୀନ
ਪਰਮਸ਼ਾਂਤ	ପରମଶାଂତ
ਪਰਮਸਿਤਾਲ	ପରମସିତାଲ
ਪਰਮਸੁਖ	ପରମସୁଖ
ਪਰਮਸੇਵਕ	ପରମସେଵକ
ਪਰਮਾਧਾਰ	ପରମାଧାର
ਪਰਮਾਰ੍ਥ	ପରମାର୍ଥ
ਪਰਮਿਂਦਰ	ପରମିଂଦର
ਪਰਮੀਤ	ପରମୀତ
ਪਰਮ੍ਦਯਾ	ପରମ୍ଦଯା
ਪਰਸਂਜੀਤ	ପରସଂଜୀତ
ਪਰਸ਼ੋਤਮ	ପରଶୋତମ
ਪਰਾਮਨੀਵਾਸ	ପରାମନୀଵାସ
ਪਰੀਦਰ੍ਸ਼ਨ	ପରୀଦର୍ଶନ
ਪਰ੍ਗਤ	ପର୍ଗତ
ਪਰ੍ਵੀਨ੍ਦੇਰ	ପର୍ଵୀନ୍ଦେର
ਪਲਬੀਨਦੇਰ	ପଲବୀନଦେର
ਪਲਵੀਨ੍ਦੇਰ੍ਪਾਲ	ପଲଵୀନ୍ଦେର୍ପାଲ
ਪਵਾਨਜੋਤ	ପଵାନଜୋତ
ਪਵਾਨਦੀਪ	ପଵାନଦୀପ
ਪਵਾਨਪ੍ਰਿਤ	ପଵାନପ୍ରିତ
ਪਵਾਨਵੀਰ	ପଵାନଵୀର
ਪਵੀਤ	ପଵୀତ
ਪਾਰਂਗਤ	ପାରଂଗତ
ਪੁਨੀਤ	ପୁନୀତ
ਪੁਨੀਤਪਾਲ	ପୁନୀତପାଲ
ਪੁਰਾਨਪ੍ਰੇਮ	ପୁରାନପ୍ରେମ
ਪੁਰਾਨ੍ਜੀਤ	ପୁରାନ୍ଜୀତ
ਪੁਸ਼ਪ੍ਰਿਤ	ପୁଶପ୍ରିତ
ਪੁਸ਼੍ਪਿਤਾ	ପୁଶ୍ପିତା
ਪੂਰਨਜੀਤ	ପୂରନଜୀତ
ਪ੍ਰਗਿਤ	ପ୍ରଗିତ
ਪ੍ਰਜਨਾ	ପ୍ରଜନା
ਪ੍ਰਣਿਤ	ପ୍ରଣିତ
ਪ੍ਰਨੀਤਾ	ପ୍ରନୀତା
ਪ੍ਰਫੂਲਦੀਪ	ପ୍ରଫୂଲଦୀପ
ਪ੍ਰਭਕੀਰਤ	ପ୍ରଭକୀରତ
ਪ੍ਰਭਕੀਰ੍ਪਾਲ	ପ୍ରଭକୀର୍ପାଲ
ਪ੍ਰਭਗੀਤ	ପ୍ରଭଗୀତ
ਪ੍ਰਭਚਰਣ	ପ୍ରଭଚରଣ
ਪ੍ਰਭਚੇਤਨ	ପ୍ରଭଚେତନ
ਪ੍ਰਭਜਿਤ	ପ୍ରଭଜିତ
ਪ੍ਰਭਜੀਤ	ପ୍ରଭଜୀତ
ਪ੍ਰਭਜੀਵਨ	ପ୍ରଭଜୀଵନ
ਪ੍ਰਭਜੋਗ	ପ୍ରଭଜୋଗ
ਪ੍ਰਭਜੋਤੇ	ପ୍ରଭଜୋତେ
ਪ੍ਰਭਜੋਧ	ପ୍ରଭଜୋଧ
ਪ੍ਰਭਤਿਰਥ	ପ୍ରଭତିରଥ
ਪ੍ਰਭਦਾਸ	ପ୍ରଭଦାସ
ਪ੍ਰਭਧਿਯਨ	ପ୍ରଭଧିଯନ
ਪ੍ਰਭਧਿਰਾਜ	ପ୍ରଭଧିରାଜ
ਪ੍ਰਭਨਾਮ	ପ୍ରଭନାମ
ਪ੍ਰਭਨੂਰ	ପ୍ରଭନୂର
ਪ੍ਰਭਪਰ੍ਵਾਨ	ପ୍ରଭପର୍ଵାନ
ਪ੍ਰਭਬੋਧ	ପ୍ରଭବୋଧ
ਪ੍ਰਭਮਿਤ	ପ୍ରଭମିତ
ਪ੍ਰਭਮੇਹਾਰ	ପ୍ରଭମେହାର
ਪ੍ਰਭਲੀਨ	ପ୍ରଭଲୀନ
ਪ੍ਰਭਵਿਚਾਰ	ପ୍ରଭଵିଚାର
ਪ੍ਰਭਸਂਗਤ	ପ୍ରଭସଂଗତ
ਪ੍ਰਭਸਿਤਾਲ	ପ୍ରଭସିତାଲ
ਪ੍ਰਭਾਤਕੀਰਣ	ପ୍ରଭାତକୀରଣ
ਪ੍ਰਭ੍ਰਮਣ	ପ୍ରଭ୍ରମଣ
ਪ੍ਰਭ੍ਰਾਤਨ	ପ୍ରଭ୍ରାତନ
ਪ੍ਰਭ੍ਰੂਪ	ପ୍ରଭ୍ରୂପ
ਪ੍ਰਸ਼ਾਰਨਬੀਰ	ପ୍ରଶାରନବୀର
ਪ੍ਰਿਤਮੋਹਨ	ପ୍ରିତମୋହନ
ਪ੍ਰਿਤੀਨ੍ਦੇਰ	ପ୍ରିତୀନ୍ଦେର
ਪ੍ਰਿਤ੍ਵੀਰ	ପ୍ରିତ୍ଵୀର
ਪ੍ਰੀਤਪਾਲ	ପ୍ରୀତପାଲ
ਪ੍ਰੀਤਮ੍ਹਾਰੀ	ପ୍ରୀତମ୍ହାରୀ
ਪ੍ਰੀਤਾਮਜਿਤ	ପ୍ରୀତାମଜିତ
ਪ੍ਰੀਥਾਮ੍ਦੀਪ	ପ୍ରୀଥାମ୍ଦୀପ
ਪ੍ਰੀਥੀਪਾਲ	ପ୍ରୀଥୀପାଲ
ਪ੍ਰੀਥ੍ਵੀਪਾਲ	ପ୍ରୀଥ୍ଵୀପାଲ
ਪ੍ਰੇਮਜਿਤ	ପ୍ରେମଜିତ
ਪ੍ਰੇਮਤੇਕ	ପ୍ରେମତେକ
ਪ੍ਰੇਮਪਾਲ	ପ୍ରେମପାଲ
ਪ੍ਰੇਮਬਂਸ	ପ୍ରେମବଂସ
ਪ੍ਰੇਮਭਾਗਤ	ପ୍ରେମଭାଗତ
ਪ੍ਰੇਮਰਂਗ	ପ୍ରେମରଂଗ
ਪ੍ਰੇਮਰਮਣ	ପ୍ରେମରମଣ
ਪ੍ਰੇਮਰਸ	ପ୍ରେମରସ
ਪ੍ਰੇਮਲੀਨ	ପ୍ରେମଲୀନ
ਪ੍ਰੇਮਵਾਂਤ	ପ୍ରେମଵାଂତ
ਪ੍ਰੇਮਸੀਰੀ	ପ୍ରେମସୀରୀ
ਪ੍ਰੇਮਸੁਖ	ପ୍ରେମସୁଖ
ਪ੍ਰੇਮ੍ਵੀਰ	ପ୍ରେମ୍ଵୀର
ਫਕੀਰ	ଫକୀର
ਫਤੇਹਕਾਰਾਮ	ଫତେହକାରାମ
ਫਤੇਹਪ੍ਰਿਤ	ଫତେହପ୍ରିତ
ਫਤੇਹਬੀਰ	ଫତେହବୀର
ਫਤੇਹ੍ਵਂਤ	ଫତେହ୍ଵଂତ
ਫਾਜਲ	ଫାଜଲ
ਫੁਲਵਂਤ	ଫୁଲଵଂତ
ਫੋਜੀਨਦੇਰ	ଫୋଜୀନଦେର
ਬਂਸਮਿਤ	ବଂସମିତ
ਬਕ੍ਸ਼ੀ	ବକ୍ଶୀ
ਬਚਾਨਬੀਰ	ବଚାନବୀର
ਬਚੀਨ੍ਤ	ବଚୀନ୍ତ
ਬਨੀਤ	ବନୀତ
ਬਨੀਨਦੇਰ	ବନୀନଦେର
ਬਰਿਨ੍ਦ੍ਰ	ବରିନ୍ଦ୍ର
ਬਰੀਨ੍ਦੇਰ	ବରୀନ୍ଦେର
ਬਲਤੇਜ	ବଲତେଜ
ਬਲਦੀਪ	ବଲଦୀପ
ਬਲਦੇਵ	ବଲଦେଵ
ਬਲਮੋਹਨ	ବଲମୋହନ
ਬਲਰਾਜ	ବଲରାଜ
ਬਲਵਿਂਦਰ	ବଲଵିଂଦର
ਬਲੀਨਦੇਰ	ବଲୀନଦେର
ਬਲੀਹਾਰ	ବଲୀହାର
ਬਲ੍ਵਿਨ੍ਦ੍ਰ	ବଲ୍ଵିନ୍ଦ୍ର
ਬਲ੍ਵੀਨ੍ਦੇਰ	ବଲ୍ଵୀନ୍ଦେର
ਬਹਾਦਰ	ବହାଦର
ਬਾਲਮਿਤ	ବାଲମିତ
ਬਿਸ਼ਨਪਾਲ	ବିଶନପାଲ
ਬਿਸ੍ਮੀਤ	ବିସ୍ମୀତ
ਬੀਨਦੇਰ	ବୀନଦେର
ਬੀਨਾ	ବୀନା
ਬੀਬੀਨਾਨਾਕੀ	ବୀବୀନାନାକୀ
ਬੀਮਾਂਲਜੋਤ	ବୀମାଂଲଜୋତ
ਬੀਰੀਨਦਾਰ	ବୀରୀନଦାର
ਬੀਸਮਾਧ	ବୀସମାଧ
ਬੀਸ਼੍ਮਿਤ	ବୀଶ୍ମିତ
ਬੁਜੀ	ବୁଜୀ
ਬੁਧ੍ਪ੍ਰਿਤ	ବୁଧ୍ପ୍ରିତ
ਬੁਧ੍ਰੂਪ	ବୁଧ୍ରୂପ
ਬੇਂਤ	ବେଂତ
ਬੇਨ੍ਨੀ	ବେନ୍ନୀ
ਬੇਬੇ	ବେବେ
ਬੈਰਾਗੀ	ବୈରାଗୀ
ਬ੍ਰਹਮਜੋਤ	ବ୍ରହମଜୋତ
ਬ੍ਰਹਾਮਲੀਨ	ବ୍ରହାମଲୀନ
ਬ੍ਰਹਾਮ੍ਜੀਤ	ବ୍ରହାମ୍ଜୀତ
ਬ੍ਰਹ੍ਮਲੀਨ	ବ୍ରହ୍ମଲୀନ
ਬ੍ਰਹ੍ਮਵੀਰ	ବ୍ରହ୍ମଵୀର
ਬ੍ਰਿਜੇਂਦਰ	ବ୍ରିଜେଂଦର
ਬ੍ਰੀਜੋਧ	ବ୍ରୀଜୋଧ
ਭਗਤ	ଭଗତ
ਭਗਵਾਨ	ଭଗଵାନ
ਭਜਨਿਕ	ଭଜନିକ
ਭਰਪੂਰ	ଭରପୂର
ਭਾਘਵੀਨ੍ਦੇਰ	ଭାଘଵୀନ୍ଦେର
ਭਾਜ੍ਨਾਮ	ଭାଜ୍ନାମ
ਭਾਜ੍ਨਿਤ	ଭାଜ୍ନିତ
ਭਾਵਜਿਤ	ଭାଵଜିତ
ਭਾਵਜੀਨ੍ਦੇਰ	ଭାଵଜୀନ୍ଦେର
ਭਾਵਨਦੀਪ	ଭାଵନଦୀପ
ਭਾਵਨੀਤ	ଭାଵନୀତ
ਭਾਵਪਾਲ	ଭାଵପାଲ
ਭਾਵਪ੍ਰੇਮ	ଭାଵପ୍ରେମ
ਭਾਵਲੀਨ	ଭାଵଲୀନ
ਭੀਨਦੇਰ੍ਪਾਲ	ଭୀନଦେର୍ପାଲ
ਭੁਪੀਨ੍ਦੇਰ	ଭୁପୀନ୍ଦେର
ਮਂਗਲਾ	ମଂଗଲା
ਮਂਤੇਕ	ମଂତେକ
ਮਜਾਲ	ମଜାଲ
ਮਣਿਪਾਲ	ମଣିପାଲ
ਮਧੁਪ੍ਰਿਤ	ମଧୁପ୍ରିତ
ਮਧੁਰਬੀਨ	ମଧୁରବୀନ
ਮਧੁਵਂਤ	ମଧୁଵଂତ
ਮਨਵਂਤ	ମନଵଂତ
ਮਰਦੁਲਾ	ମରଦୁଲା
ਮਸ੍ਤਪ੍ਰੇਮ	ମସ୍ତପ୍ରେମ
ਮਸ੍ਤਾਨ	ମସ୍ତାନ
ਮਸ੍ਤੁਕ	ମସ୍ତୁକ
ਮਸ੍ਤ੍ਵੀਰ	ମସ୍ତ୍ଵୀର
ਮਹਨਬੀਰ	ମହନବୀର
ਮਹਾਜਿਤ	ମହାଜିତ
ਮਹਾਨਗਿਯਨ	ମହାନଗିଯନ
ਮਹਾਨਗੀਤ	ମହାନଗୀତ
ਮਹਾਨਗੁਨ	ମହାନଗୁନ
ਮਹਾਨਜਿਤ	ମହାନଜିତ
ਮਹਾਨਜੀਵਨ	ମହାନଜୀଵନ
ਮਹਾਨਜੋਤ	ମହାନଜୋତ
ਮਹਾਨਤੇਕ	ମହାନତେକ
ਮਹਾਨਤ੍ਰੀਪਾਤ	ମହାନତ୍ରୀପାତ
ਮਹਾਨਦੀਪ	ମହାନଦୀପ
ਮਹਾਨਪਾਲ	ମହାନପାଲ
ਮਹਾਨਪ੍ਰੇਮ	ମହାନପ୍ରେମ
ਮਹਾਨਭਗਤ	ମହାନଭଗତ
ਮਹਿਨਦੇਰ੍ਪ੍ਰਿਤ	ମହିନଦେର୍ପ୍ରିତ
ਮਹੀਨਗਾ	ମହୀନଗା
ਮਹੀਨਦੇਰ੍ਪਾਲ	ମହୀନଦେର୍ପାଲ
ਮਹੇਕਪ੍ਰਿਤ	ମହେକପ୍ରିତ
ਮਹੇਨਦੇਰ	ମହେନଦେର
ਮਹੇਰਬਾਨੀ	ମହେରବାନୀ
ਮਹੇਸ਼ੀਨਦੇਰ	ମହେଶୀନଦେର
ਮਾਂਨਕਰਣ	ମାଂନକରଣ
ਮਾਂਨਗਲ੍ਪ੍ਰਿਤ	ମାଂନଗଲ୍ପ୍ରିତ
ਮਾਂਨਵਾਨ੍ਤ੍ਬੀਰ	ମାଂନଵାନ୍ତ୍ବୀର
ਮਾਂਨਸੀਰਤ	ମାଂନସୀରତ
ਮਾਂਨਾਵੀਨਦੇਰ	ମାଂନାଵୀନଦେର
ਮਾਂਨਾਸਪ੍ਰੇਮ	ମାଂନାସପ୍ରେମ
ਮਾਂਨੀਨਦੇਰ੍ਬੀਰ	ମାଂନୀନଦେର୍ବୀର
ਮਾਂਨੋਹਾਰਜੋਤ	ମାଂନୋହାରଜୋତ
ਮਾਂਨੋਹਾਰਦੀਪ	ମାଂନୋହାରଦୀପ
ਮਾਂਨੋਹਾਰ੍ਜੀਤ	ମାଂନୋହାର୍ଜୀତ
ਮਾਂਨੋਹਾਰ੍ਪਲ	ମାଂନୋହାର୍ପଲ
ਮਾਂਨ੍ਗਲ੍ਜੀਤ	ମାଂନ୍ଗଲ୍ଜୀତ
ਮਾਂਨ੍ਗਲ੍ਪ੍ਰੇਮ	ମାଂନ୍ଗଲ୍ପ୍ରେମ
ਮਾਂਨ੍ਸ਼ਿਤਾਲ	ମାଂନ୍ଶିତାଲ
ਮਾਦਨਬੀਰ	ମାଦନବୀର
ਮਾਦਾਨਕੀਰ੍ਪਾਲ	ମାଦାନକୀର୍ପାଲ
ਮਾਦਾਨਪਾਲ	ମାଦାନପାଲ
ਮਾਨਤੇਜ	ମାନତେଜ
ਮਾਨਦੇਵ	ମାନଦେଵ
ਮਾਨਪੁਲ	ମାନପୁଲ
ਮਾਨਬੀਰ	ମାନବୀର
ਮਾਨਰਿਤ	ମାନରିତ
ਮਾਨਾਸਦੀਪ	ମାନାସଦୀପ
ਮਾਨ੍ਕੀਰਣ	ମାନ୍କୀରଣ
ਮਾਨ੍ਗਲ੍ਜੋਤ	ମାନ୍ଗଲ୍ଜୋତ
ਮਾਨ੍ਪ੍ਰੀਯਾ	ମାନ୍ପ୍ରୀଯା
ਮਾਯ੍ਰਾਯ	ମାଯ୍ରାଯ
ਮਿਤ੍ਰਾ	ମିତ୍ରା
ਮਿਤ੍ਰਾਜ	ମିତ୍ରାଜ
ਮੀਰਾ	ମୀରା
ਮੁਕੁਂਦਾ	ମୁକୁଂଦା
ਮੁਕੁਨਦ੍ਪ੍ਰਿਤ	ମୁକୁନଦ୍ପ୍ରିତ
ਮੁਖ੍ਤਯਾਰ	ମୁଖ୍ତଯାର
ਮੁਦ੍ਰਾ	ମୁଦ୍ରା
ਮੁਨਦੀਪ	ମୁନଦୀପ
ਮੁਨਲੇਨੇ	ମୁନଲେନେ
ਮੇਸ਼	ମେଶ
ਮੇਹਰ	ମେହର
ਮੇਹਾਰਤੇਕ	ମେହାରତେକ
ਮੇਹਾਰਪਲ	ମେହାରପଲ
ਮੇਹਾਰਪ੍ਰਿਤ	ମେହାରପ୍ରିତ
ਮੇਹਾਰਭੂਪ	ମେହାରଭୂପ
ਮੇਹਾਰਮਿਤ	ମେହାରମିତ
ਮੇਹੇਰ	ମେହେର
ਮੇਹੇਰਬਾਨੀ	ମେହେରବାନୀ
ਮੋਨੀਨ੍ਦੇਰ	ମୋନୀନ୍ଦେର
ਮੋਹਨਤੇਕ	ମୋହନତେକ
ਮੋਹਨਮਿਤ	ମୋହନମିତ
ਮੋਹਨਲੀਨ	ମୋହନଲୀନ
ਮੋਹਨਵਂਤ	ମୋହନଵଂତ
ਮੋਹਨਵੀਰ	ମୋହନଵୀର
ਮੋਹਿਨ੍ਦੇਰਪਾਲ	ମୋହିନ୍ଦେରପାଲ
ਮੋਹੇਨਪਲ	ମୋହେନପଲ
ਮੋਹੇਨਪ੍ਰਿਤ	ମୋହେନପ୍ରିତ
ਯਕਿਨ	ଯକିନ
ਯਸ਼ਜੋਤ	ଯଶଜୋତ
ਯਸ਼ਨੂਰ	ଯଶନୂର
ਯਸ਼ਪਾਲ	ଯଶପାଲ
ਯਸ਼ਵਂਤ	ଯଶଵଂତ
ਯਸ਼੍ਦੀਪ	ଯଶ୍ଦୀପ
ਯਾਤੀਨਪਾਲ	ଯାତୀନପାଲ
ਯਾਦਲੀਨ	ଯାଦଲୀନ
ਯਾਦਵੀਰ	ଯାଦଵୀର
ਯਾਦ੍ਬੀਰ	ଯାଦ୍ବୀର
ਯਾਸ੍ਮੀਨੇ	ଯାସ୍ମୀନେ
ਯੁਵਰਾਨੀ	ଯୁଵରାନୀ
ਯੋਗੇਸ਼ਪਾਲ	ଯୋଗେଶପାଲ
ਰਂਗ ਰਮਨ	ରଂଗ ରମନ
ਰਂਗਜੋਤ	ରଂଗଜୋତ
ਰਂਗਪ੍ਰਿਤ	ରଂଗପ୍ରିତ
ਰਂਗਾਤਮ	ରଂଗାତମ
ਰਂਗੀਵਨ	ରଂଗୀଵନ
ਰਂਜੀਤ	ରଂଜୀତ
ਰਘੁਜਿਤ	ରଘୁଜିତ
ਰਘੁਬਂਸ	ରଘୁବଂସ
ਰਚਨਜਿਤ	ରଚନଜିତ
ਰਚਨਜੋਤ	ରଚନଜୋତ
ਰਚ੍ਪੀਨਦੇਰ੍ਜਿਤ	ରଚ୍ପୀନଦେର୍ଜିତ
ਰਜੀਨਦਾਰ	ରଜୀନଦାର
ਰਣਦੀਪ	ରଣଦୀପ
ਰਣਬੀਰ	ରଣବୀର
ਰਤਨ੍ਕਾਰਾਮ	ରତନ୍କାରାମ
ਰਤ੍ਤਾਨਜੋਤ	ରତ୍ତାନଜୋତ
ਰਤ੍ਤਾਨਦੀਪ	ରତ୍ତାନଦୀପ
ਰਨਗ੍ਰਤ੍ਤੀ	ରନଗ୍ରତ୍ତୀ
ਰਨਪ੍ਰਿਤ	ରନପ୍ରିତ
ਰਪੀਨਦੇਰ	ରପୀନଦେର
ਰਮਚੇਤਨ	ରମଚେତନ
ਰਮਣੀਕ	ରମଣୀକ
ਰਮਨਜਿਤ	ରମନଜିତ
ਰਮਨਦੀਪ	ରମନଦୀପ
ਰਮਨਿਤ	ରମନିତ
ਰਮਨੀਵਾਸ	ରମନୀଵାସ
ਰਮਲੀਨ	ରମଲୀନ
ਰਮਾਂਨਜੋਤ	ରମାଂନଜୋତ
ਰਮਾਂਨਰੂਪ	ରମାଂନରୂପ
ਰਮਾਂਨਸੁਖ	ରମାଂନସୁଖ
ਰਮਿਤ	ରମିତ
ਰਮਿਨਾਜੀਤ	ରମିନାଜୀତ
ਰਮੀਨਦੇਰ੍ਜਿਤ	ରମୀନଦେର୍ଜିତ
ਰਮੀਨਦੇਰ੍ਪਾਲ	ରମୀନଦେର୍ପାଲ
ਰਮੀਨਦੇਰ੍ਪ੍ਰਿਤ	ରମୀନଦେର୍ପ୍ରିତ
ਰਮੀਨਦੇਰ੍ਬੀਰ	ରମୀନଦେର୍ବୀର
ਰਮੇਸ਼ਪਲ	ରମେଶପଲ
ਰਮੇਸ਼ਮਿਤ	ରମେଶମିତ
ਰਵਜੋਤ	ରଵଜୋତ
ਰਵਨੀਤ	ରଵନୀତ
ਰਵਿਨ੍ਦਰ	ରଵିନ୍ଦର
ਰਵਿਰਾਜ	ରଵିରାଜ
ਰਵੀਦੀਪ	ରଵୀଦୀପ
ਰਵੀਨਦੇਰ੍ਦੀਪ	ରଵୀନଦେର୍ଦୀପ
ਰਵੀਨਦੇਰ੍ਮਿਤ	ରଵୀନଦେର୍ମିତ
ਰਸਂਜਿਤ	ରସଂଜିତ
ਰਸਂਜੋਤ	ରସଂଜୋତ
ਰਸਂਮਿਤ	ରସଂମିତ
ਰਸਗੁਨ	ରସଗୁନ
ਰਸਜੋਤ	ରସଜୋତ
ਰਸਧਾਰਮ	ରସଧାରମ
ਰਸਨਂਦ	ରସନଂଦ
ਰਸਪ੍ਰਿਤ	ରସପ୍ରିତ
ਰਸਬੀਰ	ରସବୀର
ਰਸਭਾਗਤ	ରସଭାଗତ
ਰਸਮ	ରସମ
ਰਸਮ੍ਰਿਤ	ରସମ୍ରିତ
ਰਸਲੀਨ	ରସଲୀନ
ਰਸਵਂਤ	ରସଵଂତ
ਰਸ਼ਾਨ੍ਪ੍ਰਿਤ	ରଶାନ୍ପ୍ରିତ
ਰਸੁਤ੍ਤਮ	ରସୁତ୍ତମ
ਰਹੁਲਜੀਤ	ରହୁଲଜୀତ
ਰਹੁਲਦੀਪ	ରହୁଲଦୀପ
ਰਾਖਨਾਂ	ରାଖନାଂ
ਰਾਖਬੀਰ	ରାଖବୀର
ਰਾਜਕਿਰਣ	ରାଜକିରଣ
ਰਾਜਦੀਪ	ରାଜଦୀପ
ਰਾਜਨਾਰੀਨ੍ਦ	ରାଜନାରୀନ୍ଦ
ਰਾਜਪਰਾਮ	ରାଜପରାମ
ਰਾਜਪਾਲ	ରାଜପାଲ
ਰਾਜਪ੍ਰਤਾਪ	ରାଜପ୍ରତାପ
ਰਾਜਮਂਦਰ	ରାଜମଂଦର
ਰਾਜਮਿਤ	ରାଜମିତ
ਰਾਜਸ਼ਰਣ	ରାଜଶରଣ
ਰਾਜਸੁਖ	ରାଜସୁଖ
ਰਾਜਾਨਜਿਤ	ରାଜାନଜିତ
ਰਾਜਾਨਮਿਤ	ରାଜାନମିତ
ਰਾਜਾਨ੍ਦੀਪ	ରାଜାନ୍ଦୀପ
ਰਾਤਾਨਗੀਤ	ରାତାନଗୀତ
ਰਾਤਾਨਚੇਤਨ	ରାତାନଚେତନ
ਰਾਤਾਨਜੀਵਨ	ରାତାନଜୀଵନ
ਰਾਤਾਨਪ੍ਰਿਤ	ରାତାନପ୍ରିତ
ਰਾਤਾਨਮਿਤ	ରାତାନମିତ
ਰਾਤਾਨਵਂਤ	ରାତାନଵଂତ
ਰਾਤਾਨਾਤਮ	ରାତାନାତମ
ਰਾਮਦਾਸ	ରାମଦାସ
ਰਾਮਪਾਲ	ରାମପାଲ
ਰਾਮਰਂਗ	ରାମରଂଗ
ਰਾਮਰਤ੍ਤਨ	ରାମରତ୍ତନ
ਰਾਮਸੁਖ	ରାମସୁଖ
ਰਾਸਰਮਣ	ରାସରମଣ
ਰਾਸ਼੍ਪਲ	ରାଶ୍ପଲ
ਰਾਸ਼੍ਮੀਨਦੇਰ	ରାଶ୍ମୀନଦେର
ਰਿਧਿਮਾ	ରିଧିମା
ਰੀਜਕ	ରୀଜକ
ਰੀਤੀਨਦੇਰ	ରୀତୀନଦେର
ਰੀਪਨ੍ਜੋਤ	ରୀପନ୍ଜୋତ
ਰੀਪੁਦਮ	ରୀପୁଦମ
ਰੂਂਗ / ਰਂਗ	ରୂଂଗ / ରଂଗ
ਰੂਪਦੀਪ	ରୂପଦୀପ
ਰੂਪਦੇਵ	ରୂପଦେଵ
ਰੂਪਵਂਤ	ରୂପଵଂତ
ਰੇਗੇਨਦਰ	ରେଗେନଦର
ਰੋਸ਼ਨਦੀਪ	ରୋଶନଦୀପ
ਰੌਸ਼ਾਨਪ੍ਰੇਮ	ରୌଶାନପ୍ରେମ
ਰੌਸ਼ਾਨਬੀਰ	ରୌଶାନବୀର
ਲਕ੍ਸ਼੍ਮੀ	ଲକ୍ଶ୍ମୀ
ਲਖਪ੍ਰਿਤ	ଲଖପ୍ରିତ
ਲਖਮਿਤ	ଲଖମିତ
ਲਖਰੂਪ	ଲଖରୂପ
ਲਖਵੀਰ	ଲଖଵୀର
ਲਵੇਨਿਤ	ଲଵେନିତ
ਲਾਜਵਂਤ	ଲାଜଵଂତ
ਲਾਵਪ੍ਰਿਤ	ଲାଵପ୍ରିତ
ਲਾਵਿਨਦੀਪ	ଲାଵିନଦୀପ
ਲੀਵਗੀਆਨ	ଲୀଵଗୀଆନ
ਲੀਵਚਿਤ	ଲୀଵଚିତ
ਲੀਵਚੇਤ	ଲୀଵଚେତ
ਲੀਵਜੋਤ	ଲୀଵଜୋତ
ਲੀਵਨਾਮ	ଲୀଵନାମ
ਲੀਵਸ਼ਰਣ	ଲୀଵଶରଣ
ਲੀਵਾਵਤਰ	ଲୀଵାଵତର
ਲੋਕਪਾਲ	ଲୋକପାଲ
ਲੋਕਪ੍ਰਿਤ	ଲୋକପ୍ରିତ
ਲੋਕਰੂਪ	ଲୋକରୂପ
ਲੋਕ੍ਪ੍ਰੇਮ	ଲୋକ୍ପ୍ରେମ
ਲੋਵਪ੍ਰੇਮ	ଲୋଵପ୍ରେମ
ਲੋਵੇਦੀਪ	ଲୋଵେଦୀପ
ਵਰੀਨਦੇਰ੍ਪਾਲ	ଵରୀନଦେର୍ପାଲ
ਵਰੁਨਜਿਤ	ଵରୁନଜିତ
ਵਰੁਨਦੀਪ	ଵରୁନଦୀପ
ਵਸਂਤਪ੍ਰਿਤ	ଵସଂତପ୍ରିତ
ਵਸੁਂਧਰਾ	ଵସୁଂଧରା
ਵਾਦਭਾਗ	ଵାଦଭାଗ
ਵਾਮਾਂਨਜੀਤ	ଵାମାଂନଜୀତ
ਵਾਰੀਨਦੇਰ	ଵାରୀନଦେର
ਵਾਸੀਮਬੀਰ	ଵାସୀମବୀର
ਵਾਹੀਦਪ੍ਰਿਤ	ଵାହୀଦପ୍ରିତ
ਵਾਹੇਗੁਰੁ	ଵାହେଗୁରୁ
ਵਿਕ੍ਰਮਜੀਤ	ଵିକ୍ରମଜୀତ
ਵਿਕ੍ਰਮਜੋਤ	ଵିକ୍ରମଜୋତ
ਵਿਚਾਰ੍ਚੇਤਨ	ଵିଚାର୍ଚେତନ
ਵਿਚਾਰ੍ਦੀਪ	ଵିଚାର୍ଦୀପ
ਵਿਚਾਰ੍ਲੀਨ	ଵିଚାର୍ଲୀନ
ਵਿਜਯਪ੍ਰਤਾਪ	ଵିଜଯପ୍ରତାପ
ਵਿਜਯਪ੍ਰਿਤ	ଵିଜଯପ୍ରିତ
ਵਿਜੇਂਦਰ	ଵିଜେଂଦର
ਵਿਨਾਯਦੀਪ	ଵିନାଯଦୀପ
ਵਿਨਾਯਪੁਲ	ଵିନାଯପୁଲ
ਵਿਨਾਯ੍ਬਿਰ	ଵିନାଯ୍ବିର
ਵਿਮਾਂਲਜਿਤ	ଵିମାଂଲଜିତ
ਵਿਮਾਂਲਜੋਤ	ଵିମାଂଲଜୋତ
ਵਿਮਾਂਲਪ੍ਰੇਮ	ଵିମାଂଲପ୍ରେମ
ਵਿਰੀਨਦਾਰ ; ਵਿਰੀਨਦੇਰ	ଵିରୀନଦାର ; ଵିରୀନଦେର
ਵਿਰੀਨਦੇਰ	ଵିରୀନଦେର
ਵਿਸਮਦ	ଵିସମଦ
ਵਿਸ਼ਾਲਦੀਪ	ଵିଶାଲଦୀପ
ਵਿਸ਼ਾਲਪ੍ਰਿਤ	ଵିଶାଲପ୍ରିତ
ਵਿਸ਼੍ਵਰ੍ਪ੍ਰਿਤ	ଵିଶ୍ଵର୍ପ୍ରିତ
ਵਿਸ਼੍ਵਾਤਮ	ଵିଶ୍ଵାତମ
ਵਿਸਾਹ	ଵିସାହ
ਵੀਜਯਮਿਤ	ଵୀଜଯମିତ
ਵੀਰ	ଵୀର
ਵੀਰ /ਵੀਰ	ଵୀର /ଵୀର
ਵੀਰਪਾਲ	ଵୀରପାଲ
ਵੀਵੇਕ੍ਬੀਰ	ଵୀଵେକ୍ବୀର
ਵੀਸ੍ਰਮਣ	ଵୀସ୍ରମଣ
ਵੇਰਾਜ	ଵେରାଜ
ਵੈਭਵ	ଵୈଭଵ
ਸਂਗਜਾਪ	ସଂଗଜାପ
ਸਂਗਤਪ੍ਰਿਤ	ସଂଗତପ୍ରିତ
ਸਂਗਤਰੂਪ	ସଂଗତରୂପ
ਸਂਗਤ੍ਰਸ	ସଂଗତ୍ରସ
ਸਂਗੀਤਾ	ସଂଗୀତା
ਸਂਗ੍ਰਾਮ	ସଂଗ୍ରାମ
ਸਂਜੀਤ	ସଂଜୀତ
ਸਂਜੋਗ	ସଂଜୋଗ
ਸਂਤਕੀਰੀਨ	ସଂତକୀରୀନ
ਸਂਤਪ੍ਰਕਾਸ਼	ସଂତପ୍ରକାଶ
ਸਂਤਪ੍ਰੇਮ	ସଂତପ୍ରେମ
ਸਂਤਬੀਰ	ସଂତବୀର
ਸਂਤੋਖਜੀਤ	ସଂତୋଖଜୀତ
ਸਂਤੋਖਜੋਤ	ସଂତୋଖଜୋତ
ਸਂਤੋਖਪ੍ਰਿਤ	ସଂତୋଖପ୍ରିତ
ਸਂਤੋਖਬੀਰ	ସଂତୋଖବୀର
ਸਂਦੀਪ	ସଂଦୀପ
ਸਗਲਜੋਤ	ସଗଲଜୋତ
ਸਚਕਿਰਤ	ସଚକିରତ
ਸਚਜੋਗ	ସଚଜୋଗ
ਸਚਪਾਲ	ସଚପାଲ
ਸਚਪ੍ਰਧਾਨ	ସଚପ୍ରଧାନ
ਸਚਭਾਗਤ	ସଚଭାଗତ
ਸਚਮਾਨ	ସଚମାନ
ਸਚਰੂਪ	ସଚରୂପ
ਸਚਵੀਰ	ସଚଵୀର
ਸਚਸੁਖ	ସଚସୁଖ
ਸਚਸੇਵਕ	ସଚସେଵକ
ਸਚਾਮ੍ਰਿਤ	ସଚାମ୍ରିତ
ਸਚ੍ਦੀਪ	ସଚ୍ଦୀପ
ਸਜੀਨਦੇਰ	ସଜୀନଦେର
ਸਤਕਿਰਤ	ସତକିରତ
ਸਤਕੀਰਤ	ସତକୀରତ
ਸਤਕੀਰ੍ਤਨ	ସତକୀର୍ତନ
ਸਤਗੁਨ	ସତଗୁନ
ਸਤਗੁਰ	ସତଗୁର
ਸਤਜੋਤ	ସତଜୋତ
ਸਤਨਾਮ	ସତନାମ
ਸਤਪਾਲ	ସତପାଲ
ਸਤਪ੍ਰਕਾਸ਼	ସତପ୍ରକାଶ
ਸਤਪ੍ਰਿਤ	ସତପ୍ରିତ
ਸਤਪ੍ਰੇਮ	ସତପ୍ରେମ
ਸਤਬਚਨ	ସତବଚନ
ਸਤਮਿਤ	ସତମିତ
ਸਤਰਜਿਤ	ସତରଜିତ
ਸਤਰਾਜ	ସତରାଜ
ਸਤਲੀਨ	ସତଲୀନ
ਸਤਵਂਤ	ସତଵଂତ
ਸਤਸਂਗਤ	ସତସଂଗତ
ਸਤਸਂਤੋਖ	ସତସଂତୋଖ
ਸਤਸਰਂਗ	ସତସରଂଗ
ਸਤਸੁਖ	ସତସୁଖ
ਸਤੀਨਦੇਰ੍ਜਿਤ	ସତୀନଦେର୍ଜିତ
ਸਤ੍ਯਜਿਤ	ସତ୍ଯଜିତ
ਸਤ੍ਯਪ੍ਰੇਮ	ସତ୍ଯପ୍ରେମ
ਸਥਿਨ੍ਦਰ	ସଥିନ୍ଦର
ਸਦਜੀਵਨ	ସଦଜୀଵନ
ਸਦਸੁਖ	ସଦସୁଖ
ਸਨਮੁਖ	ସନମୁଖ
ਸਨਾਨਤਨ	ସନାନତନ
ਸਪਨਦੀਪ	ସପନଦୀପ
ਸਪਾਹੀ	ସପାହୀ
ਸਬੂਰੀ	ସବୂରୀ
ਸਭਾਜੀਤ	ସଭାଜୀତ
ਸਮਰਜੀਤ	ସମରଜୀତ
ਸਮਰਣ	ସମରଣ
ਸਮਰਵੀਰ	ସମରଵୀର
ਸਮਰ੍ਥ	ସମର୍ଥ
ਸਮਾਂਰਬੀਰ	ସମାଂରବୀର
ਸਮਾਂਰ੍ਜੋਤ	ସମାଂର୍ଜୋତ
ਸਮਾਈ	ସମାଈ
ਸਮੀਨਦੀਪ	ସମୀନଦୀପ
ਸਮੀਰ	ସମୀର
ਸਰਦਾਰ	ସରଦାର
ਸਰਨਦਾਯਲ	ସରନଦାଯଲ
ਸਰਨਦੀਪ	ସରନଦୀପ
ਸਰਨਾਗਤ	ସରନାଗତ
ਸਰਬਜੀਤ / ਸਰਬਜੀਤ	ସରବଜୀତ / ସରବଜୀତ
ਸਰਬਨੀਵਾਸ	ସରବନୀଵାସ
ਸਰਬਪ੍ਰਿਤ	ସରବପ୍ରିତ
ਸਰਬਸੁਖ	ସରବସୁଖ
ਸਰਬੁਤ੍ਤਮ	ସରବୁତ୍ତମ
ਸਰਬ੍ਗਿਆਨ	ସରବ୍ଗିଆନ
ਸਰਬ੍ਜਿਤ	ସରବ୍ଜିତ
ਸਰਬ੍ਦਾਯਲ	ସରବ୍ଦାଯଲ
ਸਰਬ੍ਦੀਪ	ସରବ୍ଦୀପ
ਸਰਬ੍ਦੇਵ	ସରବ୍ଦେଵ
ਸਰਬ੍ਧਾਰਾਮ	ସରବ୍ଧାରାମ
ਸਰਲਜਿਤ	ସରଲଜିତ
ਸਰਲਬੀਰ	ସରଲବୀର
ਸਰਾਬ੍ਰਜ	ସରାବ୍ରଜ
ਸਰੂਪ	ସରୂପ
ਸਰੂਰ	ସରୂର
ਸਰ੍ਜਿਤ	ସର୍ଜିତ
ਸਰ੍ਮੀਨਦੇਰ	ସର୍ମୀନଦେର
ਸਵਾਨਪ੍ਰਿਤ	ସଵାନପ୍ରିତ
ਸਵਾਰਜਦੀਪ	ସଵାରଜଦୀପ
ਸਵਾਰਜਬੀਰ	ସଵାରଜବୀର
ਸਵਾਰਨਜੋਤ	ସଵାରନଜୋତ
ਸਵਾਰਨਪ੍ਰਿਤ	ସଵାରନପ୍ରିତ
ਸਵੀਤੀਨਦੇਰ	ସଵୀତୀନଦେର
ਸਵੀਤੋਜ	ସଵୀତୋଜ
ਸਵੀਨਦੇਰ	ସଵୀନଦେର
ਸਹੀਲਮਿਤ	ସହୀଲମିତ
ਸ਼ਯ੍ਮ੍ਸੁਨ੍ਦਾਰ	ଶଯ୍ମ୍ସୁନ୍ଦାର
ਸ਼ਰਨਪਾਲ	ଶରନପାଲ
ਸ਼ਰਨਬੀਰ	ଶରନବୀର
ਸ਼ਰਨ੍ਜੀਤ੍ਕੌਰ	ଶରନ୍ଜୀତ୍କୌର
ਸ਼ਾਂਤਚਿਤ	ଶାଂତଚିତ
ਸ਼ਾਂਤਦੀਪ	ଶାଂତଦୀପ
ਸ਼ਾਂਤਪ੍ਰਕਾਸ਼	ଶାଂତପ୍ରକାଶ
ਸ਼ਾਂਤਪ੍ਰਿਤ	ଶାଂତପ୍ରିତ
ਸ਼ਾਂਤਬੀਰ	ଶାଂତବୀର
ਸ਼ਾਂਤਲੀਨ	ଶାଂତଲୀନ
ਸ਼ਾਨਤ੍ਨੀਵਾਸ	ଶାନତ୍ନୀଵାସ
ਸ਼ਾਬਦਚੇਤ	ଶାବଦଚେତ
ਸ਼ਾਬਦਤੇਕ	ଶାବଦତେକ
ਸ਼ਾਬਦ੍ਰਾਸ	ଶାବଦ୍ରାସ
ਸ਼ਾਬਾਦ੍ਦੀਪ	ଶାବାଦ୍ଦୀପ
ਸ਼ਾਲੀਨ	ଶାଲୀନ
ਸ਼ਾਸ਼ੀਪ੍ਰਿਤ	ଶାଶୀପ୍ରିତ
ਸ਼ਿਵਚਰਣ	ଶିଵଚରଣ
ਸ਼ਿਵ੍ਚਾਰਨ੍ਜੀਤ	ଶିଵ୍ଚାରନ୍ଜୀତ
ਸ਼ੁਕਾਰਿਯਨ	ଶୁକାରିଯନ
ਸ਼ੁਭਦੀਪ	ଶୁଭଦୀପ
ਸ਼ੂਰਵੀਰ	ଶୂରଵୀର
ਸ਼ੇਰ	ଶେର
ਸ਼ੇਰਪੁਲ	ଶେରପୁଲ
ਸ਼ੇਰਬਹਾਦੁਰ	ଶେରବହାଦୁର
ਸ਼ੇਹ੍ਬਾਝ	ଶେହ୍ବାଝ
ਸਾਕਰਥ	ସାକରଥ
ਸਾਖ	ସାଖ
ਸਾਗਰ	ସାଗର
ਸਾਜ	ସାଜ
ਸਾਤਪੁਲ	ସାତପୁଲ
ਸਾਧਨਾਹ	ସାଧନାହ
ਸਾਧਿਕਾ	ସାଧିକା
ਸਾਬਰ	ସାବର
ਸਾਰ	ସାର
ਸਿਂਦਾ	ସିଂଦା
ਸਿਓਪਰਿਤ	ସିଓପରିତ
ਸਿਤਾਲਜੀਤ	ସିତାଲଜୀତ
ਸਿਤਾਲਜੋਤ	ସିତାଲଜୋତ
ਸਿਮਰਨ	ସିମରନ
ਸੀਖਲ	ସୀଖଲ
ਸੀਮਾਂਰ੍ਜਿਤ	ସୀମାଂର୍ଜିତ
ਸੀਮਾਂਰ੍ਨਾਮ	ସୀମାଂର୍ନାମ
ਸੀਮਾਂਰ੍ਪ੍ਰਿਤ	ସୀମାଂର୍ପ୍ରିତ
ਸੀਮਾਂਰ੍ਲੀਨ	ସୀମାଂର୍ଲୀନ
ਸੀਮ੍ਰਤ	ସୀମ୍ରତ
ਸੀਮ੍ਰਨਪਾਲ	ସୀମ୍ରନପାଲ
ਸੀਮ੍ਰਨਪ੍ਰਿਤ	ସୀମ୍ରନପ୍ରିତ
ਸੀਮ੍ਰਨ੍ਕੌਰ	ସୀମ୍ରନ୍କୌର
ਸੀਮ੍ਰਨ੍ਜੀਤ	ସୀମ୍ରନ୍ଜୀତ
ਸੀਮ੍ਰੀਤਾ	ସୀମ୍ରୀତା
ਸੀਰਤ	ସୀରତ
ਸੀਰੀਪ੍ਰੀਤਮ	ସୀରୀପ୍ରୀତମ
ਸੀਰੀਵੇਦ੍ਯਾ	ସୀରୀଵେଦ୍ଯା
ਸੀਰੀਸੀਮ੍ਰਣ	ସୀରୀସୀମ୍ରଣ
ਸੀਰੀਸੇਵਾ	ସୀରୀସେଵା
ਸੁਖਚੈਨ	ସୁଖଚୈନ
ਸੁਖਜੀਵਨ	ସୁଖଜୀଵନ
ਸੁਖਜੋਤ	ସୁଖଜୋତ
ਸੁਖਜੋਧ	ସୁଖଜୋଧ
ਸੁਖਦਾਯਲ	ସୁଖଦାଯଲ
ਸੁਖਦੀਪ	ସୁଖଦୀପ
ਸੁਖਦੇਵ	ସୁଖଦେଵ
ਸੁਖਬੀਰ	ସୁଖବୀର
ਸੁਖਮਾਂ	ସୁଖମାଂ
ਸੁਖਰੂਪ	ସୁଖରୂପ
ਸੁਖਸਿਤਾਲ	ସୁଖସିତାଲ
ਸੁਖਸੀਮ੍ਰਣ	ସୁଖସୀମ୍ରଣ
ਸੁਖਾਨਂਦ	ସୁଖାନଂଦ
ਸੁਖਿਤ	ସୁଖିତ
ਸੁਖੀਨ	ସୁଖୀନ
ਸੁਖੀਨ੍ਦੇਰ	ସୁଖୀନ୍ଦେର
ਸੁਖ੍ਚਾਰਨ੍ਜੀਤ	ସୁଖ୍ଚାରନ୍ଜୀତ
ਸੁਖ੍ਜਿਤ	ସୁଖ୍ଜିତ
ਸੁਚਦੀਪ	ସୁଚଦୀପ
ਸੁਚਦੇਵ	ସୁଚଦେଵ
ਸੁਚਮ	ସୁଚମ
ਸੁਜਨਰੂਪ	ସୁଜନରୂପ
ਸੁਜਨ੍ਬੀਰ	ସୁଜନ୍ବୀର
ਸੁਜ੍ਜਨ	ସୁଜ୍ଜନ
ਸੁਧਬੁਧ	ସୁଧବୁଧ
ਸੁਧਸੁਰਤ	ସୁଧସୁରତ
ਸੁਭਪ੍ਰਿਤ	ସୁଭପ୍ରିତ
ਸੁਹੇਜਦੀਪ	ସୁହେଜଦୀପ
ਸੇਵਾਕਪ੍ਰਿਤ	ସେଵାକପ୍ରିତ
ਸੇਵਾਕਪ੍ਰੇਮ	ସେଵାକପ୍ରେମ
ਸੇਵਾਕਰਣ	ସେଵାକରଣ
ਸੇਵਾਪ੍ਰੀਤ	ସେଵାପ୍ରୀତ
ਸੇਹਜ	ସେହଜ
ਸੇਹੇਜਬੀਰ	ସେହେଜବୀର
ਸੈਲੇਸ਼ਦੀਪ	ସୈଲେଶଦୀପ
ਸੈਹਜ	ସୈହଜ
ਸੈਹਾਜਨੀਵਾਸ	ସୈହାଜନୀଵାସ
ਸੈਹਾਜਲੀਨ	ସୈହାଜଲୀନ
ਸੈਹਾਜਾਧਾਰ	ସୈହାଜାଧାର
ਸੋਚੀ	ସୋଚୀ
ਸੋਨਹਨ	ସୋନହନ
ਸੋਭਾਵਂਤ	ସୋଭାଵଂତ
ਸੋਹੀਨਦੇਰ	ସୋହୀନଦେର
ਸੋਹੁਨ	ସୋହୁନ
ਸ੍ਵਰ੍ਨ	ସ୍ଵର୍ନ
ਹਕਾਮਪ੍ਰਿਤ	ହକାମପ୍ରିତ
ਹਨ੍ਸ੍ਪਾਲ	ହନ୍ସ୍ପାଲ
ਹਰਕਾਨ੍ਵਾਲ	ହରକାନ୍ଵାଲ
ਹਰਕੀਰਣ	ହରକୀରଣ
ਹਰਗੀਤ	ହରଗୀତ
ਹਰਗੁਰ੍ਮਿਤ (ਮਿਤ )	ହରଗୁର୍ମିତ (ମିତ )
ਹਰਗੋਬੀਨ੍ਦ	ହରଗୋବୀନ୍ଦ
ਹਰਚਰਣ	ହରଚରଣ
ਹਰਜਪ	ହରଜପ
ਹਰਜੀ	ହରଜୀ
ਹਰਜੀਤ	ହରଜୀତ
ਹਰਜੀਨ੍ਦੇਰ	ହରଜୀନ୍ଦେର
ਹਰਜੀਵ	ହରଜୀଵ
ਹਰਜੁਗਤ	ହରଜୁଗତ
ਹਰਜੋਗ	ହରଜୋଗ
ਹਰਜੋਧ	ହରଜୋଧ
ਹਰਜ੍ਯੋਤ	ହରଜ୍ଯୋତ
ਹਰਤਿਰਥ	ହରତିରଥ
ਹਰਤੇਜ੍ਪਾਲ	ହରତେଜ୍ପାଲ
ਹਰਦਯਾਲ	ହରଦଯାଲ
ਹਰਦਾਸ	ହରଦାସ
ਹਰਦਿਪਾ	ହରଦିପା
ਹਰਦੀਪ	ହରଦୀପ
ਹਰਧਨ	ହରଧନ
ਹਰਨਾਮ	ହରନାମ
ਹਰਨਾਰਾਯਣ	ହରନାରାଯଣ
ਹਰਨਿਤ	ହରନିତ
ਹਰਨੀਰ੍ਮਲ	ହରନୀର୍ମଲ
ਹਰਨੀਹਲ	ହରନୀହଲ
ਹਰਪਰ੍ਸਨ੍ਨ	ହରପର୍ସନ୍ନ
ਹਰਪਾਲ	ହରପାଲ
ਹਰਪ੍ਰੇਮ੍ਜੀਤ	ହରପ୍ରେମ୍ଜୀତ
ਹਰਬਿਂਦਰ	ହରବିଂଦର
ਹਰਬਿਰ	ହରବିର
ਹਰਭਗਤ	ହରଭଗତ
ਹਰਮਨਾਦ	ହରମନାଦ
ਹਰਮਾਂਨ੍ਦੇਰ	ହରମାଂନ୍ଦେର
ਹਰਮੀਤ	ହରମୀତ
ਹਰਮੀਲਨ	ହରମୀଲନ
ਹਰਮੂਰਤ	ହରମୂରତ
ਹਰਰਾਈ	ହରରାଈ
ਹਰਰੂਪ	ହରରୂପ
ਹਰਵਂਤ	ହରଵଂତ
ਹਰਵਿਨ	ହରଵିନ
ਹਰਸ਼ਰਣ	ହରଶରଣ
ਹਰਸਿਤਾਲ	ହରସିତାଲ
ਹਰਸੀਮ੍ਰਣ	ହରସୀମ୍ରଣ
ਹਰਸੀਮ੍ਰਨ੍ਜੋਤ	ହରସୀମ୍ରନ୍ଜୋତ
ਹਰਸੀਮ੍ਰਿਤ	ହରସୀମ୍ରିତ
ਹਰਸੁਖ	ହରସୁଖ
ਹਰਾਨੂਪ	ହରାନୂପ
ਹਰਾਮ੍ਰੀਤ	ହରାମ୍ରୀତ
ਹਰਿਕੀਰ੍ਤਨ	ହରିକୀର୍ତନ
ਹਰਿਦਰ੍ਸ਼ਨ	ହରିଦର୍ଶନ
ਹਰਿਨਾਰਾਯਣ	ହରିନାରାଯଣ
ਹਰਿਪ੍ਰੀਤ	ହରିପ୍ରୀତ
ਹਰੀਅਮ੍ਰਿਤ	ହରୀଅମ୍ରିତ
ਹਰੀਸਰੂਪ	ହରୀସରୂପ
ਹਰੀਸੀਮਾਂਰਣ	ହରୀସୀମାଂରଣ
ਹਰ੍ਕਾਰਾਨ੍ਜੀਤ	ହର୍କାରାନ୍ଜୀତ
ਹਰ੍ਕੀਰਨ੍ਜੀਤ	ହର୍କୀରନ୍ଜୀତ
ਹਰ੍ਕੀਰਪਾਲ	ହର୍କୀରପାଲ
ਹਰ੍ਜਸ	ହର୍ଜସ
ਹਰ੍ਤੇਇਜ	ହର୍ତେଇଜ
ਹਰ੍ਨੀਝ	ହର୍ନୀଝ
ਹਰ੍ਬਂਸ	ହର୍ବଂସ
ਹਰ੍ਮਾਂਨਜਿਤ	ହର୍ମାଂନଜିତ
ਹਰ੍ਮਾਂਨਪਾਲ	ହର୍ମାଂନପାଲ
ਹਰ੍ਮੀਨ੍ਦੇਰ	ହର୍ମୀନ୍ଦେର
ਹਰ੍ਮੇਂਦ੍ਰ	ହର୍ମେଂଦ୍ର
ਹਰ੍ਸ਼ਰ੍ਧਾ	ହର୍ଶର୍ଧା
ਹਰ੍ਸ਼ਵਰ੍ਧਨ	ହର୍ଶଵର୍ଧନ
ਹਰ੍ਸ਼ਾਗੁਨ	ହର୍ଶାଗୁନ
ਹਰ੍ਸਿਰਤ	ହର୍ସିରତ
ਹਸਨ	ହସନ
ਹਾਰਭਾਗ	ହାରଭାଗ
ਹਿਤੀਨਦੇਰ	ହିତୀନଦେର
ਹਿਤੇਨਦੇਰ	ହିତେନଦେର
ਹਿਮ੍ਮਤ	ହିମ୍ମତ
ਹਿਰੀਸ਼	ହିରୀଶ
ਹੁਅਲੀਨਾ	ହୁଅଲୀନା
ਹੁਕੁਮਪਰਿਤ	ହୁକୁମପରିତ
ਹੂਜਓਏ	ହୂଜଓଏ
ਹੇਤ	ହେତ
ਹੇਤਬੀਰ	ହେତବୀର
ਹੇਮੀਨਦੇਰ	ହେମୀନଦେର
ਹੇਯ੍ਮਾਂਨ੍ਪ੍ਰਿਤ	ହେଯ୍ମାଂନ୍ପ୍ରିତ
ਹੇਰਹੋ	ହେରହୋ
#
#
# Territory names from CLDR
ਅਸੈਂਸ਼ਨ ਟਾਪੂ	ଅସୈଂଶନ ଟାପୂ
ਅੰਡੋਰਾ	ଅଡୋରା
ਸੰਯੁਕਤ ਅਰਬ ਅਮੀਰਾਤ	ସଯୁକତ ଅରବ ଅମୀରାତ
ਅਫ਼ਗਾਨਿਸਤਾਨ	ଅଫ଼ଗାନିସତାନ
ਐਂਟੀਗੁਆ ਅਤੇ ਬਾਰਬੁਡਾ	ଐଂଟୀଗୁଆ ଅତେ ବାରବୁଡା
ਅੰਗੁਇਲਾ	ଅଗୁଇଲା
ਅਲਬਾਨੀਆ	ଅଲବାନୀଆ
ਅਰਮੀਨੀਆ	ଅରମୀନୀଆ
ਅੰਗੋਲਾ	ଅଗୋଲା
ਅੰਟਾਰਕਟਿਕਾ	ଅଟାରକଟିକା
ਅਰਜਨਟੀਨਾ	ଅରଜନଟୀନା
ਅਮੈਰੀਕਨ ਸਮੋਆ	ଅମୈରୀକନ ସମୋଆ
ਆਸਟਰੀਆ	ଆସଟରୀଆ
ਆਸਟ੍ਰੇਲੀਆ	ଆସଟ୍ରେଲୀଆ
ਅਰੂਬਾ	ଅରୂବା
ਅਲੈਂਡ ਟਾਪੂ	ଅଲୈଂଡ ଟାପୂ
ਅਜ਼ਰਬਾਈਜਾਨ	ଅଜ଼ରବାଈଜାନ
ਬੋਸਨੀਆ ਅਤੇ ਹਰਜ਼ੇਗੋਵੀਨਾ	ବୋସନୀଆ ଅତେ ହରଜ଼େଗୋଵୀନା
ਬਾਰਬਾਡੋਸ	ବାରବାଡୋସ
ਬੰਗਲਾਦੇਸ਼	ବଗଲାଦେଶ
ਬੈਲਜੀਅਮ	ବୈଲଜୀଅମ
ਬੁਰਕੀਨਾ ਫ਼ਾਸੋ	ବୁରକୀନା ଫ଼ାସୋ
ਬੁਲਗਾਰੀਆ	ବୁଲଗାରୀଆ
ਬਹਿਰੀਨ	ବହିରୀନ
ਬੁਰੁੰਡੀ	ବୁରୁଡୀ
ਬੇਨਿਨ	ବେନିନ
ਸੇਂਟ ਬਾਰਥੇਲੇਮੀ	ସେଂଟ ବାରଥେଲେମୀ
ਬਰਮੂਡਾ	ବରମୂଡା
ਬਰੂਨੇਈ	ବରୂନେଈ
ਬੋਲੀਵੀਆ	ବୋଲୀଵୀଆ
ਕੈਰੇਬੀਆਈ ਨੀਦਰਲੈਂਡ	କୈରେବୀଆଈ ନୀଦରଲୈଂଡ
ਬ੍ਰਾਜ਼ੀਲ	ବ୍ରାଜ଼ୀଲ
ਬਹਾਮਾਸ	ବହାମାସ
ਭੂਟਾਨ	ଭୂଟାନ
ਬੌਵੇਟ ਟਾਪੂ	ବୌଵେଟ ଟାପୂ
ਬੋਟਸਵਾਨਾ	ବୋଟସଵାନା
ਬੇਲਾਰੂਸ	ବେଲାରୂସ
ਬੇਲੀਜ਼	ବେଲୀଜ଼
ਕੈਨੇਡਾ	କୈନେଡା
ਕੋਕੋਸ (ਕੀਲਿੰਗ) ਟਾਪੂ	କୋକୋସ (କୀଲିଗ) ଟାପୂ
ਕਾਂਗੋ - ਕਿੰਸ਼ਾਸਾ	କାଂଗୋ - କିଶାସା
ਕਾਂਗੋ ਲੋਕਤੰਤਰੀ ਗਣਰਾਜ	କାଂଗୋ ଲୋକତତରୀ ଗଣରାଜ
ਕੇਂਦਰੀ ਅਫ਼ਰੀਕੀ ਗਣਰਾਜ	କେଂଦରୀ ଅଫ଼ରୀକୀ ଗଣରାଜ
ਕਾਂਗੋ - ਬ੍ਰਾਜ਼ਾਵਿਲੇ	କାଂଗୋ - ବ୍ରାଜ଼ାଵିଲେ
ਕਾਂਗੋ ਗਣਰਾਜ	କାଂଗୋ ଗଣରାଜ
ਸਵਿਟਜ਼ਰਲੈਂਡ	ସଵିଟଜ଼ରଲୈଂଡ
ਕੋਟ ਡੀਵੋਆਰ	କୋଟ ଡୀଵୋଆର
ਆਇਵਰੀ ਕੋਸਟ	ଆଇଵରୀ କୋସଟ
ਕੁੱਕ ਟਾਪੂ	କୁକ ଟାପୂ
ਚਿਲੀ	ଚିଲୀ
ਕੈਮਰੂਨ	କୈମରୂନ
ਚੀਨ	ଚୀନ
ਕੋਲੰਬੀਆ	କୋଲବୀଆ
ਕਲਿੱਪਰਟਨ ਟਾਪੂ	କଲିପରଟନ ଟାପୂ
ਕੋਸਟਾ ਰੀਕਾ	କୋସଟା ରୀକା
ਕਿਊਬਾ	କିଊବା
ਕੇਪ ਵਰਡੇ	କେପ ଵରଡେ
ਕੁਰਾਕਾਓ	କୁରାକାଓ
ਕ੍ਰਿਸਮਿਸ ਟਾਪੂ	କ୍ରିସମିସ ଟାପୂ
ਸਾਇਪ੍ਰਸ	ସାଇପ୍ରସ
ਚੈਕ ਗਣਰਾਜ	ଚୈକ ଗଣରାଜ
ਜਰਮਨੀ	ଜରମନୀ
ਡੀਇਗੋ ਗਾਰਸੀਆ	ଡୀଇଗୋ ଗାରସୀଆ
ਜ਼ੀਬੂਤੀ	ଜ଼ୀବୂତୀ
ਡੈਨਮਾਰਕ	ଡୈନମାରକ
ਡੋਮੀਨਿਕਾ	ଡୋମୀନିକା
ਡੋਮੀਨਿਕਾਈ ਗਣਰਾਜ	ଡୋମୀନିକାଈ ଗଣରାଜ
ਅਲਜੀਰੀਆ	ଅଲଜୀରୀଆ
ਸਿਓਟਾ ਅਤੇ ਮੇਲਿੱਲਾ	ସିଓଟା ଅତେ ମେଲିଲା
ਇਕਵੇਡੋਰ	ଇକଵେଡୋର
ਇਸਟੋਨੀਆ	ଇସଟୋନୀଆ
ਮਿਸਰ	ମିସର
ਪੱਛਮੀ ਸਹਾਰਾ	ପଛମୀ ସହାରା
ਇਰੀਟ੍ਰਿਆ	ଇରୀଟ୍ରିଆ
ਸਪੇਨ	ସପେନ
ਇਥੋਪੀਆ	ଇଥୋପୀଆ
ਯੂਰਪੀ ਯੂਨੀਅਨ	ଯୂରପୀ ଯୂନୀଅନ
ਫਿਨਲੈਂਡ	ଫିନଲୈଂଡ
ਫ਼ਿਜੀ	ଫ଼ିଜୀ
ਫ਼ਾਕਲੈਂਡ ਟਾਪੂ	ଫ଼ାକଲୈଂଡ ଟାପୂ
ਫ਼ਾਕਲੈਂਡ ਟਾਪੂ (ਆਈਲਾਸ ਮਾਲਵਿਨਾਸ)	ଫ଼ାକଲୈଂଡ ଟାପୂ (ଆଈଲାସ ମାଲଵିନାସ)
ਮਾਇਕ੍ਰੋਨੇਸ਼ੀਆ	ମାଇକ୍ରୋନେଶୀଆ
ਫੈਰੋ ਟਾਪੂ	ଫୈରୋ ଟାପୂ
ਫ਼ਰਾਂਸ	ଫ଼ରାଂସ
ਗਬੋਨ	ଗବୋନ
ਯੂਨਾਈਟਡ ਕਿੰਗਡਮ	ଯୂନାଈଟଡ କିଗଡମ
ਗ੍ਰੇਨਾਡਾ	ଗ୍ରେନାଡା
ਜਾਰਜੀਆ	ଜାରଜୀଆ
ਫ਼ਰੈਂਚ ਗੁਆਨਾ	ଫ଼ରୈଂଚ ଗୁଆନା
ਗਰਨਜੀ	ଗରନଜୀ
ਘਾਨਾ	ଘାନା
ਜਿਬਰਾਲਟਰ	ଜିବରାଲଟର
ਗ੍ਰੀਨਲੈਂਡ	ଗ୍ରୀନଲୈଂଡ
ਗੈਂਬੀਆ	ଗୈଂବୀଆ
ਗਿਨੀ	ଗିନୀ
ਗੁਆਡੇਲੋਪ	ଗୁଆଡେଲୋପ
ਭੂ-ਖੰਡੀ ਗਿਨੀ	ଭୂ-ଖଡୀ ଗିନୀ
ਗ੍ਰੀਸ	ଗ୍ରୀସ
ਦੱਖਣੀ ਜਾਰਜੀਆ ਅਤੇ ਦੱਖਣੀ ਸੈਂਡਵਿਚ ਟਾਪੂ	ଦଖଣୀ ଜାରଜୀଆ ଅତେ ଦଖଣୀ ସୈଂଡଵିଚ ଟାପୂ
ਗੁਆਟੇਮਾਲਾ	ଗୁଆଟେମାଲା
ਗੁਆਮ	ଗୁଆମ
ਗਿਨੀ-ਬਿਸਾਉ	ଗିନୀ-ବିସାଉ
ਗੁਯਾਨਾ	ଗୁଯାନା
ਹਾਂਗ ਕਾਂਗ ਐਸਏਆਰ ਚੀਨ	ହାଂଗ କାଂଗ ଐସଏଆର ଚୀନ
ਹਾਂਗ ਕਾਂਗ	ହାଂଗ କାଂଗ
ਹਰਡ ਤੇ ਮੈਕਡੋਨਾਲਡ ਟਾਪੂ	ହରଡ ତେ ମୈକଡୋନାଲଡ ଟାପୂ
ਹੋਂਡੁਰਸ	ହୋଂଡୁରସ
ਕਰੋਏਸ਼ੀਆ	କରୋଏଶୀଆ
ਹੈਤੀ	ହୈତୀ
ਹੰਗਰੀ	ହଗରୀ
ਕੇਨਾਰੀ ਟਾਪੂ	କେନାରୀ ଟାପୂ
ਇੰਡੋਨੇਸ਼ੀਆ	ଇଡୋନେଶୀଆ
ਆਇਰਲੈਂਡ	ଆଇରଲୈଂଡ
ਇਜ਼ਰਾਈਲ	ଇଜ଼ରାଈଲ
ਆਇਲ ਆਫ ਮੈਨ	ଆଇଲ ଆଫ ମୈନ
ਭਾਰਤ	ଭାରତ
ਬਰਤਾਨਵੀ ਹਿੰਦ ਮਹਾਂਸਾਗਰ ਪ੍ਰਦੇਸ਼	ବରତାନଵୀ ହିଦ ମହାଂସାଗର ପ୍ରଦେଶ
ਇਰਾਕ	ଇରାକ
ਈਰਾਨ	ଈରାନ
ਆਈਸਲੈਂਡ	ଆଈସଲୈଂଡ
ਇਟਲੀ	ଇଟଲୀ
ਜਰਸੀ	ଜରସୀ
ਜਮਾਇਕਾ	ଜମାଇକା
ਜਾਰਡਨ	ଜାରଡନ
ਜਪਾਨ	ଜପାନ
ਕੀਨੀਆ	କୀନୀଆ
ਕਿਰਗਿਜ਼ਸਤਾਨ	କିରଗିଜ଼ସତାନ
ਕੰਬੋਡੀਆ	କବୋଡୀଆ
ਕਿਰਬਾਤੀ	କିରବାତୀ
ਕੋਮੋਰੋਸ	କୋମୋରୋସ
ਸੈਂਟ ਕਿਟਸ ਐਂਡ ਨੇਵਿਸ	ସୈଂଟ କିଟସ ଐଂଡ ନେଵିସ
ਉੱਤਰੀ ਕੋਰੀਆ	ଉତରୀ କୋରୀଆ
ਦੱਖਣੀ ਕੋਰੀਆ	ଦଖଣୀ କୋରୀଆ
ਕੁਵੈਤ	କୁଵୈତ
ਕੇਮੈਨ ਟਾਪੂ	କେମୈନ ଟାପୂ
ਕਜ਼ਾਖਸਤਾਨ	କଜ଼ାଖସତାନ
ਲਾਓਸ	ଲାଓସ
ਲੈਬਨਾਨ	ଲୈବନାନ
ਸੇਂਟ ਲੂਸੀਆ	ସେଂଟ ଲୂସୀଆ
ਲਿਚੇਂਸਟਾਇਨ	ଲିଚେଂସଟାଇନ
ਸ੍ਰੀ ਲੰਕਾ	ସ୍ରୀ ଲକା
ਲਾਈਬੀਰੀਆ	ଲାଈବୀରୀଆ
ਲੇਸੋਥੋ	ଲେସୋଥୋ
ਲਿਥੁਆਨੀਆ	ଲିଥୁଆନୀଆ
ਲਕਜ਼ਮਬਰਗ	ଲକଜ଼ମବରଗ
ਲਾਟਵੀਆ	ଲାଟଵୀଆ
ਲੀਬੀਆ	ଲୀବୀଆ
ਮੋਰੱਕੋ	ମୋରକୋ
ਮੋਨਾਕੋ	ମୋନାକୋ
ਮੋਲਡੋਵਾ	ମୋଲଡୋଵା
ਮੋਂਟੇਨੇਗਰੋ	ମୋଂଟେନେଗରୋ
ਸੇਂਟ ਮਾਰਟਿਨ	ସେଂଟ ମାରଟିନ
ਮੈਡਾਗਾਸਕਰ	ମୈଡାଗାସକର
ਮਾਰਸ਼ਲ ਟਾਪੂ	ମାରଶଲ ଟାପୂ
ਮੈਕਡੋਨੀਆ	ମୈକଡୋନୀଆ
ਮੈਕਡੋਨੀਆ (ਪੂਰਵ ਯੂਗੋਸਲਾਵ ਮੈਕਡੋਨੀਆਈ ਗਣਰਾਜ)	ମୈକଡୋନୀଆ (ପୂରଵ ଯୂଗୋସଲାଵ ମୈକଡୋନୀଆଈ ଗଣରାଜ)
ਮਾਲੀ	ମାଲୀ
ਮਿਆਂਮਾਰ (ਬਰਮਾ)	ମିଆଂମାର (ବରମା)
ਮੰਗੋਲੀਆ	ମଗୋଲୀଆ
ਮਕਾਉ ਐਸਏਆਰ ਚੀਨ	ମକାଉ ଐସଏଆର ଚୀନ
ਮਕਾਉ	ମକାଉ
ਉੱਤਰੀ ਮਾਰੀਆਨਾ ਟਾਪੂ	ଉତରୀ ମାରୀଆନା ଟାପୂ
ਮਾਰਟੀਨਿਕ	ମାରଟୀନିକ
ਮੋਰਿਟਾਨੀਆ	ମୋରିଟାନୀଆ
ਮੋਂਟਸੇਰਾਤ	ମୋଂଟସେରାତ
ਮਾਲਟਾ	ମାଲଟା
ਮੌਰਿਸ਼ਸ	ମୌରିଶସ
ਮਾਲਦੀਵ	ମାଲଦୀଵ
ਮਲਾਵੀ	ମଲାଵୀ
ਮੈਕਸੀਕੋ	ମୈକସୀକୋ
ਮਲੇਸ਼ੀਆ	ମଲେଶୀଆ
ਮੋਜ਼ਾਮਬੀਕ	ମୋଜ଼ାମବୀକ
ਨਾਮੀਬੀਆ	ନାମୀବୀଆ
ਨਿਊ ਕੈਲੇਡੋਨੀਆ	ନିଊ କୈଲେଡୋନୀଆ
ਨਾਈਜਰ	ନାଈଜର
ਨੋਰਫੌਕ ਟਾਪੂ	ନୋରଫୌକ ଟାପୂ
ਨਾਈਜੀਰੀਆ	ନାଈଜୀରୀଆ
ਨਿਕਾਰਾਗੁਆ	ନିକାରାଗୁଆ
ਨੀਦਰਲੈਂਡ	ନୀଦରଲୈଂଡ
ਨਾਰਵੇ	ନାରଵେ
ਨੇਪਾਲ	ନେପାଲ
ਨਾਉਰੂ	ନାଉରୂ
ਨਿਯੂ	ନିଯୂ
ਨਿਊਜ਼ੀਲੈਂਡ	ନିଊଜ଼ୀଲୈଂଡ
ਓਮਾਨ	ଓମାନ
ਪਨਾਮਾ	ପନାମା
ਪੇਰੂ	ପେରୂ
ਫਰੈਂਚ ਪੋਲੀਨੇਸ਼ੀਆ	ଫରୈଂଚ ପୋଲୀନେଶୀଆ
ਪਾਪੂਆ ਨਿਊ ਗਿਨੀ	ପାପୂଆ ନିଊ ଗିନୀ
ਫਿਲੀਪੀਂਸ	ଫିଲୀପୀଂସ
ਪਾਕਿਸਤਾਨ	ପାକିସତାନ
ਪੋਲੈਂਡ	ପୋଲୈଂଡ
ਸੈਂਟ ਪੀਅਰੇ ਐਂਡ ਮਿਕੇਲਨ	ସୈଂଟ ପୀଅରେ ଐଂଡ ମିକେଲନ
ਪਿਟਕੇਰਨ ਟਾਪੂ	ପିଟକେରନ ଟାପୂ
ਪਿਊਰਟੋ ਰਿਕੋ	ପିଊରଟୋ ରିକୋ
ਫਿਲੀਸਤੀਨੀ ਖੇਤਰ	ଫିଲୀସତୀନୀ ଖେତର
ਫਿਲੀਸਤੀਨ	ଫିଲୀସତୀନ
ਪੁਰਤਗਾਲ	ପୁରତଗାଲ
ਪਲਾਉ	ପଲାଉ
ਪੈਰਾਗਵੇ	ପୈରାଗଵେ
ਕਤਰ	କତର
ਆਊਟਲਾਇੰਗ ਓਸ਼ੀਨੀਆ	ଆଊଟଲାଇଗ ଓଶୀନୀଆ
ਰਿਯੂਨੀਅਨ	ରିଯୂନୀଅନ
ਰੋਮਾਨੀਆ	ରୋମାନୀଆ
ਸਰਬੀਆ	ସରବୀଆ
ਰੂਸ	ରୂସ
ਰਵਾਂਡਾ	ରଵାଂଡା
ਸਾਊਦੀ ਅਰਬ	ସାଊଦୀ ଅରବ
ਸੋਲੋਮਨ ਟਾਪੂ	ସୋଲୋମନ ଟାପୂ
ਸੇਸ਼ਲਸ	ସେଶଲସ
ਸੂਡਾਨ	ସୂଡାନ
ਸਵੀਡਨ	ସଵୀଡନ
ਸਿੰਗਾਪੁਰ	ସିଗାପୁର
ਸੇਂਟ ਹੇਲੇਨਾ	ସେଂଟ ହେଲେନା
ਸਲੋਵੇਨੀਆ	ସଲୋଵେନୀଆ
ਸਵਾਲਬਰਡ ਅਤੇ ਜਾਨ ਮਾਯੇਨ	ସଵାଲବରଡ ଅତେ ଜାନ ମାଯେନ
ਸਲੋਵਾਕੀਆ	ସଲୋଵାକୀଆ
ਸਿਏਰਾ ਲਿਓਨ	ସିଏରା ଲିଓନ
ਸੈਨ ਮਰੀਨੋ	ସୈନ ମରୀନୋ
ਸੇਨੇਗਲ	ସେନେଗଲ
ਸੋਮਾਲੀਆ	ସୋମାଲୀଆ
ਸੂਰੀਨਾਮ	ସୂରୀନାମ
ਦੱਖਣੀ ਸੂਡਾਨ	ଦଖଣୀ ସୂଡାନ
ਸਾਓ ਟੋਮ ਅਤੇ ਪ੍ਰਿੰਸੀਪੇ	ସାଓ ଟୋମ ଅତେ ପ୍ରିସୀପେ
ਅਲ ਸਲਵਾਡੋਰ	ଅଲ ସଲଵାଡୋର
ਸਿੰਟ ਮਾਰਟੀਨ	ସିଟ ମାରଟୀନ
ਸੀਰੀਆ	ସୀରୀଆ
ਸਵਾਜ਼ੀਲੈਂਡ	ସଵାଜ଼ୀଲୈଂଡ
ਟ੍ਰਿਸਟਾਨ ਦਾ ਕੁੰਹਾ	ଟ୍ରିସଟାନ ଦା କୁହା
ਟੁਰਕਸ ਅਤੇ ਕੈਕੋਸ ਟਾਪੂ	ଟୁରକସ ଅତେ କୈକୋସ ଟାପୂ
ਚਾਡ	ଚାଡ
ਫਰੈਂਚ ਦੱਖਣੀ ਪ੍ਰਦੇਸ਼	ଫରୈଂଚ ଦଖଣୀ ପ୍ରଦେଶ
ਟੋਗੋ	ଟୋଗୋ
ਥਾਈਲੈਂਡ	ଥାଈଲୈଂଡ
ਤਾਜਿਕਿਸਤਾਨ	ତାଜିକିସତାନ
ਟੋਕੇਲਾਉ	ଟୋକେଲାଉ
ਤਿਮੋਰ-ਲੇਸਤੇ	ତିମୋର-ଲେସତେ
ਪੂਰਬੀ ਤਿਮੋਰ	ପୂରବୀ ତିମୋର
ਤੁਰਕਮੇਨਿਸਤਾਨ	ତୁରକମେନିସତାନ
ਟਿਊਨੀਸ਼ੀਆ	ଟିଊନୀଶୀଆ
ਟੌਂਗਾ	ଟୌଂଗା
ਤੁਰਕੀ	ତୁରକୀ
ਟ੍ਰਿਨੀਡਾਡ ਅਤੇ ਟੋਬਾਗੋ	ଟ୍ରିନୀଡାଡ ଅତେ ଟୋବାଗୋ
ਟੁਵਾਲੂ	ଟୁଵାଲୂ
ਤਾਇਵਾਨ	ତାଇଵାନ
ਤਨਜ਼ਾਨੀਆ	ତନଜ଼ାନୀଆ
ਯੂਕਰੇਨ	ଯୂକରେନ
ਯੂਗਾਂਡਾ	ଯୂଗାଂଡା
ਸੰਯੁਕਤ ਰਾਜ	ସଯୁକତ ରାଜ
ਉਰੂਗਵੇ	ଉରୂଗଵେ
ਉਜ਼ਬੇਕਿਸਤਾਨ	ଉଜ଼ବେକିସତାନ
ਵੈਟੀਕਨ ਸਿਟੀ	ଵୈଟୀକନ ସିଟୀ
ਸੇਂਟ ਵਿਨਸੈਂਟ ਐਂਡ ਗ੍ਰੇਨਾਡੀਨਸ	ସେଂଟ ଵିନସୈଂଟ ଐଂଡ ଗ୍ରେନାଡୀନସ
ਵੇਨੇਜ਼ੂਏਲਾ	ଵେନେଜ଼ୂଏଲା
ਬ੍ਰਿਟਿਸ਼ ਵਰਜਿਨ ਟਾਪੂ	ବ୍ରିଟିଶ ଵରଜିନ ଟାପୂ
ਯੂ ਐਸ ਵਰਜਿਨ ਟਾਪੂ	ଯୂ ଐସ ଵରଜିନ ଟାପୂ
ਵੀਅਤਨਾਮ	ଵୀଅତନାମ
ਵਾਨੂਆਟੂ	ଵାନୂଆଟୂ
ਵਾਲਿਸ ਅਤੇ ਫੂਟੂਨਾ	ଵାଲିସ ଅତେ ଫୂଟୂନା
ਸਾਮੋਆ	ସାମୋଆ
ਕੋਸੋਵੋ	କୋସୋଵୋ
ਯਮਨ	ଯମନ
ਮਾਯੋਟੀ	ମାଯୋଟୀ
ਦੱਖਣੀ ਅਫਰੀਕਾ	ଦଖଣୀ ଅଫରୀକା
ਜ਼ਾਮਬੀਆ	ଜ଼ାମବୀଆ
ਜ਼ਿੰਬਾਬਵੇ	ଜ଼ିବାବଵେ
ਅਣਪਛਾਤਾ ਖੇਤਰ	ଅଣପଛାତା ଖେତର
