# Baby names
അകര്ശാനാ	ਅਕਰ੍ਸ਼ਾਨਾ
അക്ശൈനീഏ	ਅਕ੍ਸ਼ੈਨੀਏ
അഗജാ	ਅਗਜਾ
അചിംത	ਅਚਿਂਤ
അചിത	ਅਚਿਤ
അച്ചിന്ദ്ര	ਅਚ੍ਚਿਨ੍ਦ੍ਰ
അഡ്യാദവൈതാ	ਅਡ੍ਯਾਦਵੈਤਾ
അദഭുതഃ	ਅਦਭੁਤ
അദേന്യ	ਅਦੇਨ੍ਯ
അദേല	ਅਦੇਲ
അദ്രിതീ	ਅਦ੍ਰਿਤੀ
അദ്രീഥീ	ਅਦ੍ਰੀਥੀ
അദ്രീമാം	ਅਦ੍ਰੀਮਾਂ
അദ്വൈയാ	ਅਦ੍ਵੈਯਾ
അധര്ഷ	ਅਧਰ੍ਸ਼
അധിപാ	ਅਧਿਪਾ
അധീരതാ	ਅਧੀਰਤਾ
അധ്യുത	ਅਧ੍ਯੁਤ
അനംതാമായാ	ਅਨੰਤਾਮਾਯਾ
അബരനാ	ਅਬਰਨਾ
അബിനയ	ਅਬਿਨਯ
അബിനാ	ਅਬਿਨਾ
അബീനംദാ	ਅਬੀਨੰਦਾ
അബീശാ	ਅਬੀਸ਼ਾ
അഭയ	ਅਭਯ
അഭയന	ਅਭਯਨ
അഭിഗ്ന്യാ	ਅਭਿਗ੍ਨ੍ਯਾ
അഭിജീതാ	ਅਭਿਜੀਤਾ
അഭിനിവേശ	ਅਭਿਨਿਵੇਸ਼
അഭിമ	ਅਭਿਮ
അഭിമാനീ	ਅਭਿਮਾਨੀ
അഭിമോദാ	ਅਭਿਮੋਦਾ
അഭിരാ	ਅਭਿਰਾ
അഭിരാത	ਅਭਿਰਾਤ
അഭീരല	ਅਭੀਰਲ
അഭീശ്രേയ	ਅਭੀਸ਼੍ਰੇਯ
അഭീസുമത	ਅਭੀਸੁਮਤ
അഭ്യപ്സീത	ਅਭ੍ਯਪ੍ਸੀਤ
അഭ്യുദയാ	ਅਭ੍ਯੁਦਯਾ
അമൃതാ	ਅਮਤਾ
അലകനംദാ	ਅਲਕਨੰਦਾ
അലക്ഷാ	ਅਲਕ੍ਸ਼ਾ
അല്കാ	ਅਲ੍ਕਾ
അശവ	ਅਸ਼ਵ
അശ്നേഇല	ਅਸ਼੍ਨੇਇਲ
ആകാശലീനാ	ਆਕਾਸ਼ਲੀਨਾ
ആകൃഥീ	ਆਕਥੀ
ആക്ഷ്യാ	ਆਕ੍ਸ਼੍ਯਾ
ആചാര്യ	ਆਚਾਰ੍ਯ
ആത്മയ	ਆਤ੍ਮਯ
ആദി	ਆਦਿ
ആദിമ	ਆਦਿਮ
ആദീവ	ਆਦੀਵ
ആധീരേന	ਆਧੀਰੇਨ
ആധ്യാ	ਆਧ੍ਯਾ
ആനംദീനീ	ਆਨੰਦੀਨੀ
ആനീകാ	ਆਨੀਕਾ
ആന്തീകാ	ਆਨ੍ਤੀਕਾ
ആന്വീ	ਆਨ੍ਵੀ
ആപ്ത	ਆਪ੍ਤ
ആപ്തി	ਆਪ੍ਤਿ
ആമാംനീ	ਆਮਾਂਨੀ
ആമിഷ	ਆਮਿਸ਼
ആമുക്ഥാ	ਆਮੁਕ੍ਥਾ
ആയുസ	ਆਯੁਸ
ആയോദ	ਆਯੋਦ
ആരംഭീ	ਆਰੰਭੀ
ആരതീ	ਆਰਤੀ
ആരസീ	ਆਰਸੀ
ആര്യ	ਆਰ੍ਯ
ആര്യക	ਆਰ੍ਯਕ
ആര്യനാ	ਆਰ੍ਯਨਾ
ആര്യമാനീ	ਆਰ੍ਯਮਾਨੀ
ആലേഃയാ	ਆਲੇਯਾ
ആവംശ	ਆਵੰਸ਼
ആവേശ	ਆਵੇਸ਼
ആശകാ	ਆਸ਼ਕਾ
ആശിയാനാ	ਆਸ਼ਿਯਾਨਾ
ആശുതോഷ	ਆਸ਼ੁਤੋਸ਼
ആശ്മീന	ਆਸ਼੍ਮੀਨ
ആശ്വിത	ਆਸ਼੍ਵਿਤ
ആസവ	ਆਸਵ
ആസ്തിക	ਆਸ੍ਤਿਕ
ഇക്ശാനാ	ਇਕ੍ਸ਼ਾਨਾ
ഇജയാ	ਇਜਯਾ
ഇനീയന	ਇਨੀਯਨ
ഇനോദയ	ਇਨੋਦਯ
ഇന്ദരകാന്ത	ਇਨ੍ਦਰਕਾਨ੍ਤ
ഇന്ദിവാരസ	ਇਨ੍ਦਿਵਾਰਸ
ഇന്ദുശിതാലാ	ਇਨ੍ਦੁਸ਼ਿਤਾਲਾ
ഇന്ദ്രജാ	ਇਨ੍ਦ੍ਰਜਾ
ഇന്ദ്രതന	ਇਨ੍ਦ੍ਰਤਨ
ഇന്ദ്രദയുമ്ന	ਇਨ੍ਦ੍ਰਦਯੁਮ੍ਨ
ഇന്ദ്രവദന	ਇਨ੍ਦ੍ਰਵਦਨ
ഇന്ദ്രാണീ	ਇਨ੍ਦ੍ਰਾਣੀ
ഇബ്ബാനീ	ਇਬ੍ਬਾਨੀ
ഇയുരേശ	ਇਯੁਰੇਸ਼
ഇയേനഗര	ਇਯੇਨਗਰ
ഇരാജ	ਇਰਾਜ
ഇരിത	ਇਰਿਤ
ഇരേശ	ਇਰੇਸ਼
ഇലിസാ	ਇਲਿਸਾ
ഇശിതാ	ਇਸ਼ਿਤਾ
ഇശ്വാര്യ	ਇਸ਼੍ਵਾਰ੍ਯ
ഇഷ്ടാ	ਇਸ਼੍ਟਾ
ഇഷ്ടി	ਇਸ਼੍ਟਿ
ഇസാര	ਇਸਾਰ
ഇസ്ശും	ਇਸ੍ਸ਼ੁਂ
ഈതന	ਈਤਨ
ഈതികാ	ਈਤਿਕਾ
ഈരേന്പ്രിത	ਈਰੇਨ੍ਪ੍ਰਿਤ
ഈര്ശീതാ	ਈਰ੍ਸ਼ੀਤਾ
ഈലാക്കീയാ	ਈਲਾਕ੍ਕੀਯਾ
ഈലികാ	ਈਲਿਕਾ
ഈലേശാ	ਈਲੇਸ਼ਾ
ഈശാര	ਈਸ਼ਾਰ
ഈശിക	ਈਸ਼ਿਕ
ഈശ്വരദത്ത	ਈਸ਼੍ਵਰਦਤ੍ਤ
ഈഹാ	ਈਹਾ
ഉഗ്രസ്രവാസ	ਉਗ੍ਰਸ੍ਰਵਾਸ
ഉജവണീ	ਉਜਵਣੀ
ഉജേശാ	ਉਜੇਸ਼ਾ
ഉജ്ജന	ਉਜ੍ਜਨ
ഉജ്ജവല	ਉਜ੍ਜਵਲ
ഉജ്ജവാലാ	ਉਜ੍ਜਵਾਲਾ
ഉജ്ജ്വലാ /ഉജ്വലാ	ਉਜ੍ਜ੍ਵਲਾ /ਉਜ੍ਵਲਾ
ഉജ്ജ്വാലാ	ਉਜ੍ਜ੍ਵਾਲਾ
ഉത്കര്ഷ	ਉਤ੍ਕਰ੍ਸ਼
ഉത്കലാ	ਉਤ੍ਕਲਾ
ഉത്തര	ਉਤ੍ਤਰ
ഉത്പര	ਉਤ੍ਪਰ
ഉത്സര്ഗ	ਉਤ੍ਸਰ੍ਗ
ഉദയ കുമാര	ਉਦਯ ਕੁਮਾਰ
ഉദരഥീ	ਉਦਰਥੀ
ഉദാന്തികാ	ਉਦਾਨ੍ਤਿਕਾ
ഉദേയ	ਉਦੇਯ
ഉദ്ധാര	ਉਦ੍ਧਾਰ
ഉദ്യത	ਉਦ੍ਯਤ
ഉദ്യമീ	ਉਦ੍ਯਮੀ
ഉദ്യോത	ਉਦ੍ਯੋਤ
ഉധവ	ਉਧਵ
ഉപംഗ	ਉਪੰਗ
ഉപദാ	ਉਪਦਾ
ഉപാധ്രീതീ	ਉਪਾਧ੍ਰੀਤੀ
ഉപ്പാസ	ਉਪ੍ਪਾਸ
ഉമാ	ਉਮਾ
ഉമേശ്വര	ਉਮੇਸ਼੍ਵਰ
ഉരിശിതാ	ਉਰਿਸ਼ਿਤਾ
ഉര്ജാ	ਉਰ੍ਜਾ
ഉര്ജീകാ	ਉਰ੍ਜੀਕਾ
ഉര്ജീതാ	ਉਰ੍ਜੀਤਾ
ഉര്ദാഹാവ	ਉਰ੍ਦਾਹਾਵ
ഉര്മികാ	ਉਰ੍ਮਿਕਾ
ഉര്മിമാലാ	ਉਰ੍ਮਿਮਾਲਾ
ഉര്വീനാഥ	ਉਰ੍ਵੀਨਾਥ
ഉല്പേശ	ਉਲ੍ਪੇਸ਼
ഉശേന്യ	ਉਸ਼ੇਨ੍ਯ
ഉഷാശി	ਉਸ਼ਾਸ਼ਿ
ഉഷ്മാ	ਉਸ਼੍ਮਾ
ഉസരീ	ਉਸਰੀ
ഊതരാ	ਊਤਰਾ
ഊര്വേശ	ਊਰ੍ਵੇਸ਼
ഏകംശീ	ਏਕੰਸ਼ੀ
ഏകക്ഷരപരാ	ਏਕਕ੍ਸ਼ਰਪਰਾ
ഏകതന	ਏਕਤਨ
ഏകതാ	ਏਕਤਾ
ഏകാംശ	ਏਕਾਂਸ਼
ഏകാകാന്യ	ਏਕਾਕਾਨ੍ਯ
ഏകാനീ	ਏਕਾਨੀ
ഏകാപര്നികാ	ਏਕਾਪਰ੍ਨਿਕਾ
ഏകേസ്വാര	ਏਕੇਸ੍ਵਾਰ
ഏത്തന	ਏਤ੍ਤਨ
ഏധിത	ਏਧਿਤ
ഏമാ	ਏਮਾ
ഏലനാ	ਏਲਨਾ
ഏലാ	ਏਲਾ
ഏലീലവേംദന	ਏਲੀਲਵੇਂਦਨ
ഏലീലീ	ਏਲੀਲੀ
ഓഈസീന	ਓਈਸੀਨ
ഓജസ്വീ	ਓਜਸ੍ਵੀ
ഓജാ	ਓਜਾ
ഓജീസ	ਓਜੀਸ
ഓനിശ	ਓਨਿਸ਼
ഓമപ്രകാശ	ਓਮਪ੍ਰਕਾਸ਼
ഓവീന	ਓਵੀਨ
ഓവൈസ	ਓਵੈਸ
കംജ	ਕੰਜ
കംജന	ਕੰਜਨ
കംഠന	ਕੰਠਨ
കംദര്പ	ਕੰਦਰ੍ਪ
കംപനാ	ਕੰਪਨਾ
കകോന	ਕਕੋਨ
കതകീ	ਕਤਕੀ
കതേല്യ്ന	ਕਤੇਲ੍ਯ੍ਨ
കനക	ਕਨਕ
കനദ	ਕਨਦ
കനാകംഗീ	ਕਨਾਕੰਗੀ
കനീജാ	ਕਨੀਜਾ
കനീരാ	ਕਨੀਰਾ
കനീസാ	ਕਨੀਸਾ
കനുഷ	ਕਨੁਸ਼
കന്വക	ਕਨ੍ਵਕ
കന്ശീകാ	ਕਨ੍ਸ਼ੀਕਾ
കപാലീന	ਕਪਾਲੀਨ
കപിലാശ്വര	ਕਪਿਲਾਸ਼੍ਵਰ
കമലാപതി	ਕਮਲਾਪਤਿ
കമലിനീ	ਕਮਲਿਨੀ
കമലേക്ഷണ	ਕਮਲੇਕ੍ਸ਼ਣ
കമ്നാ	ਕਮ੍ਨਾ
കരാലാ	ਕਰਾਲਾ
കരീസമാം	ਕਰੀਸਮਾਂ
കരുനാസ്രീ	ਕਰੁਨਾਸ੍ਰੀ
കരുപ്പസമ്യ	ਕਰੁਪ੍ਪਸਮ੍ਯ
കര്ണ	ਕਰ੍ਣ
കര്തീഗാ	ਕਰ੍ਤੀਗਾ
കര്മദീപ	ਕਰ੍ਮਦੀਪ
കര്മാശ	ਕਰ੍ਮਾਸ਼
കലരനീ	ਕਲਰਨੀ
കലശ	ਕਲਸ਼
കലാധര	ਕਲਾਧਰ
കലാനിധി	ਕਲਾਨਿਧਿ
കലാപരണ	ਕਲਾਪਰਣ
കലാപീന	ਕਲਾਪੀਨ
കലാപ്രിയാ	ਕਲਾਪ੍ਰਿਯਾ
കലൈസേലവീ	ਕਲੈਸੇਲਵੀ
കവന	ਕਵਨ
കവിപ  പ്രിയ	ਕਵਿਪ  ਪ੍ਰਿਯ
കവീനാഥ	ਕਵੀਨਾਥ
കശ്തീ	ਕਸ਼੍ਤੀ
കാജല	ਕਾਜਲ
കാജീശ	ਕਾਜੀਸ਼
കാദമ്ബരീ	ਕਾਦਮ੍ਬਰੀ
കാധിരോലീ	ਕਾਧਿਰੋਲੀ
കാനീ	ਕਾਨੀ
കാന്ജീരാ	ਕਾਨ੍ਜੀਰਾ
കാന്തീ	ਕਾਨ੍ਤੀ
കാമത	ਕਾਮਤ
കാമിഷാ	ਕਾਮਿਸ਼ਾ
കാമേശ	ਕਾਮੇਸ਼
കാരുണ്യ പ്രകാശ	ਕਾਰੁਣ੍ਯ ਪ੍ਰਕਾਸ਼
കാരൂകാ	ਕਾਰੂਕਾ
കാര്നിക	ਕਾਰ੍ਨਿਕ
കാലിക	ਕਾਲਿਕ
കാലിപദാ	ਕਾਲਿਪਦਾ
കാലിയാ	ਕਾਲਿਯਾ
കാലീതാ	ਕਾਲੀਤਾ
കാവ്യ ശ്രീ	ਕਾਵ੍ਯ ਸ਼੍ਰੀ
കിന്നേരാ	ਕਿਨ੍ਨੇਰਾ
കീഅനാ	ਕੀਅਨਾ
കീജല	ਕੀਜਲ
കീനാരീ	ਕੀਨਾਰੀ
കീന്ചനാ	ਕੀਨ੍ਚਨਾ
കേകലാ	ਕੇਕਲਾ
കേതന	ਕੇਤਨ
കേനിഷാ	ਕੇਨਿਸ਼ਾ
കേളവ്യ	ਕੇਲਵ੍ਯ
കൈരവീ	ਕੈਰਵੀ
കൈലാശ	ਕੈਲਾਸ਼
കോശേല	ਕੋਸ਼ੇਲ
കൌശികാ	ਕੌਸ਼ਿਕਾ
ഖഗേശ	ਖਗੇਸ਼
ഖമീശ	ਖਮੀਸ਼
ഖാതീരാവണ	ਖਾਤੀਰਾਵਣ
ഖാത്വന്ഗീന	ਖਾਤ੍ਵਨ੍ਗੀਨ
ഖീലതീ	ਖੀਲਤੀ
ഖുസീ	ਖੁਸੀ
ഗംഗാ	ਗੰਗਾ
ഗംദേശാ	ਗੰਦੇਸ਼ਾ
ഗംധാര	ਗੰਧਾਰ
ഗംധാരാ	ਗੰਧਾਰਾ
ഗംധാലീ	ਗੰਧਾਲੀ
ഗഗന	ਗਗਨ
ഗജവദന	ਗਜਵਦਨ
ഗജേന്ദ്ര	ਗਜੇਨ੍ਦ੍ਰ
ഗണക	ਗਣਕ
ഗണനാ പംഡിതന	ਗਣਨਾ ਪੰਡਿਤਨ
ഗണനാഥ	ਗਣਨਾਥ
ഗണ്യാ	ਗਣ੍ਯਾ
ഗതി	ਗਤਿ
ഗനേസന	ਗਨੇਸਨ
ഗന്ഗസീരുവന	ਗਨ੍ਗਸੀਰੁਵਨ
ഗയാലികാ	ਗਯਾਲਿਕਾ
ഗരിമാ	ਗਰਿਮਾ
ഗരിഷ്ട	ਗਰਿਸ਼੍ਟ
ഗരുല	ਗਰੁਲ
ഗാഇശ	ਗਾਇਸ਼
ഗാന്ഗമൈന്ദന	ਗਾਨ੍ਗਮੈਨ੍ਦਨ
ഗാമിനീ	ਗਾਮਿਨੀ
ഗായത്രീ	ਗਾਯਤ੍ਰੀ
ഗായലേ	ਗਾਯਲੇ
ഗിഅന	ਗਿਅਨ
ഗിയാ	ਗਿਯਾ
ഗിരിവര	ਗਿਰਿਵਰ
ഗീതി	ਗੀਤਿ
ഗീതീശാ	ਗੀਤੀਸ਼ਾ
ഗുംജാ	ਗੁਂਜਾ
ഗുനാജാ	ਗੁਨਾਜਾ
ഗുനാരത്നാ	ਗੁਨਾਰਤ੍ਨਾ
ഗുനാശേകാര	ਗੁਨਾਸ਼ੇਕਾਰ
ഗുനീന	ਗੁਨੀਨ
ഗുന്ജീതാ	ਗੁਨ੍ਜੀਤਾ
ഗുപ്തക	ਗੁਪ੍ਤਕ
ഗുരദയാല	ਗੁਰਦਯਾਲ
ഗുരദേവ	ਗੁਰਦੇਵ
ഗുരബാനീ	ਗੁਰਬਾਨੀ
ഗുരമാന	ਗੁਰਮਾਨ
ഗുരുത്തമ	ਗੁਰੁਤ੍ਤਮ
ഗുര്നാന്ഡീശ	ਗੁਰ੍ਨਾਨ੍ਡੀਸ਼
ഗുലമോഹര	ਗੁਲਮੋਹਰ
ഗുവീദ	ਗੁਵੀਦ
ഗൂംജീതാ	ਗੂਂਜੀਤਾ
ഗൂഹാരീ	ਗੂਹਾਰੀ
ഗേനേലിയാ	ਗੇਨੇਲਿਯਾ
ഗേശനാ	ਗੇਸ਼ਨਾ
ഗോപാല	ਗੋਪਾਲ
ഗോപീ നാഥ	ਗੋਪੀ ਨਾਥ
ഗോഭില	ਗੋਭਿਲ
ഗോരഖ-നാഥ	ਗੋਰਖ-ਨਾਥ
ഗൌരവീ	ਗੌਰਵੀ
ഗൌരീകാംത	ਗੌਰੀਕਾਂਤ
ഗൌരീശ	ਗੌਰੀਸ਼
ഗൌര്പ്രിയാ	ਗੌਰ੍ਪ੍ਰਿਯਾ
ഗ്രീതേശ	ਗ੍ਰੀਤੇਸ਼
ഗ്രീവാ	ਗ੍ਰੀਵਾ
ഗ്രീശ്മീതാ	ਗ੍ਰੀਸ਼੍ਮੀਤਾ
ഗ്രീഷ്മ	ਗ੍ਰੀਸ਼੍ਮ
ഘടോതകത്ചാ	ਘਟੋਤਕਤ੍ਚਾ
ചംചലാ	ਚੰਚਲਾ
ചംദേര്ഭാന	ਚੰਦੇਰ੍ਭਾਨ
ചംദ്രകാംത	ਚੰਦ੍ਰਕਾਂਤ
ചംദ്രകാംതാ	ਚੰਦ੍ਰਕਾਂਤਾ
ചംദ്രചുര	ਚੰਦ੍ਰਚੁਰ
ചംദ്രപുശ്പാ	ਚੰਦ੍ਰਪੁਸ਼੍ਪਾ
ചംദ്രപ്രകാശ	ਚੰਦ੍ਰਪ੍ਰਕਾਸ਼
ചംദ്രമതി	ਚੰਦ੍ਰਮਤਿ
ചംദ്രലേഖാ	ਚੰਦ੍ਰਲੇਖਾ
ചംദ്രഹാസ	ਚੰਦ੍ਰਹਾਸ
ചംദ്രാനന	ਚੰਦ੍ਰਾਨਨ
ചംദ്രാഭാ	ਚੰਦ੍ਰਾਭਾ
ചംദ്രേശ	ਚੰਦ੍ਰੇਸ਼
ചകേശ	ਚਕੇਸ਼
ചകോര	ਚਕੋਰ
ചക്ഷസ	ਚਕ੍ਸ਼ਸ
ചതുര	ਚਤੁਰ
ചതുരാ	ਚਤੁਰਾ
ചതുര്ഭുജാ	ਚਤੁਰ੍ਭੁਜਾ
ചതുര്വേദീ	ਚਤੁਰ੍ਵੇਦੀ
ചത്രീയാ	ਚਤ੍ਰੀਯਾ
ചന്ദ്രകേതു	ਚਨ੍ਦ੍ਰਕੇਤੁ
ചരണ	ਚਰਣ
ചരന്യാ	ਚਰਨ੍ਯਾ
ചലാമാ	ਚਲਾਮਾ
ചാംദ	ਚਾਂਦ
ചാനാസ്യാ	ਚਾਨਾਸ੍ਯਾ
ചാനേ	ਚਾਨੇ
ചാന്ദനികാ	ਚਾਨ੍ਦਨਿਕਾ
ചാരുന	ਚਾਰੁਨ
ചാരുവീ	ਚਾਰੁਵੀ
ചാര്മീ	ਚਾਰ੍ਮੀ
ചാര്വീ	ਚਾਰ੍ਵੀ
ചാവ്രിക	ਚਾਵ੍ਰਿਕ
ചിത്കലാ	ਚਿਤ੍ਕਲਾ
ചിത്ത	ਚਿਤ੍ਤ
ചിത്തപ്രസാദ	ਚਿਤ੍ਤਪ੍ਰਸਾਦ
ചിത്തരംജന	ਚਿਤ੍ਤਰੰਜਨ
ചിത്തരംജനീ	ਚਿਤ੍ਤਰੰਜਨੀ
ചിത്രകുന്ധാലാ	ਚਿਤ੍ਰਕੁਨ੍ਧਾਲਾ
ചിത്രകേതു	ਚਿਤ੍ਰਕੇਤੁ
ചിത്രഗംധാ	ਚਿਤ੍ਰਗੰਧਾ
ചിത്രബാനാ	ਚਿਤ੍ਰਬਾਨਾ
ചിത്രമാലാ	ਚਿਤ੍ਰਮਾਲਾ
ചിത്രര്ത	ਚਿਤ੍ਰਰ੍ਤ
ചിത്രല	ਚਿਤ੍ਰਲ
ചിത്രലേഖാ	ਚਿਤ੍ਰਲੇਖਾ
ചിത്രാദീപ	ਚਿਤ੍ਰਾਦੀਪ
ചിത്രീനീ	ਚਿਤ੍ਰੀਨੀ
ചിദംബര	ਚਿਦੰਬਰ
ചിദാനംദാ	ਚਿਦਾਨੰਦਾ
ചിനാര	ਚਿਨਾਰ
ചിന്നാദുരാഈ	ਚਿਨ੍ਨਾਦੁਰਾਈ
ചിമന	ਚਿਮਨ
ചീദാര്ത	ਚੀਦਾਰ੍ਤ
ചീന്മയേ	ਚੀਨ੍ਮਯੇ
ചീരുഷ	ਚੀਰੁਸ਼
ചേതന്ദീപ	ਚੇਤਨ੍ਦੀਪ
ചേതള	ਚੇਤਲ
ചേഥാസാ	ਚੇਥਾਸਾ
ചേമ്മല	ਚੇਮ੍ਮਲ
ചേര്വിക	ਚੇਰ੍ਵਿਕ
ചേലന	ਚੇਲਨ
ചേലിയാഁ	ਚੇਲਿਯਾഁ
ചൈതന്യാ	ਚੈਤਨ੍ਯਾ
ചൈത്രാ	ਚੈਤ੍ਰਾ
ചൈരാവലീ	ਚੈਰਾਵਲੀ
ഛായാംക	ਛਾਯਾਂਕ
ജക്ഷ	ਜਕ੍ਸ਼
ജക്ഷാനീ	ਜਕ੍ਸ਼ਾਨੀ
ജഗതപ്രകാശ	ਜਗਤਪ੍ਰਕਾਸ਼
ജഗദഗുരു	ਜਗਦਗੁਰੁ
ജഗദമ്ബാ	ਜਗਦਮ੍ਬਾ
ജഗനമോഹിനീ	ਜਗਨਮੋਹਿਨੀ
ജഗന്മയീ	ਜਗਨ੍ਮਯੀ
ജഗ്വീ	ਜਗ੍ਵੀ
ജഗ്വീര	ਜਗ੍ਵੀਰ
ജജ്വാല്യാ	ਜਜ੍ਵਾਲ੍ਯਾ
ജടായു	ਜਟਾਯੁ
ജനഹിതാ	ਜਨਹਿਤਾ
ജനാദേവ	ਜਨਾਦੇਵ
ജനാവ	ਜਨਾਵ
ജനിത	ਜਨਿਤ
ജമാംദാഗ്ന്യ മഹാദാര്പാ	ਜਮਾਂਦਾਗ੍ਨ੍ਯ ਮਹਾਦਾਰ੍ਪਾ
ജമ്ബവതപ്രീതി	ਜਮ੍ਬਵਤਪ੍ਰੀਤਿ
ജയംത	ਜਯੰਤ
ജയചംദ	ਜਯਚੰਦ
ജയപാല	ਜਯਪਾਲ
ജയമാലാ	ਜਯਮਾਲਾ
ജയശ്രീ	ਜਯਸ਼੍ਰੀ
ജയാകീര്തന	ਜਯਾਕੀਰ੍ਤਨ
ജയാകേതന	ਜਯਾਕੇਤਨ
ജയാപാദമാം	ਜਯਾਪਾਦਮਾਂ
ജയായ	ਜਯਾਯ
ജയിത	ਜਯਿਤ
ജയേശ	ਜਯੇਸ਼
ജലദ	ਜਲਦ
ജല്പേശ	ਜਲ੍ਪੇਸ਼
ജശവംത	ਜਸ਼ਵੰਤ
ജസീത്താ	ਜਸੀਤ੍ਤਾ
ജസ്സീ	ਜਸ੍ਸੀ
ജാനകീ	ਜਾਨਕੀ
ജാനകീദാസ	ਜਾਨਕੀਦਾਸ
ജാനകീനാഥ	ਜਾਨਕੀਨਾਥ
ജാനകീഭൂഷണ	ਜਾਨਕੀਭੂਸ਼ਣ
ജാനഹിതാ	ਜਾਨਹਿਤਾ
ജാപക	ਜਾਪਕ
ജായിത്രീ	ਜਾਯਿਤ੍ਰੀ
ജിനേശ്വര	ਜਿਨੇਸ਼੍ਵਰ
ജിഹാന	ਜਿਹਾਨ
ജീതേശ	ਜੀਤੇਸ਼
ജീന്ദാല	ਜੀਨ੍ਦਾਲ
ജീവനകലാ	ਜੀਵਨਕਲਾ
ജീവനീ	ਜੀਵਨੀ
ജീവന്തീനീ	ਜੀਵਨ੍ਤੀਨੀ
ജുഷ്ടി	ਜੁਸ਼੍ਟਿ
ജേനീശാ	ਜੇਨੀਸ਼ਾ
ജേര്ശീകാ	ਜੇਰ੍ਸ਼ੀਕਾ
ജൈകാപിശ	ਜੈਕਾਪਿਸ਼
ജൈചരണ	ਜੈਚਰਣ
ജൈനീശ	ਜੈਨੀਸ਼
ജൈപ്രകാശ	ਜੈਪ੍ਰਕਾਸ਼
ജൈവംത	ਜੈਵੰਤ
ജൈസല	ਜੈਸਲ
ജൈഹാസീനീ	ਜੈਹਾਸੀਨੀ
ജോംഫീ	ਜੋਂਫੀ
ജോശനീകാ	ਜੋਸ਼ਨੀਕਾ
ജോശീതാ	ਜੋਸ਼ੀਤਾ
ജ്വാലാ	ਜ੍ਵਾਲਾ
ജ്ഹില	ਜ੍ਹਿਲ
ജ്ഹീണൂക	ਜ੍ਹੀਣੂਕ
ഝഹനവീ	ਝਹਨਵੀ
ഝാനീശാ	ਝਾਨੀਸ਼ਾ
ഝാരാ	ਝਾਰਾ
ഝീയാ	ਝੀਯਾ
ഝേനീശാ	ਝੇਨੀਸ਼ਾ
ഝ്യാനനീ	ਝ੍ਯਾਨਨੀ
ടീംകു	ਟੀਂਕੁ
ഠുമരീ	ਠੁਮਰੀ
തക്ശീ	ਤਕ੍ਸ਼ੀ
തക്ശീല	ਤਕ੍ਸ਼ੀਲ
തജജ്ഞ	ਤਜਜ੍ਞ
തനവീ	ਤਨਵੀ
തനിഷ്ക	ਤਨਿਸ਼੍ਕ
തനുംജാശ്രീ	ਤਨੁਂਜਾਸ਼੍ਰੀ
തനുംശ്കാ	ਤਨੁਂਸ਼੍ਕਾ
തനോജ	ਤਨੋਜ
തപസ	ਤਪਸ
തപസ്വിനീ	ਤਪਸ੍ਵਿਨੀ
തമില  സേല്വീ	ਤਮਿਲ  ਸੇਲ੍ਵੀ
തമിശ	ਤਮਿਸ਼
തമോഘ്നാ	ਤਮੋਘ੍ਨਾ
തമോനഷ	ਤਮੋਨਸ਼
തരംജോത	ਤਰੰਜੋਤ
തരനീ	ਤਰਨੀ
തരലാ	ਤਰਲਾ
തരീനീ	ਤਰੀਨੀ
തരുശ്രീ	ਤਰੁਸ਼੍ਰੀ
തരൂണീ	ਤਰੂਣੀ
തവലീന :	ਤਵਲੀਨ :
തവിഷാ	ਤਵਿਸ਼ਾ
തസ്യ	ਤਸ੍ਯ
താക്ഷ്യാ	ਤਾਕ੍ਸ਼੍ਯਾ
താജേന്ദര	ਤਾਜੇਨ੍ਦਰ
താനാരുപീ	ਤਾਨਾਰੁਪੀ
താനിയാ	ਤਾਨਿਯਾ
താന്വീഥാ	ਤਾਨ੍ਵੀਥਾ
താപീ	ਤਾਪੀ
താരികാ	ਤਾਰਿਕਾ
താരീനീ	ਤਾਰੀਨੀ
താരൂശ	ਤਾਰੂਸ਼
താലംക	ਤਾਲੰਕ
താലീന	ਤਾਲੀਨ
താലേശ	ਤਾਲੇਸ਼
താവന	ਤਾਵਨ
താവീശാ	ਤਾਵੀਸ਼ਾ
തിതലീ	ਤਿਤਲੀ
തിനാശ	ਤਿਨਾਸ਼
തിലക	ਤਿਲਕ
തീഈവ്യേശ	ਤੀਈਵ੍ਯੇਸ਼
തീര്ഥാ	ਤੀਰ੍ਥਾ
തീസ്ചാ	ਤੀਸ੍ਚਾ
തുത്തീ	ਤੁਤ੍ਤੀ
തുനാവാ	ਤੁਨਾਵਾ
തുന്ഗാര	ਤੁਨ੍ਗਾਰ
തുപമ	ਤੁਪਮ
തുരഗ	ਤੁਰਗ
തുശീഥാ	ਤੁਸ਼ੀਥਾ
തൃപേശ	ਤਪੇਸ਼
തേജസ	ਤੇਜਸ
തേജസ്വീ	ਤੇਜਸ੍ਵੀ
തേജസ്വീന	ਤੇਜਸ੍ਵੀਨ
തേജേനദര	ਤੇਜੇਨਦਰ
തേജോമയ	ਤੇਜੋਮਯ
തോയേശ	ਤੋਯੇਸ਼
തോശീകാ	ਤੋਸ਼ੀਕਾ
തൌരുസ	ਤੌਰੁਸ
ത്രികായാ	ਤ੍ਰਿਕਾਯਾ
ത്രിപുരസുംദരീ	ਤ੍ਰਿਪੁਰਸੁਂਦਰੀ
ത്രിഭുവന	ਤ੍ਰਿਭੁਵਨ
ത്രിമാന	ਤ੍ਰਿਮਾਨ
ത്രിമൂര്തി	ਤ੍ਰਿਮੂਰ੍ਤਿ
ത്രിവേണീ	ਤ੍ਰਿਵੇਣੀ
ത്രിശല	ਤ੍ਰਿਸ਼ਲ
ത്രിശലാനാ	ਤ੍ਰਿਸ਼ਲਾਨਾ
ത്രീഝ്യാ	ਤ੍ਰੀਝ੍ਯਾ
ത്രീതിയാ	ਤ੍ਰੀਤਿਯਾ
ത്രീനേശ	ਤ੍ਰੀਨੇਸ਼
ത്രീപന	ਤ੍ਰੀਪਨ
ത്രീപ്ത	ਤ੍ਰੀਪ੍ਤ
ത്രീവീദ	ਤ੍ਰੀਵੀਦ
ത്വരിതാ	ਤ੍ਵਰਿਤਾ
ത്വീശീ	ਤ੍ਵੀਸ਼ੀ
ത്വേസാ	ਤ੍ਵੇਸਾ
ഥംസീ	ਥੰਸੀ
ഥനീരികാ	ਥਨੀਰਿਕਾ
ഥാകാപ്പന്സ്വാമീ	ਥਾਕਾਪ੍ਪਨ੍ਸ੍ਵਾਮੀ
ഥാരികാ	ਥਾਰਿਕਾ
ഥാവനീ	ਥਾਵਨੀ
ഥീരീശ്കാ	ਥੀਰੀਸ਼੍ਕਾ
ഥുസീഥാ	ਥੁਸੀਥਾ
ഥ്രേശാ	ਥ੍ਰੇਸ਼ਾ
ദംദാപാനീ	ਦੰਦਾਪਾਨੀ
ദക്ഷാഹതാ	ਦਕ੍ਸ਼ਾਹਤਾ
ദബീത	ਦਬੀਤ
ദബ്ന്ശും	ਦਬ੍ਨ੍ਸ਼ੁਂ
ദയാദാ	ਦਯਾਦਾ
ദയാനിതാ	ਦਯਾਨਿਤਾ
ദരഹാസ	ਦਰਹਾਸ
ദര്ശ	ਦਰ੍ਸ਼
ദര്ശക	ਦਰ੍ਸ਼ਕ
ദര്ശികാ	ਦਰ੍ਸ਼ਿਕਾ
ദര്ശീനീ	ਦਰ੍ਸ਼ੀਨੀ
ദര്സീകാ	ਦਰ੍ਸੀਕਾ
ദശാഗ്രീവാ ശീരോഹരാ	ਦਸ਼ਾਗ੍ਰੀਵਾ ਸ਼ੀਰੋਹਰਾ
ദശാഗ്രീവാകുലാന്താകാ	ਦਸ਼ਾਗ੍ਰੀਵਾਕੁਲਾਨ੍ਤਾਕਾ
ദശാനന	ਦਸ਼ਾਨਨ
ദഹാ	ਦਹਾ
ദാനാസ്വീ	ਦਾਨਾਸ੍ਵੀ
ദാനുംശ്രീ	ਦਾਨੁਂਸ਼੍ਰੀ
ദാന്ദാകാരാന്യ പുന്യകൃതേ	ਦਾਨ੍ਦਾਕਾਰਾਨ੍ਯ ਪੁਨ੍ਯਕਤੇ
ദാരുല	ਦਾਰੁਲ
ദാഹക	ਦਾਹਕ
ദികീശംദ	ਦਿਕੀਸ਼ੰਦ
ദിഗീശാ	ਦਿਗੀਸ਼ਾ
ദിപംശീ	ਦਿਪੰਸ਼ੀ
ദിപശീകീ	ਦਿਪਸ਼ੀਕੀ
ദിപേംദര	ਦਿਪੇਂਦਰ
ദിപ്താ	ਦਿਪ੍ਤਾ
ദിബസരീ	ਦਿਬਸਰੀ
ദിവീഥാ	ਦਿਵੀਥਾ
ദിവേനാ	ਦਿਵੇਨਾ
ദീതാ	ਦੀਤਾ
ദീനബംധു	ਦੀਨਬੰਧੁ
ദീപഥീ	ਦੀਪਥੀ
ദീപപ്രഭാ	ਦੀਪਪ੍ਰਭਾ
ദീപമാലാ	ਦੀਪਮਾਲਾ
ദീപശിഖാ	ਦੀਪਸ਼ਿਖਾ
ദീപാംജലി	ਦੀਪਾਂਜਲਿ
ദീപാശാ	ਦੀਪਾਸ਼ਾ
ദീപിത	ਦੀਪਿਤ
ദീവാംശ	ਦੀਵਾਂਸ਼
ദേജ	ਦੇਜ
ദേബജ്യോതീ	ਦੇਬਜ੍ਯੋਤੀ
ദേബദാത്താ	ਦੇਬਦਾਤ੍ਤਾ
ദേബദ്രിതാ	ਦੇਬਦ੍ਰਿਤਾ
ദേബന്ശീ	ਦੇਬਨ੍ਸ਼ੀ
ദേയ്വയാനാകാന്തന	ਦੇਯ੍ਵਯਾਨਾਕਾਨ੍ਤਨ
ദേവഗര്ഭാ	ਦੇਵਗਰ੍ਭਾ
ദേവജ്യോതി	ਦੇਵਜ੍ਯੋਤਿ
ദേവദാന	ਦੇਵਦਾਨ
ദേവന്ദ്ര	ਦੇਵਨ੍ਦ੍ਰ
ദേവമദാനാ	ਦੇਵਮਦਾਨਾ
ദേവരാജ	ਦੇਵਰਾਜ
ദേവശ്രീ	ਦੇਵਸ਼੍ਰੀ
ദേവാംഗനാ	ਦੇਵਾਂਗਨਾ
ദേവാംഗീ	ਦੇਵਾਂਗੀ
ദേവാംശു	ਦੇਵਾਂਸ਼ੁ
ദേവാദീത്യാ	ਦੇਵਾਦੀਤ੍ਯਾ
ദേവാനീ	ਦੇਵਾਨੀ
ദേവാന്ശാ	ਦੇਵਾਨ੍ਸ਼ਾ
ദേവാപ്രിയാ	ਦੇਵਾਪ੍ਰਿਯਾ
ദേവാമനോഹാരീ	ਦੇਵਾਮਨੋਹਾਰੀ
ദേവീന	ਦੇਵੀਨ
ദേവീലാല	ਦੇਵੀਲਾਲ
ദേവേന	ਦੇਵੇਨ
ദേവേശീ	ਦੇਵੇਸ਼ੀ
ദേവ്യഹ്നാന	ਦੇਵ੍ਯਹ੍ਨਾਨ
ദേശാവംത	ਦੇਸ਼ਾਵੰਤ
ദൈത്യാകുലാന്താകാ	ਦੈਤ੍ਯਾਕੁਲਾਨ੍ਤਾਕਾ
ദൈവ്യാ	ਦੈਵ੍ਯਾ
ധക്ശീന്യ	ਧਕ੍ਸ਼ੀਨ੍ਯ
ധനസുഖ	ਧਨਸੁਖ
ധനാജീ	ਧਨਾਜੀ
ധനിഷ്ഠ	ਧਨਿਸ਼੍ਠ
ധനു	ਧਨੁ
ധനുജാ	ਧਨੁਜਾ
ധനേശീ	ਧਨੇਸ਼ੀ
ധന്വികാ	ਧਨ੍ਵਿਕਾ
ധരമനിഷ്ഠ	ਧਰਮਨਿਸ਼੍ਠ
ധരാമാം	ਧਰਾਮਾਂ
ധരാഹാസീനീ	ਧਰਾਹਾਸੀਨੀ
ധരീശ	ਧਰੀਸ਼
ധര്മ  ദുത്ത	ਧਰ੍ਮ  ਦੁਤ੍ਤ
ധര്മഅധ്യക്ഷ	ਧਰ੍ਮਅਧ੍ਯਕ੍ਸ਼
ധര്മദിത്യ	ਧਰ੍ਮਦਿਤ੍ਯ
ധര്മദേവ	ਧਰ੍ਮਦੇਵ
ധര്ശീതാ	ਧਰ੍ਸ਼ੀਤਾ
ധര്ശീനീ	ਧਰ੍ਸ਼ੀਨੀ
ധാമീനീ	ਧਾਮੀਨੀ
ധാരാനീ	ਧਾਰਾਨੀ
ധിതി	ਧਿਤਿ
ധിതീ	ਧਿਤੀ
ധീപ്ത്ഹാ	ਧੀਪ੍ਤ੍ਹਾ
ധീമാഹീ	ਧੀਮਾਹੀ
ധീര്ഥാ	ਧੀਰ੍ਥਾ
ധേയാംശീ	ਧੇਯਾਂਸ਼ੀ
ധൈര്യ്യാ	ਧੈਰ੍ਯ੍ਯਾ
ധ്യുഥീ	ਧ੍ਯੁਥੀ
ധ്രുമീ	ਧ੍ਰੁਮੀ
നംദക	ਨੰਦਕ
നംദു	ਨੰਦੁ
നക്ശ	ਨਕ੍ਸ਼
നക്സത്രരാജാ	ਨਕ੍ਸਤ੍ਰਰਾਜਾ
നഗമാനീ	ਨਗਮਾਨੀ
നടവര	ਨਟਵਰ
നത്രീശാ	ਨਤ੍ਰੀਸ਼ਾ
നദീപ	ਨਦੀਪ
നഭാ	ਨਭਾ
നഭോമാനീ	ਨਭੋਮਾਨੀ
നമന	ਨਮਨ
നമനാ	ਨਮਨਾ
നയന	ਨਯਨ
നരേന്ദ്രന	ਨਰੇਨ੍ਦ੍ਰਨ
നരേന്ദ്രനാഥ	ਨਰੇਨ੍ਦ੍ਰਨਾਥ
നരേശ	ਨਰੇਸ਼
നവനീത വിലീപ്തംഗാ	ਨਵਨੀਤ ਵਿਲੀਪ੍ਤੰਗਾ
നവമ	ਨਵਮ
നവരംഗ	ਨਵਰੰਗ
നസീബ	ਨਸੀਬ
നാംബീ	ਨਾਂਬੀ
നാഗനാഥ	ਨਾਗਨਾਥ
നാഗപാല	ਨਾਗਪਾਲ
നാഗേശ്വരണ	ਨਾਗੇਸ਼੍ਵਰਣ
നാഗൈഃ	ਨਾਗੈ
നാതാഭൈരവീ	ਨਾਤਾਭੈਰਵੀ
നാതിന	ਨਾਤਿਨ
നാന്ധീനീ	ਨਾਨ੍ਧੀਨੀ
നാന്നാന	ਨਾਨ੍ਨਾਨ
നാഭിതാ	ਨਾਭਿਤਾ
നാഭേംദു	ਨਾਭੇਂਦੁ
നാമത	ਨਾਮਤ
നായകീ	ਨਾਯਕੀ
നായാനീ	ਨਾਯਾਨੀ
നായാനീകാ	ਨਾਯਾਨੀਕਾ
നാലിനികാംത	ਨਾਲਿਨਿਕਾਂਤ
നാലീനേശയ	ਨਾਲੀਨੇਸ਼ਯ
നാവീന്യ	ਨਾਵੀਨ੍ਯ
നാവീല	ਨਾਵੀਲ
നാവ്യാ ദുര്ഗാ	ਨਾਵ੍ਯਾ ਦੁਰ੍ਗਾ
നാവ്രീതാ	ਨਾਵ੍ਰੀਤਾ
നികാരാ	ਨਿਕਾਰਾ
നിഖിതാ	ਨਿਖਿਤਾ
നിഖില	ਨਿਖਿਲ
നിജു	ਨਿਜੁ
നിധി	ਨਿਧਿ
നിധിപാ	ਨਿਧਿਪਾ
നിപാ	ਨਿਪਾ
നിരംജനാ	ਨਿਰੰਜਨਾ
നിരമഈ	ਨਿਰਮਈ
നിരുപമാ	ਨਿਰੁਪਮਾ
നിര്മളാ	ਨਿਰ੍ਮਲਾ
നിര്മിതി	ਨਿਰ੍ਮਿਤਿ
നിലാശാ	ਨਿਲਾਸ਼ਾ
നിശാനഥീ	ਨਿਸ਼ਾਨਥੀ
നീഗീഥാ	ਨੀਗੀਥਾ
നീതു	ਨੀਤੁ
നീഥീകാ	ਨੀਥੀਕਾ
നീധാ	ਨੀਧਾ
നീധാര്സനാ	ਨੀਧਾਰ੍ਸਨਾ
നീമാംലന	ਨੀਮਾਂਲਨ
നീരാലികാ	ਨੀਰਾਲਿਕਾ
നീരൈമാംഥീ	ਨੀਰੈਮਾਂਥੀ
നീര്മുകതാ	ਨੀਰ੍ਮੁਕਤਾ
നീല മാധവ	ਨੀਲ ਮਾਧਵ
നീലംജന	ਨੀਲੰਜਨ
നീലക്ഷ	ਨੀਲਕ੍ਸ਼
നീല്ജാ	ਨੀਲ੍ਜਾ
നീശാലീ	ਨੀਸ਼ਾਲੀ
നീശീതീ	ਨੀਸ਼ੀਤੀ
നീശ്മീഥാ	ਨੀਸ਼੍ਮੀਥਾ
നീസ്ചീഥാ	ਨੀਸ੍ਚੀਥਾ
നീഹാ	ਨੀਹਾ
നേമീശാ	ਨੇਮੀਸ਼ਾ
നേയ്സാ	ਨੇਯ੍ਸਾ
നേരീശാ	ਨੇਰੀਸ਼ਾ
നൈജാ	ਨੈਜਾ
നൈരീതീ	ਨੈਰੀਤੀ
നൈവേധീ	ਨੈਵੇਧੀ
നൌസദ	ਨੌਸਦ
പംകജന	ਪੰਕਜਨ
പംചഭൂതാത്മികാ	ਪੰਚਭੂਤਾਤ੍ਮਿਕਾ
പംഥീനീ	ਪੰਥੀਨੀ
പഝ്ഹേനീ	ਪਝ੍ਹੇਨੀ
പത്താമ്ബരാപരീധാനാ	ਪਤ੍ਤਾਮ੍ਬਰਾਪਰੀਧਾਨਾ
പത്ര	ਪਤ੍ਰ
പന്ദാലാവാസന	ਪਨ੍ਦਾਲਾਵਾਸਨ
പമ്പാ	ਪਮ੍ਪਾ
പമ്ഫാ	ਪਮ੍ਫਾ
പയാസ	ਪਯਾਸ
പയോധീ	ਪਯੋਧੀ
പരംതാപാ	ਪਰੰਤਾਪਾ
പരമാംത്മികാ	ਪਰਮਾਂਤ੍ਮਿਕਾ
പരമാംന്ത്ര	ਪਰਮਾਂਨ੍ਤ੍ਰ
പരമിലാ	ਪਰਮਿਲਾ
പരമേശ്വരീ	ਪਰਮੇਸ਼੍ਵਰੀ
പരമ്വാര്ദാന	ਪਰਮ੍ਵਾਰ੍ਦਾਨ
പരവാനീ	ਪਰਵਾਨੀ
പരവിംദര	ਪਰਵਿਂਦਰ
പരാകാഷ	ਪਰਾਕਾਸ਼
പരാവീ	ਪਰਾਵੀ
പരിഹാ	ਪਰਿਹਾ
പര്തീബന	ਪਰ੍ਤੀਬਨ
പര്ലീ	ਪਰ੍ਲੀ
പര്വ	ਪਰ੍ਵ
പലാക്ഷ	ਪਲਾਕ੍ਸ਼
പലാശീനീ	ਪਲਾਸ਼ੀਨੀ
പവന	ਪਵਨ
പവനസുത	ਪਵਨਸੁਤ
പശുപതി	ਪਸ਼ੁਪਤਿ
പഹലാജ	ਪਹਲਾਜ
പാടലാ	ਪਾਟਲਾ
പാന്ദുരംഗാ	ਪਾਨ੍ਦੁਰੰਗਾ
പായല	ਪਾਯਲ
പാരു	ਪਾਰੁ
പാര്ഥിക	ਪਾਰ੍ਥਿਕ
പാര്ഥീവീ	ਪਾਰ੍ਥੀਵੀ
പാര്ഥോ	ਪਾਰ੍ਥੋ
പാളവീ	ਪਾਲਵੀ
പാവകീ	ਪਾਵਕੀ
പാവനാ	ਪਾਵਨਾ
പാവാനാ	ਪਾਵਾਨਾ
പാഹീ	ਪਾਹੀ
പിവാല	ਪਿਵਾਲ
പൂജന	ਪੂਜਨ
പൂരതീ	ਪੂਰਤੀ
പൂരികാ	ਪੂਰਿਕਾ
പൂര്വജാ	ਪੂਰ੍ਵਜਾ
പൂര്വികാ	ਪੂਰ੍ਵਿਕਾ
പേഖമ	ਪੇਖਮ
പേത്ചീ	ਪੇਤ੍ਚੀ
പേരാരസീ	ਪੇਰਾਰਸੀ
പ്രകൃഥീ	ਪ੍ਰਕਥੀ
പ്രഗന്യാ	ਪ੍ਰਗਨ੍ਯਾ
പ്രഗ്യപരാമിതാ	ਪ੍ਰਗ੍ਯਪਰਾਮਿਤਾ
പ്രജാനാ	ਪ੍ਰਜਾਨਾ
പ്രനാദാ	ਪ੍ਰਨਾਦਾ
പ്രനീധാനാ	ਪ੍ਰਨੀਧਾਨਾ
പ്രബകരണ	ਪ੍ਰਬਕਰਣ
പ്രഭാകര	ਪ੍ਰਭਾਕਰ
പ്രഭാകരന	ਪ੍ਰਭਾਕਰਨ
പ്രഭാത	ਪ੍ਰਭਾਤ
പ്രഭാവ	ਪ੍ਰਭਾਵ
പ്രാതീകാ	ਪ੍ਰਾਤੀਕਾ
ഫനീ	ਫਨੀ
ഫനീഭുഷണ	ਫਨੀਭੁਸ਼ਣ
ഫാല്ഗുനീ	ਫਾਲ੍ਗੁਨੀ
ഫൂലന	ਫੂਲਨ
ഫ്രാന്ചീസ	ਫ੍ਰਾਨ੍ਚੀਸ
ബംദിശ	ਬੰਦਿਸ਼
ബംധൂല	ਬੰਧੂਲ
ബംശീ	ਬੰਸ਼ੀ
ബംസീധര	ਬੰਸੀਧਰ
ബകുലാ	ਬਕੁਲਾ
ബകൂല	ਬਕੂਲ
ബദ്രീ	ਬਦ੍ਰੀ
ബനജ	ਬਨਜ
ബനവാരീ	ਬਨਵਾਰੀ
ബബന	ਬਬਨ
ബബിശ	ਬਬਿਸ਼
ബര്ഹന	ਬਰ੍ਹਨ
ബലബീര	ਬਲਬੀਰ
ബഹവാസ്യ	ਬਹਵਾਸ੍ਯ
ബാബു	ਬਾਬੁ
ബാബുല	ਬਾਬੁਲ
ബാല മുകുന്ദ	ਬਾਲ ਮੁਕੁਨ੍ਦ
ബാലധി	ਬਾਲਧਿ
ബാലാമോഹന	ਬਾਲਾਮੋਹਨ
ബാലാരാജ	ਬਾਲਾਰਾਜ
ബാലാശംകര	ਬਾਲਾਸ਼ੰਕਰ
ബാലു	ਬਾਲੁ
ബാലേന്ദു	ਬਾਲੇਨ੍ਦੁ
ബാസ്കാര	ਬਾਸ੍ਕਾਰ
ബിനീതാ	ਬਿਨੀਤਾ
ബീനും	ਬੀਨੁਂ
ബീന്ദുശ്രീ	ਬੀਨ੍ਦੁਸ਼੍ਰੀ
ബീന്നീകേര	ਬੀਨ੍ਨੀਕੇਰ
ബീപുല	ਬੀਪੁਲ
ബീബീന	ਬੀਬੀਨ
ബീരത	ਬੀਰਤ
ബീഹാന	ਬੀਹਾਨ
ബേനീതാ	ਬੇਨੀਤਾ
ബേനും	ਬੇਨੁਂ
ബേലുരമീ	ਬੇਲੁਰਮੀ
ബേല്ലീ	ਬੇਲ੍ਲੀ
ബൈവാവീ	ਬੈਵਾਵੀ
ബൈസാഖീ	ਬੈਸਾਖੀ
ബ്രീഥ്ഹീ	ਬ੍ਰੀਥ੍ਹੀ
ബ്ലേസ്സീ	ਬ੍ਲੇਸ੍ਸੀ
ഭഗവാന	ਭਗਵਾਨ
ഭദ്രക്ഷ	ਭਦ੍ਰਕ੍ਸ਼
ഭദ്രനിധി	ਭਦ੍ਰਨਿਧਿ
ഭദ്രപ്രിയാ	ਭਦ੍ਰਪ੍ਰਿਯਾ
ഭദ്രിക	ਭਦ੍ਰਿਕ
ഭദ്രീശാ	ਭਦ੍ਰੀਸ਼ਾ
ഭവാനീ	ਭਵਾਨੀ
ഭവ്യരാജ	ਭਵ੍ਯਰਾਜ
ഭാഗവംതീ	ਭਾਗਵੰਤੀ
ഭാദരന	ਭਾਦਰਨ
ഭാനുമിത്ര	ਭਾਨੁਮਿਤ੍ਰ
ഭാരഥീ	ਭਾਰਥੀ
ഭാര്ഗവന	ਭਾਰ੍ਗਵਨ
ഭാര്ഗവാ	ਭਾਰ੍ਗਵਾ
ഭാര്ഘവീ	ਭਾਰ੍ਘਵੀ
ഭാര്ദ്ദ്വാജ	ਭਾਰ੍ਦ੍ਦ੍ਵਾਜ
ഭാലേംദ്ര	ਭਾਲੇਂਦ੍ਰ
ഭാവതീ	ਭਾਵਤੀ
ഭാവീഗുരും	ਭਾਵੀਗੁਰੁਂ
ഭാവ്യമ	ਭਾਵ੍ਯਮ
ഭാശ്വീനീ	ਭਾਸ਼੍ਵੀਨੀ
ഭാസു	ਭਾਸੁ
ഭാസ്കാരീ	ਭਾਸ੍ਕਾਰੀ
ഭാസ്കേര	ਭਾਸ੍ਕੇਰ
ഭീമശംകര	ਭੀਮਸ਼ੰਕਰ
ഭൂദേവ	ਭੂਦੇਵ
ഭൂപത	ਭੂਪਤ
ഭൂപാല	ਭੂਪਾਲ
ഭൂമാ	ਭੂਮਾ
ഭൂമാം	ਭੂਮਾਂ
ഭേരേശ	ਭੇਰੇਸ਼
ഭൈരവീ	ਭੈਰਵੀ
മംഗലമ	ਮੰਗਲਮ
മംഗേശ	ਮੰਗੇਸ਼
മംജു  പ്രസന്ന	ਮੰਜੁ  ਪ੍ਰਸਨ੍ਨ
മംജുനാഥ	ਮੰਜੁਨਾਥ
മംജുലാ	ਮੰਜੁਲਾ
മംത	ਮੰਤ
മംതോഷ	ਮੰਤੋਸ਼
മംദിഥാ	ਮੰਦਿਥਾ
മംദിരാ	ਮੰਦਿਰਾ
മകാലീ	ਮਕਾਲੀ
മകുര	ਮਕੁਰ
മഗന	ਮਗਨ
മണികാംത	ਮਣਿਕਾਂਤ
മദുരാ	ਮਦੁਰਾ
മധുനിഷാ	ਮਧੁਨਿਸ਼ਾ
മധുമാംലീ	ਮਧੁਮਾਂਲੀ
മധുരിമാ	ਮਧੁਰਿਮਾ
മധുവംതീ	ਮਧੁਵੰਤੀ
മനജീത	ਮਨਜੀਤ
മനപ	ਮਨਪ
മനസ്വിന	ਮਨਸ੍ਵਿਨ
മനാല്പ	ਮਨਾਲ੍ਪ
മനീതാ	ਮਨੀਤਾ
മനീഷ	ਮਨੀਸ਼
മനോജ	ਮਨੋਜ
മനോരനജനീ	ਮਨੋਰਨਜਨੀ
മനോരിഥാ	ਮਨੋਰਿਥਾ
മന്നത	ਮਨ੍ਨਤ
മന്മായീ	ਮਨ੍ਮਾਯੀ
മല്ലികാ	ਮਲ੍ਲਿਕਾ
മഹംത	ਮਹੰਤ
മഹാതപസ്വീ	ਮਹਾਤਪਸ੍ਵੀ
മഹാദുര്ഗാ	ਮਹਾਦੁਰ੍ਗਾ
മഹാദേവാ	ਮਹਾਦੇਵਾ
മഹാദേവാദീപുജീതാ	ਮਹਾਦੇਵਾਦੀਪੁਜੀਤਾ
മഹാന്തേശ	ਮਹਾਨ੍ਤੇਸ਼
മഹാബാലാ	ਮਹਾਬਾਲਾ
മഹാസ്വേതാ	ਮਹਾਸ੍ਵੇਤਾ
മഹിപതി	ਮਹਿਪਤਿ
മഹിഷാസുരമര്ദിനീ	ਮਹਿਸ਼ਾਸੁਰਮਰ੍ਦਿਨੀ
മഹീജിത	ਮਹੀਜਿਤ
മഹേംദ്രാ	ਮਹੇਂਦ੍ਰਾ
മഹേശ	ਮਹੇਸ਼
മഹേശനീ	ਮਹੇਸ਼ਨੀ
മഹേശീ	ਮਹੇਸ਼ੀ
മാംതിക	ਮਾਂਤਿਕ
മാംനീമോഝ്ഹീ	ਮਾਂਨੀਮੋਝ੍ਹੀ
മാംനുസരീ	ਮਾਂਨੁਸਰੀ
മാംന്ക്ഷ	ਮਾਂਨ੍ਕ੍ਸ਼
മാംന്ഗീരീ	ਮਾਂਨ੍ਗੀਰੀ
മാംന്താവ്യാഹ	ਮਾਂਨ੍ਤਾਵ੍ਯਾਹ
മാംന്തീകാ	ਮਾਂਨ੍ਤੀਕਾ
മാംന്ദീതാ	ਮਾਂਨ੍ਦੀਤਾ
മാംലാമാംകാല മകാന	ਮਾਂਲਾਮਾਂਕਾਲ ਮਕਾਨ
മാഇല	ਮਾਇਲ
മാനകാ	ਮਾਨਕਾ
മാനജ	ਮਾਨਜ
മാനശ	ਮਾਨਸ਼
മാനിക	ਮਾਨਿਕ
മാനീശീന	ਮਾਨੀਸ਼ੀਨ
മാനോരിത	ਮਾਨੋਰਿਤ
മാന്കന	ਮਾਨ੍ਕਨ
മാന്ദാവിക	ਮਾਨ੍ਦਾਵਿਕ
മായാ	ਮਾਯਾ
മാര്ഗശീ	ਮਾਰ੍ਗਸ਼ੀ
മാര്ഗീ	ਮਾਰ੍ਗੀ
മാര്തംദ	ਮਾਰ੍ਤੰਦ
മാര്ഥീകാ	ਮਾਰ੍ਥੀਕਾ
മാര്യ	ਮਾਰ੍ਯ
മാര്യാ	ਮਾਰ੍ਯਾ
മാര്ഷാ	ਮਾਰ੍ਸ਼ਾ
മാലാര്കോഡീ	ਮਾਲਾਰ੍ਕੋਡੀ
മാലിനീ	ਮਾਲਿਨੀ
മാല്ലേശാ	ਮਾਲ੍ਲੇਸ਼ਾ
മാസൂമ	ਮਾਸੂਮ
മാസൂമീ	ਮਾਸੂਮੀ
മാഹിയാ	ਮਾਹਿਯਾ
മാഹിരാജ	ਮਾਹਿਰਾਜ
മാഹുലീ	ਮਾਹੁਲੀ
മിലീ	ਮਿਲੀ
മിഹീകാ	ਮਿਹੀਕਾ
മീനാ	ਮੀਨਾ
മേധ	ਮੇਧ
മേധീനീ	ਮੇਧੀਨੀ
മൈത്രായ	ਮੈਤ੍ਰਾਯ
മൌലീശാ	ਮੌਲੀਸ਼ਾ
മ്യ്ഥിലീ	ਮ੍ਯ੍ਥਿਲੀ
യംശ	ਯੰਸ਼
യക്ഷ	ਯਕ੍ਸ਼
യജും	ਯਜੁਂ
യജുസ	ਯਜੁਸ
യജ്നേശ	ਯਜ੍ਨੇਸ਼
യഥാര്ഥ	ਯਥਾਰ੍ਥ
യദുനംദന	ਯਦੁਨੰਦਨ
യശസ്വിനീ	ਯਸ਼ਸ੍ਵਿਨੀ
യശാശ്രീ	ਯਸ਼ਾਸ਼੍ਰੀ
യശ്ദീപ	ਯਸ਼੍ਦੀਪ
യശ്മിത	ਯਸ਼੍ਮਿਤ
യശ്മിതാ	ਯਸ਼੍ਮਿਤਾ
യശ്വാര്ധാനാ	ਯਸ਼੍ਵਾਰ੍ਧਾਨਾ
യശ്വീന	ਯਸ਼੍ਵੀਨ
യശ്വീനീ	ਯਸ਼੍ਵੀਨੀ
യസ്വംഥ	ਯਸ੍ਵੰਥ
യാക്സീനീ	ਯਾਕ੍ਸੀਨੀ
യാഗ്നാകായാ	ਯਾਗ੍ਨਾਕਾਯਾ
യാഗ്നീഥാ	ਯਾਗ੍ਨੀਥਾ
യാചന	ਯਾਚਨ
യാതീരാജു	ਯਾਤੀਰਾਜੁ
യാദവീ	ਯਾਦਵੀ
യാദവേന്ദ്ര	ਯਾਦਵੇਨ੍ਦ੍ਰ
യാന്തി	ਯਾਨ੍ਤਿ
യാശ്രീഥാ	ਯਾਸ਼੍ਰੀਥਾ
യാഷ്ക	ਯਾਸ਼੍ਕ
യാസസ്വീ	ਯਾਸਸ੍ਵੀ
യുഗന്തീകാ	ਯੁਗਨ੍ਤੀਕਾ
യുഗപ	ਯੁਗਪ
യുഗാന്ധര	ਯੁਗਾਨ੍ਧਰ
യുതി	ਯੁਤਿ
യുവംശ	ਯੁਵੰਸ਼
യുവനാഥ	ਯੁਵਨਾਥ
യുവല	ਯੁਵਲ
യുവാഥീ	ਯੁਵਾਥੀ
യുവാന  സൂര്യ	ਯੁਵਾਨ  ਸੂਰ੍ਯ
യുവ്നീക	ਯੁਵ੍ਨੀਕ
യേര്രപ്പാ	ਯੇਰ੍ਰਪ੍ਪਾ
യേശനാ	ਯੇਸ਼ਨਾ
യേശാസ്വീനീ	ਯੇਸ਼ਾਸ੍ਵੀਨੀ
യേസസരീ	ਯੇਸਸਰੀ
യോഗദേവാ	ਯੋਗਦੇਵਾ
യോഗരാജ	ਯੋਗਰਾਜ
യോഗാനംദ	ਯੋਗਾਨੰਦ
യോഗിത	ਯੋਗਿਤ
യോഗിതാ	ਯੋਗਿਤਾ
യോഗിഥ	ਯੋਗਿਥ
യോഗേശ്വര	ਯੋਗੇਸ਼੍ਵਰ
യോഗ്ദീപ	ਯੋਗ੍ਦੀਪ
യോത്ശനാ	ਯੋਤ੍ਸ਼ਨਾ
യോനേന്ദ്ര	ਯੋਨੇਨ੍ਦ੍ਰ
യോഹ്ശീനീ	ਯੋਹ੍ਸ਼ੀਨੀ
യൌവാനീ	ਯੌਵਾਨੀ
രംഗനാഥ	ਰੰਗਨਾਥ
രംജന	ਰੰਜਨ
രംജികാ	ਰੰਜਿਕਾ
രംജീവ	ਰੰਜੀਵ
രഈര്ഥ	ਰਈਰ੍ਥ
രക്ത	ਰਕ੍ਤ
രക്തകമള	ਰਕ੍ਤਕਮਲ
രക്ഷികാ	ਰਕ੍ਸ਼ਿਕਾ
രക്ഷിത	ਰਕ੍ਸ਼ਿਤ
രഘവാ	ਰਘਵਾ
രഘവേന്ദര	ਰਘਵੇਨ੍ਦਰ
രഘുനാഥ	ਰਘੁਨਾਥ
രജത	ਰਜਤ
രജനീശ	ਰਜਨੀਸ਼
രജനേശ	ਰਜਨੇਸ਼
രജീത	ਰਜੀਤ
രതന	ਰਤਨ
രതാംജലി	ਰਤਾਂਜਲਿ
രതീക	ਰਤੀਕ
രതുല	ਰਤੁਲ
രത്നാകര	ਰਤ੍ਨਾਕਰ
രത്നാബലീ	ਰਤ੍ਨਾਬਲੀ
രഥനാ	ਰਥਨਾ
രന്യ	ਰਨ੍ਯ
രന്വിഥാ	ਰਨ੍ਵਿਥਾ
രബേക	ਰਬੇਕ
രമാംസ്വമ്യ	ਰਮਾਂਸ੍ਵਮ੍ਯ
രമ്ബേശ	ਰਮ੍ਬੇਸ਼
രയാന	ਰਯਾਨ
രര്ശ്മീതാ	ਰਰ੍ਸ਼੍ਮੀਤਾ
രവി കാന്ത	ਰਵਿ ਕਾਨ੍ਤ
രവികാംത	ਰਵਿਕਾਂਤ
രവിത	ਰਵਿਤ
രവീജാ	ਰਵੀਜਾ
രവീനാ	ਰਵੀਨਾ
രവ്യംകീ	ਰਵ੍ਯੰਕੀ
രശീലാ	ਰਸ਼ੀਲਾ
രസവംത	ਰਸਵੰਤ
രസ്മീന	ਰਸ੍ਮੀਨ
രാഈ കുമാര	ਰਾਈ ਕੁਮਾਰ
രാഖീ	ਰਾਖੀ
രാഗാവ	ਰਾਗਾਵ
രാഗിനീ	ਰਾਗਿਨੀ
രാഗേശ	ਰਾਗੇਸ਼
രാഗ്വേദ	ਰਾਗ੍ਵੇਦ
രാജക	ਰਾਜਕ
രാജകന്യാ	ਰਾਜਕਨ੍ਯਾ
രാജഗോപാല	ਰਾਜਗੋਪਾਲ
രാജയവര്ദന	ਰਾਜਯਵਰ੍ਦਨ
രാജാ	ਰਾਜਾ
രാജാര്ശീ	ਰਾਜਾਰ੍ਸ਼ੀ
രാജികാ	ਰਾਜਿਕਾ
രാജീവ	ਰਾਜੀਵ
രാജേംദ്രമോഹന	ਰਾਜੇਂਦ੍ਰਮੋਹਨ
രാജേശ്വര	ਰਾਜੇਸ਼੍ਵਰ
രാജ്യശ്രീ	ਰਾਜ੍ਯਸ਼੍ਰੀ
രാധാനീ	ਰਾਧਾਨੀ
രാനീ	ਰਾਨੀ
രാമ  കീന്കാര	ਰਾਮ  ਕੀਨ੍ਕਾਰ
രാമഗോപാല	ਰਾਮਗੋਪਾਲ
രാമചന്ദ്രന	ਰਾਮਚਨ੍ਦ੍ਰਨ
രാമനാരായണ	ਰਾਮਨਾਰਾਯਣ
രാമരാ	ਰਾਮਰਾ
രാമരാജ	ਰਾਮਰਾਜ
രാമാംസുഗ്രീവാ	ਰਾਮਾਂਸੁਗ੍ਰੀਵਾ
രാമാനംദ	ਰਾਮਾਨੰਦ
രാമാനുജമ	ਰਾਮਾਨੁਜਮ
രാമോജീ	ਰਾਮੋਜੀ
രാഹിത്യ	ਰਾਹਿਤ੍ਯ
രാഹീന്യ	ਰਾਹੀਨ੍ਯ
രാഹുലരാജ	ਰਾਹੁਲਰਾਜ
രിദ്ധി	ਰਿਦ੍ਧਿ
രീചികാ	ਰੀਚਿਕਾ
രീതൂ	ਰੀਤੂ
രീഥേകാ	ਰੀਥੇਕਾ
രീദേവ	ਰੀਦੇਵ
രീധമാം	ਰੀਧਮਾਂ
രീഭ്യാ	ਰੀਭ੍ਯਾ
രീശും	ਰੀਸ਼ੁਂ
രീശ്മേഥാ	ਰੀਸ਼੍ਮੇਥਾ
രേഖാ	ਰੇਖਾ
രേത്വിക	ਰੇਤ੍ਵਿਕ
രേധാ	ਰੇਧਾ
രേനാ	ਰੇਨਾ
രേനേശ	ਰੇਨੇਸ਼
രേമാംനീകാ	ਰੇਮਾਂਨੀਕਾ
രേമീ	ਰੇਮੀ
രേവാതീ	ਰੇਵਾਤੀ
രേവീഥാ	ਰੇਵੀਥਾ
രേശമീ	ਰੇਸ਼ਮੀ
രേശ്വീന	ਰੇਸ਼੍ਵੀਨ
രേഹാംശീ	ਰੇਹਾਂਸ਼ੀ
രേഹാനാ	ਰੇਹਾਨਾ
രേഹേഈലാ	ਰੇਹੇਈਲਾ
രേഹ്നുഘാ	ਰੇਹ੍ਨੁਘਾ
രൈവത	ਰੈਵਤ
രൈവതാ	ਰੈਵਤਾ
ലംഗീത	ਲੰਗੀਤ
ലക്ഷ	ਲਕ੍ਸ਼
ലക്ഷാകീ	ਲਕ੍ਸ਼ਾਕੀ
ലക്ഷിതാ	ਲਕ੍ਸ਼ਿਤਾ
ലക്ഷ്മീകാനതമ	ਲਕ੍ਸ਼੍ਮੀਕਾਨਤਮ
ലജ്ജാ	ਲਜ੍ਜਾ
ലജ്ജാകാ	ਲਜ੍ਜਾਕਾ
ലതാ	ਲਤਾ
ലതേശ	ਲਤੇਸ਼
ലവപാല	ਲਵਪਾਲ
ലവലീന	ਲਵਲੀਨ
ലഹരീ	ਲਹਰੀ
ലാക്ശേതാ	ਲਾਕ੍ਸ਼ੇਤਾ
ലാജവംതീ	ਲਾਜਵੰਤੀ
ലാതീശ	ਲਾਤੀਸ਼
ലാനീബന	ਲਾਨੀਬਨ
ലാഭാ	ਲਾਭਾ
ലാമ്ബോധാര	ਲਾਮ੍ਬੋਧਾਰ
ലാരീനാ	ਲਾਰੀਨਾ
ലാര്മികാ	ਲਾਰ੍ਮਿਕਾ
ലാര്രാജ	ਲਾਰ੍ਰਾਜ
ലാര്ശന	ਲਾਰ੍ਸ਼ਨ
ലാവനീ	ਲਾਵਨੀ
ലാവിനാ	ਲਾਵਿਨਾ
ലീകേശ	ਲੀਕੇਸ਼
ലീത്സാ	ਲੀਤ੍ਸਾ
ലീനാശാ	ਲੀਨਾਸ਼ਾ
ലീനീത	ਲੀਨੀਤ
ലീപാക്ഷീ	ਲੀਪਾਕ੍ਸ਼ੀ
ലീപ്സീകാ	ਲੀਪ੍ਸੀਕਾ
ലീമനാ	ਲੀਮਨਾ
ലീലാമഈ	ਲੀਲਾਮਈ
ലീശാംത	ਲੀਸ਼ਾਂਤ
ലുസിയാ	ਲੁਸਿਯਾ
ലേഈവീനാ	ਲੇਈਵੀਨਾ
ലേഖീശാ	ਲੇਖੀਸ਼ਾ
ലേമാര	ਲੇਮਾਰ
ലോകനേത്ര	ਲੋਕਨੇਤ੍ਰ
ലോകാജനാനീ	ਲੋਕਾਜਨਾਨੀ
ലോകാമാത്രീ	ਲੋਕਾਮਾਤ੍ਰੀ
ലോകീഥാ	ਲੋਕੀਥਾ
ലോകേന്ദ്ര	ਲੋਕੇਨ੍ਦ੍ਰ
ലോഗീനീ	ਲੋਗੀਨੀ
ലോഗേശ്വരണ	ਲੋਗੇਸ਼੍ਵਰਣ
ലോചനാ	ਲੋਚਨਾ
ലോനാ	ਲੋਨਾ
ലോമാംകേശ	ਲੋਮਾਂਕੇਸ਼
ലോഹിത	ਲੋਹਿਤ
ലോഹിതാശ്വാ	ਲੋਹਿਤਾਸ਼੍ਵਾ
ലൌക്യ	ਲੌਕ੍ਯ
വംദിതാ	ਵੰਦਿਤਾ
വംസികൃഷ്ണ	ਵੰਸਿਕਸ਼੍ਣ
വനദ	ਵਨਦ
വനമാംഥീ	ਵਨਮਾਂਥੀ
വനസ	ਵਨਸ
വനിനാധ	ਵਨਿਨਾਧ
വന്ജുല	ਵਨ੍ਜੁਲ
വപുസ	ਵਪੁਸ
വയദീശ	ਵਯਦੀਸ਼
വരലീ	ਵਰਲੀ
വരിന	ਵਰਿਨ
വരിയാസ	ਵਰਿਯਾਸ
വരുന	ਵਰੁਨ
വരുനികാ	ਵਰੁਨਿਕਾ
വര്ണിത	ਵਰ੍ਣਿਤ
വര്ധമാന	ਵਰ੍ਧਮਾਨ
വര്ധാനീ	ਵਰ੍ਧਾਨੀ
വര്ധീമൈനകാപുജീതാ	ਵਰ੍ਧੀਮੈਨਕਾਪੁਜੀਤਾ
വര്നീശാ	ਵਰ੍ਨੀਸ਼ਾ
വര്ശനേയാ	ਵਰ੍ਸ਼ਨੇਯਾ
വര്ശീകാ	ਵਰ੍ਸ਼ੀਕਾ
വര്ശീതാ	ਵਰ੍ਸ਼ੀਤਾ
വര്ശീദ	ਵਰ੍ਸ਼ੀਦ
വര്ഷനീ	ਵਰ੍ਸ਼ਨੀ
വല്ലികാ	ਵਲ੍ਲਿਕਾ
വസംതാ	ਵਸੰਤਾ
വസംതീ	ਵਸੰਤੀ
വസീസതാ	ਵਸੀਸਤਾ
വസുമിത്ര	ਵਸੁਮਿਤ੍ਰ
വസുസേന	ਵਸੁਸੇਨ
വാക്പതി	ਵਾਕ੍ਪਤਿ
വാക്ഷു	ਵਾਕ੍ਸ਼ੁ
വാച്യ	ਵਾਚ੍ਯ
വാജ്രക്ഷ	ਵਾਜ੍ਰਕ੍ਸ਼
വാതത്മാജ	ਵਾਤਤ੍ਮਾਜ
വാത്സല്യ	ਵਾਤ੍ਸਲ੍ਯ
വാദിവേലും	ਵਾਦਿਵੇਲੁਂ
വാനര	ਵਾਨਰ
വാന്ശുല	ਵਾਨ੍ਸ਼ੁਲ
വാമന	ਵਾਮਨ
വാമാംക്ഷീ	ਵਾਮਾਂਕ੍ਸ਼ੀ
വാമീല	ਵਾਮੀਲ
വാരനാ	ਵਾਰਨਾ
വാരുനീ	ਵਾਰੁਨੀ
വാലാരമാംഥീ	ਵਾਲਾਰਮਾਂਥੀ
വാല്ല്മാംനാലന	ਵਾਲ੍ਲ੍ਮਾਂਨਾਲਨ
വാശു	ਵਾਸ਼ੁ
വാസുമന	ਵਾਸੁਮਨ
വാഹിനീ	ਵਾਹਿਨੀ
വികീശാ	ਵਿਕੀਸ਼ਾ
വിക്ഷിത	ਵਿਕ੍ਸ਼ਿਤ
വിജയാലക്ഷ്മീ	ਵਿਜਯਾਲਕ੍ਸ਼੍ਮੀ
വിജയാശാനഥീ	ਵਿਜਯਾਸ਼ਾਨਥੀ
വിജീതാ	ਵਿਜੀਤਾ
വിദിശാ	ਵਿਦਿਸ਼ਾ
വിദ്യാ	ਵਿਦ੍ਯਾ
വിദ്യുല	ਵਿਦ੍ਯੁਲ
വിധാഥരീ	ਵਿਧਾਥਰੀ
വിന്ധുജാ	ਵਿਨ੍ਧੁਜਾ
വിബാലീ	ਵਿਬਾਲੀ
വിഭാവാ	ਵਿਭਾਵਾ
വിഭൂതി	ਵਿਭੂਤਿ
വിഭൂഷ	ਵਿਭੂਸ਼
വിയാമര്ശ	ਵਿਯਾਮਰ੍ਸ਼
വിരഗനാപതീ	ਵਿਰਗਨਾਪਤੀ
വിരഭാദ്രപ്പാ	ਵਿਰਭਾਦ੍ਰਪ੍ਪਾ
വിരാജ	ਵਿਰਾਜ
വിലാശീനീ	ਵਿਲਾਸ਼ੀਨੀ
വീണാ	ਵੀਣਾ
വീണാധാരീ	ਵੀਣਾਧਾਰੀ
വേക്രാംത	ਵੇਕ੍ਰਾਂਤ
വേഗ	ਵੇਗ
വേഗവാഹീനീ	ਵੇਗਵਾਹੀਨੀ
വേഗീ	ਵੇਗੀ
വേണു	ਵੇਣੁ
വേത്ത്രീ	ਵੇਤ੍ਤ੍ਰੀ
വേത്രിവാല	ਵੇਤ੍ਰਿਵਾਲ
വേത്രീവേല	ਵੇਤ੍ਰੀਵੇਲ
വേദകാര്തിക	ਵੇਦਕਾਰ੍ਤਿਕ
വേദവല്ലീ	ਵੇਦਵਲ੍ਲੀ
വേദാ	ਵੇਦਾ
വേദാ ശ്രീ	ਵੇਦਾ ਸ਼੍ਰੀ
വേധാംത	ਵੇਧਾਂਤ
വേന്കാത്രമണ	ਵੇਨ੍ਕਾਤ੍ਰਮਣ
വേന്തന	ਵੇਨ੍ਤਨ
വേന്നേലാ	ਵੇਨ੍ਨੇਲਾ
വേന്മതീ	ਵੇਨ੍ਮਤੀ
വേലു	ਵੇਲੁ
വേഹംത	ਵੇਹੰਤ
വൈകുംഠ	ਵੈਕੁਂਠ
വൈജീനാഥ	ਵੈਜੀਨਾਥ
വൈദത	ਵੈਦਤ
വൈദേഹീ	ਵੈਦੇਹੀ
വൈദ്യുംത	ਵੈਦ੍ਯੁਂਤ
വൈധേ	ਵੈਧੇ
വൈധ്യാത	ਵੈਧ੍ਯਾਤ
വൈരാഗ	ਵੈਰਾਗ
വൈരോചന	ਵੈਰੋਚਨ
വൈശാലീ	ਵੈਸ਼ਾਲੀ
വൈശ്വീ	ਵੈਸ਼੍ਵੀ
വൈഷ്ണവീ	ਵੈਸ਼੍ਣਵੀ
വൈസകാ	ਵੈਸਕਾ
സംക്രാംതി	ਸੰਕ੍ਰਾਂਤਿ
സംഗമിത്ര	ਸੰਗਮਿਤ੍ਰ
സംഗമീധീരാ	ਸੰਗਮੀਧੀਰਾ
സംചയ	ਸੰਚਯ
സംചീതീ	ਸੰਚੀਤੀ
സംജേനാ	ਸੰਜੇਨਾ
സംജോലീ	ਸੰਜੋਲੀ
സംതോക	ਸੰਤੋਕ
സംദിപോന	ਸੰਦਿਪੋਨ
സംദീപ	ਸੰਦੀਪ
സംദേശ	ਸੰਦੇਸ਼
സംധരാ	ਸੰਧਰਾ
സംധ്യാ	ਸੰਧ੍ਯਾ
സംബീതാ	ਸੰਬੀਤਾ
സംമീതാ	ਸੰਮੀਤਾ
സംയുക്ത	ਸੰਯੁਕ੍ਤ
സംവിധാ	ਸੰਵਿਧਾ
സംവീഥാ	ਸੰਵੀਥਾ
സംസ്കൃതി	ਸੰਸ੍ਕਤਿ
സംഹിത	ਸੰਹਿਤ
സക്ശീന്യാ	ਸਕ੍ਸ਼ੀਨ੍ਯਾ
സഖ്യാ	ਸਖ੍ਯਾ
സഗന	ਸਗਨ
സഗുനാ	ਸਗੁਨਾ
സചിതാ	ਸਚਿਤਾ
സചിദാനംദ വിഗ്രഹ	ਸਚਿਦਾਨੰਦ ਵਿਗ੍ਰਹ
സചേതന	ਸਚੇਤਨ
സച്ചിദാനംദാ	ਸਚ੍ਚਿਦਾਨੰਦਾ
സജീത	ਸਜੀਤ
സജീലീ	ਸਜੀਲੀ
സദഗതി	ਸਦਗਤਿ
സദഗുനാ	ਸਦਗੁਨਾ
സദാശിവ	ਸਦਾਸ਼ਿਵ
സദിശ	ਸਦਿਸ਼
സപനാ	ਸਪਨਾ
സപുഷ്പാ	ਸਪੁਸ਼੍ਪਾ
സപ്താബീ	ਸਪ੍ਤਾਬੀ
സപ്തോര്ശീ	ਸਪ੍ਤੋਰ੍ਸ਼ੀ
സമജാ	ਸਮਜਾ
സമദര്ശീ	ਸਮਦਰ੍ਸ਼ੀ
സമഭ്ദ്ധാ	ਸਮਭ੍ਦ੍ਧਾ
സമരേശ	ਸਮਰੇਸ਼
സമാംദ്രിതാ	ਸਮਾਂਦ੍ਰਿਤਾ
സമാംര്ധ	ਸਮਾਂਰ੍ਧ
സമാജസ	ਸਮਾਜਸ
സമാരാസ്യാ	ਸਮਾਰਾਸ੍ਯਾ
സമിക	ਸਮਿਕ
സമിരന	ਸਮਿਰਨ
സമേംദ്ര	ਸਮੇਂਦ੍ਰ
സമേശ	ਸਮੇਸ਼
സമ്പൂര്ണ	ਸਮ੍ਪੂਰ੍ਣ
സമ്പ്രഥ്യ	ਸਮ੍ਪ੍ਰਥ੍ਯ
സമ്പ്രീതീ	ਸਮ੍ਪ੍ਰੀਤੀ
സമ്രാട	ਸਮ੍ਰਾਟ
സമ്രീധ	ਸਮ੍ਰੀਧ
സരസംഗീ	ਸਰਸੰਗੀ
സലീജ	ਸਲੀਜ
സഹര്സീതാ	ਸਹਰ੍ਸੀਤਾ
സഹശ്രദ	ਸਹਸ਼੍ਰਦ
സഹസ്ത്രജീത	ਸਹਸ੍ਤ੍ਰਜੀਤ
സഹസ്ത്രബാഹു	ਸਹਸ੍ਤ੍ਰਬਾਹੁ
സഹീത	ਸਹੀਤ
സഹീരാമ	ਸਹੀਰਾਮ
സഹ്യ	ਸਹ੍ਯ
സാംജ	ਸਾਂਜ
സാഇ രാമ	ਸਾਇ ਰਾਮ
സാഈനാഥ	ਸਾਈਨਾਥ
സാചീ	ਸਾਚੀ
സാജന	ਸਾਜਨ
സാദ്രീശീ	ਸਾਦ੍ਰੀਸ਼ੀ
സാദ്വിഥാ	ਸਾਦ੍ਵਿਥਾ
സാധന	ਸਾਧਨ
സാധ്യാ	ਸਾਧ੍ਯਾ
സാനിധ്യ	ਸਾਨਿਧ੍ਯ
സാമംതാ	ਸਾਮੰਤਾ
സാമ്ഭാ	ਸਾਮ੍ਭਾ
സാരണീ	ਸਾਰਣੀ
സാരഥീ	ਸਾਰਥੀ
സാരികാ	ਸਾਰਿਕਾ
സാലവീ	ਸਾਲਵੀ
സാലസാ	ਸਾਲਸਾ
സൈകത	ਸੈਕਤ
സൈനീത്യ	ਸੈਨੀਤ੍ਯ
സൈന്ധന്യ	ਸੈਨ੍ਧਨ੍ਯ
സൈലീ	ਸੈਲੀ
സൈഹാര്സന	ਸੈਹਾਰ੍ਸਨ
ഹംസമാലാ	ਹੰਸਮਾਲਾ
ഹംസാവാഥ്യ	ਹੰਸਾਵਾਥ੍ਯ
ഹനാര്വീന	ਹਨਾਰ੍ਵੀਨ
ഹനീതാ	ਹਨੀਤਾ
ഹനുപ	ਹਨੁਪ
ഹനുമാന	ਹਨੁਮਾਨ
ഹബീതാ	ਹਬੀਤਾ
ഹമസാദീപികാ	ਹਮਸਾਦੀਪਿਕਾ
ഹമസാനംദീനീ	ਹਮਸਾਨੰਦੀਨੀ
ഹമീര	ਹਮੀਰ
ഹരജീത	ਹਰਜੀਤ
ഹരജീവന	ਹਰਜੀਵਨ
ഹരനാധ	ਹਰਨਾਧ
ഹരശും	ਹਰਸ਼ੁਂ
ഹരികിശന	ਹਰਿਕਿਸ਼ਨ
ഹരിഗംഗാ	ਹਰਿਗੰਗਾ
ഹരിഗോപാല	ਹਰਿਗੋਪਾਲ
ഹരിദാസ	ਹਰਿਦਾਸ
ഹരിദ്വാര	ਹਰਿਦ੍ਵਾਰ
ഹരിപ്രീത	ਹਰਿਪ੍ਰੀਤ
ഹരിമംതീ	ਹਰਿਮੰਤੀ
ഹരീ	ਹਰੀ
ഹരേശ്വര	ਹਰੇਸ਼੍ਵਰ
ഹര്മീന	ਹਰ੍ਮੀਨ
ഹര്ഷണ	ਹਰ੍ਸ਼ਣ
ഹര്സികാ	ਹਰ੍ਸਿਕਾ
ഹശ്മീതാ	ਹਸ਼੍ਮੀਤਾ
ഹസമുഖ	ਹਸਮੁਖ
ഹസീതാ	ਹਸੀਤਾ
ഹസ്വീഥാ	ਹਸ੍ਵੀਥਾ
ഹാര്ദീനീ	ਹਾਰ੍ਦੀਨੀ
ഹാര്ശീനീ	ਹਾਰ੍ਸ਼ੀਨੀ
ഹാലിക	ਹਾਲਿਕ
ഹിംഡോള	ਹਿਂਡੋਲ
ഹിംദോലാ	ਹਿਂਦੋਲਾ
ഹിതാക്ഷീ	ਹਿਤਾਕ੍ਸ਼ੀ
ഹിതീ	ਹਿਤੀ
ഹിഥീക്സാ	ਹਿਥੀਕ੍ਸਾ
ഹിമാംശു	ਹਿਮਾਂਸ਼ੁ
ഹിമാക്ഷ	ਹਿਮਾਕ੍ਸ਼
ഹിമാലയ	ਹਿਮਾਲਯ
ഹിരംയക	ਹਿਰੰਯਕ
ഹിരവ	ਹਿਰਵ
ഹിരവാ	ਹਿਰਵਾ
ഹിരുധായാ	ਹਿਰੁਧਾਯਾ
ഹിവാ	ਹਿਵਾ
ഹീരാനമാം	ਹੀਰਾਨਮਾਂ
ഹീരാന്യാപ്രകാഈ	ਹੀਰਾਨ੍ਯਾਪ੍ਰਕਾਈ
ഹീര്നാക്ഷീ	ਹੀਰ੍ਨਾਕ੍ਸ਼ੀ
ഹുവീശ്കാ	ਹੁਵੀਸ਼੍ਕਾ
ഹൃദയനാഥ	ਹਦਯਨਾਥ
ഹേഈദീ	ਹੇਈਦੀ
ഹേജല	ਹੇਜਲ
ഹേതാ	ਹੇਤਾ
ഹേതാശ	ਹੇਤਾਸ਼
ഹേത്ശ്രീ	ਹੇਤ੍ਸ਼੍ਰੀ
ഹേഥാന്ശ്രീ	ਹੇਥਾਨ੍ਸ਼੍ਰੀ
ഹേനീത	ਹੇਨੀਤ
ഹേനീല	ਹੇਨੀਲ
ഹേമനാഥ	ਹੇਮਨਾਥ
ഹേമലതാ	ਹੇਮਲਤਾ
ഹേമാ	ਹੇਮਾ
ഹേമാംദ്രികാ	ਹੇਮਾਂਦ੍ਰਿਕਾ
ഹേമാഗൌരീ	ਹੇਮਾਗੌਰੀ
ഹേമാനംദ	ਹੇਮਾਨੰਦ
ഹേമാലാ	ਹੇਮਾਲਾ
ഹേമാവതീ	ਹੇਮਾਵਤੀ
ഹേമാവാതിനംദന	ਹੇਮਾਵਾਤਿਨੰਦਨ
ഹേമേംദു	ਹੇਮੇਂਦੁ
ഹേയന	ਹੇਯਨ
ഹേയാംശ	ਹੇਯਾਂਸ਼
ഹേരീത	ਹੇਰੀਤ
ഹേലീ	ਹੇਲੀ
ഹോന്നേശാ	ਹੋਨ੍ਨੇਸ਼ਾ
ഹോമാ	ਹੋਮਾ
ഹ്രീത്വിക	ਹ੍ਰੀਤ੍ਵਿਕ
ഹ്രീദാന്ക്ഷ	ਹ੍ਰੀਦਾਨ੍ਕ੍ਸ਼
ഹ്രീധാന	ਹ੍ਰੀਧਾਨ
ഹ്രീശന	ਹ੍ਰੀਸ਼ਨ
ഹ്രീശാംത	ਹ੍ਰੀਸ਼ਾਂਤ
ഹ്രീഷിത	ਹ੍ਰੀਸ਼ਿਤ
ഹ്രുദയ	ਹ੍ਰੁਦਯ
ഹ്രുശാല	ਹ੍ਰੁਸ਼ਾਲ
ഹ്രേയാംശ	ਹ੍ਰੇਯਾਂਸ਼
ഹ്ര്യ്ദയേശ	ਹ੍ਰ੍ਯ੍ਦਯੇਸ਼
#
#
# Territory names from CLDR
അസൻഷൻ ദ്വീപ്	ਅਸਨ੍ਸ਼ਨ੍ ਦ੍ਵੀਪ੍
അന്റോറ	ਅਨ੍ਰ਼ੋਰ਼
യുണൈറ്റഡ് അറബ് എമിറൈറ്റ്‌സ്	ਯੁਣੈਰ਼੍ਰ਼ਡ੍ ਅਰ਼ਬ੍ ਏਮਿਰ਼ੈਰ਼੍ਰ਼੍‌ਸ੍
അഫ്‌ഗാനിസ്ഥാൻ	ਅਫ੍‌ਗਾਨਿਸ੍ਥਾਨ੍
ആൻറിഗ്വയും ബർബുഡയും	ਆਨ੍ਰ਼ਿਗ੍ਵਯੁਂ ਬਰ੍ਬੁਡਯੁਂ
ആൻഗ്വില്ല	ਆਨ੍ਗ੍ਵਿਲ੍ਲ
അൽബേനിയ	ਅਲ੍ਬੇਨਿਯ
അർമേനിയ	ਅਰ੍ਮੇਨਿਯ
അംഗോള	ਅਂਗੋਲ
അൻറാർട്ടിക്ക	ਅਨ੍ਰ਼ਾਰ੍ਟ੍ਟਿਕ੍ਕ
അർജൻറീന	ਅਰ੍ਜਨ੍ਰ਼ੀਨ
അമേരിക്കൻ സമോവ	ਅਮੇਰਿਕ੍ਕਨ੍ ਸਮੋਵ
ഓസ്ട്രിയ	ਓਸ੍ਟ੍ਰਿਯ
ഓസ്‌ട്രേലിയ	ਓਸ੍‌ਟ੍ਰੇਲਿਯ
അറൂബ	ਅਰ਼ੂਬ
അലൻഡ് ദ്വീപുകൾ	ਅਲਨ੍ਡ੍ ਦ੍ਵੀਪੁਕਲ੍
അസർബൈജാൻ	ਅਸਰ੍ਬੈਜਾਨ੍
ബോസ്നിയയും ഹെർസഗോവിനയും	ਬੋਸ੍ਨਿਯਯੁਂ ਹੇਰ੍ਸਗੋਵਿਨਯੁਂ
ബാർബഡോസ്	ਬਾਰ੍ਬਡੋਸ੍
ബംഗ്ലാദേശ്	ਬੰਗ੍ਲਾਦੇਸ਼੍
ബെൽജിയം	ਬੇਲ੍ਜਿਯੰ
ബുർക്കിനാ ഫാസോ	ਬੁਰ੍ਕ੍ਕਿਨਾ ਫਾਸੋ
ബൾഗേറിയ	ਬਲ੍ਗੇਰ਼ਿਯ
ബഹ്റിൻ	ਬਹ੍ਰ਼ਿਨ੍
ബറുണ്ടി	ਬਰ਼ੁਣ੍ਟਿ
ബെനിൻ	ਬੇਨਿਨ੍
സെന്റ് ബാർത്തലമി	ਸੇਨ੍ਰ਼੍ ਬਾਰ੍ਤ੍ਤਲਮਿ
ബർമുഡ	ਬਰ੍ਮੁਡ
ബ്രൂണൈ	ਬ੍ਰੂਣੈ
ബൊളീവിയ	ਬੋਲੀਵਿਯ
ബൊണെയ്ർ, സിന്റ് യുസ്റ്റേഷ്യസ്, സാബ എന്നിവ	ਬੋਣੇਯ੍ਰ੍, ਸਿਨ੍ਰ਼੍ ਯੁਸ੍ਰ਼੍ਰ਼ੇਸ਼੍ਯਸ੍, ਸਾਬ ਏਨ੍ਨਿਵ
ബ്രസീൽ	ਬ੍ਰਸੀਲ੍
ബഹാമാസ്	ਬਹਾਮਾਸ੍
ഭൂട്ടാൻ	ਭੂਟ੍ਟਾਨ੍
ബൗവെട്ട് ദ്വീപ്	ਬੌਵੇਟ੍ਟ੍ ਦ੍ਵੀਪ੍
ബോട്സ്വാന	ਬੋਟ੍ਸ੍ਵਾਨ
ബെലറൂസ്	ਬੇਲਰ਼ੂਸ੍
ബെലീസ്	ਬੇਲੀਸ੍
കാനഡ	ਕਾਨਡ
കോക്കസ് (കീലിംഗ്) ദ്വീപുകൾ	ਕੋਕ੍ਕਸ੍ (ਕੀਲਿਂਗ੍) ਦ੍ਵੀਪੁਕਲ੍
കോംഗോ - കിൻഷാസ	ਕੋਂਗੋ - ਕਿਨ੍ਸ਼ਾਸ
കോംഗോ (DRC)	ਕੋਂਗੋ (DRC)
സെൻട്രൽ ആഫ്രിക്കൻ റിപ്പബ്ലിക്	ਸੇਨ੍ਟ੍ਰਲ੍ ਆਫ੍ਰਿਕ੍ਕਨ੍ ਰ਼ਿਪ੍ਪਬ੍ਲਿਕ੍
കോംഗോ - ബ്രാസവില്ലി	ਕੋਂਗੋ - ਬ੍ਰਾਸਵਿਲ੍ਲਿ
കോംഗോ (റിപ്പബ്ലിക്ക്)	ਕੋਂਗੋ (ਰ਼ਿਪ੍ਪਬ੍ਲਿਕ੍ਕ੍)
സ്വിറ്റ്സർലാൻഡ്	ਸ੍ਵਿਰ਼੍ਰ਼੍ਸਰ੍ਲਾਨ੍ਡ੍
കോട്ട് ഡി വാർ	ਕੋਟ੍ਟ੍ ਡਿ ਵਾਰ੍
ഐവറി കോസ്റ്റ്	ਐਵਰ਼ਿ ਕੋਸ੍ਰ਼੍ਰ਼੍
കുക്ക് ദ്വീപുകൾ	ਕੁਕ੍ਕ੍ ਦ੍ਵੀਪੁਕਲ੍
ചിലി	ਚਿਲਿ
കാമറൂൺ	ਕਾਮਰ਼ੂਣ੍
ചൈന	ਚੈਨ
കൊളംബിയ	ਕੋਲੰਬਿਯ
ക്ലിപ്പെർട്ടൻ ദ്വീപ്	ਕ੍ਲਿਪ੍ਪੇਰ੍ਟ੍ਟਨ੍ ਦ੍ਵੀਪ੍
കോസ്റ്ററിക്ക	ਕੋਸ੍ਰ਼੍ਰ਼ਰ਼ਿਕ੍ਕ
ക്യൂബ	ਕ੍ਯੂਬ
കേപ്പ് വെർദെ	ਕੇਪ੍ਪ੍ ਵੇਰ੍ਦੇ
കുറാകാവോ	ਕੁਰ਼ਾਕਾਵੋ
ക്രിസ്മസ് ദ്വീപ്	ਕ੍ਰਿਸ੍ਮਸ੍ ਦ੍ਵੀਪ੍
സൈപ്രസ്	ਸੈਪ੍ਰਸ੍
ചെക്ക് റിപ്പബ്ലിക്	ਚੇਕ੍ਕ੍ ਰ਼ਿਪ੍ਪਬ੍ਲਿਕ੍
ജർമനി	ਜਰ੍ਮਨਿ
ഡീഗോ ഗ്രാഷ്യ	ਡੀਗੋ ਗ੍ਰਾਸ਼੍ਯ
ദിജിബൗട്ടി	ਦਿਜਿਬੌਟ੍ਟਿ
ഡെൻമാർക്ക്	ਡੇਨ੍ਮਾਰ੍ਕ੍ਕ੍
ഡൊമിനിക്ക	ਡੋਮਿਨਿਕ੍ਕ
ഡൊമിനിക്കൻ റിപ്പബ്ലിക്	ਡੋਮਿਨਿਕ੍ਕਨ੍ ਰ਼ਿਪ੍ਪਬ੍ਲਿਕ੍
അൾജീരിയ	ਅਲ੍ਜੀਰਿਯ
സെയൂത്ത ആൻഡ് മെലിയ	ਸੇਯੂਤ੍ਤ ਆਨ੍ਡ੍ ਮੇਲਿਯ
ഇക്വഡോർ	ਇਕ੍ਵਡੋਰ੍
എസ്റ്റോണിയ‍	ਏਸ੍ਰ਼੍ਰ਼ੋਣਿਯ‍
ഈജിപ്ത്	ਈਜਿਪ੍ਤ੍
പശ്ചിമ സഹാറ	ਪਸ਼੍ਚਿਮ ਸਹਾਰ਼
എറിത്രിയ	ਏਰ਼ਿਤ੍ਰਿਯ
സ്‌പെയിൻ	ਸ੍‌ਪੇਯਿਨ੍
എത്യോപ്യ	ਏਤ੍ਯੋਪ੍ਯ
യൂറോപ്യൻ യൂണിയൻ	ਯੂਰ਼ੋਪ੍ਯਨ੍ ਯੂਣਿਯਨ੍
ഫിൻലാൻഡ്	ਫਿਨ੍ਲਾਨ੍ਡ੍
ഫിജി	ਫਿਜਿ
ഫാക്ക്‌ലാന്റ് ദ്വീപുകൾ	ਫਾਕ੍ਕ੍‌ਲਾਨ੍ਰ਼੍ ਦ੍ਵੀਪੁਕਲ੍
ഫോക്ക്‌ലാൻഡ് ദ്വീപുകൾ (ഐലാസ് മാൽവിനാസ്)	ਫੋਕ੍ਕ੍‌ਲਾਨ੍ਡ੍ ਦ੍ਵੀਪੁਕਲ੍ (ਐਲਾਸ੍ ਮਾਲ੍ਵਿਨਾਸ੍)
മൈക്രോനേഷ്യ	ਮੈਕ੍ਰੋਨੇਸ਼੍ਯ
ഫറോ ദ്വീപുകൾ	ਫਰ਼ੋ ਦ੍ਵੀਪੁਕਲ੍
ഫ്രാൻസ്	ਫ੍ਰਾਨ੍ਸ੍
ഗാബൺ	ਗਾਬਣ੍
യുണൈറ്റഡ് കിംഗ്ഡം	ਯੁਣੈਰ਼੍ਰ਼ਡ੍ ਕਿਂਗ੍ਡੰ
ഗ്രനേഡ	ਗ੍ਰਨੇਡ
ജോർജ്ജിയ	ਜੋਰ੍ਜ੍ਜਿਯ
ഫ്രഞ്ച് ഗയാന	ਫ੍ਰਞ੍ਚ੍ ਗਯਾਨ
ഗേൺസി	ਗੇਣ੍ਸਿ
ഘാന	ਘਾਨ
ജിബ്രാൾട്ടർ	ਜਿਬ੍ਰਾਲ੍ਟ੍ਟਰ੍
ഗ്രീൻലാൻറ്	ਗ੍ਰੀਨ੍ਲਾਨ੍ਰ਼੍
ഗാംബിയ	ਗਾਂਬਿਯ
ഗിനിയ	ਗਿਨਿਯ
ഗ്വാഡലൂപ്പ്	ਗ੍ਵਾਡਲੂਪ੍ਪ੍
ഇക്വറ്റോറിയൽ ഗിനിയ	ਇਕ੍ਵਰ਼੍ਰ਼ੋਰ਼ਿਯਲ੍ ਗਿਨਿਯ
ഗ്രീസ്	ਗ੍ਰੀਸ੍
ദക്ഷിണ ജോർജ്ജിയയും ദക്ഷിണ സാൻഡ്‌വിച്ച് ദ്വീപുകളും	ਦਕ੍ਸ਼ਿਣ ਜੋਰ੍ਜ੍ਜਿਯਯੁਂ ਦਕ੍ਸ਼ਿਣ ਸਾਨ੍ਡ੍‌ਵਿਚ੍ਚ੍ ਦ੍ਵੀਪੁਕਲੁਂ
ഗ്വാട്ടിമാല	ਗ੍ਵਾਟ੍ਟਿਮਾਲ
ഗ്വാം	ਗ੍ਵਾਂ
ഗിനിയ-ബിസൗ	ਗਿਨਿਯ-ਬਿਸੌ
ഗയാന	ਗਯਾਨ
ഹോങ്കോങ്ങ് (SAR) ചൈന	ਹੋਙ੍ਕੋਙ੍ਙ੍ (SAR) ਚੈਨ
ഹോങ്കോങ്ങ്	ਹੋਙ੍ਕੋਙ੍ਙ੍
ഹിയേർഡും മക്‌ഡൊണാൾഡ് ദ്വീപുകളും	ਹਿਯੇਰ੍ਡੁਂ ਮਕ੍‌ਡੋਣਾਲ੍ਡ੍ ਦ੍ਵੀਪੁਕਲੁਂ
ഹോണ്ടുറാസ്	ਹੋਣ੍ਟੁਰ਼ਾਸ੍
ക്രൊയേഷ്യ	ਕ੍ਰੋਯੇਸ਼੍ਯ
ഹെയ്തി	ਹੇਯ੍ਤਿ
ഹംഗറി	ਹੰਗਰ਼ਿ
കാനറി ദ്വീപുകൾ	ਕਾਨਰ਼ਿ ਦ੍ਵੀਪੁਕਲ੍
ഇന്തോനേഷ്യ	ਇਨ੍ਤੋਨੇਸ਼੍ਯ
അയർലാൻഡ്	ਅਯਰ੍ਲਾਨ੍ਡ੍
ഇസ്രായേൽ	ਇਸ੍ਰਾਯੇਲ੍
ഐൽ ഓഫ് മാൻ	ਐਲ੍ ਓਫ੍ ਮਾਨ੍
ഇന്ത്യ	ਇਨ੍ਤ੍ਯ
ബ്രിട്ടീഷ് ഇന്ത്യൻ മഹാസമുദ്ര പ്രദേശം	ਬ੍ਰਿਟ੍ਟੀਸ਼੍ ਇਨ੍ਤ੍ਯਨ੍ ਮਹਾਸਮੁਦ੍ਰ ਪ੍ਰਦੇਸ਼ੰ
ഇറാഖ്	ਇਰ਼ਾਖ੍
ഇറാൻ	ਇਰ਼ਾਨ੍
ഐസ്‌ലാന്റ്	ਐਸ੍‌ਲਾਨ੍ਰ਼੍
ഇറ്റലി	ਇਰ਼੍ਰ਼ਲਿ
ജേഴ്സി	ਜੇਲ਼੍ਸਿ
ജമൈക്ക	ਜਮੈਕ੍ਕ
ജോർദ്ദാൻ	ਜੋਰ੍ਦ੍ਦਾਨ੍
ജപ്പാൻ	ਜਪ੍ਪਾਨ੍
കെനിയ	ਕੇਨਿਯ
കിർഗിസ്ഥാൻ	ਕਿਰ੍ਗਿਸ੍ਥਾਨ੍
കംബോഡിയ	ਕੰਬੋਡਿਯ
കിരിബാട്ടി	ਕਿਰਿਬਾਟ੍ਟਿ
കോമൊറോസ്	ਕੋਮੋਰ਼ੋਸ੍
സെന്റ് കിറ്റ്‌സും നെവിസും	ਸੇਨ੍ਰ਼੍ ਕਿਰ਼੍ਰ਼੍‌ਸੁਂ ਨੇਵਿਸੁਂ
ഉത്തരകൊറിയ	ਉਤ੍ਤਰਕੋਰ਼ਿਯ
ദക്ഷിണകൊറിയ	ਦਕ੍ਸ਼ਿਣਕੋਰ਼ਿਯ
കുവൈറ്റ്	ਕੁਵੈਰ਼੍ਰ਼੍
കേമാൻ ദ്വീപുകൾ	ਕੇਮਾਨ੍ ਦ੍ਵੀਪੁਕਲ੍
കസാഖിസ്ഥാൻ	ਕਸਾਖਿਸ੍ਥਾਨ੍
ലാവോസ്	ਲਾਵੋਸ੍
ലെബനൻ	ਲੇਬਨਨ੍
സെൻറ് ലൂസിയ	ਸੇਨ੍ਰ਼੍ ਲੂਸਿਯ
ലിച്ചൺസ്റ്റൈൻ	ਲਿਚ੍ਚਣ੍ਸ੍ਰ਼੍ਰ਼ੈਨ੍
ശ്രീലങ്ക	ਸ਼੍ਰੀਲਙ੍ਕ
ലൈബീരിയ	ਲੈਬੀਰਿਯ
ലെസോതോ	ਲੇਸੋਤੋ
ലിത്വാനിയ	ਲਿਤ੍ਵਾਨਿਯ
ലക്സംബർഗ്	ਲਕ੍ਸੰਬਰ੍ਗ੍
ലാറ്റ്വിയ	ਲਾਰ਼੍ਰ਼੍ਵਿਯ
ലിബിയ	ਲਿਬਿਯ
മൊറോക്കൊ	ਮੋਰ਼ੋਕ੍ਕੋ
മൊണാക്കോ	ਮੋਣਾਕ੍ਕੋ
മൾഡോവ	ਮਲ੍ਡੋਵ
മോണ്ടെനെഗ്രോ	ਮੋਣ੍ਟੇਨੇਗ੍ਰੋ
സെൻറ് മാർട്ടിൻ	ਸੇਨ੍ਰ਼੍ ਮਾਰ੍ਟ੍ਟਿਨ੍
മഡഗാസ്കർ	ਮਡਗਾਸ੍ਕਰ੍
മാർഷൽ‍‍ ദ്വീപുകൾ	ਮਾਰ੍ਸ਼ਲ੍‍‍ ਦ੍ਵੀਪੁਕਲ੍
മാസിഡോണിയ	ਮਾਸਿਡੋਣਿਯ
മാസിഡോണിയ (FYROM)	ਮਾਸਿਡੋਣਿਯ (FYROM)
മാലി	ਮਾਲਿ
മ്യാൻമാർ (ബർമ്മ)	ਮ੍ਯਾਨ੍ਮਾਰ੍ (ਬਰ੍ਮ੍ਮ)
മംഗോളിയ	ਮੰਗੋਲਿਯ
മക്കാവു (SAR) ചൈന	ਮਕ੍ਕਾਵੁ (SAR) ਚੈਨ
മക്കാവു	ਮਕ੍ਕਾਵੁ
ഉത്തര മറിയാനാ ദ്വീപുകൾ	ਉਤ੍ਤਰ ਮਰ਼ਿਯਾਨਾ ਦ੍ਵੀਪੁਕਲ੍
മാർട്ടിനിക്ക്	ਮਾਰ੍ਟ੍ਟਿਨਿਕ੍ਕ੍
മൗറിറ്റാനിയ	ਮੌਰ਼ਿਰ਼੍ਰ਼ਾਨਿਯ
മൊണ്ടെസരത്ത്	ਮੋਣ੍ਟੇਸਰਤ੍ਤ੍
മാൾട്ട	ਮਾਲ੍ਟ੍ਟ
മൗറീഷ്യസ്	ਮੌਰ਼ੀਸ਼੍ਯਸ੍
മാലിദ്വീപ്	ਮਾਲਿਦ੍ਵੀਪ੍
മലാവി	ਮਲਾਵਿ
മെക്സിക്കോ	ਮੇਕ੍ਸਿਕ੍ਕੋ
മലേഷ്യ	ਮਲੇਸ਼੍ਯ
മൊസാംബിക്ക്	ਮੋਸਾਂਬਿਕ੍ਕ੍
നമീബിയ	ਨਮੀਬਿਯ
പുതിയ കാലിഡോണിയ	ਪੁਤਿਯ ਕਾਲਿਡੋਣਿਯ
നൈജർ	ਨੈਜਰ੍
നോർഫോക് ദ്വീപ്	ਨੋਰ੍ਫੋਕ੍ ਦ੍ਵੀਪ੍
നൈജീരിയ	ਨੈਜੀਰਿਯ
നിക്കരാഗ്വ	ਨਿਕ੍ਕਰਾਗ੍ਵ
നെതർലാൻഡ്‌സ്	ਨੇਤਰ੍ਲਾਨ੍ਡ੍‌ਸ੍
നോർവെ	ਨੋਰ੍ਵੇ
നേപ്പാൾ	ਨੇਪ੍ਪਾਲ੍
നൗറു	ਨੌਰ਼ੁ
ന്യൂയി	ਨ੍ਯੂਯਿ
ന്യൂസിലാൻറ്	ਨ੍ਯੂਸਿਲਾਨ੍ਰ਼੍
ഒമാൻ	ਓਮਾਨ੍
പനാമ	ਪਨਾਮ
പെറു	ਪੇਰ਼ੁ
ഫ്രഞ്ച് പോളിനേഷ്യ	ਫ੍ਰਞ੍ਚ੍ ਪੋਲਿਨੇਸ਼੍ਯ
പാപ്പുവ ന്യൂ ഗിനിയ	ਪਾਪ੍ਪੁਵ ਨ੍ਯੂ ਗਿਨਿਯ
ഫിലിപ്പൈൻസ്	ਫਿਲਿਪ੍ਪੈਨ੍ਸ੍
പാക്കിസ്ഥാൻ	ਪਾਕ੍ਕਿਸ੍ਥਾਨ੍
പോളണ്ട്	ਪੋਲਣ੍ਟ੍
സെന്റ് പിയറിയും മിക്കലണും	ਸੇਨ੍ਰ਼੍ ਪਿਯਰ਼ਿਯੁਂ ਮਿਕ੍ਕਲਣੁਂ
പിറ്റ്‌കെയ്‌ൻ ദ്വീപുകൾ	ਪਿਰ਼੍ਰ਼੍‌ਕੇਯ੍‌ਨ੍ ਦ੍ਵੀਪੁਕਲ੍
പ്യൂർട്ടോ റിക്കോ	ਪ੍ਯੂਰ੍ਟ੍ਟੋ ਰ਼ਿਕ੍ਕੋ
പാലസ്‌തീൻ പ്രദേശങ്ങൾ	ਪਾਲਸ੍‌ਤੀਨ੍ ਪ੍ਰਦੇਸ਼ਙ੍ਙਲ੍
പലസ്‌തീൻ	ਪਲਸ੍‌ਤੀਨ੍
പോർച്ചുഗൽ	ਪੋਰ੍ਚ੍ਚੁਗਲ੍
പലാവു	ਪਲਾਵੁ
പരാഗ്വേ	ਪਰਾਗ੍ਵੇ
ഖത്തർ	ਖਤ੍ਤਰ੍
ദ്വീപസമൂഹം	ਦ੍ਵੀਪਸਮੂਹੰ
റീയൂണിയൻ	ਰ਼ੀਯੂਣਿਯਨ੍
റൊമാനിയ	ਰ਼ੋਮਾਨਿਯ
സെർബിയ	ਸੇਰ੍ਬਿਯ
റഷ്യ	ਰ਼ਸ਼੍ਯ
റുവാണ്ട	ਰ਼ੁਵਾਣ੍ਟ
സൗദി അറേബ്യ	ਸੌਦਿ ਅਰ਼ੇਬ੍ਯ
സോളമൻ‍ ദ്വീപുകൾ	ਸੋਲਮਨ੍‍ ਦ੍ਵੀਪੁਕਲ੍
സെയ്‌ഷെൽസ്	ਸੇਯ੍‌ਸ਼ੇਲ੍ਸ੍
സുഡാൻ	ਸੁਡਾਨ੍
സ്വീഡൻ	ਸ੍ਵੀਡਨ੍
സിംഗപ്പുർ	ਸਿਂਗਪ੍ਪੁਰ੍
സെൻറ് ഹെലീന	ਸੇਨ੍ਰ਼੍ ਹੇਲੀਨ
സ്ലോവേനിയ	ਸ੍ਲੋਵੇਨਿਯ
സ്വാൽബാഡും ജാൻ മായേനും	ਸ੍ਵਾਲ੍ਬਾਡੁਂ ਜਾਨ੍ ਮਾਯੇਨੁਂ
സ്ലോവാക്യ	ਸ੍ਲੋਵਾਕ੍ਯ
സിയെറ ലിയോൺ	ਸਿਯੇਰ਼ ਲਿਯੋਣ੍
സാൻ മറിനോ	ਸਾਨ੍ ਮਰ਼ਿਨੋ
സെനഗൽ	ਸੇਨਗਲ੍
സോമാലിയ	ਸੋਮਾਲਿਯ
സുരിനെയിം	ਸੁਰਿਨੇਯਿਂ
ദക്ഷിണ സുഡാൻ	ਦਕ੍ਸ਼ਿਣ ਸੁਡਾਨ੍
സാവോ ടോമും പ്രിൻസിപെയും	ਸਾਵੋ ਟੋਮੁਂ ਪ੍ਰਿਨ੍ਸਿਪੇਯੁਂ
എൽ സാൽവദോർ	ਏਲ੍ ਸਾਲ੍ਵਦੋਰ੍
സിന്റ് മാർട്ടെൻ	ਸਿਨ੍ਰ਼੍ ਮਾਰ੍ਟ੍ਟੇਨ੍
സിറിയ	ਸਿਰ਼ਿਯ
സ്വാസിലാൻറ്	ਸ੍ਵਾਸਿਲਾਨ੍ਰ਼੍
ട്രസ്റ്റൻ ഡ കൂന	ਟ੍ਰਸ੍ਰ਼੍ਰ਼ਨ੍ ਡ ਕੂਨ
ടർക്ക്‌സും കെയ്‌ക്കോ ദ്വീപുകളും	ਟਰ੍ਕ੍ਕ੍‌ਸੁਂ ਕੇਯ੍‌ਕ੍ਕੋ ਦ੍ਵੀਪੁਕਲੁਂ
ഛാഡ്	ਛਾਡ੍
ഫ്രഞ്ച് ദക്ഷിണ ഭൂപ്രദേശം	ਫ੍ਰਞ੍ਚ੍ ਦਕ੍ਸ਼ਿਣ ਭੂਪ੍ਰਦੇਸ਼ੰ
ടോഗോ	ਟੋਗੋ
തായ്‌ലാൻഡ്	ਤਾਯ੍‌ਲਾਨ੍ਡ੍
താജിക്കിസ്ഥാൻ	ਤਾਜਿਕ੍ਕਿਸ੍ਥਾਨ੍
ടോക്കെലൂ	ਟੋਕ੍ਕੇਲੂ
തിമോർ-ലെസ്റ്റെ	ਤਿਮੋਰ੍-ਲੇਸ੍ਰ਼੍ਰ਼ੇ
കിഴക്കൻ തിമോർ	ਕਿਲ਼ਕ੍ਕਨ੍ ਤਿਮੋਰ੍
തുർക്ക്മെനിസ്ഥാൻ	ਤੁਰ੍ਕ੍ਕ੍ਮੇਨਿਸ੍ਥਾਨ੍
ടുണീഷ്യ	ਟੁਣੀਸ਼੍ਯ
ടോംഗ	ਟੋਂਗ
തുർക്കി	ਤੁਰ੍ਕ੍ਕਿ
ട്രിനിഡാഡും ടുബാഗോയും	ਟ੍ਰਿਨਿਡਾਡੁਂ ਟੁਬਾਗੋਯੁਂ
ടുവാലു	ਟੁਵਾਲੁ
തായ്‌വാൻ	ਤਾਯ੍‌ਵਾਨ੍
ടാൻസാനിയ	ਟਾਨ੍ਸਾਨਿਯ
ഉക്രെയ്‌ൻ	ਉਕ੍ਰੇਯ੍‌ਨ੍
ഉഗാണ്ട	ਉਗਾਣ੍ਟ
അമേരിക്കൻ ഐക്യനാടുകൾ	ਅਮੇਰਿਕ੍ਕਨ੍ ਐਕ੍ਯਨਾਟੁਕਲ੍
ഉറുഗ്വേ	ਉਰ਼ੁਗ੍ਵੇ
ഉസ്‌ബെക്കിസ്ഥാൻ	ਉਸ੍‌ਬੇਕ੍ਕਿਸ੍ਥਾਨ੍
വത്തിക്കാൻ	ਵਤ੍ਤਿਕ੍ਕਾਨ੍
സെന്റ് വിൻസെന്റും ഗ്രനെഡൈൻസും	ਸੇਨ੍ਰ਼੍ ਵਿਨ੍ਸੇਨ੍ਰ਼ੁਂ ਗ੍ਰਨੇਡੈਨ੍ਸੁਂ
വെനിസ്വേല	ਵੇਨਿਸ੍ਵੇਲ
ബ്രിട്ടീഷ് വെർജിൻ ദ്വീപുകൾ	ਬ੍ਰਿਟ੍ਟੀਸ਼੍ ਵੇਰ੍ਜਿਨ੍ ਦ੍ਵੀਪੁਕਲ੍
വിയറ്റ്നാം	ਵਿਯਰ਼੍ਰ਼੍ਨਾਂ
വന്വാതു	ਵਨ੍ਵਾਤੁ
വാലിസ് ആന്റ് ഫ്യൂച്യുന	ਵਾਲਿਸ੍ ਆਨ੍ਰ਼੍ ਫ੍ਯੂਚ੍ਯੁਨ
സമോവ	ਸਮੋਵ
കൊസോവൊ	ਕੋਸੋਵੋ
യെമൻ	ਯੇਮਨ੍
മയോട്ടി	ਮਯੋਟ੍ਟਿ
ദക്ഷിണാഫ്രിക്ക	ਦਕ੍ਸ਼ਿਣਾਫ੍ਰਿਕ੍ਕ
സാംബിയ	ਸਾਂਬਿਯ
സിംബാബ്‌വേ	ਸਿਂਬਾਬ੍‌ਵੇ
അജ്ഞാത പ്രദേശം	ਅਜ੍ਞਾਤ ਪ੍ਰਦੇਸ਼ੰ
