# Baby names
ਅਂਗਦ	અંગદ
ਅਂਗਦ ਦੇਵ	અંગદ દેવ
ਅਂਗਾਰਿਕਾ	અંગારિકા
ਅਂਤਰਜੋਤ	અંતરજોત
ਅਂਤਰਪ੍ਰਿਤ	અંતરપ્રિત
ਅਂਤਰਾ	અંતરા
ਅਕਲਤਟ	અકલતટ
ਅਕਲਰੂਪ	અકલરૂપ
ਅਕਲਸ਼ਰਣ	અકલશરણ
ਅਕਲਸੀਮਾਰ	અકલસીમાર
ਅਕਾਲਜੋਗ	અકાલજોગ
ਅਕਾਲਦੀਪ	અકાલદીપ
ਅਕਾਲਪ੍ਰੀਤ	અકાલપ્રીત
ਅਕਾਲਬੀਰ	અકાલબીર
ਅਗਮਜੀਤ	અગમજીત
ਅਗਮਜੋਤ	અગમજોત
ਅਗਮ੍ਪਾਲ	અગમ્પાલ
ਅਗਮ੍ਪ੍ਰੀਤ	અગમ્પ્રીત
ਅਜ੍ਮੀਨ੍ਦੇਰ	અજ્મીન્દેર
ਅਝਾਦਬੀਰ	અઝાદબીર
ਅਝੀਝ	અઝીઝ
ਅਤੀਨਦੇਰ੍ਜਿਤ	અતીનદેર્જિત
ਅਤੀਨ੍ਦੇਰ	અતીન્દેર
ਅਤ੍ਤਾਮਜਿਤ	અત્તામજિત
ਅਨਂਤਦੇਵ	અનંતદેવ
ਅਨਂਤਰ	અનંતર
ਅਨਂਤਵੀਰ	અનંતવીર
ਅਨਂਤ੍ਜੀਤ	અનંત્જીત
ਅਨਾਹਤ	અનાહત
ਅਨਿਂਦਿਤਾ	અનિંદિતા
ਅਨਿਸ਼ਾ	અનિશા
ਅਨੀਲਜੋਤ	અનીલજોત
ਅਨੀਸ਼੍ਕੋਉਂਰ	અનીશ્કોઉંર
ਅਨੁਂਜਪਾਲ	અનુંજપાલ
ਅਨੁਂਪਜੋਤ	અનુંપજોત
ਅਨੁਰਾਧਾ	અનુરાધા
ਅਨੁਸ਼੍ਕਾ	અનુશ્કા
ਅਨੂਪਜੋਤ	અનૂપજોત
ਅਨੂਪਬੀਰ	અનૂપબીર
ਅਨੂਪਲੋਕ	અનૂપલોક
ਅਪੂਰ੍ਵਾ	અપૂર્વા
ਅਪ੍ਰੀਨਦੇਰ	અપ્રીનદેર
ਅਬਨੀ	અબની
ਅਬਿਚਾਲ	અબિચાલ
ਅਬਿਨਾਸ਼	અબિનાશ
ਅਭਿਜੀਤ	અભિજીત
ਅਭਿਰੂਪ	અભિરૂપ
ਅਮਨਜੀਤ	અમનજીત
ਅਮਰਜੋਤ	અમરજોત
ਅਮਰਤ	અમરત
ਅਮਰਿਂਦਰ	અમરિંદર
ਅਮਰਿਤ	અમરિત
ਅਮਲਜੋਤ	અમલજોત
ਅਮਾਨਜੀਵਨ	અમાનજીવન
ਅਮਾਨੀਨ੍ਦੇਰ	અમાનીન્દેર
ਅਮਾਨ੍ਰੂਪ	અમાન્રૂપ
ਅਮਾਰ੍ਪਾਲ	અમાર્પાલ
ਅਮਾਰ੍ਬੀਰ	અમાર્બીર
ਅਮਿਕ	અમિક
ਅਮਿਤ	અમિત
ਅਮਿਤੋਜ	અમિતોજ
ਅਮੀਤਪਾਲ	અમીતપાલ
ਅਮੀਤ੍ਬੀਰ	અમીત્બીર
ਅਮੋਲ੍ਰਸ	અમોલ્રસ
ਅਮ੍ਨੀਨ੍ਦੇਰ	અમ્નીન્દેર
ਅਮ੍ਰੀਤਬਾਨ	અમ્રીતબાન
ਅਮ੍ਰੀਤ੍ਪ੍ਰਿਤ	અમ્રીત્પ્રિત
ਅਮ੍ਰੀਤ੍ਵਾਨੀ	અમ્રીત્વાની
ਅਰਮਾਨੀ	અરમાની
ਅਰਵਜੋਤ	અરવજોત
ਅਰੀਨਾਜੇਤ	અરીનાજેત
ਅਰੀਨ੍ਦੇਰ੍ਜੀਤ	અરીન્દેર્જીત
ਅਰੁਨਜੀਤ	અરુનજીત
ਅਰੁਨਜੋਤ	અરુનજોત
ਅਰ੍ਚਨਾ	અર્ચના
ਅਰ੍ਦਮਨ	અર્દમન
ਅਰ੍ਨਾਲੀਨ੍ਦੇਰ	અર્નાલીન્દેર
ਅਰ੍ਸ਼੍ਦੀਪ	અર્શ્દીપ
ਅਲੋਕ੍ਪਾਲ	અલોક્પાલ
ਅਲ੍ਪਨਾ	અલ્પના
ਅਵਨੀਨਦੇਰ	અવનીનદેર
ਅਵਿਰ	અવિર
ਅਵ੍ਲੀਨ	અવ્લીન
ਅਸਂਖ	અસંખ
ਅਸ਼ਮਿਤ	અશમિત
ਅਸ਼ਰ੍ਨਾਮ	અશર્નામ
ਅਸ਼ਰ੍ਪ੍ਰੀਤ	અશર્પ્રીત
ਅਸ਼ਰ੍ਪ੍ਰੇਮ	અશર્પ્રેમ
ਅਸ਼ਰ੍ਵੀਰ	અશર્વીર
ਅਸ਼ਿਮਾ	અશિમા
ਅਸੀਮ	અસીમ
ਅਸੀਸ	અસીસ
ਅਸ੍ਨੇਹ	અસ્નેહ
ਆਖਰੀ	આખરી
ਆਤ੍ਮਜਾ	આત્મજા
ਆਨਂਦਮਯੀ	આનંદમયી
ਆਨਂਦਰੂਪ	આનંદરૂપ
ਆਯਕਾਰ	આયકાર
ਆਯਾਤਪ੍ਰਿਤ	આયાતપ્રિત
ਆਯੁਸ਼੍ਮਤਿ	આયુશ્મતિ
ਆਰਮਾਨ	આરમાન
ਆਰਾਧ	આરાધ
ਆਰਾਧਨਾ	આરાધના
ਆਰ੍ਯਨ	આર્યન
ਇਂਦਰਬੀਰ	ઇંદરબીર
ਇਂਦਿਵਰ	ઇંદિવર
ਇਕਪ੍ਰਿਤ	ઇકપ્રિત
ਇਕਬਾਲ	ઇકબાલ
ਇਕਰੂਪ	ઇકરૂપ
ਇਕ੍ਪੂਜ	ઇક્પૂજ
ਇਕ੍ਮਾਨ	ઇક્માન
ਇਚ੍ਕਜਿਤ	ઇચ્કજિત
ਇਨ੍ਦਾਰਤੇਜ	ઇન્દારતેજ
ਇਨ੍ਦਾਰਮਿਤ	ઇન્દારમિત
ਇਨ੍ਦਾਰ੍ਦੀਪ	ઇન્દાર્દીપ
ਇਨ੍ਦਾਰ੍ਪ੍ਰਿਤ	ઇન્દાર્પ્રિત
ਇਨ੍ਦਾਰ੍ਪ੍ਰੇਮ	ઇન્દાર્પ્રેમ
ਇਨ੍ਦੇਰ	ઇન્દેર
ਇਨ੍ਦੇਰਪਲ	ઇન્દેરપલ
ਇਨ੍ਦੇਰਮਾਨ	ઇન્દેરમાન
ਇਨ੍ਦੇਰਹਾਰ੍ਜਿਤ	ઇન્દેરહાર્જિત
ਇਮਰਾਤ	ઇમરાત
ਈਖ੍ਤਿਅਰ	ઈખ્તિઅર
ਈਨ੍ਦਰ੍ਜੀਏਤ	ઈન્દર્જીએત
ਈਨ੍ਦੇਰਤੇਕ	ઈન્દેરતેક
ਈਨ੍ਦੇਰਵੀਰ	ઈન્દેરવીર
ਈਬਾਦਤ	ઈબાદત
ਈਸ਼ਪਾਲ	ઈશપાલ
ਈਸ਼ਲੀਨ	ઈશલીન
ਈਸ਼ਾਰਤੇਕ	ઈશારતેક
ਈਸ਼ਾਰਪਾਲ	ઈશારપાલ
ਈਸ਼੍ਤ੍ਵਰ੍ਜਿਤ	ઈશ્ત્વર્જિત
ਈਸ਼੍ਪ੍ਰਿਤ	ઈશ્પ્રિત
ਈਸ਼੍ਵਾਰ੍ਜਿਤ	ઈશ્વાર્જિત
ਈਸ਼੍ਵੀਨਦੇਰ	ઈશ્વીનદેર
ਉਖ੍ਤਿਅਰ	ઉખ્તિઅર
ਉਚਪਾਲ	ઉચપાલ
ਉਚਪ੍ਰਿਤ	ઉચપ્રિત
ਉਚੀਤਦੀਪ	ઉચીતદીપ
ਉਚੀਤਪ੍ਰਿਤ	ઉચીતપ્રિત
ਉਚੀਤਬੀਰ	ઉચીતબીર
ਉਚੀਤਰੂਪ	ઉચીતરૂપ
ਉਚੀਤਲੋਕ	ઉચીતલોક
ਉਚੀਤਵਂਤ	ઉચીતવંત
ਉਜਗਰ੍ਜੋਤ	ઉજગર્જોત
ਉਜਗਰ੍ਦੀਪ	ઉજગર્દીપ
ਉਜਗਰ੍ਬੀਰ	ઉજગર્બીર
ਉਜਾਗਰ	ઉજાગર
ਉਜਾਲਾ	ઉજાલા
ਉਜ੍ਜਲਜੋਤ	ઉજ્જલજોત
ਉਤ੍ਤਮ	ઉત્તમ
ਉਤ੍ਤਮਪਾਲ	ઉત્તમપાલ
ਉਤ੍ਤਮਲੀਵ	ઉત્તમલીવ
ਉਤ੍ਤਾਮਕਾਰਾਮ	ઉત્તામકારામ
ਉਤ੍ਤਾਮਜੋਧ	ઉત્તામજોધ
ਉਤ੍ਤਾਮਤਿਰਥ	ઉત્તામતિરથ
ਉਤ੍ਤਾਮਤੇਕ	ઉત્તામતેક
ਉਤ੍ਤਾਮਦੀਪ	ઉત્તામદીપ
ਉਤ੍ਤਾਮਪਦ	ઉત્તામપદ
ਉਤ੍ਤਾਮ੍ਰਸ	ઉત્તામ્રસ
ਉਤ੍ਤਾਮ੍ਰੂਪ	ઉત્તામ્રૂપ
ਉਤ੍ਰਕ੍ਸ਼	ઉત્રક્શ
ਉਦੀਤਦੀਪ	ઉદીતદીપ
ਉਦੀਤਪ੍ਰਿਤ	ઉદીતપ્રિત
ਉਦੀਤਬੀਰ	ઉદીતબીર
ਉਦੈਬੀਰ	ઉદૈબીર
ਉਦੈਭਗਤ	ઉદૈભગત
ਉਦ੍ਦਾਮਜੀਤ	ઉદ્દામજીત
ਉਪਕਰਮ	ઉપકરમ
ਉਪਕਿਰਤ	ઉપકિરત
ਉਪਜਿਤ	ઉપજિત
ਉਪਨਿਤ	ઉપનિત
ਉਪੀਨਦੇਰ੍ਪ੍ਰਿਤ	ઉપીનદેર્પ્રિત
ਉਪੇਨ੍ਦੇਰ	ઉપેન્દેર
ਉਮੀਦ	ઉમીદ
ਊਤ੍ਤਮ੍ਗਿਆਨ	ઊત્તમ્ગિઆન
ਏਕਂਕਰ	એકંકર
ਏਕਬੀਰ	એકબીર
ਏਕਮ	એકમ
ਏਕਮਪੂਜ	એકમપૂજ
ਏਕਮਬੀਰ	એકમબીર
ਏਕਮ੍ਜੋਤ	એકમ્જોત
ਏਕਮ੍ਰੂਪ	એકમ્રૂપ
ਏਕਾਨਪ੍ਰੀਤ	એકાનપ્રીત
ਏਕ੍ਕਾਮ	એક્કામ
ਏਤੀਬਾਰ	એતીબાર
ਏਤ੍ਤਲੀਨ	એત્તલીન
ਏਰਸ਼ੀਨ	એરશીન
ਏਵੇਨਿਤ	એવેનિત
ਏਸ਼ਨਾ	એશના
ਏਸ਼੍ਵਰ	એશ્વર
ਓਨਕਾਰ੍ਜਿਤ	ઓનકાર્જિત
ਓਨਕਾਰ੍ਜੀਤ	ઓનકાર્જીત
ਓਨਕਾਰ੍ਪ੍ਰਿਤ	ઓનકાર્પ્રિત
ਓਮਪ੍ਰਿਤ	ઓમપ્રિત
ਕਂਵਲ	કંવલ
ਕਂਵਲਜੀਤ	કંવલજીત
ਕਨਵਾਰ੍ਜਾਗਤ	કનવાર્જાગત
ਕਨਵਾਰ੍ਜਿਤ	કનવાર્જિત
ਕਨਵਾਰ੍ਪ੍ਰੇਮ	કનવાર્પ્રેમ
ਕਨਵਾਲ੍ਜੋਤ	કનવાલ્જોત
ਕਨਵਾਲ੍ਨੈਨ	કનવાલ્નૈન
ਕਨਵਾਲ੍ਪਾਲ	કનવાલ્પાલ
ਕਨਵਾਲ੍ਪ੍ਰੇਮ	કનવાલ્પ્રેમ
ਕਨਵਾਲ੍ਬੀਰ	કનવાલ્બીર
ਕਨਵਾਲ੍ਰੂਪ	કનવાલ્રૂપ
ਕਨ੍ਚਨ੍ਦੀਪ	કન્ચન્દીપ
ਕਨ੍ਚਾਨ੍ਪਾਲ	કન્ચાન્પાલ
ਕਨ੍ਵਾਰਪਾਲ	કન્વારપાલ
ਕਮਾਲ੍ਲਾ	કમાલ્લા
ਕਰਨਦੀਪ	કરનદીપ
ਕਰਨਪਾਲ	કરનપાલ
ਕਰਨਪ੍ਰਿਤ	કરનપ્રિત
ਕਰਨਰੂਪ	કરનરૂપ
ਕਰਮਪਲ	કરમપલ
ਕਰਮਪੁਲ	કરમપુલ
ਕਰਮ੍ਜੋਤ	કરમ્જોત
ਕਰੁਨ੍ਯਾ	કરુન્યા
ਕਲਬੀਰ	કલબીર
ਕਲਾਜੋਤ	કલાજોત
ਕਲਾਪ੍ਰੇਮ	કલાપ્રેમ
ਕਵਨਿਤ	કવનિત
ਕਵਨੀਰ	કવનીર
ਕਵਾਲ੍ਨਾਨ	કવાલ્નાન
ਕਵਿਰਾਜ	કવિરાજ
ਕਸਮ	કસમ
ਕਾਨਵਾਲੀਨ੍ਦੇਰ	કાનવાલીન્દેર
ਕਾਮਾਂਲਜੋਤ	કામાંલજોત
ਕਾਮਾਂਲਮਿਤ	કામાંલમિત
ਕਾਮਾਂਲਮੋਹਨ	કામાંલમોહન
ਕਾਮਾਂਲ੍ਪਤਿ	કામાંલ્પતિ
ਕਾਰਮਨ	કારમન
ਕਾਵਾਲਪ੍ਰਿਤ	કાવાલપ્રિત
ਕਿਰਣਜੀਤ	કિરણજીત
ਕਿਰਨਰੂਪ	કિરનરૂપ
ਕਿਰਨਸੁਖ	કિરનસુખ
ਕਿਸ਼ੇਨ	કિશેન
ਕੁਂਵਰਜੀਤ	કુંવરજીત
ਕੁਲ	કુલ
ਕੁਲਜੋਤ	કુલજોત
ਕੁਲਮਿਤ	કુલમિત
ਕੁਲਰਾਤਨ	કુલરાતન
ਕੁਲਰੂਪ	કુલરૂપ
ਕੁਲਵਂਠ	કુલવંઠ
ਕੁਸ਼ਪ੍ਰਿਤ	કુશપ્રિત
ਕੇਵਾਲਦੀਪ	કેવાલદીપ
ਕੇਵਾਲਬੀਰ	કેવાલબીર
ਕੋਉਰ	કોઉર
ਕੋਮਾਂਲਜੀਤ	કોમાંલજીત
ਕੋਮਾਂਲਪ੍ਰੇਮ	કોમાંલપ્રેમ
ਕੋਮਾਲਦੀਪ	કોમાલદીપ
ਕੋਮਾਲਮਿਤ	કોમાલમિત
ਕੌਰ	કૌર
ਕ੍ਰਿਸ਼੍ਦੀਪ	ક્રિશ્દીપ
ਕ੍ਸ਼ਾਗਨ	ક્શાગન
ਕ੍ਸ਼ਾਗਰ	ક્શાગર
ਕ੍ਸ਼ਿਤਿਜ	ક્શિતિજ
ਕ੍ਸ਼੍ਹੀਮ	ક્શ્હીમ
ਖਰਗ	ખરગ
ਖਾਲਾਕ੍ਵੀਰ	ખાલાક્વીર
ਖੁਂਸ਼ਜੋਤ	ખુંશજોત
ਖੁਸ	ખુસ
ਖੁਸ਼	ખુશ
ਖੁਸ਼ਜੀਤ	ખુશજીત
ਖੇਮਵਂਤ	ખેમવંત
ਗਗਨ	ગગન
ਗਗਨਜੀਵ	ગગનજીવ
ਗਗਨਜੋਤ	ગગનજોત
ਗਗਨਪ੍ਰਿਤ	ગગનપ્રિત
ਗਗਨਮਿਤ	ગગનમિત
ਗਤਲੀਨ	ગતલીન
ਗਤਸ਼ਰਣ	ગતશરણ
ਗਤਸੀਮਾਰ	ગતસીમાર
ਗਰੀਨ੍ਦੇਰ	ગરીન્દેર
ਗਰ੍ਗੋਤ	ગર્ગોત
ਗਾਤਨੀਵਾਸ	ગાતનીવાસ
ਗਿਅਨ	ગિઅન
ਗੀਂਜੀਵਨ	ગીંજીવન
ਗੀਂਰਾਤਨ	ગીંરાતન
ਗੀਂਲੀਨ	ગીંલીન
ਗੀਅਂਗੀਤ	ગીઅંગીત
ਗੀਅਂਚੇਤਨ	ગીઅંચેતન
ਗੀਅਂਜੋਤ	ગીઅંજોત
ਗੀਅਂਪ੍ਰਿਤ	ગીઅંપ્રિત
ਗੀਅਂਰੂਪ	ગીઅંરૂપ
ਗੀਅਨੀਨਦੇਰ	ગીઅનીનદેર
ਗੀਅਨ੍ਬੀਰ	ગીઅન્બીર
ਗੀਆਨਪ੍ਰਿਤ	ગીઆનપ્રિત
ਗੀਆਨਲੀਨ	ગીઆનલીન
ਗੀਤ	ગીત
ਗੀਤਲੀਨ	ગીતલીન
ਗੀਤੀਨਦੇਰ	ગીતીનદેર
ਗੁਣਿਤ	ગુણિત
ਗੁਨ ਦਾਤ	ગુન દાત
ਗੁਨਕਿਰਤ	ગુનકિરત
ਗੁਨਜਸ	ગુનજસ
ਗੁਨਜਿਤ	ગુનજિત
ਗੁਨਜੀਵਨ	ગુનજીવન
ਗੁਨਜੁਨ	ગુનજુન
ਗੁਨਜੋਤ	ગુનજોત
ਗੁਨਪ੍ਰਿਤ	ગુનપ્રિત
ਗੁਨਮਿਤ	ગુનમિત
ਗੁਨਰਾਜ	ગુનરાજ
ਗੁਨਸ਼ਾਂਤ	ગુનશાંત
ਗੁਨਾਤਮ	ગુનાતમ
ਗੁਨਿਤਪੁਲ	ગુનિતપુલ
ਗੁਨਿਤਪ੍ਰਿਤ	ગુનિતપ્રિત
ਗੁਨ੍ਰਿਤ	ગુન્રિત
ਗੁਰਕਮਲ਼	ગુરકમલ઼
ਗੁਰਗਿਯਨ	ગુરગિયન
ਗੁਰਜਾਸ	ગુરજાસ
ਗੁਰਜੀਵਨ	ગુરજીવન
ਗੁਰਜੋਗ	ગુરજોગ
ਗੁਰਜੋਤ	ગુરજોત
ਗੁਰਝੀਲ	ગુરઝીલ
ਗੁਰਤਰਣ	ગુરતરણ
ਗੁਰਤਿਰਥ	ગુરતિરથ
ਗੁਰਦਰ੍ਸ਼ਨ	ગુરદર્શન
ਗੁਰਦਿਤ	ગુરદિત
ਗੁਰਦੀਤ੍ਤਾ	ગુરદીત્તા
ਗੁਰਦ੍ਵੀਪ	ગુરદ્વીપ
ਗੁਰਨਾਦ	ગુરનાદ
ਗੁਰਨਾਮਾਸ੍ਕਾਰ	ગુરનામાસ્કાર
ਗੁਰਨੀਧ	ગુરનીધ
ਗੁਰਨੀਰ੍ਮਾਲ	ગુરનીર્માલ
ਗੁਰਨੀਸ਼ਾਨ	ગુરનીશાન
ਗੁਰਨ੍ਯਮ	ગુરન્યમ
ਗੁਰਪਰ੍ਵਿਨ	ગુરપર્વિન
ਗੁਰਪੀਨਦੇਰ	ગુરપીનદેર
ਗੁਰਪ੍ਰੀਤਮ	ગુરપ્રીતમ
ਗੁਰਬਕ੍ਸ਼	ગુરબક્શ
ਗੁਰਬਲੀਹਾਰ	ગુરબલીહાર
ਗੁਰਬੀਨ੍ਦੇਰ	ગુરબીન્દેર
ਗੁਰਬੀਰ	ગુરબીર
ਗੁਰਭਜਨ	ગુરભજન
ਗੁਰਭਾਗਤ	ગુરભાગત
ਗੁਰਮਾਰ	ગુરમાર
ਗੁਰਮਾਹੇਰ	ગુરમાહેર
ਗੁਰਮੁਖ	ગુરમુખ
ਗੁਰਮੇਹਾਰ	ગુરમેહાર
ਗੁਰਮੈਲ	ગુરમૈલ
ਗੁਰਮ੍ਰਿਤ	ગુરમ્રિત
ਗੁਰਲੋਚਨ	ગુરલોચન
ਗੁਰਵਿਂਦਰ	ગુરવિંદર
ਗੁਰਵੀਨ੍ਦੇਰ	ગુરવીન્દેર
ਗੁਰਵੀਰ	ગુરવીર
ਗੁਰਸਨ੍ਦੀਪ	ગુરસન્દીપ
ਗੁਰਸ਼ਾਨ	ગુરશાન
ਗੁਰਸੁਖ	ગુરસુખ
ਗੁਰਸੇਵ	ગુરસેવ
ਗੁਰਹਾਰ੍ਪਾਲ	ગુરહાર્પાલ
ਗੁਰਿਂਦਰ	ગુરિંદર
ਗੁਰੀਨਦੇਰ੍ਪਾਲ	ગુરીનદેર્પાલ
ਗੁਰੁਕਾਰ	ગુરુકાર
ਗੁਰੁਗੁਲ੍ਝਾਰ	ગુરુગુલ્ઝાર
ਗੁਰੁਚਰਣ	ગુરુચરણ
ਗੁਰੁਦਰ੍ਸ਼ਨ	ગુરુદર્શન
ਗੁਰੁਦਾਸ	ગુરુદાસ
ਗੁਰੁਦੀਪ	ગુરુદીપ
ਗੁਰੁਪ੍ਰੇਮ	ગુરુપ્રેમ
ਗੁਰੁਬੀਰ	ગુરુબીર
ਗੁਰੁਮਾਂਨ੍ਦੀਰ	ગુરુમાંન્દીર
ਗੁਰੁਸੀਮ੍ਰਣ	ગુરુસીમ્રણ
ਗੁਰ੍ਕੀਰਣ	ગુર્કીરણ
ਗੁਰ੍ਕੀਰਪਾਲ	ગુર્કીરપાલ
ਗੁਰ੍ਚਾਰਾਨ੍ਜੋਤ	ગુર્ચારાન્જોત
ਗੁਰ੍ਜਨਪਾਲ	ગુર્જનપાલ
ਗੁਰ੍ਜੁ	ગુર્જુ
ਗੁਰ੍ਤੇਜ	ગુર્તેજ
ਗੁਰ੍ਨੀਵਾਝ	ગુર્નીવાઝ
ਗੁਰ੍ਨੂਰ	ગુર્નૂર
ਗੁਰ੍ਪ੍ਰਿਤੀ	ગુર્પ્રિતી
ਗੁਰ੍ਮੀਤ	ગુર્મીત
ਗੁਰ੍ਮੀਨਦੇਰ	ગુર્મીનદેર
ਗੁਰ੍ਮੁਖਨੀਹਲ	ગુર્મુખનીહલ
ਗੁਰ੍ਸ਼ਣ	ગુર્શણ
ਗੁਰ੍ਸ਼ਾਂਤ	ગુર્શાંત
ਗੁਰ੍ਸ਼ੀਲ	ગુર્શીલ
ਗੁਰ੍ਸਾਹੇਬ	ગુર્સાહેબ
ਗੁਲਦੀਪ	ગુલદીપ
ਗੁਲਵਂਤ	ગુલવંત
ਗੁਲਸ਼ਾਨ੍ਰੂਪ	ગુલશાન્રૂપ
ਗੁਲ੍ਵਾਨ੍ਤਪ੍ਰਿਤ	ગુલ્વાન્તપ્રિત
ਗੁਲ੍ਸ਼ਾਨਪ੍ਰਿਤ	ગુલ્શાનપ્રિત
ਗੁਲ੍ਸ਼ਾਨਮਿਤ	ગુલ્શાનમિત
ਗੋਪਲਪ੍ਰਿਤ	ગોપલપ્રિત
ਗੋਬਿਂਦ	ગોબિંદ
ਗੋਬੀਨਦੇਰ	ગોબીનદેર
ਗੋਬੀਨਦੇਰ੍ਜਿਤ	ગોબીનદેર્જિત
ਗੋਬੀਨ੍ਦਰਾਈ	ગોબીન્દરાઈ
ਗੌਰਵ੍ਪ੍ਰਿਤ	ગૌરવ્પ્રિત
ਘਮਾਂਨਦ੍ਜਿਤ	ઘમાંનદ્જિત
ਘਮਾਂਨਦ੍ਪਾਲ	ઘમાંનદ્પાલ
ਚਂਚਲਜਿਤ	ચંચલજિત
ਚਂਚਲ੍ਪ੍ਰੀਤ	ચંચલ્પ્રીત
ਚਂਦਨ	ચંદન
ਚਂਦਨਦੀਪ	ચંદનદીપ
ਚਮਕੌਰ	ચમકૌર
ਚਮਨਜਿਤ	ચમનજિત
ਚਮਨਪ੍ਰਿਤ	ચમનપ્રિત
ਚਮਨਰੂਪ	ચમનરૂપ
ਚਰਨਕਾਨ੍ਵਾਲ	ચરનકાન્વાલ
ਚਰਨਜੋਤ /ਚਰਨਜ੍ਯੋਤ	ચરનજોત /ચરનજ્યોત
ਚਰਨਪ੍ਰੇਮ	ચરનપ્રેમ
ਚਾਂਦ	ચાંદ
ਚਿਤਰਾਮਣ	ચિતરામણ
ਚਿਤਸਰੂਪ	ચિતસરૂપ
ਚੀਤਪ੍ਰਿਤ	ચીતપ્રિત
ਚੇਤਨ੍ਦੀਪ	ચેતન્દીપ
ਜਗਜੀਤ	જગજીત
ਜਗਜੀਵ	જગજીવ
ਜਗਜੀਵਨ	જગજીવન
ਜਗਤਜੀਤ	જગતજીત
ਜਗਤਪ੍ਰੇਮ	જગતપ્રેમ
ਜਗਤਰਣ	જગતરણ
ਜਗਤਰੂਪ	જગતરૂપ
ਜਗਨ	જગન
ਜਗਪਾਲ	જગપાલ
ਜਗਪ੍ਰਿਤ	જગપ્રિત
ਜਗਪ੍ਰੇਮ	જગપ્રેમ
ਜਗਮਿਤ	જગમિત
ਜਗਮੇਹਾਰ	જગમેહાર
ਜਗਮੋਹਨ	જગમોહન
ਜਗਰਾਜ	જગરાજ
ਜਗਰੂਪ	જગરૂપ
ਜਗਵੀਨ੍ਦੇਰ	જગવીન્દેર
ਜਗਵੀਰ	જગવીર
ਜਗੀਨਦੇਰ	જગીનદેર
ਜਗੀਨ੍ਦੇਰਪਾਲ	જગીન્દેરપાલ
ਜਗ੍ਵੀਰ	જગ્વીર
ਜਘ੍ਰ	જઘ્ર
ਜਤੀਨਦੇਰ੍ਜਿਤ	જતીનદેર્જિત
ਜਤੀਨਦੇਰ੍ਬੀਰ	જતીનદેર્બીર
ਜਤੀਨਦੇਰ੍ਮਿਤ	જતીનદેર્મિત
ਜਨਜਿਤ	જનજિત
ਜਨਜੋਤ	જનજોત
ਜਨਪ੍ਰਿਤ	જનપ્રિત
ਜਨਰਾਜ	જનરાજ
ਜਨਿਸ਼	જનિશ
ਜਪਜਿਤ	જપજિત
ਜਪਧਾਰਾਮ	જપધારામ
ਜਪਧਿਰ	જપધિર
ਜਪਨਾਮ	જપનામ
ਜਪਸ਼ੇਰ	જપશેર
ਜਪੁਜੀ	જપુજી
ਜਬਰਜਂਗ	જબરજંગ
ਜਮੀਲ	જમીલ
ਜਯਂਸ਼	જયંશ
ਜਯਪਾਲ	જયપાલ
ਜਰ੍ਨੈਲ	જર્નૈલ
ਜਲਿਨ੍ਦ੍ਰ	જલિન્દ્ર
ਜਲ੍ਬੀਰ	જલ્બીર
ਜਸਂਜੋਤ	જસંજોત
ਜਸਂਪਾਲ	જસંપાલ
ਜਸਂਮਿਤ	જસંમિત
ਜਸਕੀਰਣ	જસકીરણ
ਜਸਗੁਰ੍ਕੀਰ੍ਤਤ	જસગુર્કીર્તત
ਜਸਜੀਨ੍ਦੇਰ	જસજીન્દેર
ਜਸਜੀਵਨ	જસજીવન
ਜਸਜੋਤ	જસજોત
ਜਸਤਰਣ	જસતરણ
ਜਸਨਾਮ	જસનામ
ਜਸਪਾਲ (ਪੁਲ )	જસપાલ (પુલ )
ਜਸਬੀਰ	જસબીર
ਜਸਭੂਪ	જસભૂપ
ਜਸਮਿਂਦਰ	જસમિંદર
ਜਸਮੋਹਨ	જસમોહન
ਜਸਰੂਪ	જસરૂપ
ਜਸ੍ਕਰਣ	જસ્કરણ
ਜਸ੍ਕੀਰਿਤ	જસ્કીરિત
ਜਸ੍ਕੀਰ੍ਪਲ	જસ્કીર્પલ
ਜਸ੍ਗੁਨ	જસ્ગુન
ਜਸ੍ਮਿਤ	જસ્મિત
ਜਸ੍ਮੀਨਪ੍ਰਿਤ	જસ્મીનપ્રિત
ਜਸ੍ਰਜਪ੍ਰਿਤ	જસ્રજપ્રિત
ਜਸ੍ਸੀ	જસ્સી
ਜਾਗ	જાગ
ਜਾਗਰੀਤ	જાગરીત
ਜਾਤਵਂਤ	જાતવંત
ਜਾਤਿਨਦੇਰ੍ਦੀਪ	જાતિનદેર્દીપ
ਜਾਨਾਕਪ੍ਰਿਤ	જાનાકપ્રિત
ਜਾਪਮਾਨ	જાપમાન
ਜਾਸਨਿਤ	જાસનિત
ਜਾਸ਼ਾਨਪ੍ਰਿਤ	જાશાનપ્રિત
ਜਾਸ੍ਮੀਲ	જાસ્મીલ
ਜੀਵਨਦੀਪ ; ਜੀਵਨਦੀਪ ; ਜੀਵਨਦੀਪ	જીવનદીપ ; જીવનદીપ ; જીવનદીપ
ਜੀਵਨਪਲ	જીવનપલ
ਜੀਵਨਪ੍ਰਿਤ	જીવનપ્રિત
ਜੀਵਾਨਬੀਰ	જીવાનબીર
ਜੁਗਦ	જુગદ
ਜੁਪੀਨਦੇਰਦੀਪ	જુપીનદેરદીપ
ਜੁਪੀਨਦੇਰ੍ਬੀਰ	જુપીનદેર્બીર
ਜੁਸਜਿਤ	જુસજિત
ਜੁਸਪੁਲ	જુસપુલ
ਜੁਸਮੈਲ	જુસમૈલ
ਜੇਬਾ	જેબા
ਜੇਸਪਾਲ	જેસપાલ
ਜੈਕਾਰ	જૈકાર
ਜੈਪ੍ਰਜ	જૈપ્રજ
ਜੈਪ੍ਰਤਨ	જૈપ્રતન
ਜੈਬੀਰ	જૈબીર
ਜੈਸਂਗਤ	જૈસંગત
ਜੈਸੁਖਬੀਰ	જૈસુખબીર
ਜੋਗਧੀਆਨ	જોગધીઆન
ਜੋਗਪ੍ਰਕਾਸ਼	જોગપ્રકાશ
ਜੋਗੀਨਦੇਰ੍ਬੀਰ	જોગીનદેર્બીર
ਜੋਗੀਨਦੇਰ੍ਮਿਤ	જોગીનદેર્મિત
ਜੋਗੇਨਦੇਰ	જોગેનદેર
ਜੋਤਪ੍ਰਕਾਸ਼	જોતપ્રકાશ
ਜੋਬਨਰੂਪ	જોબનરૂપ
ਜੋਹਾਰ	જોહાર
ਜ੍ਞਾਨਜਿਤ	જ્ઞાનજિત
ਜ੍ਞਾਨਜੋਤ	જ્ઞાનજોત
ਜ੍ਞਾਨਪ੍ਰਿਤ	જ્ઞાનપ્રિત
ਜ੍ਞਾਨਰੂਪ	જ્ઞાનરૂપ
ਜ੍ਞਾਨਵੀਰ	જ્ઞાનવીર
ਜ੍ਞਾਨੇਨ੍ਦੇਰ	જ્ઞાનેન્દેર
ਜ੍ਹਮਕ	જ્હમક
ਜ੍ਹਾਗਰ	જ્હાગર
ਝਈਤੂਨ	ઝઈતૂન
ਝਹਾਗਨ	ઝહાગન
ਝਾਮੀਨਾਹ	ઝામીનાહ
ਝੀਤੁਨ	ઝીતુન
ਝੀਲ	ઝીલ
ਝੁਲਾਖਾ	ઝુલાખા
ਝੁਲ੍ਫਾ	ઝુલ્ફા
ਝੇਬਵਂਤ	ઝેબવંત
ਝੋਰਾਵਾਰ	ઝોરાવાર
ਟੇਇਜਿਨ੍ਦੇਰ	ટેઇજિન્દેર
ਤਕਦੀਰ	તકદીર
ਤਖਤ	તખત
ਤਤਜੋਗ	તતજોગ
ਤਤਬੀਰ	તતબીર
ਤਤਵਿਚਾਰ	તતવિચાર
ਤਤ੍ਰਾਤਨ	તત્રાતન
ਤਦਬੀਰ	તદબીર
ਤਨਦੀਪ	તનદીપ
ਤਨਵੀਰ	તનવીર
ਤਮਨ੍ਪ੍ਰਿਤ	તમન્પ્રિત
ਤਰਣਵੀਰ	તરણવીર
ਤਰਲੋਚਨ	તરલોચન
ਤਰਸੇਮ	તરસેમ
ਤਰੁਨਜਿਤ	તરુનજિત
ਤਲਵਿਨ	તલવિન
ਤਾਜਦਾਰ	તાજદાર
ਤਾਜੀਨਦੇਰ੍ਦੀਪ	તાજીનદેર્દીપ
ਤਾਜੀਨਦੇਰ੍ਪ੍ਰੇਮ	તાજીનદેર્પ્રેમ
ਤਾਨੁਪ੍ਰਿਤ	તાનુપ્રિત
ਤਾਪਨਪਾਲ	તાપનપાલ
ਤੀਰਨ /ਤਿਹ੍ਰਣ /ਤੇਯ੍ਰੁਣ	તીરન /તિહ્રણ /તેય્રુણ
ਤੀਰਾਥ੍ਰਾਮ	તીરાથ્રામ
ਤੁਵਿਜਾਤ	તુવિજાત
ਤੇਕਜੀਤ	તેકજીત
ਤੇਕਦੀਪ	તેકદીપ
ਤੇਕਪ੍ਰਿਤ	તેકપ્રિત
ਤੇਕ੍ਪਾਲ	તેક્પાલ
ਤੇਘਬਹਾਦੁਰ	તેઘબહાદુર
ਤੇਜਧਾਰਾਮ	તેજધારામ
ਤੇਜਨਾਮ	તેજનામ
ਤੇਜਪ੍ਰਤਾਪ	તેજપ્રતાપ
ਤੇਜ਼	તેજ઼
ਤੇਜਾਸਵੀਰ	તેજાસવીર
ਤੇਜੀਨਦੇਰ੍ਜੀਤ	તેજીનદેર્જીત
ਤੇਜੀਨਦੇਰ੍ਪਾਲ	તેજીનદેર્પાલ
ਤੋਤਾਸਿਂਹ	તોતાસિંહ
ਤ੍ਰਿਪਲ	ત્રિપલ
ਤ੍ਰਿਲੋਚਨ	ત્રિલોચન
ਤ੍ਰੀਭਾਵਾਨ	ત્રીભાવાન
ਤ੍ਰੀਸ਼ਾਨਜੋਤ	ત્રીશાનજોત
ਤ੍ਰੀਸ਼ਾਨਦੀਪ	ત્રીશાનદીપ
ਤ੍ਰੀਸ਼ਾਨਬੀਰ	ત્રીશાનબીર
ਥਾਕੁਰਨਾਮ	થાકુરનામ
ਥਾਲਭੂਪ	થાલભૂપ
ਥਾਲਰਾਜ	થાલરાજ
ਥੀਰਮਾਨ	થીરમાન
ਥੀਰ੍ਧੀਆਨ	થીર્ધીઆન
ਦਮਨਜਿਤ	દમનજિત
ਦਮਨਜੋਤ	દમનજોત
ਦਯਾਜੋਤ	દયાજોત
ਦਯਾਦੀਪ	દયાદીપ
ਦਰਮੀਨ੍ਦੇਰ	દરમીન્દેર
ਦਰ੍ਪ੍ਰਿਤ	દર્પ્રિત
ਦਲਜੋਧ	દલજોધ
ਦਲਬੀਨਦੇਰ	દલબીનદેર
ਦਲਬੀਨ੍ਦੇਰ੍ਜਿਤ	દલબીન્દેર્જિત
ਦਲਰਾਜ	દલરાજ
ਦਲੇਰ	દલેર
ਦਵੀਨ੍ਦੇਰ	દવીન્દેર
ਦਿਦਾਰ	દિદાર
ਦਿਨਤੇਕ	દિનતેક
ਦਿਪਲੀਨ	દિપલીન
ਦਿਲਜੋਤ	દિલજોત
ਦਿਲਨਿਤ	દિલનિત
ਦਿਲਪ੍ਰਿਤ	દિલપ્રિત
ਦਿਲਮਿਤ	દિલમિત
ਦਿਲਰਿਤ	દિલરિત
ਦਿਲਸ਼ਾਨ	દિલશાન
ਦਿਲਸ਼ੇਰ	દિલશેર
ਦਿਵ੍ਯਜ੍ਯੋਤ	દિવ્યજ્યોત
ਦੀਲਜੀਤ	દીલજીત
ਦੀਲਬਾਘ	દીલબાઘ
ਦੀਲ੍ਜਿਤ	દીલ્જિત
ਦੀਵ੍ਯਜੋਤ	દીવ્યજોત
ਦੇਵਜੀਤ	દેવજીત
ਦੇਵਪ੍ਰਿਤ	દેવપ્રિત
ਦੇਵਾਤ੍ਮਾ	દેવાત્મા
ਦੇਵੀਨ੍ਦੇਰ	દેવીન્દેર
ਧਰਮਜ੍ਯੋਤ	ધરમજ્યોત
ਧਰਮਪਾਲ	ધરમપાલ
ਧਰਮਪ੍ਰੀਤ	ધરમપ્રીત
ਧਰਮਲੀਨ	ધરમલીન
ਧੀਅਨ੍ਜੋਗ	ધીઅન્જોગ
ਨਕ੍ਸ਼ਤ੍ਰਾ	નક્શત્રા
ਨਮ੍ਰੀਤਾਬੀਰ	નમ્રીતાબીર
ਨਯਨਦੀਪ	નયનદીપ
ਨਰਿਨ੍ਦਰ	નરિન્દર
ਨਰੇਨ੍ਦ੍ਰ	નરેન્દ્ર
ਨਵਜੀਤ	નવજીત
ਨਵਜੀਵਨ	નવજીવન
ਨਵਦੀਪ	નવદીપ
ਨਵਬੀਰ	નવબીર
ਨਵਮਿਤ	નવમિત
ਨਵ੍ਜੀਨ੍ਦੇਰ	નવ્જીન્દેર
ਨਾਗਂਦਰ	નાગંદર
ਨਾਨਕੀ	નાનકી
ਨਾਨਵੀਰ	નાનવીર
ਨਾਨ੍ਦਾਨਜਿਤ	નાન્દાનજિત
ਨਾਨ੍ਦਾਨਪ੍ਰਿਤ	નાન્દાનપ્રિત
ਨਾਮਜੀਵ	નામજીવ
ਨਾਮਜੋਗ	નામજોગ
ਨਾਮਜੋਤ	નામજોત
ਨਾਮਜੋਧ	નામજોધ
ਨਾਮਧਾਰ	નામધાર
ਨਾਮਧਿਯਨ	નામધિયન
ਨਾਮਧਿਰ	નામધિર
ਨਾਮਨੀਰ੍ਮਾਲ	નામનીર્માલ
ਨਾਮਨੀਵਾਸ	નામનીવાસ
ਨਾਮਪ੍ਰਿਤ	નામપ્રિત
ਨਾਮਪ੍ਰੇਮ	નામપ્રેમ
ਨਾਮਭਾਗਤ	નામભાગત
ਨਾਮਵਿਚਾਰ	નામવિચાર
ਨਾਮਸ਼ਰਣ	નામશરણ
ਨਾਮਾਂਡੋਲ਼	નામાંડોલ઼
ਨਾਮਾਹਾਰ	નામાહાર
ਨਾਮੁਤ੍ਤਮ	નામુત્તમ
ਨਾਮ੍ਰਾਤਨ	નામ્રાતન
ਨਾਮ੍ਰਿਤਾ	નામ્રિતા
ਨਾਮ੍ਰੀਤਾਜੋਤ	નામ્રીતાજોત
ਨਾਮ੍ਰੀਤਾਦੀਪ	નામ્રીતાદીપ
ਨਾਮ੍ਰੀਤਾਪ੍ਰਿਤ	નામ્રીતાપ્રિત
ਨਾਰ	નાર
ਨਾਰਂਜਨ	નારંજન
ਨਾਰੀਤਪਲ	નારીતપલ
ਨਾਰੀਨਦੇਰਦੀਪ	નારીનદેરદીપ
ਨਾਰੈਨ	નારૈન
ਨਾਵਿਨਜਿਤ	નાવિનજિત
ਨਾਵ੍ਕੀਰਣ	નાવ્કીરણ
ਨਾਵ੍ਕੀਰਨਜੋਤ	નાવ્કીરનજોત
ਨਾਵ੍ਪ੍ਰਿਤ	નાવ્પ્રિત
ਨਿਮਾਈ	નિમાઈ
ਨਿਰਂਜਨ	નિરંજન
ਨਿਰਂਜਨਾ	નિરંજના
ਨਿਰ੍ਮਲਜੀਤ	નિર્મલજીત
ਨਿਲਾਮਜੋਤ	નિલામજોત
ਨਿਲਾਮਪੁਲ	નિલામપુલ
ਨਿਲਾਮਪ੍ਰਿਤ	નિલામપ્રિત
ਨਿਲਾਮਬੇਰ	નિલામબેર
ਨਿਸ਼ਾ	નિશા
ਨਿਹ੍ਚਾਲਤੇਕ	નિહ્ચાલતેક
ਨਿਹ੍ਚਾਲਮਿਤ	નિહ્ચાલમિત
ਨੀਤਨਾਮ	નીતનામ
ਨੀਨਦੇਰ੍ਬੀਰ	નીનદેર્બીર
ਨੀਮਮਾਂਪ੍ਰਿਤ	નીમમાંપ્રિત
ਨੀਮਮਾਂਰ੍ਦੀਪ	નીમમાંર્દીપ
ਨੀਮ੍ਮਾਂਰਤਾ	નીમ્માંરતા
ਨੀਮ੍ਰਤ	નીમ્રત
ਨੀਰਮਾਂਲਦੀਪ	નીરમાંલદીપ
ਨੀਰਮਾਂਲਬੀਰ	નીરમાંલબીર
ਨੀਰਮੋਲ	નીરમોલ
ਨੀਰਵੈਰ	નીરવૈર
ਨੀਰ੍ਭਾਉ	નીર્ભાઉ
ਨੀਰ੍ਮਾਂਲਕਾਰਾਮ	નીર્માંલકારામ
ਨੀਰ੍ਮਾਂਲਜੀਵ	નીર્માંલજીવ
ਨੀਰ੍ਮਾਂਲਜੋਤ	નીર્માંલજોત
ਨੀਰ੍ਮਾਂਲਤੇਕ	નીર્માંલતેક
ਨੀਰ੍ਮਾਂਲਧਾਰਾਮ	નીર્માંલધારામ
ਨੀਰ੍ਮਾਂਲਪ੍ਰਿਤ	નીર્માંલપ્રિત
ਨੀਸ਼ਾਨ੍ਦੀਪ	નીશાન્દીપ
ਨੀਹ੍ਚਾਲ੍ਪ੍ਰੇਮ	નીહ્ચાલ્પ્રેમ
ਨੂਰਦੇਵ	નૂરદેવ
ਨੂਰਨਿਤ	નૂરનિત
ਨੂਰਪ੍ਰਿਤ	નૂરપ્રિત
ਨੇਕਨਾਮ	નેકનામ
ਨੇਕੀਨਦੇਰ	નેકીનદેર
ਨੇਕ੍ਦੀਪ	નેક્દીપ
ਨੇਕ੍ਪਾਲ	નેક્પાલ
ਨੇਹ੍ਚਾਲਪ੍ਰਿਤ	નેહ્ચાલપ્રિત
ਨੈਨਤਾਰ	નૈનતાર
ਨੈਨਦੀਪ	નૈનદીપ
ਨੈਨੀਨਦੇਰ	નૈનીનદેર
ਨੋਉਲਖ	નોઉલખ
ਨੌਹਨੀਹਲ	નૌહનીહલ
ਨ੍ਰੀਪਜੋਤ	ન્રીપજોત
ਪਤਵਂਤ	પતવંત
ਪਤਵੀਰ	પતવીર
ਪਦਾਮਜਿਤ	પદામજિત
ਪਦਾਮਪ੍ਰੇਮ	પદામપ્રેમ
ਪਦ੍ਮਸ਼੍ਰੀ	પદ્મશ્રી
ਪਰਤਾਪ ; ਪਰਤਾਪ	પરતાપ ; પરતાપ
ਪਰਤਾਪੀ	પરતાપી
ਪਰਦੀਪ	પરદીપ
ਪਰਬੀਨ	પરબીન
ਪਰਮਕਮਲ਼	પરમકમલ઼
ਪਰਮਕਿਰਤ	પરમકિરત
ਪਰਮਗੁਨ	પરમગુન
ਪਰਮਜਾਪ	પરમજાપ
ਪਰਮਜੀਤ ; ਪਰਮਜੀਤ	પરમજીત ; પરમજીત
ਪਰਮਜੁਗਤ	પરમજુગત
ਪਰਮਜੋਗ	પરમજોગ
ਪਰਮਜੋਧ	પરમજોધ
ਪਰਮਠਾਕਰ	પરમઠાકર
ਪਰਮਤੇਕ	પરમતેક
ਪਰਮਦੀਪ	પરમદીપ
ਪਰਮਧਾਰਾਮ	પરમધારામ
ਪਰਮਧਿਰ	પરમધિર
ਪਰਮਪਾਲ	પરમપાલ
ਪਰਮਪ੍ਰੇਮ	પરમપ્રેમ
ਪਰਮਬੋਧ	પરમબોધ
ਪਰਮਯੋਗ	પરમયોગ
ਪਰਮਰਂਗ	પરમરંગ
ਪਰਮਲੀਨ	પરમલીન
ਪਰਮਸ਼ਾਂਤ	પરમશાંત
ਪਰਮਸਿਤਾਲ	પરમસિતાલ
ਪਰਮਸੁਖ	પરમસુખ
ਪਰਮਸੇਵਕ	પરમસેવક
ਪਰਮਾਧਾਰ	પરમાધાર
ਪਰਮਾਰ੍ਥ	પરમાર્થ
ਪਰਮਿਂਦਰ	પરમિંદર
ਪਰਮੀਤ	પરમીત
ਪਰਮ੍ਦਯਾ	પરમ્દયા
ਪਰਸਂਜੀਤ	પરસંજીત
ਪਰਸ਼ੋਤਮ	પરશોતમ
ਪਰਾਮਨੀਵਾਸ	પરામનીવાસ
ਪਰੀਦਰ੍ਸ਼ਨ	પરીદર્શન
ਪਰ੍ਗਤ	પર્ગત
ਪਰ੍ਵੀਨ੍ਦੇਰ	પર્વીન્દેર
ਪਲਬੀਨਦੇਰ	પલબીનદેર
ਪਲਵੀਨ੍ਦੇਰ੍ਪਾਲ	પલવીન્દેર્પાલ
ਪਵਾਨਜੋਤ	પવાનજોત
ਪਵਾਨਦੀਪ	પવાનદીપ
ਪਵਾਨਪ੍ਰਿਤ	પવાનપ્રિત
ਪਵਾਨਵੀਰ	પવાનવીર
ਪਵੀਤ	પવીત
ਪਾਰਂਗਤ	પારંગત
ਪੁਨੀਤ	પુનીત
ਪੁਨੀਤਪਾਲ	પુનીતપાલ
ਪੁਰਾਨਪ੍ਰੇਮ	પુરાનપ્રેમ
ਪੁਰਾਨ੍ਜੀਤ	પુરાન્જીત
ਪੁਸ਼ਪ੍ਰਿਤ	પુશપ્રિત
ਪੁਸ਼੍ਪਿਤਾ	પુશ્પિતા
ਪੂਰਨਜੀਤ	પૂરનજીત
ਪ੍ਰਗਿਤ	પ્રગિત
ਪ੍ਰਜਨਾ	પ્રજના
ਪ੍ਰਣਿਤ	પ્રણિત
ਪ੍ਰਨੀਤਾ	પ્રનીતા
ਪ੍ਰਫੂਲਦੀਪ	પ્રફૂલદીપ
ਪ੍ਰਭਕੀਰਤ	પ્રભકીરત
ਪ੍ਰਭਕੀਰ੍ਪਾਲ	પ્રભકીર્પાલ
ਪ੍ਰਭਗੀਤ	પ્રભગીત
ਪ੍ਰਭਚਰਣ	પ્રભચરણ
ਪ੍ਰਭਚੇਤਨ	પ્રભચેતન
ਪ੍ਰਭਜਿਤ	પ્રભજિત
ਪ੍ਰਭਜੀਤ	પ્રભજીત
ਪ੍ਰਭਜੀਵਨ	પ્રભજીવન
ਪ੍ਰਭਜੋਗ	પ્રભજોગ
ਪ੍ਰਭਜੋਤੇ	પ્રભજોતે
ਪ੍ਰਭਜੋਧ	પ્રભજોધ
ਪ੍ਰਭਤਿਰਥ	પ્રભતિરથ
ਪ੍ਰਭਦਾਸ	પ્રભદાસ
ਪ੍ਰਭਧਿਯਨ	પ્રભધિયન
ਪ੍ਰਭਧਿਰਾਜ	પ્રભધિરાજ
ਪ੍ਰਭਨਾਮ	પ્રભનામ
ਪ੍ਰਭਨੂਰ	પ્રભનૂર
ਪ੍ਰਭਪਰ੍ਵਾਨ	પ્રભપર્વાન
ਪ੍ਰਭਬੋਧ	પ્રભબોધ
ਪ੍ਰਭਮਿਤ	પ્રભમિત
ਪ੍ਰਭਮੇਹਾਰ	પ્રભમેહાર
ਪ੍ਰਭਲੀਨ	પ્રભલીન
ਪ੍ਰਭਵਿਚਾਰ	પ્રભવિચાર
ਪ੍ਰਭਸਂਗਤ	પ્રભસંગત
ਪ੍ਰਭਸਿਤਾਲ	પ્રભસિતાલ
ਪ੍ਰਭਾਤਕੀਰਣ	પ્રભાતકીરણ
ਪ੍ਰਭ੍ਰਮਣ	પ્રભ્રમણ
ਪ੍ਰਭ੍ਰਾਤਨ	પ્રભ્રાતન
ਪ੍ਰਭ੍ਰੂਪ	પ્રભ્રૂપ
ਪ੍ਰਸ਼ਾਰਨਬੀਰ	પ્રશારનબીર
ਪ੍ਰਿਤਮੋਹਨ	પ્રિતમોહન
ਪ੍ਰਿਤੀਨ੍ਦੇਰ	પ્રિતીન્દેર
ਪ੍ਰਿਤ੍ਵੀਰ	પ્રિત્વીર
ਪ੍ਰੀਤਪਾਲ	પ્રીતપાલ
ਪ੍ਰੀਤਮ੍ਹਾਰੀ	પ્રીતમ્હારી
ਪ੍ਰੀਤਾਮਜਿਤ	પ્રીતામજિત
ਪ੍ਰੀਥਾਮ੍ਦੀਪ	પ્રીથામ્દીપ
ਪ੍ਰੀਥੀਪਾਲ	પ્રીથીપાલ
ਪ੍ਰੀਥ੍ਵੀਪਾਲ	પ્રીથ્વીપાલ
ਪ੍ਰੇਮਜਿਤ	પ્રેમજિત
ਪ੍ਰੇਮਤੇਕ	પ્રેમતેક
ਪ੍ਰੇਮਪਾਲ	પ્રેમપાલ
ਪ੍ਰੇਮਬਂਸ	પ્રેમબંસ
ਪ੍ਰੇਮਭਾਗਤ	પ્રેમભાગત
ਪ੍ਰੇਮਰਂਗ	પ્રેમરંગ
ਪ੍ਰੇਮਰਮਣ	પ્રેમરમણ
ਪ੍ਰੇਮਰਸ	પ્રેમરસ
ਪ੍ਰੇਮਲੀਨ	પ્રેમલીન
ਪ੍ਰੇਮਵਾਂਤ	પ્રેમવાંત
ਪ੍ਰੇਮਸੀਰੀ	પ્રેમસીરી
ਪ੍ਰੇਮਸੁਖ	પ્રેમસુખ
ਪ੍ਰੇਮ੍ਵੀਰ	પ્રેમ્વીર
ਫਕੀਰ	ફકીર
ਫਤੇਹਕਾਰਾਮ	ફતેહકારામ
ਫਤੇਹਪ੍ਰਿਤ	ફતેહપ્રિત
ਫਤੇਹਬੀਰ	ફતેહબીર
ਫਤੇਹ੍ਵਂਤ	ફતેહ્વંત
ਫਾਜਲ	ફાજલ
ਫੁਲਵਂਤ	ફુલવંત
ਫੋਜੀਨਦੇਰ	ફોજીનદેર
ਬਂਸਮਿਤ	બંસમિત
ਬਕ੍ਸ਼ੀ	બક્શી
ਬਚਾਨਬੀਰ	બચાનબીર
ਬਚੀਨ੍ਤ	બચીન્ત
ਬਨੀਤ	બનીત
ਬਨੀਨਦੇਰ	બનીનદેર
ਬਰਿਨ੍ਦ੍ਰ	બરિન્દ્ર
ਬਰੀਨ੍ਦੇਰ	બરીન્દેર
ਬਲਤੇਜ	બલતેજ
ਬਲਦੀਪ	બલદીપ
ਬਲਦੇਵ	બલદેવ
ਬਲਮੋਹਨ	બલમોહન
ਬਲਰਾਜ	બલરાજ
ਬਲਵਿਂਦਰ	બલવિંદર
ਬਲੀਨਦੇਰ	બલીનદેર
ਬਲੀਹਾਰ	બલીહાર
ਬਲ੍ਵਿਨ੍ਦ੍ਰ	બલ્વિન્દ્ર
ਬਲ੍ਵੀਨ੍ਦੇਰ	બલ્વીન્દેર
ਬਹਾਦਰ	બહાદર
ਬਾਲਮਿਤ	બાલમિત
ਬਿਸ਼ਨਪਾਲ	બિશનપાલ
ਬਿਸ੍ਮੀਤ	બિસ્મીત
ਬੀਨਦੇਰ	બીનદેર
ਬੀਨਾ	બીના
ਬੀਬੀਨਾਨਾਕੀ	બીબીનાનાકી
ਬੀਮਾਂਲਜੋਤ	બીમાંલજોત
ਬੀਰੀਨਦਾਰ	બીરીનદાર
ਬੀਸਮਾਧ	બીસમાધ
ਬੀਸ਼੍ਮਿਤ	બીશ્મિત
ਬੁਜੀ	બુજી
ਬੁਧ੍ਪ੍ਰਿਤ	બુધ્પ્રિત
ਬੁਧ੍ਰੂਪ	બુધ્રૂપ
ਬੇਂਤ	બેંત
ਬੇਨ੍ਨੀ	બેન્ની
ਬੇਬੇ	બેબે
ਬੈਰਾਗੀ	બૈરાગી
ਬ੍ਰਹਮਜੋਤ	બ્રહમજોત
ਬ੍ਰਹਾਮਲੀਨ	બ્રહામલીન
ਬ੍ਰਹਾਮ੍ਜੀਤ	બ્રહામ્જીત
ਬ੍ਰਹ੍ਮਲੀਨ	બ્રહ્મલીન
ਬ੍ਰਹ੍ਮਵੀਰ	બ્રહ્મવીર
ਬ੍ਰਿਜੇਂਦਰ	બ્રિજેંદર
ਬ੍ਰੀਜੋਧ	બ્રીજોધ
ਭਗਤ	ભગત
ਭਗਵਾਨ	ભગવાન
ਭਜਨਿਕ	ભજનિક
ਭਰਪੂਰ	ભરપૂર
ਭਾਘਵੀਨ੍ਦੇਰ	ભાઘવીન્દેર
ਭਾਜ੍ਨਾਮ	ભાજ્નામ
ਭਾਜ੍ਨਿਤ	ભાજ્નિત
ਭਾਵਜਿਤ	ભાવજિત
ਭਾਵਜੀਨ੍ਦੇਰ	ભાવજીન્દેર
ਭਾਵਨਦੀਪ	ભાવનદીપ
ਭਾਵਨੀਤ	ભાવનીત
ਭਾਵਪਾਲ	ભાવપાલ
ਭਾਵਪ੍ਰੇਮ	ભાવપ્રેમ
ਭਾਵਲੀਨ	ભાવલીન
ਭੀਨਦੇਰ੍ਪਾਲ	ભીનદેર્પાલ
ਭੁਪੀਨ੍ਦੇਰ	ભુપીન્દેર
ਮਂਗਲਾ	મંગલા
ਮਂਤੇਕ	મંતેક
ਮਜਾਲ	મજાલ
ਮਣਿਪਾਲ	મણિપાલ
ਮਧੁਪ੍ਰਿਤ	મધુપ્રિત
ਮਧੁਰਬੀਨ	મધુરબીન
ਮਧੁਵਂਤ	મધુવંત
ਮਨਵਂਤ	મનવંત
ਮਰਦੁਲਾ	મરદુલા
ਮਸ੍ਤਪ੍ਰੇਮ	મસ્તપ્રેમ
ਮਸ੍ਤਾਨ	મસ્તાન
ਮਸ੍ਤੁਕ	મસ્તુક
ਮਸ੍ਤ੍ਵੀਰ	મસ્ત્વીર
ਮਹਨਬੀਰ	મહનબીર
ਮਹਾਜਿਤ	મહાજિત
ਮਹਾਨਗਿਯਨ	મહાનગિયન
ਮਹਾਨਗੀਤ	મહાનગીત
ਮਹਾਨਗੁਨ	મહાનગુન
ਮਹਾਨਜਿਤ	મહાનજિત
ਮਹਾਨਜੀਵਨ	મહાનજીવન
ਮਹਾਨਜੋਤ	મહાનજોત
ਮਹਾਨਤੇਕ	મહાનતેક
ਮਹਾਨਤ੍ਰੀਪਾਤ	મહાનત્રીપાત
ਮਹਾਨਦੀਪ	મહાનદીપ
ਮਹਾਨਪਾਲ	મહાનપાલ
ਮਹਾਨਪ੍ਰੇਮ	મહાનપ્રેમ
ਮਹਾਨਭਗਤ	મહાનભગત
ਮਹਿਨਦੇਰ੍ਪ੍ਰਿਤ	મહિનદેર્પ્રિત
ਮਹੀਨਗਾ	મહીનગા
ਮਹੀਨਦੇਰ੍ਪਾਲ	મહીનદેર્પાલ
ਮਹੇਕਪ੍ਰਿਤ	મહેકપ્રિત
ਮਹੇਨਦੇਰ	મહેનદેર
ਮਹੇਰਬਾਨੀ	મહેરબાની
ਮਹੇਸ਼ੀਨਦੇਰ	મહેશીનદેર
ਮਾਂਨਕਰਣ	માંનકરણ
ਮਾਂਨਗਲ੍ਪ੍ਰਿਤ	માંનગલ્પ્રિત
ਮਾਂਨਵਾਨ੍ਤ੍ਬੀਰ	માંનવાન્ત્બીર
ਮਾਂਨਸੀਰਤ	માંનસીરત
ਮਾਂਨਾਵੀਨਦੇਰ	માંનાવીનદેર
ਮਾਂਨਾਸਪ੍ਰੇਮ	માંનાસપ્રેમ
ਮਾਂਨੀਨਦੇਰ੍ਬੀਰ	માંનીનદેર્બીર
ਮਾਂਨੋਹਾਰਜੋਤ	માંનોહારજોત
ਮਾਂਨੋਹਾਰਦੀਪ	માંનોહારદીપ
ਮਾਂਨੋਹਾਰ੍ਜੀਤ	માંનોહાર્જીત
ਮਾਂਨੋਹਾਰ੍ਪਲ	માંનોહાર્પલ
ਮਾਂਨ੍ਗਲ੍ਜੀਤ	માંન્ગલ્જીત
ਮਾਂਨ੍ਗਲ੍ਪ੍ਰੇਮ	માંન્ગલ્પ્રેમ
ਮਾਂਨ੍ਸ਼ਿਤਾਲ	માંન્શિતાલ
ਮਾਦਨਬੀਰ	માદનબીર
ਮਾਦਾਨਕੀਰ੍ਪਾਲ	માદાનકીર્પાલ
ਮਾਦਾਨਪਾਲ	માદાનપાલ
ਮਾਨਤੇਜ	માનતેજ
ਮਾਨਦੇਵ	માનદેવ
ਮਾਨਪੁਲ	માનપુલ
ਮਾਨਬੀਰ	માનબીર
ਮਾਨਰਿਤ	માનરિત
ਮਾਨਾਸਦੀਪ	માનાસદીપ
ਮਾਨ੍ਕੀਰਣ	માન્કીરણ
ਮਾਨ੍ਗਲ੍ਜੋਤ	માન્ગલ્જોત
ਮਾਨ੍ਪ੍ਰੀਯਾ	માન્પ્રીયા
ਮਾਯ੍ਰਾਯ	માય્રાય
ਮਿਤ੍ਰਾ	મિત્રા
ਮਿਤ੍ਰਾਜ	મિત્રાજ
ਮੀਰਾ	મીરા
ਮੁਕੁਂਦਾ	મુકુંદા
ਮੁਕੁਨਦ੍ਪ੍ਰਿਤ	મુકુનદ્પ્રિત
ਮੁਖ੍ਤਯਾਰ	મુખ્તયાર
ਮੁਦ੍ਰਾ	મુદ્રા
ਮੁਨਦੀਪ	મુનદીપ
ਮੁਨਲੇਨੇ	મુનલેને
ਮੇਸ਼	મેશ
ਮੇਹਰ	મેહર
ਮੇਹਾਰਤੇਕ	મેહારતેક
ਮੇਹਾਰਪਲ	મેહારપલ
ਮੇਹਾਰਪ੍ਰਿਤ	મેહારપ્રિત
ਮੇਹਾਰਭੂਪ	મેહારભૂપ
ਮੇਹਾਰਮਿਤ	મેહારમિત
ਮੇਹੇਰ	મેહેર
ਮੇਹੇਰਬਾਨੀ	મેહેરબાની
ਮੋਨੀਨ੍ਦੇਰ	મોનીન્દેર
ਮੋਹਨਤੇਕ	મોહનતેક
ਮੋਹਨਮਿਤ	મોહનમિત
ਮੋਹਨਲੀਨ	મોહનલીન
ਮੋਹਨਵਂਤ	મોહનવંત
ਮੋਹਨਵੀਰ	મોહનવીર
ਮੋਹਿਨ੍ਦੇਰਪਾਲ	મોહિન્દેરપાલ
ਮੋਹੇਨਪਲ	મોહેનપલ
ਮੋਹੇਨਪ੍ਰਿਤ	મોહેનપ્રિત
ਯਕਿਨ	યકિન
ਯਸ਼ਜੋਤ	યશજોત
ਯਸ਼ਨੂਰ	યશનૂર
ਯਸ਼ਪਾਲ	યશપાલ
ਯਸ਼ਵਂਤ	યશવંત
ਯਸ਼੍ਦੀਪ	યશ્દીપ
ਯਾਤੀਨਪਾਲ	યાતીનપાલ
ਯਾਦਲੀਨ	યાદલીન
ਯਾਦਵੀਰ	યાદવીર
ਯਾਦ੍ਬੀਰ	યાદ્બીર
ਯਾਸ੍ਮੀਨੇ	યાસ્મીને
ਯੁਵਰਾਨੀ	યુવરાની
ਯੋਗੇਸ਼ਪਾਲ	યોગેશપાલ
ਰਂਗ ਰਮਨ	રંગ રમન
ਰਂਗਜੋਤ	રંગજોત
ਰਂਗਪ੍ਰਿਤ	રંગપ્રિત
ਰਂਗਾਤਮ	રંગાતમ
ਰਂਗੀਵਨ	રંગીવન
ਰਂਜੀਤ	રંજીત
ਰਘੁਜਿਤ	રઘુજિત
ਰਘੁਬਂਸ	રઘુબંસ
ਰਚਨਜਿਤ	રચનજિત
ਰਚਨਜੋਤ	રચનજોત
ਰਚ੍ਪੀਨਦੇਰ੍ਜਿਤ	રચ્પીનદેર્જિત
ਰਜੀਨਦਾਰ	રજીનદાર
ਰਣਦੀਪ	રણદીપ
ਰਣਬੀਰ	રણબીર
ਰਤਨ੍ਕਾਰਾਮ	રતન્કારામ
ਰਤ੍ਤਾਨਜੋਤ	રત્તાનજોત
ਰਤ੍ਤਾਨਦੀਪ	રત્તાનદીપ
ਰਨਗ੍ਰਤ੍ਤੀ	રનગ્રત્તી
ਰਨਪ੍ਰਿਤ	રનપ્રિત
ਰਪੀਨਦੇਰ	રપીનદેર
ਰਮਚੇਤਨ	રમચેતન
ਰਮਣੀਕ	રમણીક
ਰਮਨਜਿਤ	રમનજિત
ਰਮਨਦੀਪ	રમનદીપ
ਰਮਨਿਤ	રમનિત
ਰਮਨੀਵਾਸ	રમનીવાસ
ਰਮਲੀਨ	રમલીન
ਰਮਾਂਨਜੋਤ	રમાંનજોત
ਰਮਾਂਨਰੂਪ	રમાંનરૂપ
ਰਮਾਂਨਸੁਖ	રમાંનસુખ
ਰਮਿਤ	રમિત
ਰਮਿਨਾਜੀਤ	રમિનાજીત
ਰਮੀਨਦੇਰ੍ਜਿਤ	રમીનદેર્જિત
ਰਮੀਨਦੇਰ੍ਪਾਲ	રમીનદેર્પાલ
ਰਮੀਨਦੇਰ੍ਪ੍ਰਿਤ	રમીનદેર્પ્રિત
ਰਮੀਨਦੇਰ੍ਬੀਰ	રમીનદેર્બીર
ਰਮੇਸ਼ਪਲ	રમેશપલ
ਰਮੇਸ਼ਮਿਤ	રમેશમિત
ਰਵਜੋਤ	રવજોત
ਰਵਨੀਤ	રવનીત
ਰਵਿਨ੍ਦਰ	રવિન્દર
ਰਵਿਰਾਜ	રવિરાજ
ਰਵੀਦੀਪ	રવીદીપ
ਰਵੀਨਦੇਰ੍ਦੀਪ	રવીનદેર્દીપ
ਰਵੀਨਦੇਰ੍ਮਿਤ	રવીનદેર્મિત
ਰਸਂਜਿਤ	રસંજિત
ਰਸਂਜੋਤ	રસંજોત
ਰਸਂਮਿਤ	રસંમિત
ਰਸਗੁਨ	રસગુન
ਰਸਜੋਤ	રસજોત
ਰਸਧਾਰਮ	રસધારમ
ਰਸਨਂਦ	રસનંદ
ਰਸਪ੍ਰਿਤ	રસપ્રિત
ਰਸਬੀਰ	રસબીર
ਰਸਭਾਗਤ	રસભાગત
ਰਸਮ	રસમ
ਰਸਮ੍ਰਿਤ	રસમ્રિત
ਰਸਲੀਨ	રસલીન
ਰਸਵਂਤ	રસવંત
ਰਸ਼ਾਨ੍ਪ੍ਰਿਤ	રશાન્પ્રિત
ਰਸੁਤ੍ਤਮ	રસુત્તમ
ਰਹੁਲਜੀਤ	રહુલજીત
ਰਹੁਲਦੀਪ	રહુલદીપ
ਰਾਖਨਾਂ	રાખનાં
ਰਾਖਬੀਰ	રાખબીર
ਰਾਜਕਿਰਣ	રાજકિરણ
ਰਾਜਦੀਪ	રાજદીપ
ਰਾਜਨਾਰੀਨ੍ਦ	રાજનારીન્દ
ਰਾਜਪਰਾਮ	રાજપરામ
ਰਾਜਪਾਲ	રાજપાલ
ਰਾਜਪ੍ਰਤਾਪ	રાજપ્રતાપ
ਰਾਜਮਂਦਰ	રાજમંદર
ਰਾਜਮਿਤ	રાજમિત
ਰਾਜਸ਼ਰਣ	રાજશરણ
ਰਾਜਸੁਖ	રાજસુખ
ਰਾਜਾਨਜਿਤ	રાજાનજિત
ਰਾਜਾਨਮਿਤ	રાજાનમિત
ਰਾਜਾਨ੍ਦੀਪ	રાજાન્દીપ
ਰਾਤਾਨਗੀਤ	રાતાનગીત
ਰਾਤਾਨਚੇਤਨ	રાતાનચેતન
ਰਾਤਾਨਜੀਵਨ	રાતાનજીવન
ਰਾਤਾਨਪ੍ਰਿਤ	રાતાનપ્રિત
ਰਾਤਾਨਮਿਤ	રાતાનમિત
ਰਾਤਾਨਵਂਤ	રાતાનવંત
ਰਾਤਾਨਾਤਮ	રાતાનાતમ
ਰਾਮਦਾਸ	રામદાસ
ਰਾਮਪਾਲ	રામપાલ
ਰਾਮਰਂਗ	રામરંગ
ਰਾਮਰਤ੍ਤਨ	રામરત્તન
ਰਾਮਸੁਖ	રામસુખ
ਰਾਸਰਮਣ	રાસરમણ
ਰਾਸ਼੍ਪਲ	રાશ્પલ
ਰਾਸ਼੍ਮੀਨਦੇਰ	રાશ્મીનદેર
ਰਿਧਿਮਾ	રિધિમા
ਰੀਜਕ	રીજક
ਰੀਤੀਨਦੇਰ	રીતીનદેર
ਰੀਪਨ੍ਜੋਤ	રીપન્જોત
ਰੀਪੁਦਮ	રીપુદમ
ਰੂਂਗ / ਰਂਗ	રૂંગ / રંગ
ਰੂਪਦੀਪ	રૂપદીપ
ਰੂਪਦੇਵ	રૂપદેવ
ਰੂਪਵਂਤ	રૂપવંત
ਰੇਗੇਨਦਰ	રેગેનદર
ਰੋਸ਼ਨਦੀਪ	રોશનદીપ
ਰੌਸ਼ਾਨਪ੍ਰੇਮ	રૌશાનપ્રેમ
ਰੌਸ਼ਾਨਬੀਰ	રૌશાનબીર
ਲਕ੍ਸ਼੍ਮੀ	લક્શ્મી
ਲਖਪ੍ਰਿਤ	લખપ્રિત
ਲਖਮਿਤ	લખમિત
ਲਖਰੂਪ	લખરૂપ
ਲਖਵੀਰ	લખવીર
ਲਵੇਨਿਤ	લવેનિત
ਲਾਜਵਂਤ	લાજવંત
ਲਾਵਪ੍ਰਿਤ	લાવપ્રિત
ਲਾਵਿਨਦੀਪ	લાવિનદીપ
ਲੀਵਗੀਆਨ	લીવગીઆન
ਲੀਵਚਿਤ	લીવચિત
ਲੀਵਚੇਤ	લીવચેત
ਲੀਵਜੋਤ	લીવજોત
ਲੀਵਨਾਮ	લીવનામ
ਲੀਵਸ਼ਰਣ	લીવશરણ
ਲੀਵਾਵਤਰ	લીવાવતર
ਲੋਕਪਾਲ	લોકપાલ
ਲੋਕਪ੍ਰਿਤ	લોકપ્રિત
ਲੋਕਰੂਪ	લોકરૂપ
ਲੋਕ੍ਪ੍ਰੇਮ	લોક્પ્રેમ
ਲੋਵਪ੍ਰੇਮ	લોવપ્રેમ
ਲੋਵੇਦੀਪ	લોવેદીપ
ਵਰੀਨਦੇਰ੍ਪਾਲ	વરીનદેર્પાલ
ਵਰੁਨਜਿਤ	વરુનજિત
ਵਰੁਨਦੀਪ	વરુનદીપ
ਵਸਂਤਪ੍ਰਿਤ	વસંતપ્રિત
ਵਸੁਂਧਰਾ	વસુંધરા
ਵਾਦਭਾਗ	વાદભાગ
ਵਾਮਾਂਨਜੀਤ	વામાંનજીત
ਵਾਰੀਨਦੇਰ	વારીનદેર
ਵਾਸੀਮਬੀਰ	વાસીમબીર
ਵਾਹੀਦਪ੍ਰਿਤ	વાહીદપ્રિત
ਵਾਹੇਗੁਰੁ	વાહેગુરુ
ਵਿਕ੍ਰਮਜੀਤ	વિક્રમજીત
ਵਿਕ੍ਰਮਜੋਤ	વિક્રમજોત
ਵਿਚਾਰ੍ਚੇਤਨ	વિચાર્ચેતન
ਵਿਚਾਰ੍ਦੀਪ	વિચાર્દીપ
ਵਿਚਾਰ੍ਲੀਨ	વિચાર્લીન
ਵਿਜਯਪ੍ਰਤਾਪ	વિજયપ્રતાપ
ਵਿਜਯਪ੍ਰਿਤ	વિજયપ્રિત
ਵਿਜੇਂਦਰ	વિજેંદર
ਵਿਨਾਯਦੀਪ	વિનાયદીપ
ਵਿਨਾਯਪੁਲ	વિનાયપુલ
ਵਿਨਾਯ੍ਬਿਰ	વિનાય્બિર
ਵਿਮਾਂਲਜਿਤ	વિમાંલજિત
ਵਿਮਾਂਲਜੋਤ	વિમાંલજોત
ਵਿਮਾਂਲਪ੍ਰੇਮ	વિમાંલપ્રેમ
ਵਿਰੀਨਦਾਰ ; ਵਿਰੀਨਦੇਰ	વિરીનદાર ; વિરીનદેર
ਵਿਰੀਨਦੇਰ	વિરીનદેર
ਵਿਸਮਦ	વિસમદ
ਵਿਸ਼ਾਲਦੀਪ	વિશાલદીપ
ਵਿਸ਼ਾਲਪ੍ਰਿਤ	વિશાલપ્રિત
ਵਿਸ਼੍ਵਰ੍ਪ੍ਰਿਤ	વિશ્વર્પ્રિત
ਵਿਸ਼੍ਵਾਤਮ	વિશ્વાતમ
ਵਿਸਾਹ	વિસાહ
ਵੀਜਯਮਿਤ	વીજયમિત
ਵੀਰ	વીર
ਵੀਰ /ਵੀਰ	વીર /વીર
ਵੀਰਪਾਲ	વીરપાલ
ਵੀਵੇਕ੍ਬੀਰ	વીવેક્બીર
ਵੀਸ੍ਰਮਣ	વીસ્રમણ
ਵੇਰਾਜ	વેરાજ
ਵੈਭਵ	વૈભવ
ਸਂਗਜਾਪ	સંગજાપ
ਸਂਗਤਪ੍ਰਿਤ	સંગતપ્રિત
ਸਂਗਤਰੂਪ	સંગતરૂપ
ਸਂਗਤ੍ਰਸ	સંગત્રસ
ਸਂਗੀਤਾ	સંગીતા
ਸਂਗ੍ਰਾਮ	સંગ્રામ
ਸਂਜੀਤ	સંજીત
ਸਂਜੋਗ	સંજોગ
ਸਂਤਕੀਰੀਨ	સંતકીરીન
ਸਂਤਪ੍ਰਕਾਸ਼	સંતપ્રકાશ
ਸਂਤਪ੍ਰੇਮ	સંતપ્રેમ
ਸਂਤਬੀਰ	સંતબીર
ਸਂਤੋਖਜੀਤ	સંતોખજીત
ਸਂਤੋਖਜੋਤ	સંતોખજોત
ਸਂਤੋਖਪ੍ਰਿਤ	સંતોખપ્રિત
ਸਂਤੋਖਬੀਰ	સંતોખબીર
ਸਂਦੀਪ	સંદીપ
ਸਗਲਜੋਤ	સગલજોત
ਸਚਕਿਰਤ	સચકિરત
ਸਚਜੋਗ	સચજોગ
ਸਚਪਾਲ	સચપાલ
ਸਚਪ੍ਰਧਾਨ	સચપ્રધાન
ਸਚਭਾਗਤ	સચભાગત
ਸਚਮਾਨ	સચમાન
ਸਚਰੂਪ	સચરૂપ
ਸਚਵੀਰ	સચવીર
ਸਚਸੁਖ	સચસુખ
ਸਚਸੇਵਕ	સચસેવક
ਸਚਾਮ੍ਰਿਤ	સચામ્રિત
ਸਚ੍ਦੀਪ	સચ્દીપ
ਸਜੀਨਦੇਰ	સજીનદેર
ਸਤਕਿਰਤ	સતકિરત
ਸਤਕੀਰਤ	સતકીરત
ਸਤਕੀਰ੍ਤਨ	સતકીર્તન
ਸਤਗੁਨ	સતગુન
ਸਤਗੁਰ	સતગુર
ਸਤਜੋਤ	સતજોત
ਸਤਨਾਮ	સતનામ
ਸਤਪਾਲ	સતપાલ
ਸਤਪ੍ਰਕਾਸ਼	સતપ્રકાશ
ਸਤਪ੍ਰਿਤ	સતપ્રિત
ਸਤਪ੍ਰੇਮ	સતપ્રેમ
ਸਤਬਚਨ	સતબચન
ਸਤਮਿਤ	સતમિત
ਸਤਰਜਿਤ	સતરજિત
ਸਤਰਾਜ	સતરાજ
ਸਤਲੀਨ	સતલીન
ਸਤਵਂਤ	સતવંત
ਸਤਸਂਗਤ	સતસંગત
ਸਤਸਂਤੋਖ	સતસંતોખ
ਸਤਸਰਂਗ	સતસરંગ
ਸਤਸੁਖ	સતસુખ
ਸਤੀਨਦੇਰ੍ਜਿਤ	સતીનદેર્જિત
ਸਤ੍ਯਜਿਤ	સત્યજિત
ਸਤ੍ਯਪ੍ਰੇਮ	સત્યપ્રેમ
ਸਥਿਨ੍ਦਰ	સથિન્દર
ਸਦਜੀਵਨ	સદજીવન
ਸਦਸੁਖ	સદસુખ
ਸਨਮੁਖ	સનમુખ
ਸਨਾਨਤਨ	સનાનતન
ਸਪਨਦੀਪ	સપનદીપ
ਸਪਾਹੀ	સપાહી
ਸਬੂਰੀ	સબૂરી
ਸਭਾਜੀਤ	સભાજીત
ਸਮਰਜੀਤ	સમરજીત
ਸਮਰਣ	સમરણ
ਸਮਰਵੀਰ	સમરવીર
ਸਮਰ੍ਥ	સમર્થ
ਸਮਾਂਰਬੀਰ	સમાંરબીર
ਸਮਾਂਰ੍ਜੋਤ	સમાંર્જોત
ਸਮਾਈ	સમાઈ
ਸਮੀਨਦੀਪ	સમીનદીપ
ਸਮੀਰ	સમીર
ਸਰਦਾਰ	સરદાર
ਸਰਨਦਾਯਲ	સરનદાયલ
ਸਰਨਦੀਪ	સરનદીપ
ਸਰਨਾਗਤ	સરનાગત
ਸਰਬਜੀਤ / ਸਰਬਜੀਤ	સરબજીત / સરબજીત
ਸਰਬਨੀਵਾਸ	સરબનીવાસ
ਸਰਬਪ੍ਰਿਤ	સરબપ્રિત
ਸਰਬਸੁਖ	સરબસુખ
ਸਰਬੁਤ੍ਤਮ	સરબુત્તમ
ਸਰਬ੍ਗਿਆਨ	સરબ્ગિઆન
ਸਰਬ੍ਜਿਤ	સરબ્જિત
ਸਰਬ੍ਦਾਯਲ	સરબ્દાયલ
ਸਰਬ੍ਦੀਪ	સરબ્દીપ
ਸਰਬ੍ਦੇਵ	સરબ્દેવ
ਸਰਬ੍ਧਾਰਾਮ	સરબ્ધારામ
ਸਰਲਜਿਤ	સરલજિત
ਸਰਲਬੀਰ	સરલબીર
ਸਰਾਬ੍ਰਜ	સરાબ્રજ
ਸਰੂਪ	સરૂપ
ਸਰੂਰ	સરૂર
ਸਰ੍ਜਿਤ	સર્જિત
ਸਰ੍ਮੀਨਦੇਰ	સર્મીનદેર
ਸਵਾਨਪ੍ਰਿਤ	સવાનપ્રિત
ਸਵਾਰਜਦੀਪ	સવારજદીપ
ਸਵਾਰਜਬੀਰ	સવારજબીર
ਸਵਾਰਨਜੋਤ	સવારનજોત
ਸਵਾਰਨਪ੍ਰਿਤ	સવારનપ્રિત
ਸਵੀਤੀਨਦੇਰ	સવીતીનદેર
ਸਵੀਤੋਜ	સવીતોજ
ਸਵੀਨਦੇਰ	સવીનદેર
ਸਹੀਲਮਿਤ	સહીલમિત
ਸ਼ਯ੍ਮ੍ਸੁਨ੍ਦਾਰ	શય્મ્સુન્દાર
ਸ਼ਰਨਪਾਲ	શરનપાલ
ਸ਼ਰਨਬੀਰ	શરનબીર
ਸ਼ਰਨ੍ਜੀਤ੍ਕੌਰ	શરન્જીત્કૌર
ਸ਼ਾਂਤਚਿਤ	શાંતચિત
ਸ਼ਾਂਤਦੀਪ	શાંતદીપ
ਸ਼ਾਂਤਪ੍ਰਕਾਸ਼	શાંતપ્રકાશ
ਸ਼ਾਂਤਪ੍ਰਿਤ	શાંતપ્રિત
ਸ਼ਾਂਤਬੀਰ	શાંતબીર
ਸ਼ਾਂਤਲੀਨ	શાંતલીન
ਸ਼ਾਨਤ੍ਨੀਵਾਸ	શાનત્નીવાસ
ਸ਼ਾਬਦਚੇਤ	શાબદચેત
ਸ਼ਾਬਦਤੇਕ	શાબદતેક
ਸ਼ਾਬਦ੍ਰਾਸ	શાબદ્રાસ
ਸ਼ਾਬਾਦ੍ਦੀਪ	શાબાદ્દીપ
ਸ਼ਾਲੀਨ	શાલીન
ਸ਼ਾਸ਼ੀਪ੍ਰਿਤ	શાશીપ્રિત
ਸ਼ਿਵਚਰਣ	શિવચરણ
ਸ਼ਿਵ੍ਚਾਰਨ੍ਜੀਤ	શિવ્ચારન્જીત
ਸ਼ੁਕਾਰਿਯਨ	શુકારિયન
ਸ਼ੁਭਦੀਪ	શુભદીપ
ਸ਼ੂਰਵੀਰ	શૂરવીર
ਸ਼ੇਰ	શેર
ਸ਼ੇਰਪੁਲ	શેરપુલ
ਸ਼ੇਰਬਹਾਦੁਰ	શેરબહાદુર
ਸ਼ੇਹ੍ਬਾਝ	શેહ્બાઝ
ਸਾਕਰਥ	સાકરથ
ਸਾਖ	સાખ
ਸਾਗਰ	સાગર
ਸਾਜ	સાજ
ਸਾਤਪੁਲ	સાતપુલ
ਸਾਧਨਾਹ	સાધનાહ
ਸਾਧਿਕਾ	સાધિકા
ਸਾਬਰ	સાબર
ਸਾਰ	સાર
ਸਿਂਦਾ	સિંદા
ਸਿਓਪਰਿਤ	સિઓપરિત
ਸਿਤਾਲਜੀਤ	સિતાલજીત
ਸਿਤਾਲਜੋਤ	સિતાલજોત
ਸਿਮਰਨ	સિમરન
ਸੀਖਲ	સીખલ
ਸੀਮਾਂਰ੍ਜਿਤ	સીમાંર્જિત
ਸੀਮਾਂਰ੍ਨਾਮ	સીમાંર્નામ
ਸੀਮਾਂਰ੍ਪ੍ਰਿਤ	સીમાંર્પ્રિત
ਸੀਮਾਂਰ੍ਲੀਨ	સીમાંર્લીન
ਸੀਮ੍ਰਤ	સીમ્રત
ਸੀਮ੍ਰਨਪਾਲ	સીમ્રનપાલ
ਸੀਮ੍ਰਨਪ੍ਰਿਤ	સીમ્રનપ્રિત
ਸੀਮ੍ਰਨ੍ਕੌਰ	સીમ્રન્કૌર
ਸੀਮ੍ਰਨ੍ਜੀਤ	સીમ્રન્જીત
ਸੀਮ੍ਰੀਤਾ	સીમ્રીતા
ਸੀਰਤ	સીરત
ਸੀਰੀਪ੍ਰੀਤਮ	સીરીપ્રીતમ
ਸੀਰੀਵੇਦ੍ਯਾ	સીરીવેદ્યા
ਸੀਰੀਸੀਮ੍ਰਣ	સીરીસીમ્રણ
ਸੀਰੀਸੇਵਾ	સીરીસેવા
ਸੁਖਚੈਨ	સુખચૈન
ਸੁਖਜੀਵਨ	સુખજીવન
ਸੁਖਜੋਤ	સુખજોત
ਸੁਖਜੋਧ	સુખજોધ
ਸੁਖਦਾਯਲ	સુખદાયલ
ਸੁਖਦੀਪ	સુખદીપ
ਸੁਖਦੇਵ	સુખદેવ
ਸੁਖਬੀਰ	સુખબીર
ਸੁਖਮਾਂ	સુખમાં
ਸੁਖਰੂਪ	સુખરૂપ
ਸੁਖਸਿਤਾਲ	સુખસિતાલ
ਸੁਖਸੀਮ੍ਰਣ	સુખસીમ્રણ
ਸੁਖਾਨਂਦ	સુખાનંદ
ਸੁਖਿਤ	સુખિત
ਸੁਖੀਨ	સુખીન
ਸੁਖੀਨ੍ਦੇਰ	સુખીન્દેર
ਸੁਖ੍ਚਾਰਨ੍ਜੀਤ	સુખ્ચારન્જીત
ਸੁਖ੍ਜਿਤ	સુખ્જિત
ਸੁਚਦੀਪ	સુચદીપ
ਸੁਚਦੇਵ	સુચદેવ
ਸੁਚਮ	સુચમ
ਸੁਜਨਰੂਪ	સુજનરૂપ
ਸੁਜਨ੍ਬੀਰ	સુજન્બીર
ਸੁਜ੍ਜਨ	સુજ્જન
ਸੁਧਬੁਧ	સુધબુધ
ਸੁਧਸੁਰਤ	સુધસુરત
ਸੁਭਪ੍ਰਿਤ	સુભપ્રિત
ਸੁਹੇਜਦੀਪ	સુહેજદીપ
ਸੇਵਾਕਪ੍ਰਿਤ	સેવાકપ્રિત
ਸੇਵਾਕਪ੍ਰੇਮ	સેવાકપ્રેમ
ਸੇਵਾਕਰਣ	સેવાકરણ
ਸੇਵਾਪ੍ਰੀਤ	સેવાપ્રીત
ਸੇਹਜ	સેહજ
ਸੇਹੇਜਬੀਰ	સેહેજબીર
ਸੈਲੇਸ਼ਦੀਪ	સૈલેશદીપ
ਸੈਹਜ	સૈહજ
ਸੈਹਾਜਨੀਵਾਸ	સૈહાજનીવાસ
ਸੈਹਾਜਲੀਨ	સૈહાજલીન
ਸੈਹਾਜਾਧਾਰ	સૈહાજાધાર
ਸੋਚੀ	સોચી
ਸੋਨਹਨ	સોનહન
ਸੋਭਾਵਂਤ	સોભાવંત
ਸੋਹੀਨਦੇਰ	સોહીનદેર
ਸੋਹੁਨ	સોહુન
ਸ੍ਵਰ੍ਨ	સ્વર્ન
ਹਕਾਮਪ੍ਰਿਤ	હકામપ્રિત
ਹਨ੍ਸ੍ਪਾਲ	હન્સ્પાલ
ਹਰਕਾਨ੍ਵਾਲ	હરકાન્વાલ
ਹਰਕੀਰਣ	હરકીરણ
ਹਰਗੀਤ	હરગીત
ਹਰਗੁਰ੍ਮਿਤ (ਮਿਤ )	હરગુર્મિત (મિત )
ਹਰਗੋਬੀਨ੍ਦ	હરગોબીન્દ
ਹਰਚਰਣ	હરચરણ
ਹਰਜਪ	હરજપ
ਹਰਜੀ	હરજી
ਹਰਜੀਤ	હરજીત
ਹਰਜੀਨ੍ਦੇਰ	હરજીન્દેર
ਹਰਜੀਵ	હરજીવ
ਹਰਜੁਗਤ	હરજુગત
ਹਰਜੋਗ	હરજોગ
ਹਰਜੋਧ	હરજોધ
ਹਰਜ੍ਯੋਤ	હરજ્યોત
ਹਰਤਿਰਥ	હરતિરથ
ਹਰਤੇਜ੍ਪਾਲ	હરતેજ્પાલ
ਹਰਦਯਾਲ	હરદયાલ
ਹਰਦਾਸ	હરદાસ
ਹਰਦਿਪਾ	હરદિપા
ਹਰਦੀਪ	હરદીપ
ਹਰਧਨ	હરધન
ਹਰਨਾਮ	હરનામ
ਹਰਨਾਰਾਯਣ	હરનારાયણ
ਹਰਨਿਤ	હરનિત
ਹਰਨੀਰ੍ਮਲ	હરનીર્મલ
ਹਰਨੀਹਲ	હરનીહલ
ਹਰਪਰ੍ਸਨ੍ਨ	હરપર્સન્ન
ਹਰਪਾਲ	હરપાલ
ਹਰਪ੍ਰੇਮ੍ਜੀਤ	હરપ્રેમ્જીત
ਹਰਬਿਂਦਰ	હરબિંદર
ਹਰਬਿਰ	હરબિર
ਹਰਭਗਤ	હરભગત
ਹਰਮਨਾਦ	હરમનાદ
ਹਰਮਾਂਨ੍ਦੇਰ	હરમાંન્દેર
ਹਰਮੀਤ	હરમીત
ਹਰਮੀਲਨ	હરમીલન
ਹਰਮੂਰਤ	હરમૂરત
ਹਰਰਾਈ	હરરાઈ
ਹਰਰੂਪ	હરરૂપ
ਹਰਵਂਤ	હરવંત
ਹਰਵਿਨ	હરવિન
ਹਰਸ਼ਰਣ	હરશરણ
ਹਰਸਿਤਾਲ	હરસિતાલ
ਹਰਸੀਮ੍ਰਣ	હરસીમ્રણ
ਹਰਸੀਮ੍ਰਨ੍ਜੋਤ	હરસીમ્રન્જોત
ਹਰਸੀਮ੍ਰਿਤ	હરસીમ્રિત
ਹਰਸੁਖ	હરસુખ
ਹਰਾਨੂਪ	હરાનૂપ
ਹਰਾਮ੍ਰੀਤ	હરામ્રીત
ਹਰਿਕੀਰ੍ਤਨ	હરિકીર્તન
ਹਰਿਦਰ੍ਸ਼ਨ	હરિદર્શન
ਹਰਿਨਾਰਾਯਣ	હરિનારાયણ
ਹਰਿਪ੍ਰੀਤ	હરિપ્રીત
ਹਰੀਅਮ੍ਰਿਤ	હરીઅમ્રિત
ਹਰੀਸਰੂਪ	હરીસરૂપ
ਹਰੀਸੀਮਾਂਰਣ	હરીસીમાંરણ
ਹਰ੍ਕਾਰਾਨ੍ਜੀਤ	હર્કારાન્જીત
ਹਰ੍ਕੀਰਨ੍ਜੀਤ	હર્કીરન્જીત
ਹਰ੍ਕੀਰਪਾਲ	હર્કીરપાલ
ਹਰ੍ਜਸ	હર્જસ
ਹਰ੍ਤੇਇਜ	હર્તેઇજ
ਹਰ੍ਨੀਝ	હર્નીઝ
ਹਰ੍ਬਂਸ	હર્બંસ
ਹਰ੍ਮਾਂਨਜਿਤ	હર્માંનજિત
ਹਰ੍ਮਾਂਨਪਾਲ	હર્માંનપાલ
ਹਰ੍ਮੀਨ੍ਦੇਰ	હર્મીન્દેર
ਹਰ੍ਮੇਂਦ੍ਰ	હર્મેંદ્ર
ਹਰ੍ਸ਼ਰ੍ਧਾ	હર્શર્ધા
ਹਰ੍ਸ਼ਵਰ੍ਧਨ	હર્શવર્ધન
ਹਰ੍ਸ਼ਾਗੁਨ	હર્શાગુન
ਹਰ੍ਸਿਰਤ	હર્સિરત
ਹਸਨ	હસન
ਹਾਰਭਾਗ	હારભાગ
ਹਿਤੀਨਦੇਰ	હિતીનદેર
ਹਿਤੇਨਦੇਰ	હિતેનદેર
ਹਿਮ੍ਮਤ	હિમ્મત
ਹਿਰੀਸ਼	હિરીશ
ਹੁਅਲੀਨਾ	હુઅલીના
ਹੁਕੁਮਪਰਿਤ	હુકુમપરિત
ਹੂਜਓਏ	હૂજઓએ
ਹੇਤ	હેત
ਹੇਤਬੀਰ	હેતબીર
ਹੇਮੀਨਦੇਰ	હેમીનદેર
ਹੇਯ੍ਮਾਂਨ੍ਪ੍ਰਿਤ	હેય્માંન્પ્રિત
ਹੇਰਹੋ	હેરહો
#
#
# Territory names from CLDR
ਅਸੈਂਸ਼ਨ ਟਾਪੂ	અસૈંશન ટાપૂ
ਅੰਡੋਰਾ	અડોરા
ਸੰਯੁਕਤ ਅਰਬ ਅਮੀਰਾਤ	સયુકત અરબ અમીરાત
ਅਫ਼ਗਾਨਿਸਤਾਨ	અફ઼ગાનિસતાન
ਐਂਟੀਗੁਆ ਅਤੇ ਬਾਰਬੁਡਾ	ઐંટીગુઆ અતે બારબુડા
ਅੰਗੁਇਲਾ	અગુઇલા
ਅਲਬਾਨੀਆ	અલબાનીઆ
ਅਰਮੀਨੀਆ	અરમીનીઆ
ਅੰਗੋਲਾ	અગોલા
ਅੰਟਾਰਕਟਿਕਾ	અટારકટિકા
ਅਰਜਨਟੀਨਾ	અરજનટીના
ਅਮੈਰੀਕਨ ਸਮੋਆ	અમૈરીકન સમોઆ
ਆਸਟਰੀਆ	આસટરીઆ
ਆਸਟ੍ਰੇਲੀਆ	આસટ્રેલીઆ
ਅਰੂਬਾ	અરૂબા
ਅਲੈਂਡ ਟਾਪੂ	અલૈંડ ટાપૂ
ਅਜ਼ਰਬਾਈਜਾਨ	અજ઼રબાઈજાન
ਬੋਸਨੀਆ ਅਤੇ ਹਰਜ਼ੇਗੋਵੀਨਾ	બોસનીઆ અતે હરજ઼ેગોવીના
ਬਾਰਬਾਡੋਸ	બારબાડોસ
ਬੰਗਲਾਦੇਸ਼	બગલાદેશ
ਬੈਲਜੀਅਮ	બૈલજીઅમ
ਬੁਰਕੀਨਾ ਫ਼ਾਸੋ	બુરકીના ફ઼ાસો
ਬੁਲਗਾਰੀਆ	બુલગારીઆ
ਬਹਿਰੀਨ	બહિરીન
ਬੁਰੁੰਡੀ	બુરુડી
ਬੇਨਿਨ	બેનિન
ਸੇਂਟ ਬਾਰਥੇਲੇਮੀ	સેંટ બારથેલેમી
ਬਰਮੂਡਾ	બરમૂડા
ਬਰੂਨੇਈ	બરૂનેઈ
ਬੋਲੀਵੀਆ	બોલીવીઆ
ਕੈਰੇਬੀਆਈ ਨੀਦਰਲੈਂਡ	કૈરેબીઆઈ નીદરલૈંડ
ਬ੍ਰਾਜ਼ੀਲ	બ્રાજ઼ીલ
ਬਹਾਮਾਸ	બહામાસ
ਭੂਟਾਨ	ભૂટાન
ਬੌਵੇਟ ਟਾਪੂ	બૌવેટ ટાપૂ
ਬੋਟਸਵਾਨਾ	બોટસવાના
ਬੇਲਾਰੂਸ	બેલારૂસ
ਬੇਲੀਜ਼	બેલીજ઼
ਕੈਨੇਡਾ	કૈનેડા
ਕੋਕੋਸ (ਕੀਲਿੰਗ) ਟਾਪੂ	કોકોસ (કીલિગ) ટાપૂ
ਕਾਂਗੋ - ਕਿੰਸ਼ਾਸਾ	કાંગો - કિશાસા
ਕਾਂਗੋ ਲੋਕਤੰਤਰੀ ਗਣਰਾਜ	કાંગો લોકતતરી ગણરાજ
ਕੇਂਦਰੀ ਅਫ਼ਰੀਕੀ ਗਣਰਾਜ	કેંદરી અફ઼રીકી ગણરાજ
ਕਾਂਗੋ - ਬ੍ਰਾਜ਼ਾਵਿਲੇ	કાંગો - બ્રાજ઼ાવિલે
ਕਾਂਗੋ ਗਣਰਾਜ	કાંગો ગણરાજ
ਸਵਿਟਜ਼ਰਲੈਂਡ	સવિટજ઼રલૈંડ
ਕੋਟ ਡੀਵੋਆਰ	કોટ ડીવોઆર
ਆਇਵਰੀ ਕੋਸਟ	આઇવરી કોસટ
ਕੁੱਕ ਟਾਪੂ	કુક ટાપૂ
ਚਿਲੀ	ચિલી
ਕੈਮਰੂਨ	કૈમરૂન
ਚੀਨ	ચીન
ਕੋਲੰਬੀਆ	કોલબીઆ
ਕਲਿੱਪਰਟਨ ਟਾਪੂ	કલિપરટન ટાપૂ
ਕੋਸਟਾ ਰੀਕਾ	કોસટા રીકા
ਕਿਊਬਾ	કિઊબા
ਕੇਪ ਵਰਡੇ	કેપ વરડે
ਕੁਰਾਕਾਓ	કુરાકાઓ
ਕ੍ਰਿਸਮਿਸ ਟਾਪੂ	ક્રિસમિસ ટાપૂ
ਸਾਇਪ੍ਰਸ	સાઇપ્રસ
ਚੈਕ ਗਣਰਾਜ	ચૈક ગણરાજ
ਜਰਮਨੀ	જરમની
ਡੀਇਗੋ ਗਾਰਸੀਆ	ડીઇગો ગારસીઆ
ਜ਼ੀਬੂਤੀ	જ઼ીબૂતી
ਡੈਨਮਾਰਕ	ડૈનમારક
ਡੋਮੀਨਿਕਾ	ડોમીનિકા
ਡੋਮੀਨਿਕਾਈ ਗਣਰਾਜ	ડોમીનિકાઈ ગણરાજ
ਅਲਜੀਰੀਆ	અલજીરીઆ
ਸਿਓਟਾ ਅਤੇ ਮੇਲਿੱਲਾ	સિઓટા અતે મેલિલા
ਇਕਵੇਡੋਰ	ઇકવેડોર
ਇਸਟੋਨੀਆ	ઇસટોનીઆ
ਮਿਸਰ	મિસર
ਪੱਛਮੀ ਸਹਾਰਾ	પછમી સહારા
ਇਰੀਟ੍ਰਿਆ	ઇરીટ્રિઆ
ਸਪੇਨ	સપેન
ਇਥੋਪੀਆ	ઇથોપીઆ
ਯੂਰਪੀ ਯੂਨੀਅਨ	યૂરપી યૂનીઅન
ਫਿਨਲੈਂਡ	ફિનલૈંડ
ਫ਼ਿਜੀ	ફ઼િજી
ਫ਼ਾਕਲੈਂਡ ਟਾਪੂ	ફ઼ાકલૈંડ ટાપૂ
ਫ਼ਾਕਲੈਂਡ ਟਾਪੂ (ਆਈਲਾਸ ਮਾਲਵਿਨਾਸ)	ફ઼ાકલૈંડ ટાપૂ (આઈલાસ માલવિનાસ)
ਮਾਇਕ੍ਰੋਨੇਸ਼ੀਆ	માઇક્રોનેશીઆ
ਫੈਰੋ ਟਾਪੂ	ફૈરો ટાપૂ
ਫ਼ਰਾਂਸ	ફ઼રાંસ
ਗਬੋਨ	ગબોન
ਯੂਨਾਈਟਡ ਕਿੰਗਡਮ	યૂનાઈટડ કિગડમ
ਗ੍ਰੇਨਾਡਾ	ગ્રેનાડા
ਜਾਰਜੀਆ	જારજીઆ
ਫ਼ਰੈਂਚ ਗੁਆਨਾ	ફ઼રૈંચ ગુઆના
ਗਰਨਜੀ	ગરનજી
ਘਾਨਾ	ઘાના
ਜਿਬਰਾਲਟਰ	જિબરાલટર
ਗ੍ਰੀਨਲੈਂਡ	ગ્રીનલૈંડ
ਗੈਂਬੀਆ	ગૈંબીઆ
ਗਿਨੀ	ગિની
ਗੁਆਡੇਲੋਪ	ગુઆડેલોપ
ਭੂ-ਖੰਡੀ ਗਿਨੀ	ભૂ-ખડી ગિની
ਗ੍ਰੀਸ	ગ્રીસ
ਦੱਖਣੀ ਜਾਰਜੀਆ ਅਤੇ ਦੱਖਣੀ ਸੈਂਡਵਿਚ ਟਾਪੂ	દખણી જારજીઆ અતે દખણી સૈંડવિચ ટાપૂ
ਗੁਆਟੇਮਾਲਾ	ગુઆટેમાલા
ਗੁਆਮ	ગુઆમ
ਗਿਨੀ-ਬਿਸਾਉ	ગિની-બિસાઉ
ਗੁਯਾਨਾ	ગુયાના
ਹਾਂਗ ਕਾਂਗ ਐਸਏਆਰ ਚੀਨ	હાંગ કાંગ ઐસએઆર ચીન
ਹਾਂਗ ਕਾਂਗ	હાંગ કાંગ
ਹਰਡ ਤੇ ਮੈਕਡੋਨਾਲਡ ਟਾਪੂ	હરડ તે મૈકડોનાલડ ટાપૂ
ਹੋਂਡੁਰਸ	હોંડુરસ
ਕਰੋਏਸ਼ੀਆ	કરોએશીઆ
ਹੈਤੀ	હૈતી
ਹੰਗਰੀ	હગરી
ਕੇਨਾਰੀ ਟਾਪੂ	કેનારી ટાપૂ
ਇੰਡੋਨੇਸ਼ੀਆ	ઇડોનેશીઆ
ਆਇਰਲੈਂਡ	આઇરલૈંડ
ਇਜ਼ਰਾਈਲ	ઇજ઼રાઈલ
ਆਇਲ ਆਫ ਮੈਨ	આઇલ આફ મૈન
ਭਾਰਤ	ભારત
ਬਰਤਾਨਵੀ ਹਿੰਦ ਮਹਾਂਸਾਗਰ ਪ੍ਰਦੇਸ਼	બરતાનવી હિદ મહાંસાગર પ્રદેશ
ਇਰਾਕ	ઇરાક
ਈਰਾਨ	ઈરાન
ਆਈਸਲੈਂਡ	આઈસલૈંડ
ਇਟਲੀ	ઇટલી
ਜਰਸੀ	જરસી
ਜਮਾਇਕਾ	જમાઇકા
ਜਾਰਡਨ	જારડન
ਜਪਾਨ	જપાન
ਕੀਨੀਆ	કીનીઆ
ਕਿਰਗਿਜ਼ਸਤਾਨ	કિરગિજ઼સતાન
ਕੰਬੋਡੀਆ	કબોડીઆ
ਕਿਰਬਾਤੀ	કિરબાતી
ਕੋਮੋਰੋਸ	કોમોરોસ
ਸੈਂਟ ਕਿਟਸ ਐਂਡ ਨੇਵਿਸ	સૈંટ કિટસ ઐંડ નેવિસ
ਉੱਤਰੀ ਕੋਰੀਆ	ઉતરી કોરીઆ
ਦੱਖਣੀ ਕੋਰੀਆ	દખણી કોરીઆ
ਕੁਵੈਤ	કુવૈત
ਕੇਮੈਨ ਟਾਪੂ	કેમૈન ટાપૂ
ਕਜ਼ਾਖਸਤਾਨ	કજ઼ાખસતાન
ਲਾਓਸ	લાઓસ
ਲੈਬਨਾਨ	લૈબનાન
ਸੇਂਟ ਲੂਸੀਆ	સેંટ લૂસીઆ
ਲਿਚੇਂਸਟਾਇਨ	લિચેંસટાઇન
ਸ੍ਰੀ ਲੰਕਾ	સ્રી લકા
ਲਾਈਬੀਰੀਆ	લાઈબીરીઆ
ਲੇਸੋਥੋ	લેસોથો
ਲਿਥੁਆਨੀਆ	લિથુઆનીઆ
ਲਕਜ਼ਮਬਰਗ	લકજ઼મબરગ
ਲਾਟਵੀਆ	લાટવીઆ
ਲੀਬੀਆ	લીબીઆ
ਮੋਰੱਕੋ	મોરકો
ਮੋਨਾਕੋ	મોનાકો
ਮੋਲਡੋਵਾ	મોલડોવા
ਮੋਂਟੇਨੇਗਰੋ	મોંટેનેગરો
ਸੇਂਟ ਮਾਰਟਿਨ	સેંટ મારટિન
ਮੈਡਾਗਾਸਕਰ	મૈડાગાસકર
ਮਾਰਸ਼ਲ ਟਾਪੂ	મારશલ ટાપૂ
ਮੈਕਡੋਨੀਆ	મૈકડોનીઆ
ਮੈਕਡੋਨੀਆ (ਪੂਰਵ ਯੂਗੋਸਲਾਵ ਮੈਕਡੋਨੀਆਈ ਗਣਰਾਜ)	મૈકડોનીઆ (પૂરવ યૂગોસલાવ મૈકડોનીઆઈ ગણરાજ)
ਮਾਲੀ	માલી
ਮਿਆਂਮਾਰ (ਬਰਮਾ)	મિઆંમાર (બરમા)
ਮੰਗੋਲੀਆ	મગોલીઆ
ਮਕਾਉ ਐਸਏਆਰ ਚੀਨ	મકાઉ ઐસએઆર ચીન
ਮਕਾਉ	મકાઉ
ਉੱਤਰੀ ਮਾਰੀਆਨਾ ਟਾਪੂ	ઉતરી મારીઆના ટાપૂ
ਮਾਰਟੀਨਿਕ	મારટીનિક
ਮੋਰਿਟਾਨੀਆ	મોરિટાનીઆ
ਮੋਂਟਸੇਰਾਤ	મોંટસેરાત
ਮਾਲਟਾ	માલટા
ਮੌਰਿਸ਼ਸ	મૌરિશસ
ਮਾਲਦੀਵ	માલદીવ
ਮਲਾਵੀ	મલાવી
ਮੈਕਸੀਕੋ	મૈકસીકો
ਮਲੇਸ਼ੀਆ	મલેશીઆ
ਮੋਜ਼ਾਮਬੀਕ	મોજ઼ામબીક
ਨਾਮੀਬੀਆ	નામીબીઆ
ਨਿਊ ਕੈਲੇਡੋਨੀਆ	નિઊ કૈલેડોનીઆ
ਨਾਈਜਰ	નાઈજર
ਨੋਰਫੌਕ ਟਾਪੂ	નોરફૌક ટાપૂ
ਨਾਈਜੀਰੀਆ	નાઈજીરીઆ
ਨਿਕਾਰਾਗੁਆ	નિકારાગુઆ
ਨੀਦਰਲੈਂਡ	નીદરલૈંડ
ਨਾਰਵੇ	નારવે
ਨੇਪਾਲ	નેપાલ
ਨਾਉਰੂ	નાઉરૂ
ਨਿਯੂ	નિયૂ
ਨਿਊਜ਼ੀਲੈਂਡ	નિઊજ઼ીલૈંડ
ਓਮਾਨ	ઓમાન
ਪਨਾਮਾ	પનામા
ਪੇਰੂ	પેરૂ
ਫਰੈਂਚ ਪੋਲੀਨੇਸ਼ੀਆ	ફરૈંચ પોલીનેશીઆ
ਪਾਪੂਆ ਨਿਊ ਗਿਨੀ	પાપૂઆ નિઊ ગિની
ਫਿਲੀਪੀਂਸ	ફિલીપીંસ
ਪਾਕਿਸਤਾਨ	પાકિસતાન
ਪੋਲੈਂਡ	પોલૈંડ
ਸੈਂਟ ਪੀਅਰੇ ਐਂਡ ਮਿਕੇਲਨ	સૈંટ પીઅરે ઐંડ મિકેલન
ਪਿਟਕੇਰਨ ਟਾਪੂ	પિટકેરન ટાપૂ
ਪਿਊਰਟੋ ਰਿਕੋ	પિઊરટો રિકો
ਫਿਲੀਸਤੀਨੀ ਖੇਤਰ	ફિલીસતીની ખેતર
ਫਿਲੀਸਤੀਨ	ફિલીસતીન
ਪੁਰਤਗਾਲ	પુરતગાલ
ਪਲਾਉ	પલાઉ
ਪੈਰਾਗਵੇ	પૈરાગવે
ਕਤਰ	કતર
ਆਊਟਲਾਇੰਗ ਓਸ਼ੀਨੀਆ	આઊટલાઇગ ઓશીનીઆ
ਰਿਯੂਨੀਅਨ	રિયૂનીઅન
ਰੋਮਾਨੀਆ	રોમાનીઆ
ਸਰਬੀਆ	સરબીઆ
ਰੂਸ	રૂસ
ਰਵਾਂਡਾ	રવાંડા
ਸਾਊਦੀ ਅਰਬ	સાઊદી અરબ
ਸੋਲੋਮਨ ਟਾਪੂ	સોલોમન ટાપૂ
ਸੇਸ਼ਲਸ	સેશલસ
ਸੂਡਾਨ	સૂડાન
ਸਵੀਡਨ	સવીડન
ਸਿੰਗਾਪੁਰ	સિગાપુર
ਸੇਂਟ ਹੇਲੇਨਾ	સેંટ હેલેના
ਸਲੋਵੇਨੀਆ	સલોવેનીઆ
ਸਵਾਲਬਰਡ ਅਤੇ ਜਾਨ ਮਾਯੇਨ	સવાલબરડ અતે જાન માયેન
ਸਲੋਵਾਕੀਆ	સલોવાકીઆ
ਸਿਏਰਾ ਲਿਓਨ	સિએરા લિઓન
ਸੈਨ ਮਰੀਨੋ	સૈન મરીનો
ਸੇਨੇਗਲ	સેનેગલ
ਸੋਮਾਲੀਆ	સોમાલીઆ
ਸੂਰੀਨਾਮ	સૂરીનામ
ਦੱਖਣੀ ਸੂਡਾਨ	દખણી સૂડાન
ਸਾਓ ਟੋਮ ਅਤੇ ਪ੍ਰਿੰਸੀਪੇ	સાઓ ટોમ અતે પ્રિસીપે
ਅਲ ਸਲਵਾਡੋਰ	અલ સલવાડોર
ਸਿੰਟ ਮਾਰਟੀਨ	સિટ મારટીન
ਸੀਰੀਆ	સીરીઆ
ਸਵਾਜ਼ੀਲੈਂਡ	સવાજ઼ીલૈંડ
ਟ੍ਰਿਸਟਾਨ ਦਾ ਕੁੰਹਾ	ટ્રિસટાન દા કુહા
ਟੁਰਕਸ ਅਤੇ ਕੈਕੋਸ ਟਾਪੂ	ટુરકસ અતે કૈકોસ ટાપૂ
ਚਾਡ	ચાડ
ਫਰੈਂਚ ਦੱਖਣੀ ਪ੍ਰਦੇਸ਼	ફરૈંચ દખણી પ્રદેશ
ਟੋਗੋ	ટોગો
ਥਾਈਲੈਂਡ	થાઈલૈંડ
ਤਾਜਿਕਿਸਤਾਨ	તાજિકિસતાન
ਟੋਕੇਲਾਉ	ટોકેલાઉ
ਤਿਮੋਰ-ਲੇਸਤੇ	તિમોર-લેસતે
ਪੂਰਬੀ ਤਿਮੋਰ	પૂરબી તિમોર
ਤੁਰਕਮੇਨਿਸਤਾਨ	તુરકમેનિસતાન
ਟਿਊਨੀਸ਼ੀਆ	ટિઊનીશીઆ
ਟੌਂਗਾ	ટૌંગા
ਤੁਰਕੀ	તુરકી
ਟ੍ਰਿਨੀਡਾਡ ਅਤੇ ਟੋਬਾਗੋ	ટ્રિનીડાડ અતે ટોબાગો
ਟੁਵਾਲੂ	ટુવાલૂ
ਤਾਇਵਾਨ	તાઇવાન
ਤਨਜ਼ਾਨੀਆ	તનજ઼ાનીઆ
ਯੂਕਰੇਨ	યૂકરેન
ਯੂਗਾਂਡਾ	યૂગાંડા
ਸੰਯੁਕਤ ਰਾਜ	સયુકત રાજ
ਉਰੂਗਵੇ	ઉરૂગવે
ਉਜ਼ਬੇਕਿਸਤਾਨ	ઉજ઼બેકિસતાન
ਵੈਟੀਕਨ ਸਿਟੀ	વૈટીકન સિટી
ਸੇਂਟ ਵਿਨਸੈਂਟ ਐਂਡ ਗ੍ਰੇਨਾਡੀਨਸ	સેંટ વિનસૈંટ ઐંડ ગ્રેનાડીનસ
ਵੇਨੇਜ਼ੂਏਲਾ	વેનેજ઼ૂએલા
ਬ੍ਰਿਟਿਸ਼ ਵਰਜਿਨ ਟਾਪੂ	બ્રિટિશ વરજિન ટાપૂ
ਯੂ ਐਸ ਵਰਜਿਨ ਟਾਪੂ	યૂ ઐસ વરજિન ટાપૂ
ਵੀਅਤਨਾਮ	વીઅતનામ
ਵਾਨੂਆਟੂ	વાનૂઆટૂ
ਵਾਲਿਸ ਅਤੇ ਫੂਟੂਨਾ	વાલિસ અતે ફૂટૂના
ਸਾਮੋਆ	સામોઆ
ਕੋਸੋਵੋ	કોસોવો
ਯਮਨ	યમન
ਮਾਯੋਟੀ	માયોટી
ਦੱਖਣੀ ਅਫਰੀਕਾ	દખણી અફરીકા
ਜ਼ਾਮਬੀਆ	જ઼ામબીઆ
ਜ਼ਿੰਬਾਬਵੇ	જ઼િબાબવે
ਅਣਪਛਾਤਾ ਖੇਤਰ	અણપછાતા ખેતર
