# Baby names
അകര്ശാനാ	அகர்ஶாநா
അക്ശൈനീഏ	அக்ஶைநீஏ
അഗജാ	அகஜா
അചിംത	அசிஂத
അചിത	அசித
അച്ചിന്ദ്ര	அச்சிந்த்ர
അഡ്യാദവൈതാ	அட்யாதவைதா
അദഭുതഃ	அதபுதஃ
അദേന്യ	அதேந்ய
അദേല	அதேல
അദ്രിതീ	அத்ரிதீ
അദ്രീഥീ	அத்ரீதீ
അദ്രീമാം	அத்ரீமாஂ
അദ്വൈയാ	அத்வையா
അധര്ഷ	அதர்ஷ
അധിപാ	அதிபா
അധീരതാ	அதீரதா
അധ്യുത	அத்யுத
അനംതാമായാ	அநஂதாமாயா
അബരനാ	அபரநா
അബിനയ	அபிநய
അബിനാ	அபிநா
അബീനംദാ	அபீநஂதா
അബീശാ	அபீஶா
അഭയ	அபய
അഭയന	அபயந
അഭിഗ്ന്യാ	அபிக்ந்யா
അഭിജീതാ	அபிஜீதா
അഭിനിവേശ	அபிநிவேஶ
അഭിമ	அபிம
അഭിമാനീ	அபிமாநீ
അഭിമോദാ	அபிமோதா
അഭിരാ	அபிரா
അഭിരാത	அபிராத
അഭീരല	அபீரல
അഭീശ്രേയ	அபீஶ்ரேய
അഭീസുമത	அபீஸுமத
അഭ്യപ്സീത	அப்யப்ஸீத
അഭ്യുദയാ	அப்யுதயா
അമൃതാ	அம்ரிதா
അലകനംദാ	அலகநஂதா
അലക്ഷാ	அலக்ஷா
അല്കാ	அல்கா
അശവ	அஶவ
അശ്നേഇല	அஶ்நேஇல
ആകാശലീനാ	ஆகாஶலீநா
ആകൃഥീ	ஆக்ரிதீ
ആക്ഷ്യാ	ஆக்ஷ்யா
ആചാര്യ	ஆசார்ய
ആത്മയ	ஆத்மய
ആദി	ஆதி
ആദിമ	ஆதிம
ആദീവ	ஆதீவ
ആധീരേന	ஆதீரேந
ആധ്യാ	ஆத்யா
ആനംദീനീ	ஆநஂதீநீ
ആനീകാ	ஆநீகா
ആന്തീകാ	ஆந்தீகா
ആന്വീ	ஆந்வீ
ആപ്ത	ஆப்த
ആപ്തി	ஆப்தி
ആമാംനീ	ஆமாஂநீ
ആമിഷ	ஆமிஷ
ആമുക്ഥാ	ஆமுக்தா
ആയുസ	ஆயுஸ
ആയോദ	ஆயோத
ആരംഭീ	ஆரஂபீ
ആരതീ	ஆரதீ
ആരസീ	ஆரஸீ
ആര്യ	ஆர்ய
ആര്യക	ஆர்யக
ആര്യനാ	ஆர்யநா
ആര്യമാനീ	ஆர்யமாநீ
ആലേഃയാ	ஆலேஃயா
ആവംശ	ஆவஂஶ
ആവേശ	ஆவேஶ
ആശകാ	ஆஶகா
ആശിയാനാ	ஆஶியாநா
ആശുതോഷ	ஆஶுதோஷ
ആശ്മീന	ஆஶ்மீந
ആശ്വിത	ஆஶ்வித
ആസവ	ஆஸவ
ആസ്തിക	ஆஸ்திக
ഇക്ശാനാ	இக்ஶாநா
ഇജയാ	இஜயா
ഇനീയന	இநீயந
ഇനോദയ	இநோதய
ഇന്ദരകാന്ത	இந்தரகாந்த
ഇന്ദിവാരസ	இந்திவாரஸ
ഇന്ദുശിതാലാ	இந்துஶிதாலா
ഇന്ദ്രജാ	இந்த்ரஜா
ഇന്ദ്രതന	இந்த்ரதந
ഇന്ദ്രദയുമ്ന	இந்த்ரதயும்ந
ഇന്ദ്രവദന	இந்த்ரவதந
ഇന്ദ്രാണീ	இந்த்ராணீ
ഇബ്ബാനീ	இப்பாநீ
ഇയുരേശ	இயுரேஶ
ഇയേനഗര	இயேநகர
ഇരാജ	இராஜ
ഇരിത	இரித
ഇരേശ	இரேஶ
ഇലിസാ	இலிஸா
ഇശിതാ	இஶிதா
ഇശ്വാര്യ	இஶ்வார்ய
ഇഷ്ടാ	இஷ்டா
ഇഷ്ടി	இஷ்டி
ഇസാര	இஸார
ഇസ്ശും	இஸ்ஶுஂ
ഈതന	ஈதந
ഈതികാ	ஈதிகா
ഈരേന്പ്രിത	ஈரேந்ப்ரித
ഈര്ശീതാ	ஈர்ஶீதா
ഈലാക്കീയാ	ஈலாக்கீயா
ഈലികാ	ஈலிகா
ഈലേശാ	ஈலேஶா
ഈശാര	ஈஶார
ഈശിക	ஈஶிக
ഈശ്വരദത്ത	ஈஶ்வரதத்த
ഈഹാ	ஈஹா
ഉഗ്രസ്രവാസ	உக்ரஸ்ரவாஸ
ഉജവണീ	உஜவணீ
ഉജേശാ	உஜேஶா
ഉജ്ജന	உஜ்ஜந
ഉജ്ജവല	உஜ்ஜவல
ഉജ്ജവാലാ	உஜ்ஜவாலா
ഉജ്ജ്വലാ /ഉജ്വലാ	உஜ்ஜ்வலா /உஜ்வலா
ഉജ്ജ്വാലാ	உஜ்ஜ்வாலா
ഉത്കര്ഷ	உத்கர்ஷ
ഉത്കലാ	உத்கலா
ഉത്തര	உத்தர
ഉത്പര	உத்பர
ഉത്സര്ഗ	உத்ஸர்க
ഉദയ കുമാര	உதய குமார
ഉദരഥീ	உதரதீ
ഉദാന്തികാ	உதாந்திகா
ഉദേയ	உதேய
ഉദ്ധാര	உத்தார
ഉദ്യത	உத்யத
ഉദ്യമീ	உத்யமீ
ഉദ്യോത	உத்யோத
ഉധവ	உதவ
ഉപംഗ	உபஂக
ഉപദാ	உபதா
ഉപാധ്രീതീ	உபாத்ரீதீ
ഉപ്പാസ	உப்பாஸ
ഉമാ	உமா
ഉമേശ്വര	உமேஶ்வர
ഉരിശിതാ	உரிஶிதா
ഉര്ജാ	உர்ஜா
ഉര്ജീകാ	உர்ஜீகா
ഉര്ജീതാ	உர்ஜீதா
ഉര്ദാഹാവ	உர்தாஹாவ
ഉര്മികാ	உர்மிகா
ഉര്മിമാലാ	உர்மிமாலா
ഉര്വീനാഥ	உர்வீநாத
ഉല്പേശ	உல்பேஶ
ഉശേന്യ	உஶேந்ய
ഉഷാശി	உஷாஶி
ഉഷ്മാ	உஷ்மா
ഉസരീ	உஸரீ
ഊതരാ	ஊதரா
ഊര്വേശ	ஊர்வேஶ
ഏകംശീ	ஏகஂஶீ
ഏകക്ഷരപരാ	ஏகக்ஷரபரா
ഏകതന	ஏகதந
ഏകതാ	ஏகதா
ഏകാംശ	ஏகாஂஶ
ഏകാകാന്യ	ஏகாகாந்ய
ഏകാനീ	ஏகாநீ
ഏകാപര്നികാ	ஏகாபர்நிகா
ഏകേസ്വാര	ஏகேஸ்வார
ഏത്തന	ஏத்தந
ഏധിത	ஏதித
ഏമാ	ஏமா
ഏലനാ	ஏலநா
ഏലാ	ஏலா
ഏലീലവേംദന	ஏலீலவேஂதந
ഏലീലീ	ஏலீலீ
ഓഈസീന	ஓஈஸீந
ഓജസ്വീ	ஓஜஸ்வீ
ഓജാ	ஓஜா
ഓജീസ	ஓஜீஸ
ഓനിശ	ஓநிஶ
ഓമപ്രകാശ	ஓமப்ரகாஶ
ഓവീന	ஓவீந
ഓവൈസ	ஓவைஸ
കംജ	கஂஜ
കംജന	கஂஜந
കംഠന	கஂடந
കംദര്പ	கஂதர்ப
കംപനാ	கஂபநா
കകോന	ககோந
കതകീ	கதகீ
കതേല്യ്ന	கதேல்ய்ந
കനക	கநக
കനദ	கநத
കനാകംഗീ	கநாகஂகீ
കനീജാ	கநீஜா
കനീരാ	கநீரா
കനീസാ	கநீஸா
കനുഷ	கநுஷ
കന്വക	கந்வக
കന്ശീകാ	கந்ஶீகா
കപാലീന	கபாலீந
കപിലാശ്വര	கபிலாஶ்வர
കമലാപതി	கமலாபதி
കമലിനീ	கமலிநீ
കമലേക്ഷണ	கமலேக்ஷண
കമ്നാ	கம்நா
കരാലാ	கராலா
കരീസമാം	கரீஸமாஂ
കരുനാസ്രീ	கருநாஸ்ரீ
കരുപ്പസമ്യ	கருப்பஸம்ய
കര്ണ	கர்ண
കര്തീഗാ	கர்தீகா
കര്മദീപ	கர்மதீப
കര്മാശ	கர்மாஶ
കലരനീ	கலரநீ
കലശ	கலஶ
കലാധര	கலாதர
കലാനിധി	கலாநிதி
കലാപരണ	கலாபரண
കലാപീന	கலாபீந
കലാപ്രിയാ	கலாப்ரியா
കലൈസേലവീ	கலைஸேலவீ
കവന	கவந
കവിപ  പ്രിയ	கவிப  ப்ரிய
കവീനാഥ	கவீநாத
കശ്തീ	கஶ்தீ
കാജല	காஜல
കാജീശ	காஜீஶ
കാദമ്ബരീ	காதம்பரீ
കാധിരോലീ	காதிரோலீ
കാനീ	காநீ
കാന്ജീരാ	காந்ஜீரா
കാന്തീ	காந்தீ
കാമത	காமத
കാമിഷാ	காமிஷா
കാമേശ	காமேஶ
കാരുണ്യ പ്രകാശ	காருண்ய ப்ரகாஶ
കാരൂകാ	காரூகா
കാര്നിക	கார்நிக
കാലിക	காலிக
കാലിപദാ	காலிபதா
കാലിയാ	காலியா
കാലീതാ	காலீதா
കാവ്യ ശ്രീ	காவ்ய ஶ்ரீ
കിന്നേരാ	கிந்நேரா
കീഅനാ	கீஅநா
കീജല	கீஜல
കീനാരീ	கீநாரீ
കീന്ചനാ	கீந்சநா
കേകലാ	கேகலா
കേതന	கேதந
കേനിഷാ	கேநிஷா
കേളവ്യ	கேளவ்ய
കൈരവീ	கைரவீ
കൈലാശ	கைலாஶ
കോശേല	கோஶேல
കൌശികാ	கௌஶிகா
ഖഗേശ	ககேஶ
ഖമീശ	கமீஶ
ഖാതീരാവണ	காதீராவண
ഖാത്വന്ഗീന	காத்வந்கீந
ഖീലതീ	கீலதீ
ഖുസീ	குஸீ
ഗംഗാ	கஂகா
ഗംദേശാ	கஂதேஶா
ഗംധാര	கஂதார
ഗംധാരാ	கஂதாரா
ഗംധാലീ	கஂதாலீ
ഗഗന	ககந
ഗജവദന	கஜவதந
ഗജേന്ദ്ര	கஜேந்த்ர
ഗണക	கணக
ഗണനാ പംഡിതന	கணநா பஂடிதந
ഗണനാഥ	கணநாத
ഗണ്യാ	கண்யா
ഗതി	கதி
ഗനേസന	கநேஸந
ഗന്ഗസീരുവന	கந்கஸீருவந
ഗയാലികാ	கயாலிகா
ഗരിമാ	கரிமா
ഗരിഷ്ട	கரிஷ்ட
ഗരുല	கருல
ഗാഇശ	காஇஶ
ഗാന്ഗമൈന്ദന	காந்கமைந்தந
ഗാമിനീ	காமிநீ
ഗായത്രീ	காயத்ரீ
ഗായലേ	காயலே
ഗിഅന	கிஅந
ഗിയാ	கியா
ഗിരിവര	கிரிவர
ഗീതി	கீதி
ഗീതീശാ	கீதீஶா
ഗുംജാ	குஂஜா
ഗുനാജാ	குநாஜா
ഗുനാരത്നാ	குநாரத்நா
ഗുനാശേകാര	குநாஶேகார
ഗുനീന	குநீந
ഗുന്ജീതാ	குந்ஜீதா
ഗുപ്തക	குப்தக
ഗുരദയാല	குரதயால
ഗുരദേവ	குரதேவ
ഗുരബാനീ	குரபாநீ
ഗുരമാന	குரமாந
ഗുരുത്തമ	குருத்தம
ഗുര്നാന്ഡീശ	குர்நாந்டீஶ
ഗുലമോഹര	குலமோஹர
ഗുവീദ	குவீத
ഗൂംജീതാ	கூஂஜீதா
ഗൂഹാരീ	கூஹாரீ
ഗേനേലിയാ	கேநேலியா
ഗേശനാ	கேஶநா
ഗോപാല	கோபால
ഗോപീ നാഥ	கோபீ நாத
ഗോഭില	கோபில
ഗോരഖ-നാഥ	கோரக-நாத
ഗൌരവീ	கௌரவீ
ഗൌരീകാംത	கௌரீகாஂத
ഗൌരീശ	கௌரீஶ
ഗൌര്പ്രിയാ	கௌர்ப்ரியா
ഗ്രീതേശ	க்ரீதேஶ
ഗ്രീവാ	க்ரீவா
ഗ്രീശ്മീതാ	க்ரீஶ்மீதா
ഗ്രീഷ്മ	க்ரீஷ்ம
ഘടോതകത്ചാ	கடோதகத்சா
ചംചലാ	சஂசலா
ചംദേര്ഭാന	சஂதேர்பாந
ചംദ്രകാംത	சஂத்ரகாஂத
ചംദ്രകാംതാ	சஂத்ரகாஂதா
ചംദ്രചുര	சஂத்ரசுர
ചംദ്രപുശ്പാ	சஂத்ரபுஶ்பா
ചംദ്രപ്രകാശ	சஂத்ரப்ரகாஶ
ചംദ്രമതി	சஂத்ரமதி
ചംദ്രലേഖാ	சஂத்ரலேகா
ചംദ്രഹാസ	சஂத்ரஹாஸ
ചംദ്രാനന	சஂத்ராநந
ചംദ്രാഭാ	சஂத்ராபா
ചംദ്രേശ	சஂத்ரேஶ
ചകേശ	சகேஶ
ചകോര	சகோர
ചക്ഷസ	சக்ஷஸ
ചതുര	சதுர
ചതുരാ	சதுரா
ചതുര്ഭുജാ	சதுர்புஜா
ചതുര്വേദീ	சதுர்வேதீ
ചത്രീയാ	சத்ரீயா
ചന്ദ്രകേതു	சந்த்ரகேது
ചരണ	சரண
ചരന്യാ	சரந்யா
ചലാമാ	சலாமா
ചാംദ	சாஂத
ചാനാസ്യാ	சாநாஸ்யா
ചാനേ	சாநே
ചാന്ദനികാ	சாந்தநிகா
ചാരുന	சாருந
ചാരുവീ	சாருவீ
ചാര്മീ	சார்மீ
ചാര്വീ	சார்வீ
ചാവ്രിക	சாவ்ரிக
ചിത്കലാ	சித்கலா
ചിത്ത	சித்த
ചിത്തപ്രസാദ	சித்தப்ரஸாத
ചിത്തരംജന	சித்தரஂஜந
ചിത്തരംജനീ	சித்தரஂஜநீ
ചിത്രകുന്ധാലാ	சித்ரகுந்தாலா
ചിത്രകേതു	சித்ரகேது
ചിത്രഗംധാ	சித்ரகஂதா
ചിത്രബാനാ	சித்ரபாநா
ചിത്രമാലാ	சித்ரமாலா
ചിത്രര്ത	சித்ரர்த
ചിത്രല	சித்ரல
ചിത്രലേഖാ	சித்ரலேகா
ചിത്രാദീപ	சித்ராதீப
ചിത്രീനീ	சித்ரீநீ
ചിദംബര	சிதஂபர
ചിദാനംദാ	சிதாநஂதா
ചിനാര	சிநார
ചിന്നാദുരാഈ	சிந்நாதுராஈ
ചിമന	சிமந
ചീദാര്ത	சீதார்த
ചീന്മയേ	சீந்மயே
ചീരുഷ	சீருஷ
ചേതന്ദീപ	சேதந்தீப
ചേതള	சேதள
ചേഥാസാ	சேதாஸா
ചേമ്മല	சேம்மல
ചേര്വിക	சேர்விக
ചേലന	சேலந
ചേലിയാഁ	சேலியாഁ
ചൈതന്യാ	சைதந்யா
ചൈത്രാ	சைத்ரா
ചൈരാവലീ	சைராவலீ
ഛായാംക	சாயாஂக
ജക്ഷ	ஜக்ஷ
ജക്ഷാനീ	ஜக்ஷாநீ
ജഗതപ്രകാശ	ஜகதப்ரகாஶ
ജഗദഗുരു	ஜகதகுரு
ജഗദമ്ബാ	ஜகதம்பா
ജഗനമോഹിനീ	ஜகநமோஹிநீ
ജഗന്മയീ	ஜகந்மயீ
ജഗ്വീ	ஜக்வீ
ജഗ്വീര	ஜக்வீர
ജജ്വാല്യാ	ஜஜ்வால்யா
ജടായു	ஜடாயு
ജനഹിതാ	ஜநஹிதா
ജനാദേവ	ஜநாதேவ
ജനാവ	ஜநாவ
ജനിത	ஜநித
ജമാംദാഗ്ന്യ മഹാദാര്പാ	ஜமாஂதாக்ந்ய மஹாதார்பா
ജമ്ബവതപ്രീതി	ஜம்பவதப்ரீதி
ജയംത	ஜயஂத
ജയചംദ	ஜயசஂத
ജയപാല	ஜயபால
ജയമാലാ	ஜயமாலா
ജയശ്രീ	ஜயஶ்ரீ
ജയാകീര്തന	ஜயாகீர்தந
ജയാകേതന	ஜயாகேதந
ജയാപാദമാം	ஜயாபாதமாஂ
ജയായ	ஜயாய
ജയിത	ஜயித
ജയേശ	ஜயேஶ
ജലദ	ஜலத
ജല്പേശ	ஜல்பேஶ
ജശവംത	ஜஶவஂத
ജസീത്താ	ஜஸீத்தா
ജസ്സീ	ஜஸ்ஸீ
ജാനകീ	ஜாநகீ
ജാനകീദാസ	ஜாநகீதாஸ
ജാനകീനാഥ	ஜாநகீநாத
ജാനകീഭൂഷണ	ஜாநகீபூஷண
ജാനഹിതാ	ஜாநஹிதா
ജാപക	ஜாபக
ജായിത്രീ	ஜாயித்ரீ
ജിനേശ്വര	ஜிநேஶ்வர
ജിഹാന	ஜிஹாந
ജീതേശ	ஜீதேஶ
ജീന്ദാല	ஜீந்தால
ജീവനകലാ	ஜீவநகலா
ജീവനീ	ஜீவநீ
ജീവന്തീനീ	ஜீவந்தீநீ
ജുഷ്ടി	ஜுஷ்டி
ജേനീശാ	ஜேநீஶா
ജേര്ശീകാ	ஜேர்ஶீகா
ജൈകാപിശ	ஜைகாபிஶ
ജൈചരണ	ஜைசரண
ജൈനീശ	ஜைநீஶ
ജൈപ്രകാശ	ஜைப்ரகாஶ
ജൈവംത	ஜைவஂத
ജൈസല	ஜைஸல
ജൈഹാസീനീ	ஜைஹாஸீநீ
ജോംഫീ	ஜோஂபீ
ജോശനീകാ	ஜோஶநீகா
ജോശീതാ	ஜோஶீதா
ജ്വാലാ	ஜ்வாலா
ജ്ഹില	ஜ்ஹில
ജ്ഹീണൂക	ஜ்ஹீணூக
ഝഹനവീ	சஹநவீ
ഝാനീശാ	சாநீஶா
ഝാരാ	சாரா
ഝീയാ	சீயா
ഝേനീശാ	சேநீஶா
ഝ്യാനനീ	ச்யாநநீ
ടീംകു	டீஂகு
ഠുമരീ	டுமரீ
തക്ശീ	தக்ஶீ
തക്ശീല	தக்ஶீல
തജജ്ഞ	தஜஜ்ஞ
തനവീ	தநவீ
തനിഷ്ക	தநிஷ்க
തനുംജാശ്രീ	தநுஂஜாஶ்ரீ
തനുംശ്കാ	தநுஂஶ்கா
തനോജ	தநோஜ
തപസ	தபஸ
തപസ്വിനീ	தபஸ்விநீ
തമില  സേല്വീ	தமில  ஸேல்வீ
തമിശ	தமிஶ
തമോഘ്നാ	தமோக்நா
തമോനഷ	தமோநஷ
തരംജോത	தரஂஜோத
തരനീ	தரநீ
തരലാ	தரலா
തരീനീ	தரீநீ
തരുശ്രീ	தருஶ்ரீ
തരൂണീ	தரூணீ
തവലീന :	தவலீந :
തവിഷാ	தவிஷா
തസ്യ	தஸ்ய
താക്ഷ്യാ	தாக்ஷ்யா
താജേന്ദര	தாஜேந்தர
താനാരുപീ	தாநாருபீ
താനിയാ	தாநியா
താന്വീഥാ	தாந்வீதா
താപീ	தாபீ
താരികാ	தாரிகா
താരീനീ	தாரீநீ
താരൂശ	தாரூஶ
താലംക	தாலஂக
താലീന	தாலீந
താലേശ	தாலேஶ
താവന	தாவந
താവീശാ	தாவீஶா
തിതലീ	திதலீ
തിനാശ	திநாஶ
തിലക	திலக
തീഈവ്യേശ	தீஈவ்யேஶ
തീര്ഥാ	தீர்தா
തീസ്ചാ	தீஸ்சா
തുത്തീ	துத்தீ
തുനാവാ	துநாவா
തുന്ഗാര	துந்கார
തുപമ	துபம
തുരഗ	துரக
തുശീഥാ	துஶீதா
തൃപേശ	த்ரிபேஶ
തേജസ	தேஜஸ
തേജസ്വീ	தேஜஸ்வீ
തേജസ്വീന	தேஜஸ்வீந
തേജേനദര	தேஜேநதர
തേജോമയ	தேஜோமய
തോയേശ	தோயேஶ
തോശീകാ	தோஶீகா
തൌരുസ	தௌருஸ
ത്രികായാ	த்ரிகாயா
ത്രിപുരസുംദരീ	த்ரிபுரஸுஂதரீ
ത്രിഭുവന	த்ரிபுவந
ത്രിമാന	த்ரிமாந
ത്രിമൂര്തി	த்ரிமூர்தி
ത്രിവേണീ	த்ரிவேணீ
ത്രിശല	த்ரிஶல
ത്രിശലാനാ	த்ரிஶலாநா
ത്രീഝ്യാ	த்ரீச்யா
ത്രീതിയാ	த்ரீதியா
ത്രീനേശ	த்ரீநேஶ
ത്രീപന	த்ரீபந
ത്രീപ്ത	த்ரீப்த
ത്രീവീദ	த்ரீவீத
ത്വരിതാ	த்வரிதா
ത്വീശീ	த்வீஶீ
ത്വേസാ	த்வேஸா
ഥംസീ	தஂஸீ
ഥനീരികാ	தநீரிகா
ഥാകാപ്പന്സ്വാമീ	தாகாப்பந்ஸ்வாமீ
ഥാരികാ	தாரிகா
ഥാവനീ	தாவநீ
ഥീരീശ്കാ	தீரீஶ்கா
ഥുസീഥാ	துஸீதா
ഥ്രേശാ	த்ரேஶா
ദംദാപാനീ	தஂதாபாநீ
ദക്ഷാഹതാ	தக்ஷாஹதா
ദബീത	தபீத
ദബ്ന്ശും	தப்ந்ஶுஂ
ദയാദാ	தயாதா
ദയാനിതാ	தயாநிதா
ദരഹാസ	தரஹாஸ
ദര്ശ	தர்ஶ
ദര്ശക	தர்ஶக
ദര്ശികാ	தர்ஶிகா
ദര്ശീനീ	தர்ஶீநீ
ദര്സീകാ	தர்ஸீகா
ദശാഗ്രീവാ ശീരോഹരാ	தஶாக்ரீவா ஶீரோஹரா
ദശാഗ്രീവാകുലാന്താകാ	தஶாக்ரீவாகுலாந்தாகா
ദശാനന	தஶாநந
ദഹാ	தஹா
ദാനാസ്വീ	தாநாஸ்வீ
ദാനുംശ്രീ	தாநுஂஶ்ரீ
ദാന്ദാകാരാന്യ പുന്യകൃതേ	தாந்தாகாராந்ய புந்யக்ரிதே
ദാരുല	தாருல
ദാഹക	தாஹக
ദികീശംദ	திகீஶஂத
ദിഗീശാ	திகீஶா
ദിപംശീ	திபஂஶீ
ദിപശീകീ	திபஶீகீ
ദിപേംദര	திபேஂதர
ദിപ്താ	திப்தா
ദിബസരീ	திபஸரீ
ദിവീഥാ	திவீதா
ദിവേനാ	திவேநா
ദീതാ	தீதா
ദീനബംധു	தீநபஂது
ദീപഥീ	தீபதீ
ദീപപ്രഭാ	தீபப்ரபா
ദീപമാലാ	தீபமாலா
ദീപശിഖാ	தீபஶிகா
ദീപാംജലി	தீபாஂஜலி
ദീപാശാ	தீபாஶா
ദീപിത	தீபித
ദീവാംശ	தீவாஂஶ
ദേജ	தேஜ
ദേബജ്യോതീ	தேபஜ்யோதீ
ദേബദാത്താ	தேபதாத்தா
ദേബദ്രിതാ	தேபத்ரிதா
ദേബന്ശീ	தேபந்ஶீ
ദേയ്വയാനാകാന്തന	தேய்வயாநாகாந்தந
ദേവഗര്ഭാ	தேவகர்பா
ദേവജ്യോതി	தேவஜ்யோதி
ദേവദാന	தேவதாந
ദേവന്ദ്ര	தேவந்த்ர
ദേവമദാനാ	தேவமதாநா
ദേവരാജ	தேவராஜ
ദേവശ്രീ	தேவஶ்ரீ
ദേവാംഗനാ	தேவாஂகநா
ദേവാംഗീ	தேவாஂகீ
ദേവാംശു	தேவாஂஶு
ദേവാദീത്യാ	தேவாதீத்யா
ദേവാനീ	தேவாநீ
ദേവാന്ശാ	தேவாந்ஶா
ദേവാപ്രിയാ	தேவாப்ரியா
ദേവാമനോഹാരീ	தேவாமநோஹாரீ
ദേവീന	தேவீந
ദേവീലാല	தேவீலால
ദേവേന	தேவேந
ദേവേശീ	தேவேஶீ
ദേവ്യഹ്നാന	தேவ்யஹ்நாந
ദേശാവംത	தேஶாவஂத
ദൈത്യാകുലാന്താകാ	தைத்யாகுலாந்தாகா
ദൈവ്യാ	தைவ்யா
ധക്ശീന്യ	தக்ஶீந்ய
ധനസുഖ	தநஸுக
ധനാജീ	தநாஜீ
ധനിഷ്ഠ	தநிஷ்ட
ധനു	தநு
ധനുജാ	தநுஜா
ധനേശീ	தநேஶீ
ധന്വികാ	தந்விகா
ധരമനിഷ്ഠ	தரமநிஷ்ட
ധരാമാം	தராமாஂ
ധരാഹാസീനീ	தராஹாஸீநீ
ധരീശ	தரீஶ
ധര്മ  ദുത്ത	தர்ம  துத்த
ധര്മഅധ്യക്ഷ	தர்மஅத்யக்ஷ
ധര്മദിത്യ	தர்மதித்ய
ധര്മദേവ	தர்மதேவ
ധര്ശീതാ	தர்ஶீதா
ധര്ശീനീ	தர்ஶீநீ
ധാമീനീ	தாமீநீ
ധാരാനീ	தாராநீ
ധിതി	திதி
ധിതീ	திதீ
ധീപ്ത്ഹാ	தீப்த்ஹா
ധീമാഹീ	தீமாஹீ
ധീര്ഥാ	தீர்தா
ധേയാംശീ	தேயாஂஶீ
ധൈര്യ്യാ	தைர்ய்யா
ധ്യുഥീ	த்யுதீ
ധ്രുമീ	த்ருமீ
നംദക	நஂதக
നംദു	நஂது
നക്ശ	நக்ஶ
നക്സത്രരാജാ	நக்ஸத்ரராஜா
നഗമാനീ	நகமாநீ
നടവര	நடவர
നത്രീശാ	நத்ரீஶா
നദീപ	நதீப
നഭാ	நபா
നഭോമാനീ	நபோமாநீ
നമന	நமந
നമനാ	நமநா
നയന	நயந
നരേന്ദ്രന	நரேந்த்ரந
നരേന്ദ്രനാഥ	நரேந்த்ரநாத
നരേശ	நரேஶ
നവനീത വിലീപ്തംഗാ	நவநீத விலீப்தஂகா
നവമ	நவம
നവരംഗ	நவரஂக
നസീബ	நஸீப
നാംബീ	நாஂபீ
നാഗനാഥ	நாகநாத
നാഗപാല	நாகபால
നാഗേശ്വരണ	நாகேஶ்வரண
നാഗൈഃ	நாகைஃ
നാതാഭൈരവീ	நாதாபைரவீ
നാതിന	நாதிந
നാന്ധീനീ	நாந்தீநீ
നാന്നാന	நாந்நாந
നാഭിതാ	நாபிதா
നാഭേംദു	நாபேஂது
നാമത	நாமத
നായകീ	நாயகீ
നായാനീ	நாயாநீ
നായാനീകാ	நாயாநீகா
നാലിനികാംത	நாலிநிகாஂத
നാലീനേശയ	நாலீநேஶய
നാവീന്യ	நாவீந்ய
നാവീല	நாவீல
നാവ്യാ ദുര്ഗാ	நாவ்யா துர்கா
നാവ്രീതാ	நாவ்ரீதா
നികാരാ	நிகாரா
നിഖിതാ	நிகிதா
നിഖില	நிகில
നിജു	நிஜு
നിധി	நிதி
നിധിപാ	நிதிபா
നിപാ	நிபா
നിരംജനാ	நிரஂஜநா
നിരമഈ	நிரமஈ
നിരുപമാ	நிருபமா
നിര്മളാ	நிர்மளா
നിര്മിതി	நிர்மிதி
നിലാശാ	நிலாஶா
നിശാനഥീ	நிஶாநதீ
നീഗീഥാ	நீகீதா
നീതു	நீது
നീഥീകാ	நீதீகா
നീധാ	நீதா
നീധാര്സനാ	நீதார்ஸநா
നീമാംലന	நீமாஂலந
നീരാലികാ	நீராலிகா
നീരൈമാംഥീ	நீரைமாஂதீ
നീര്മുകതാ	நீர்முகதா
നീല മാധവ	நீல மாதவ
നീലംജന	நீலஂஜந
നീലക്ഷ	நீலக்ஷ
നീല്ജാ	நீல்ஜா
നീശാലീ	நீஶாலீ
നീശീതീ	நீஶீதீ
നീശ്മീഥാ	நீஶ்மீதா
നീസ്ചീഥാ	நீஸ்சீதா
നീഹാ	நீஹா
നേമീശാ	நேமீஶா
നേയ്സാ	நேய்ஸா
നേരീശാ	நேரீஶா
നൈജാ	நைஜா
നൈരീതീ	நைரீதீ
നൈവേധീ	நைவேதீ
നൌസദ	நௌஸத
പംകജന	பஂகஜந
പംചഭൂതാത്മികാ	பஂசபூதாத்மிகா
പംഥീനീ	பஂதீநீ
പഝ്ഹേനീ	பச்ஹேநீ
പത്താമ്ബരാപരീധാനാ	பத்தாம்பராபரீதாநா
പത്ര	பத்ர
പന്ദാലാവാസന	பந்தாலாவாஸந
പമ്പാ	பம்பா
പമ്ഫാ	பம்பா
പയാസ	பயாஸ
പയോധീ	பயோதீ
പരംതാപാ	பரஂதாபா
പരമാംത്മികാ	பரமாஂத்மிகா
പരമാംന്ത്ര	பரமாஂந்த்ர
പരമിലാ	பரமிலா
പരമേശ്വരീ	பரமேஶ்வரீ
പരമ്വാര്ദാന	பரம்வார்தாந
പരവാനീ	பரவாநீ
പരവിംദര	பரவிஂதர
പരാകാഷ	பராகாஷ
പരാവീ	பராவீ
പരിഹാ	பரிஹா
പര്തീബന	பர்தீபந
പര്ലീ	பர்லீ
പര്വ	பர்வ
പലാക്ഷ	பலாக்ஷ
പലാശീനീ	பலாஶீநீ
പവന	பவந
പവനസുത	பவநஸுத
പശുപതി	பஶுபதி
പഹലാജ	பஹலாஜ
പാടലാ	பாடலா
പാന്ദുരംഗാ	பாந்துரஂகா
പായല	பாயல
പാരു	பாரு
പാര്ഥിക	பார்திக
പാര്ഥീവീ	பார்தீவீ
പാര്ഥോ	பார்தோ
പാളവീ	பாளவீ
പാവകീ	பாவகீ
പാവനാ	பாவநா
പാവാനാ	பாவாநா
പാഹീ	பாஹீ
പിവാല	பிவால
പൂജന	பூஜந
പൂരതീ	பூரதீ
പൂരികാ	பூரிகா
പൂര്വജാ	பூர்வஜா
പൂര്വികാ	பூர்விகா
പേഖമ	பேகம
പേത്ചീ	பேத்சீ
പേരാരസീ	பேராரஸீ
പ്രകൃഥീ	ப்ரக்ரிதீ
പ്രഗന്യാ	ப்ரகந்யா
പ്രഗ്യപരാമിതാ	ப்ரக்யபராமிதா
പ്രജാനാ	ப்ரஜாநா
പ്രനാദാ	ப்ரநாதா
പ്രനീധാനാ	ப்ரநீதாநா
പ്രബകരണ	ப்ரபகரண
പ്രഭാകര	ப்ரபாகர
പ്രഭാകരന	ப்ரபாகரந
പ്രഭാത	ப்ரபாத
പ്രഭാവ	ப்ரபாவ
പ്രാതീകാ	ப்ராதீகா
ഫനീ	பநீ
ഫനീഭുഷണ	பநீபுஷண
ഫാല്ഗുനീ	பால்குநீ
ഫൂലന	பூலந
ഫ്രാന്ചീസ	ப்ராந்சீஸ
ബംദിശ	பஂதிஶ
ബംധൂല	பஂதூல
ബംശീ	பஂஶீ
ബംസീധര	பஂஸீதர
ബകുലാ	பகுலா
ബകൂല	பகூல
ബദ്രീ	பத்ரீ
ബനജ	பநஜ
ബനവാരീ	பநவாரீ
ബബന	பபந
ബബിശ	பபிஶ
ബര്ഹന	பர்ஹந
ബലബീര	பலபீர
ബഹവാസ്യ	பஹவாஸ்ய
ബാബു	பாபு
ബാബുല	பாபுல
ബാല മുകുന്ദ	பால முகுந்த
ബാലധി	பாலதி
ബാലാമോഹന	பாலாமோஹந
ബാലാരാജ	பாலாராஜ
ബാലാശംകര	பாலாஶஂகர
ബാലു	பாலு
ബാലേന്ദു	பாலேந்து
ബാസ്കാര	பாஸ்கார
ബിനീതാ	பிநீதா
ബീനും	பீநுஂ
ബീന്ദുശ്രീ	பீந்துஶ்ரீ
ബീന്നീകേര	பீந்நீகேர
ബീപുല	பீபுல
ബീബീന	பீபீந
ബീരത	பீரத
ബീഹാന	பீஹாந
ബേനീതാ	பேநீதா
ബേനും	பேநுஂ
ബേലുരമീ	பேலுரமீ
ബേല്ലീ	பேல்லீ
ബൈവാവീ	பைவாவீ
ബൈസാഖീ	பைஸாகீ
ബ്രീഥ്ഹീ	ப்ரீத்ஹீ
ബ്ലേസ്സീ	ப்லேஸ்ஸீ
ഭഗവാന	பகவாந
ഭദ്രക്ഷ	பத்ரக்ஷ
ഭദ്രനിധി	பத்ரநிதி
ഭദ്രപ്രിയാ	பத்ரப்ரியா
ഭദ്രിക	பத்ரிக
ഭദ്രീശാ	பத்ரீஶா
ഭവാനീ	பவாநீ
ഭവ്യരാജ	பவ்யராஜ
ഭാഗവംതീ	பாகவஂதீ
ഭാദരന	பாதரந
ഭാനുമിത്ര	பாநுமித்ர
ഭാരഥീ	பாரதீ
ഭാര്ഗവന	பார்கவந
ഭാര്ഗവാ	பார்கவா
ഭാര്ഘവീ	பார்கவீ
ഭാര്ദ്ദ്വാജ	பார்த்த்வாஜ
ഭാലേംദ്ര	பாலேஂத்ர
ഭാവതീ	பாவதீ
ഭാവീഗുരും	பாவீகுருஂ
ഭാവ്യമ	பாவ்யம
ഭാശ്വീനീ	பாஶ்வீநீ
ഭാസു	பாஸு
ഭാസ്കാരീ	பாஸ்காரீ
ഭാസ്കേര	பாஸ்கேர
ഭീമശംകര	பீமஶஂகர
ഭൂദേവ	பூதேவ
ഭൂപത	பூபத
ഭൂപാല	பூபால
ഭൂമാ	பூமா
ഭൂമാം	பூமாஂ
ഭേരേശ	பேரேஶ
ഭൈരവീ	பைரவீ
മംഗലമ	மஂகலம
മംഗേശ	மஂகேஶ
മംജു  പ്രസന്ന	மஂஜு  ப்ரஸந்ந
മംജുനാഥ	மஂஜுநாத
മംജുലാ	மஂஜுலா
മംത	மஂத
മംതോഷ	மஂதோஷ
മംദിഥാ	மஂதிதா
മംദിരാ	மஂதிரா
മകാലീ	மகாலீ
മകുര	மகுர
മഗന	மகந
മണികാംത	மணிகாஂத
മദുരാ	மதுரா
മധുനിഷാ	மதுநிஷா
മധുമാംലീ	மதுமாஂலீ
മധുരിമാ	மதுரிமா
മധുവംതീ	மதுவஂதீ
മനജീത	மநஜீத
മനപ	மநப
മനസ്വിന	மநஸ்விந
മനാല്പ	மநால்ப
മനീതാ	மநீதா
മനീഷ	மநீஷ
മനോജ	மநோஜ
മനോരനജനീ	மநோரநஜநீ
മനോരിഥാ	மநோரிதா
മന്നത	மந்நத
മന്മായീ	மந்மாயீ
മല്ലികാ	மல்லிகா
മഹംത	மஹஂத
മഹാതപസ്വീ	மஹாதபஸ்வீ
മഹാദുര്ഗാ	மஹாதுர்கா
മഹാദേവാ	மஹாதேவா
മഹാദേവാദീപുജീതാ	மஹாதேவாதீபுஜீதா
മഹാന്തേശ	மஹாந்தேஶ
മഹാബാലാ	மஹாபாலா
മഹാസ്വേതാ	மஹாஸ்வேதா
മഹിപതി	மஹிபதி
മഹിഷാസുരമര്ദിനീ	மஹிஷாஸுரமர்திநீ
മഹീജിത	மஹீஜித
മഹേംദ്രാ	மஹேஂத்ரா
മഹേശ	மஹேஶ
മഹേശനീ	மஹேஶநீ
മഹേശീ	மஹேஶீ
മാംതിക	மாஂதிக
മാംനീമോഝ്ഹീ	மாஂநீமோச்ஹீ
മാംനുസരീ	மாஂநுஸரீ
മാംന്ക്ഷ	மாஂந்க்ஷ
മാംന്ഗീരീ	மாஂந்கீரீ
മാംന്താവ്യാഹ	மாஂந்தாவ்யாஹ
മാംന്തീകാ	மாஂந்தீகா
മാംന്ദീതാ	மாஂந்தீதா
മാംലാമാംകാല മകാന	மாஂலாமாஂகால மகாந
മാഇല	மாஇல
മാനകാ	மாநகா
മാനജ	மாநஜ
മാനശ	மாநஶ
മാനിക	மாநிக
മാനീശീന	மாநீஶீந
മാനോരിത	மாநோரித
മാന്കന	மாந்கந
മാന്ദാവിക	மாந்தாவிக
മായാ	மாயா
മാര്ഗശീ	மார்கஶீ
മാര്ഗീ	மார்கீ
മാര്തംദ	மார்தஂத
മാര്ഥീകാ	மார்தீகா
മാര്യ	மார்ய
മാര്യാ	மார்யா
മാര്ഷാ	மார்ஷா
മാലാര്കോഡീ	மாலார்கோடீ
മാലിനീ	மாலிநீ
മാല്ലേശാ	மால்லேஶா
മാസൂമ	மாஸூம
മാസൂമീ	மாஸூமீ
മാഹിയാ	மாஹியா
മാഹിരാജ	மாஹிராஜ
മാഹുലീ	மாஹுலீ
മിലീ	மிலீ
മിഹീകാ	மிஹீகா
മീനാ	மீநா
മേധ	மேத
മേധീനീ	மேதீநீ
മൈത്രായ	மைத்ராய
മൌലീശാ	மௌலீஶா
മ്യ്ഥിലീ	ம்ய்திலீ
യംശ	யஂஶ
യക്ഷ	யக்ஷ
യജും	யஜுஂ
യജുസ	யஜுஸ
യജ്നേശ	யஜ்நேஶ
യഥാര്ഥ	யதார்த
യദുനംദന	யதுநஂதந
യശസ്വിനീ	யஶஸ்விநீ
യശാശ്രീ	யஶாஶ்ரீ
യശ്ദീപ	யஶ்தீப
യശ്മിത	யஶ்மித
യശ്മിതാ	யஶ்மிதா
യശ്വാര്ധാനാ	யஶ்வார்தாநா
യശ്വീന	யஶ்வீந
യശ്വീനീ	யஶ்வீநீ
യസ്വംഥ	யஸ்வஂத
യാക്സീനീ	யாக்ஸீநீ
യാഗ്നാകായാ	யாக்நாகாயா
യാഗ്നീഥാ	யாக்நீதா
യാചന	யாசந
യാതീരാജു	யாதீராஜு
യാദവീ	யாதவீ
യാദവേന്ദ്ര	யாதவேந்த்ர
യാന്തി	யாந்தி
യാശ്രീഥാ	யாஶ்ரீதா
യാഷ്ക	யாஷ்க
യാസസ്വീ	யாஸஸ்வீ
യുഗന്തീകാ	யுகந்தீகா
യുഗപ	யுகப
യുഗാന്ധര	யுகாந்தர
യുതി	யுதி
യുവംശ	யுவஂஶ
യുവനാഥ	யுவநாத
യുവല	யுவல
യുവാഥീ	யுவாதீ
യുവാന  സൂര്യ	யுவாந  ஸூர்ய
യുവ്നീക	யுவ்நீக
യേര്രപ്പാ	யேர்ரப்பா
യേശനാ	யேஶநா
യേശാസ്വീനീ	யேஶாஸ்வீநீ
യേസസരീ	யேஸஸரீ
യോഗദേവാ	யோகதேவா
യോഗരാജ	யோகராஜ
യോഗാനംദ	யோகாநஂத
യോഗിത	யோகித
യോഗിതാ	யோகிதா
യോഗിഥ	யோகித
യോഗേശ്വര	யோகேஶ்வர
യോഗ്ദീപ	யோக்தீப
യോത്ശനാ	யோத்ஶநா
യോനേന്ദ്ര	யோநேந்த்ர
യോഹ്ശീനീ	யோஹ்ஶீநீ
യൌവാനീ	யௌவாநீ
രംഗനാഥ	ரஂகநாத
രംജന	ரஂஜந
രംജികാ	ரஂஜிகா
രംജീവ	ரஂஜீவ
രഈര്ഥ	ரஈர்த
രക്ത	ரக்த
രക്തകമള	ரக்தகமள
രക്ഷികാ	ரக்ஷிகா
രക്ഷിത	ரக்ஷித
രഘവാ	ரகவா
രഘവേന്ദര	ரகவேந்தர
രഘുനാഥ	ரகுநாத
രജത	ரஜத
രജനീശ	ரஜநீஶ
രജനേശ	ரஜநேஶ
രജീത	ரஜீத
രതന	ரதந
രതാംജലി	ரதாஂஜலி
രതീക	ரதீக
രതുല	ரதுல
രത്നാകര	ரத்நாகர
രത്നാബലീ	ரத்நாபலீ
രഥനാ	ரதநா
രന്യ	ரந்ய
രന്വിഥാ	ரந்விதா
രബേക	ரபேக
രമാംസ്വമ്യ	ரமாஂஸ்வம்ய
രമ്ബേശ	ரம்பேஶ
രയാന	ரயாந
രര്ശ്മീതാ	ரர்ஶ்மீதா
രവി കാന്ത	ரவி காந்த
രവികാംത	ரவிகாஂத
രവിത	ரவித
രവീജാ	ரவீஜா
രവീനാ	ரவீநா
രവ്യംകീ	ரவ்யஂகீ
രശീലാ	ரஶீலா
രസവംത	ரஸவஂத
രസ്മീന	ரஸ்மீந
രാഈ കുമാര	ராஈ குமார
രാഖീ	ராகீ
രാഗാവ	ராகாவ
രാഗിനീ	ராகிநீ
രാഗേശ	ராகேஶ
രാഗ്വേദ	ராக்வேத
രാജക	ராஜக
രാജകന്യാ	ராஜகந்யா
രാജഗോപാല	ராஜகோபால
രാജയവര്ദന	ராஜயவர்தந
രാജാ	ராஜா
രാജാര്ശീ	ராஜார்ஶீ
രാജികാ	ராஜிகா
രാജീവ	ராஜீவ
രാജേംദ്രമോഹന	ராஜேஂத்ரமோஹந
രാജേശ്വര	ராஜேஶ்வர
രാജ്യശ്രീ	ராஜ்யஶ்ரீ
രാധാനീ	ராதாநீ
രാനീ	ராநீ
രാമ  കീന്കാര	ராம  கீந்கார
രാമഗോപാല	ராமகோபால
രാമചന്ദ്രന	ராமசந்த்ரந
രാമനാരായണ	ராமநாராயண
രാമരാ	ராமரா
രാമരാജ	ராமராஜ
രാമാംസുഗ്രീവാ	ராமாஂஸுக்ரீவா
രാമാനംദ	ராமாநஂத
രാമാനുജമ	ராமாநுஜம
രാമോജീ	ராமோஜீ
രാഹിത്യ	ராஹித்ய
രാഹീന്യ	ராஹீந்ய
രാഹുലരാജ	ராஹுலராஜ
രിദ്ധി	ரித்தி
രീചികാ	ரீசிகா
രീതൂ	ரீதூ
രീഥേകാ	ரீதேகா
രീദേവ	ரீதேவ
രീധമാം	ரீதமாஂ
രീഭ്യാ	ரீப்யா
രീശും	ரீஶுஂ
രീശ്മേഥാ	ரீஶ்மேதா
രേഖാ	ரேகா
രേത്വിക	ரேத்விக
രേധാ	ரேதா
രേനാ	ரேநா
രേനേശ	ரேநேஶ
രേമാംനീകാ	ரேமாஂநீகா
രേമീ	ரேமீ
രേവാതീ	ரேவாதீ
രേവീഥാ	ரேவீதா
രേശമീ	ரேஶமீ
രേശ്വീന	ரேஶ்வீந
രേഹാംശീ	ரேஹாஂஶீ
രേഹാനാ	ரேஹாநா
രേഹേഈലാ	ரேஹேஈலா
രേഹ്നുഘാ	ரேஹ்நுகா
രൈവത	ரைவத
രൈവതാ	ரைவதா
ലംഗീത	லஂகீத
ലക്ഷ	லக்ஷ
ലക്ഷാകീ	லக்ஷாகீ
ലക്ഷിതാ	லக்ஷிதா
ലക്ഷ്മീകാനതമ	லக்ஷ்மீகாநதம
ലജ്ജാ	லஜ்ஜா
ലജ്ജാകാ	லஜ்ஜாகா
ലതാ	லதா
ലതേശ	லதேஶ
ലവപാല	லவபால
ലവലീന	லவலீந
ലഹരീ	லஹரீ
ലാക്ശേതാ	லாக்ஶேதா
ലാജവംതീ	லாஜவஂதீ
ലാതീശ	லாதீஶ
ലാനീബന	லாநீபந
ലാഭാ	லாபா
ലാമ്ബോധാര	லாம்போதார
ലാരീനാ	லாரீநா
ലാര്മികാ	லார்மிகா
ലാര്രാജ	லார்ராஜ
ലാര്ശന	லார்ஶந
ലാവനീ	லாவநீ
ലാവിനാ	லாவிநா
ലീകേശ	லீகேஶ
ലീത്സാ	லீத்ஸா
ലീനാശാ	லீநாஶா
ലീനീത	லீநீத
ലീപാക്ഷീ	லீபாக்ஷீ
ലീപ്സീകാ	லீப்ஸீகா
ലീമനാ	லீமநா
ലീലാമഈ	லீலாமஈ
ലീശാംത	லீஶாஂத
ലുസിയാ	லுஸியா
ലേഈവീനാ	லேஈவீநா
ലേഖീശാ	லேகீஶா
ലേമാര	லேமார
ലോകനേത്ര	லோகநேத்ர
ലോകാജനാനീ	லோகாஜநாநீ
ലോകാമാത്രീ	லோகாமாத்ரீ
ലോകീഥാ	லோகீதா
ലോകേന്ദ്ര	லோகேந்த்ர
ലോഗീനീ	லோகீநீ
ലോഗേശ്വരണ	லோகேஶ்வரண
ലോചനാ	லோசநா
ലോനാ	லோநா
ലോമാംകേശ	லோமாஂகேஶ
ലോഹിത	லோஹித
ലോഹിതാശ്വാ	லோஹிதாஶ்வா
ലൌക്യ	லௌக்ய
വംദിതാ	வஂதிதா
വംസികൃഷ്ണ	வஂஸிக்ரிஷ்ண
വനദ	வநத
വനമാംഥീ	வநமாஂதீ
വനസ	வநஸ
വനിനാധ	வநிநாத
വന്ജുല	வந்ஜுல
വപുസ	வபுஸ
വയദീശ	வயதீஶ
വരലീ	வரலீ
വരിന	வரிந
വരിയാസ	வரியாஸ
വരുന	வருந
വരുനികാ	வருநிகா
വര്ണിത	வர்ணித
വര്ധമാന	வர்தமாந
വര്ധാനീ	வர்தாநீ
വര്ധീമൈനകാപുജീതാ	வர்தீமைநகாபுஜீதா
വര്നീശാ	வர்நீஶா
വര്ശനേയാ	வர்ஶநேயா
വര്ശീകാ	வர்ஶீகா
വര്ശീതാ	வர்ஶீதா
വര്ശീദ	வர்ஶீத
വര്ഷനീ	வர்ஷநீ
വല്ലികാ	வல்லிகா
വസംതാ	வஸஂதா
വസംതീ	வஸஂதீ
വസീസതാ	வஸீஸதா
വസുമിത്ര	வஸுமித்ர
വസുസേന	வஸுஸேந
വാക്പതി	வாக்பதி
വാക്ഷു	வாக்ஷு
വാച്യ	வாச்ய
വാജ്രക്ഷ	வாஜ்ரக்ஷ
വാതത്മാജ	வாதத்மாஜ
വാത്സല്യ	வாத்ஸல்ய
വാദിവേലും	வாதிவேலுஂ
വാനര	வாநர
വാന്ശുല	வாந்ஶுல
വാമന	வாமந
വാമാംക്ഷീ	வாமாஂக்ஷீ
വാമീല	வாமீல
വാരനാ	வாரநா
വാരുനീ	வாருநீ
വാലാരമാംഥീ	வாலாரமாஂதீ
വാല്ല്മാംനാലന	வால்ல்மாஂநாலந
വാശു	வாஶு
വാസുമന	வாஸுமந
വാഹിനീ	வாஹிநீ
വികീശാ	விகீஶா
വിക്ഷിത	விக்ஷித
വിജയാലക്ഷ്മീ	விஜயாலக்ஷ்மீ
വിജയാശാനഥീ	விஜயாஶாநதீ
വിജീതാ	விஜீதா
വിദിശാ	விதிஶா
വിദ്യാ	வித்யா
വിദ്യുല	வித்யுல
വിധാഥരീ	விதாதரீ
വിന്ധുജാ	விந்துஜா
വിബാലീ	விபாலீ
വിഭാവാ	விபாவா
വിഭൂതി	விபூதி
വിഭൂഷ	விபூஷ
വിയാമര്ശ	வியாமர்ஶ
വിരഗനാപതീ	விரகநாபதீ
വിരഭാദ്രപ്പാ	விரபாத்ரப்பா
വിരാജ	விராஜ
വിലാശീനീ	விலாஶீநீ
വീണാ	வீணா
വീണാധാരീ	வீணாதாரீ
വേക്രാംത	வேக்ராஂத
വേഗ	வேக
വേഗവാഹീനീ	வேகவாஹீநீ
വേഗീ	வேகீ
വേണു	வேணு
വേത്ത്രീ	வேத்த்ரீ
വേത്രിവാല	வேத்ரிவால
വേത്രീവേല	வேத்ரீவேல
വേദകാര്തിക	வேதகார்திக
വേദവല്ലീ	வேதவல்லீ
വേദാ	வேதா
വേദാ ശ്രീ	வேதா ஶ்ரீ
വേധാംത	வேதாஂத
വേന്കാത്രമണ	வேந்காத்ரமண
വേന്തന	வேந்தந
വേന്നേലാ	வேந்நேலா
വേന്മതീ	வேந்மதீ
വേലു	வேலு
വേഹംത	வேஹஂத
വൈകുംഠ	வைகுஂட
വൈജീനാഥ	வைஜீநாத
വൈദത	வைதத
വൈദേഹീ	வைதேஹீ
വൈദ്യുംത	வைத்யுஂத
വൈധേ	வைதே
വൈധ്യാത	வைத்யாத
വൈരാഗ	வைராக
വൈരോചന	வைரோசந
വൈശാലീ	வைஶாலீ
വൈശ്വീ	வைஶ்வீ
വൈഷ്ണവീ	வைஷ்ணவீ
വൈസകാ	வைஸகா
സംക്രാംതി	ஸஂக்ராஂதி
സംഗമിത്ര	ஸஂகமித்ர
സംഗമീധീരാ	ஸஂகமீதீரா
സംചയ	ஸஂசய
സംചീതീ	ஸஂசீதீ
സംജേനാ	ஸஂஜேநா
സംജോലീ	ஸஂஜோலீ
സംതോക	ஸஂதோக
സംദിപോന	ஸஂதிபோந
സംദീപ	ஸஂதீப
സംദേശ	ஸஂதேஶ
സംധരാ	ஸஂதரா
സംധ്യാ	ஸஂத்யா
സംബീതാ	ஸஂபீதா
സംമീതാ	ஸஂமீதா
സംയുക്ത	ஸஂயுக்த
സംവിധാ	ஸஂவிதா
സംവീഥാ	ஸஂவீதா
സംസ്കൃതി	ஸஂஸ்க்ரிதி
സംഹിത	ஸஂஹித
സക്ശീന്യാ	ஸக்ஶீந்யா
സഖ്യാ	ஸக்யா
സഗന	ஸகந
സഗുനാ	ஸகுநா
സചിതാ	ஸசிதா
സചിദാനംദ വിഗ്രഹ	ஸசிதாநஂத விக்ரஹ
സചേതന	ஸசேதந
സച്ചിദാനംദാ	ஸச்சிதாநஂதா
സജീത	ஸஜீத
സജീലീ	ஸஜீலீ
സദഗതി	ஸதகதி
സദഗുനാ	ஸதகுநா
സദാശിവ	ஸதாஶிவ
സദിശ	ஸதிஶ
സപനാ	ஸபநா
സപുഷ്പാ	ஸபுஷ்பா
സപ്താബീ	ஸப்தாபீ
സപ്തോര്ശീ	ஸப்தோர்ஶீ
സമജാ	ஸமஜா
സമദര്ശീ	ஸமதர்ஶீ
സമഭ്ദ്ധാ	ஸமப்த்தா
സമരേശ	ஸமரேஶ
സമാംദ്രിതാ	ஸமாஂத்ரிதா
സമാംര്ധ	ஸமாஂர்த
സമാജസ	ஸமாஜஸ
സമാരാസ്യാ	ஸமாராஸ்யா
സമിക	ஸமிக
സമിരന	ஸமிரந
സമേംദ്ര	ஸமேஂத்ர
സമേശ	ஸமேஶ
സമ്പൂര്ണ	ஸம்பூர்ண
സമ്പ്രഥ്യ	ஸம்ப்ரத்ய
സമ്പ്രീതീ	ஸம்ப்ரீதீ
സമ്രാട	ஸம்ராட
സമ്രീധ	ஸம்ரீத
സരസംഗീ	ஸரஸஂகீ
സലീജ	ஸலீஜ
സഹര്സീതാ	ஸஹர்ஸீதா
സഹശ്രദ	ஸஹஶ்ரத
സഹസ്ത്രജീത	ஸஹஸ்த்ரஜீத
സഹസ്ത്രബാഹു	ஸஹஸ்த்ரபாஹு
സഹീത	ஸஹீத
സഹീരാമ	ஸஹீராம
സഹ്യ	ஸஹ்ய
സാംജ	ஸாஂஜ
സാഇ രാമ	ஸாஇ ராம
സാഈനാഥ	ஸாஈநாத
സാചീ	ஸாசீ
സാജന	ஸாஜந
സാദ്രീശീ	ஸாத்ரீஶீ
സാദ്വിഥാ	ஸாத்விதா
സാധന	ஸாதந
സാധ്യാ	ஸாத்யா
സാനിധ്യ	ஸாநித்ய
സാമംതാ	ஸாமஂதா
സാമ്ഭാ	ஸாம்பா
സാരണീ	ஸாரணீ
സാരഥീ	ஸாரதீ
സാരികാ	ஸாரிகா
സാലവീ	ஸாலவீ
സാലസാ	ஸாலஸா
സൈകത	ஸைகத
സൈനീത്യ	ஸைநீத்ய
സൈന്ധന്യ	ஸைந்தந்ய
സൈലീ	ஸைலீ
സൈഹാര്സന	ஸைஹார்ஸந
ഹംസമാലാ	ஹஂஸமாலா
ഹംസാവാഥ്യ	ஹஂஸாவாத்ய
ഹനാര്വീന	ஹநார்வீந
ഹനീതാ	ஹநீதா
ഹനുപ	ஹநுப
ഹനുമാന	ஹநுமாந
ഹബീതാ	ஹபீதா
ഹമസാദീപികാ	ஹமஸாதீபிகா
ഹമസാനംദീനീ	ஹமஸாநஂதீநீ
ഹമീര	ஹமீர
ഹരജീത	ஹரஜீத
ഹരജീവന	ஹரஜீவந
ഹരനാധ	ஹரநாத
ഹരശും	ஹரஶுஂ
ഹരികിശന	ஹரிகிஶந
ഹരിഗംഗാ	ஹரிகஂகா
ഹരിഗോപാല	ஹரிகோபால
ഹരിദാസ	ஹரிதாஸ
ഹരിദ്വാര	ஹரித்வார
ഹരിപ്രീത	ஹரிப்ரீத
ഹരിമംതീ	ஹரிமஂதீ
ഹരീ	ஹரீ
ഹരേശ്വര	ஹரேஶ்வர
ഹര്മീന	ஹர்மீந
ഹര്ഷണ	ஹர்ஷண
ഹര്സികാ	ஹர்ஸிகா
ഹശ്മീതാ	ஹஶ்மீதா
ഹസമുഖ	ஹஸமுக
ഹസീതാ	ஹஸீதா
ഹസ്വീഥാ	ஹஸ்வீதா
ഹാര്ദീനീ	ஹார்தீநீ
ഹാര്ശീനീ	ஹார்ஶீநீ
ഹാലിക	ஹாலிக
ഹിംഡോള	ஹிஂடோள
ഹിംദോലാ	ஹிஂதோலா
ഹിതാക്ഷീ	ஹிதாக்ஷீ
ഹിതീ	ஹிதீ
ഹിഥീക്സാ	ஹிதீக்ஸா
ഹിമാംശു	ஹிமாஂஶு
ഹിമാക്ഷ	ஹிமாக்ஷ
ഹിമാലയ	ஹிமாலய
ഹിരംയക	ஹிரஂயக
ഹിരവ	ஹிரவ
ഹിരവാ	ஹிரவா
ഹിരുധായാ	ஹிருதாயா
ഹിവാ	ஹிவா
ഹീരാനമാം	ஹீராநமாஂ
ഹീരാന്യാപ്രകാഈ	ஹீராந்யாப்ரகாஈ
ഹീര്നാക്ഷീ	ஹீர்நாக்ஷீ
ഹുവീശ്കാ	ஹுவீஶ்கா
ഹൃദയനാഥ	ஹ்ரிதயநாத
ഹേഈദീ	ஹேஈதீ
ഹേജല	ஹேஜல
ഹേതാ	ஹேதா
ഹേതാശ	ஹேதாஶ
ഹേത്ശ്രീ	ஹேத்ஶ்ரீ
ഹേഥാന്ശ്രീ	ஹேதாந்ஶ்ரீ
ഹേനീത	ஹேநீத
ഹേനീല	ஹேநீல
ഹേമനാഥ	ஹேமநாத
ഹേമലതാ	ஹேமலதா
ഹേമാ	ஹேமா
ഹേമാംദ്രികാ	ஹேமாஂத்ரிகா
ഹേമാഗൌരീ	ஹேமாகௌரீ
ഹേമാനംദ	ஹேமாநஂத
ഹേമാലാ	ஹேமாலா
ഹേമാവതീ	ஹேமாவதீ
ഹേമാവാതിനംദന	ஹேமாவாதிநஂதந
ഹേമേംദു	ஹேமேஂது
ഹേയന	ஹேயந
ഹേയാംശ	ஹேயாஂஶ
ഹേരീത	ஹேரீத
ഹേലീ	ஹேலீ
ഹോന്നേശാ	ஹோந்நேஶா
ഹോമാ	ஹோமா
ഹ്രീത്വിക	ஹ்ரீத்விக
ഹ്രീദാന്ക്ഷ	ஹ்ரீதாந்க்ஷ
ഹ്രീധാന	ஹ்ரீதாந
ഹ്രീശന	ஹ்ரீஶந
ഹ്രീശാംത	ஹ்ரீஶாஂத
ഹ്രീഷിത	ஹ்ரீஷித
ഹ്രുദയ	ஹ்ருதய
ഹ്രുശാല	ஹ்ருஶால
ഹ്രേയാംശ	ஹ்ரேயாஂஶ
ഹ്ര്യ്ദയേശ	ஹ்ர்ய்தயேஶ
#
#
# Territory names from CLDR
അസൻഷൻ ദ്വീപ്	அஸந்ஷந் த்வீப்
അന്റോറ	அந்றோற
യുണൈറ്റഡ് അറബ് എമിറൈറ്റ്‌സ്	யுணைற்றட் அறப் எமிறைற்ற்ஸ்
അഫ്‌ഗാനിസ്ഥാൻ	அப்காநிஸ்தாந்
ആൻറിഗ്വയും ബർബുഡയും	ஆந்றிக்வயுஂ பர்புடயுஂ
ആൻഗ്വില്ല	ஆந்க்வில்ல
അൽബേനിയ	அல்பேநிய
അർമേനിയ	அர்மேநிய
അംഗോള	அஂகோள
അൻറാർട്ടിക്ക	அந்றார்ட்டிக்க
അർജൻറീന	அர்ஜந்றீந
അമേരിക്കൻ സമോവ	அமேரிக்கந் ஸமோவ
ഓസ്ട്രിയ	ஓஸ்ட்ரிய
ഓസ്‌ട്രേലിയ	ஓஸ்ட்ரேலிய
അറൂബ	அறூப
അലൻഡ് ദ്വീപുകൾ	அலந்ட் த்வீபுகள்
അസർബൈജാൻ	அஸர்பைஜாந்
ബോസ്നിയയും ഹെർസഗോവിനയും	போஸ்நியயுஂ ஹெர்ஸகோவிநயுஂ
ബാർബഡോസ്	பார்படோஸ்
ബംഗ്ലാദേശ്	பஂக்லாதேஶ்
ബെൽജിയം	பெல்ஜியஂ
ബുർക്കിനാ ഫാസോ	புர்க்கிநா பாஸோ
ബൾഗേറിയ	பள்கேறிய
ബഹ്റിൻ	பஹ்றிந்
ബറുണ്ടി	பறுண்டி
ബെനിൻ	பெநிந்
സെന്റ് ബാർത്തലമി	ஸெந்ற் பார்த்தலமி
ബർമുഡ	பர்முட
ബ്രൂണൈ	ப்ரூணை
ബൊളീവിയ	பொளீவிய
ബൊണെയ്ർ, സിന്റ് യുസ്റ്റേഷ്യസ്, സാബ എന്നിവ	பொணெய்ர், ஸிந்ற் யுஸ்ற்றேஷ்யஸ், ஸாப எந்நிவ
ബ്രസീൽ	ப்ரஸீல்
ബഹാമാസ്	பஹாமாஸ்
ഭൂട്ടാൻ	பூட்டாந்
ബൗവെട്ട് ദ്വീപ്	பௌவெட்ட் த்வீப்
ബോട്സ്വാന	போட்ஸ்வாந
ബെലറൂസ്	பெலறூஸ்
ബെലീസ്	பெலீஸ்
കാനഡ	காநட
കോക്കസ് (കീലിംഗ്) ദ്വീപുകൾ	கோக்கஸ் (கீலிஂக்) த்வீபுகள்
കോംഗോ - കിൻഷാസ	கோஂகோ - கிந்ஷாஸ
കോംഗോ (DRC)	கோஂகோ (DRC)
സെൻട്രൽ ആഫ്രിക്കൻ റിപ്പബ്ലിക്	ஸெந்ட்ரல் ஆப்ரிக்கந் றிப்பப்லிக்
കോംഗോ - ബ്രാസവില്ലി	கோஂகோ - ப்ராஸவில்லி
കോംഗോ (റിപ്പബ്ലിക്ക്)	கோஂகோ (றிப்பப்லிக்க்)
സ്വിറ്റ്സർലാൻഡ്	ஸ்விற்ற்ஸர்லாந்ட்
കോട്ട് ഡി വാർ	கோட்ட் டி வார்
ഐവറി കോസ്റ്റ്	ஐவறி கோஸ்ற்ற்
കുക്ക് ദ്വീപുകൾ	குக்க் த்வீபுகள்
ചിലി	சிலி
കാമറൂൺ	காமறூண்
ചൈന	சைந
കൊളംബിയ	கொளஂபிய
ക്ലിപ്പെർട്ടൻ ദ്വീപ്	க்லிப்பெர்ட்டந் த்வீப்
കോസ്റ്ററിക്ക	கோஸ்ற்றறிக்க
ക്യൂബ	க்யூப
കേപ്പ് വെർദെ	கேப்ப் வெர்தெ
കുറാകാവോ	குறாகாவோ
ക്രിസ്മസ് ദ്വീപ്	க்ரிஸ்மஸ் த்வீப்
സൈപ്രസ്	ஸைப்ரஸ்
ചെക്ക് റിപ്പബ്ലിക്	செக்க் றிப்பப்லிக்
ജർമനി	ஜர்மநி
ഡീഗോ ഗ്രാഷ്യ	டீகோ க்ராஷ்ய
ദിജിബൗട്ടി	திஜிபௌட்டி
ഡെൻമാർക്ക്	டெந்மார்க்க்
ഡൊമിനിക്ക	டொமிநிக்க
ഡൊമിനിക്കൻ റിപ്പബ്ലിക്	டொமிநிக்கந் றிப்பப்லிக்
അൾജീരിയ	அள்ஜீரிய
സെയൂത്ത ആൻഡ് മെലിയ	ஸெயூத்த ஆந்ட் மெலிய
ഇക്വഡോർ	இக்வடோர்
എസ്റ്റോണിയ	எஸ்ற்றோணிய
ഈജിപ്ത്	ஈஜிப்த்
പശ്ചിമ സഹാറ	பஶ்சிம ஸஹாற
എറിത്രിയ	எறித்ரிய
സ്‌പെയിൻ	ஸ்பெயிந்
എത്യോപ്യ	எத்யோப்ய
യൂറോപ്യൻ യൂണിയൻ	யூறோப்யந் யூணியந்
ഫിൻലാൻഡ്	பிந்லாந்ட்
ഫിജി	பிஜி
ഫാക്ക്‌ലാന്റ് ദ്വീപുകൾ	பாக்க்லாந்ற் த்வீபுகள்
ഫോക്ക്‌ലാൻഡ് ദ്വീപുകൾ (ഐലാസ് മാൽവിനാസ്)	போக்க்லாந்ட் த்வீபுகள் (ஐலாஸ் மால்விநாஸ்)
മൈക്രോനേഷ്യ	மைக்ரோநேஷ்ய
ഫറോ ദ്വീപുകൾ	பறோ த்வீபுகள்
ഫ്രാൻസ്	ப்ராந்ஸ்
ഗാബൺ	காபண்
യുണൈറ്റഡ് കിംഗ്ഡം	யுணைற்றட் கிஂக்டஂ
ഗ്രനേഡ	க்ரநேட
ജോർജ്ജിയ	ஜோர்ஜ்ஜிய
ഫ്രഞ്ച് ഗയാന	ப்ரஞ்ச் கயாந
ഗേൺസി	கேண்ஸி
ഘാന	காந
ജിബ്രാൾട്ടർ	ஜிப்ராள்ட்டர்
ഗ്രീൻലാൻറ്	க்ரீந்லாந்ற்
ഗാംബിയ	காஂபிய
ഗിനിയ	கிநிய
ഗ്വാഡലൂപ്പ്	க்வாடலூப்ப்
ഇക്വറ്റോറിയൽ ഗിനിയ	இக்வற்றோறியல் கிநிய
ഗ്രീസ്	க்ரீஸ்
ദക്ഷിണ ജോർജ്ജിയയും ദക്ഷിണ സാൻഡ്‌വിച്ച് ദ്വീപുകളും	தக்ஷிண ஜோர்ஜ்ஜியயுஂ தக்ஷிண ஸாந்ட்விச்ச் த்வீபுகளுஂ
ഗ്വാട്ടിമാല	க்வாட்டிமால
ഗ്വാം	க்வாஂ
ഗിനിയ-ബിസൗ	கிநிய-பிஸௌ
ഗയാന	கயாந
ഹോങ്കോങ്ങ് (SAR) ചൈന	ஹோங்கோங்ங் (SAR) சைந
ഹോങ്കോങ്ങ്	ஹோங்கோங்ங்
ഹിയേർഡും മക്‌ഡൊണാൾഡ് ദ്വീപുകളും	ஹியேர்டுஂ மக்டொணாள்ட் த்வீபுகளுஂ
ഹോണ്ടുറാസ്	ஹோண்டுறாஸ்
ക്രൊയേഷ്യ	க்ரொயேஷ்ய
ഹെയ്തി	ஹெய்தி
ഹംഗറി	ஹஂகறி
കാനറി ദ്വീപുകൾ	காநறி த்வீபுகள்
ഇന്തോനേഷ്യ	இந்தோநேஷ்ய
അയർലാൻഡ്	அயர்லாந்ட்
ഇസ്രായേൽ	இஸ்ராயேல்
ഐൽ ഓഫ് മാൻ	ஐல் ஓப் மாந்
ഇന്ത്യ	இந்த்ய
ബ്രിട്ടീഷ് ഇന്ത്യൻ മഹാസമുദ്ര പ്രദേശം	ப்ரிட்டீஷ் இந்த்யந் மஹாஸமுத்ர ப்ரதேஶஂ
ഇറാഖ്	இறாக்
ഇറാൻ	இறாந்
ഐസ്‌ലാന്റ്	ஐஸ்லாந்ற்
ഇറ്റലി	இற்றலி
ജേഴ്സി	ஜேழ்ஸி
ജമൈക്ക	ஜமைக்க
ജോർദ്ദാൻ	ஜோர்த்தாந்
ജപ്പാൻ	ஜப்பாந்
കെനിയ	கெநிய
കിർഗിസ്ഥാൻ	கிர்கிஸ்தாந்
കംബോഡിയ	கஂபோடிய
കിരിബാട്ടി	கிரிபாட்டி
കോമൊറോസ്	கோமொறோஸ்
സെന്റ് കിറ്റ്‌സും നെവിസും	ஸெந்ற் கிற்ற்ஸுஂ நெவிஸுஂ
ഉത്തരകൊറിയ	உத்தரகொறிய
ദക്ഷിണകൊറിയ	தக்ஷிணகொறிய
കുവൈറ്റ്	குவைற்ற்
കേമാൻ ദ്വീപുകൾ	கேமாந் த்வீபுகள்
കസാഖിസ്ഥാൻ	கஸாகிஸ்தாந்
ലാവോസ്	லாவோஸ்
ലെബനൻ	லெபநந்
സെൻറ് ലൂസിയ	ஸெந்ற் லூஸிய
ലിച്ചൺസ്റ്റൈൻ	லிச்சண்ஸ்ற்றைந்
ശ്രീലങ്ക	ஶ்ரீலங்க
ലൈബീരിയ	லைபீரிய
ലെസോതോ	லெஸோதோ
ലിത്വാനിയ	லித்வாநிய
ലക്സംബർഗ്	லக்ஸஂபர்க்
ലാറ്റ്വിയ	லாற்ற்விய
ലിബിയ	லிபிய
മൊറോക്കൊ	மொறோக்கொ
മൊണാക്കോ	மொணாக்கோ
മൾഡോവ	மள்டோவ
മോണ്ടെനെഗ്രോ	மோண்டெநெக்ரோ
സെൻറ് മാർട്ടിൻ	ஸெந்ற் மார்ட்டிந்
മഡഗാസ്കർ	மடகாஸ்கர்
മാർഷൽ ദ്വീപുകൾ	மார்ஷல் த்வீபுகள்
മാസിഡോണിയ	மாஸிடோணிய
മാസിഡോണിയ (FYROM)	மாஸிடோணிய (FYROM)
മാലി	மாலி
മ്യാൻമാർ (ബർമ്മ)	ம்யாந்மார் (பர்ம்ம)
മംഗോളിയ	மஂகோளிய
മക്കാവു (SAR) ചൈന	மக்காவு (SAR) சைந
മക്കാവു	மக்காவு
ഉത്തര മറിയാനാ ദ്വീപുകൾ	உத்தர மறியாநா த்வீபுகள்
മാർട്ടിനിക്ക്	மார்ட்டிநிக்க்
മൗറിറ്റാനിയ	மௌறிற்றாநிய
മൊണ്ടെസരത്ത്	மொண்டெஸரத்த்
മാൾട്ട	மாள்ட்ட
മൗറീഷ്യസ്	மௌறீஷ்யஸ்
മാലിദ്വീപ്	மாலித்வீப்
മലാവി	மலாவி
മെക്സിക്കോ	மெக்ஸிக்கோ
മലേഷ്യ	மலேஷ்ய
മൊസാംബിക്ക്	மொஸாஂபிக்க்
നമീബിയ	நமீபிய
പുതിയ കാലിഡോണിയ	புதிய காலிடோணிய
നൈജർ	நைஜர்
നോർഫോക് ദ്വീപ്	நோர்போக் த்வீப்
നൈജീരിയ	நைஜீரிய
നിക്കരാഗ്വ	நிக்கராக்வ
നെതർലാൻഡ്‌സ്	நெதர்லாந்ட்ஸ்
നോർവെ	நோர்வெ
നേപ്പാൾ	நேப்பாள்
നൗറു	நௌறு
ന്യൂയി	ந்யூயி
ന്യൂസിലാൻറ്	ந்யூஸிலாந்ற்
ഒമാൻ	ஒமாந்
പനാമ	பநாம
പെറു	பெறு
ഫ്രഞ്ച് പോളിനേഷ്യ	ப்ரஞ்ச் போளிநேஷ்ய
പാപ്പുവ ന്യൂ ഗിനിയ	பாப்புவ ந்யூ கிநிய
ഫിലിപ്പൈൻസ്	பிலிப்பைந்ஸ்
പാക്കിസ്ഥാൻ	பாக்கிஸ்தாந்
പോളണ്ട്	போளண்ட்
സെന്റ് പിയറിയും മിക്കലണും	ஸெந்ற் பியறியுஂ மிக்கலணுஂ
പിറ്റ്‌കെയ്‌ൻ ദ്വീപുകൾ	பிற்ற்கெய்ந் த்வீபுகள்
പ്യൂർട്ടോ റിക്കോ	ப்யூர்ட்டோ றிக்கோ
പാലസ്‌തീൻ പ്രദേശങ്ങൾ	பாலஸ்தீந் ப்ரதேஶங்ஙள்
പലസ്‌തീൻ	பலஸ்தீந்
പോർച്ചുഗൽ	போர்ச்சுகல்
പലാവു	பலாவு
പരാഗ്വേ	பராக்வே
ഖത്തർ	கத்தர்
ദ്വീപസമൂഹം	த்வீபஸமூஹஂ
റീയൂണിയൻ	றீயூணியந்
റൊമാനിയ	றொமாநிய
സെർബിയ	ஸெர்பிய
റഷ്യ	றஷ்ய
റുവാണ്ട	றுவாண்ட
സൗദി അറേബ്യ	ஸௌதி அறேப்ய
സോളമൻ ദ്വീപുകൾ	ஸோளமந் த்வீபுகள்
സെയ്‌ഷെൽസ്	ஸெய்ஷெல்ஸ்
സുഡാൻ	ஸுடாந்
സ്വീഡൻ	ஸ்வீடந்
സിംഗപ്പുർ	ஸிஂகப்புர்
സെൻറ് ഹെലീന	ஸெந்ற் ஹெலீந
സ്ലോവേനിയ	ஸ்லோவேநிய
സ്വാൽബാഡും ജാൻ മായേനും	ஸ்வால்பாடுஂ ஜாந் மாயேநுஂ
സ്ലോവാക്യ	ஸ்லோவாக்ய
സിയെറ ലിയോൺ	ஸியெற லியோண்
സാൻ മറിനോ	ஸாந் மறிநோ
സെനഗൽ	ஸெநகல்
സോമാലിയ	ஸோமாலிய
സുരിനെയിം	ஸுரிநெயிஂ
ദക്ഷിണ സുഡാൻ	தக்ஷிண ஸுடாந்
സാവോ ടോമും പ്രിൻസിപെയും	ஸாவோ டோமுஂ ப்ரிந்ஸிபெயுஂ
എൽ സാൽവദോർ	எல் ஸால்வதோர்
സിന്റ് മാർട്ടെൻ	ஸிந்ற் மார்ட்டெந்
സിറിയ	ஸிறிய
സ്വാസിലാൻറ്	ஸ்வாஸிலாந்ற்
ട്രസ്റ്റൻ ഡ കൂന	ட்ரஸ்ற்றந் ட கூந
ടർക്ക്‌സും കെയ്‌ക്കോ ദ്വീപുകളും	டர்க்க்ஸுஂ கெய்க்கோ த்வீபுகளுஂ
ഛാഡ്	சாட்
ഫ്രഞ്ച് ദക്ഷിണ ഭൂപ്രദേശം	ப்ரஞ்ச் தக்ஷிண பூப்ரதேஶஂ
ടോഗോ	டோகோ
തായ്‌ലാൻഡ്	தாய்லாந்ட்
താജിക്കിസ്ഥാൻ	தாஜிக்கிஸ்தாந்
ടോക്കെലൂ	டோக்கெலூ
തിമോർ-ലെസ്റ്റെ	திமோர்-லெஸ்ற்றெ
കിഴക്കൻ തിമോർ	கிழக்கந் திமோர்
തുർക്ക്മെനിസ്ഥാൻ	துர்க்க்மெநிஸ்தாந்
ടുണീഷ്യ	டுணீஷ்ய
ടോംഗ	டோஂக
തുർക്കി	துர்க்கி
ട്രിനിഡാഡും ടുബാഗോയും	ட்ரிநிடாடுஂ டுபாகோயுஂ
ടുവാലു	டுவாலு
തായ്‌വാൻ	தாய்வாந்
ടാൻസാനിയ	டாந்ஸாநிய
ഉക്രെയ്‌ൻ	உக்ரெய்ந்
ഉഗാണ്ട	உகாண்ட
അമേരിക്കൻ ഐക്യനാടുകൾ	அமேரிக்கந் ஐக்யநாடுகள்
ഉറുഗ്വേ	உறுக்வே
ഉസ്‌ബെക്കിസ്ഥാൻ	உஸ்பெக்கிஸ்தாந்
വത്തിക്കാൻ	வத்திக்காந்
സെന്റ് വിൻസെന്റും ഗ്രനെഡൈൻസും	ஸெந்ற் விந்ஸெந்றுஂ க்ரநெடைந்ஸுஂ
വെനിസ്വേല	வெநிஸ்வேல
ബ്രിട്ടീഷ് വെർജിൻ ദ്വീപുകൾ	ப்ரிட்டீஷ் வெர்ஜிந் த்வீபுகள்
വിയറ്റ്നാം	வியற்ற்நாஂ
വന്വാതു	வந்வாது
വാലിസ് ആന്റ് ഫ്യൂച്യുന	வாலிஸ் ஆந்ற் ப்யூச்யுந
സമോവ	ஸமோவ
കൊസോവൊ	கொஸோவொ
യെമൻ	யெமந்
മയോട്ടി	மயோட்டி
ദക്ഷിണാഫ്രിക്ക	தக்ஷிணாப்ரிக்க
സാംബിയ	ஸாஂபிய
സിംബാബ്‌വേ	ஸிஂபாப்வே
അജ്ഞാത പ്രദേശം	அஜ்ஞாத ப்ரதேஶஂ
#
#
# Miscellaneous
എഩ്ഩാൽ	என்னால்
പതിറ്റുപ്പത്തു	பதிற்றுப்பத்து
തമിഴ്	தமிழ்
ആലപ്പുഴ	ஆலப்புழ
ദുഃഖം	துஃகஂ
ഊഃ	ஊஃ
ഗൌതമ	கௌதம
ഗൗതമ	கௌதம
ശിവോഽഹം	ஶிவோஹஂ
നിൎവാണം	நிர்வாணஂ
സൂര്യൻ	ஸூர்யந்
ഋഷി	ரிஷி
൦൧൨൩൪൫൬൭൮൯	௦௧௨௩௪௫௬௭௮௯
൰	௰
൱	௱
൲	௲
