# Baby names
അകര്ശാനാ	ಅಕರ್ಶಾನಾ
അക്ശൈനീഏ	ಅಕ್ಶೈನೀಏ
അഗജാ	ಅಗಜಾ
അചിംത	ಅಚಿಂತ
അചിത	ಅಚಿತ
അച്ചിന്ദ്ര	ಅಚ್ಚಿನ್ದ್ರ
അഡ്യാദവൈതാ	ಅಡ್ಯಾದವೈತಾ
അദഭുതഃ	ಅದಭುತಃ
അദേന്യ	ಅದೇನ್ಯ
അദേല	ಅದೇಲ
അദ്രിതീ	ಅದ್ರಿತೀ
അദ്രീഥീ	ಅದ್ರೀಥೀ
അദ്രീമാം	ಅದ್ರೀಮಾಂ
അദ്വൈയാ	ಅದ್ವೈಯಾ
അധര്ഷ	ಅಧರ್ಷ
അധിപാ	ಅಧಿಪಾ
അധീരതാ	ಅಧೀರತಾ
അധ്യുത	ಅಧ್ಯುತ
അനംതാമായാ	ಅನಂತಾಮಾಯಾ
അബരനാ	ಅಬರನಾ
അബിനയ	ಅಬಿನಯ
അബിനാ	ಅಬಿನಾ
അബീനംദാ	ಅಬೀನಂದಾ
അബീശാ	ಅಬೀಶಾ
അഭയ	ಅಭಯ
അഭയന	ಅಭಯನ
അഭിഗ്ന്യാ	ಅಭಿಗ್ನ್ಯಾ
അഭിജീതാ	ಅಭಿಜೀತಾ
അഭിനിവേശ	ಅಭಿನಿವೇಶ
അഭിമ	ಅಭಿಮ
അഭിമാനീ	ಅಭಿಮಾನೀ
അഭിമോദാ	ಅಭಿಮೋದಾ
അഭിരാ	ಅಭಿರಾ
അഭിരാത	ಅಭಿರಾತ
അഭീരല	ಅಭೀರಲ
അഭീശ്രേയ	ಅಭೀಶ್ರೇಯ
അഭീസുമത	ಅಭೀಸುಮತ
അഭ്യപ്സീത	ಅಭ್ಯಪ್ಸೀತ
അഭ്യുദയാ	ಅಭ್ಯುದಯಾ
അമൃതാ	ಅಮೃತಾ
അലകനംദാ	ಅಲಕನಂದಾ
അലക്ഷാ	ಅಲಕ್ಷಾ
അല്കാ	ಅಲ್ಕಾ
അശവ	ಅಶವ
അശ്നേഇല	ಅಶ್ನೇಇಲ
ആകാശലീനാ	ಆಕಾಶಲೀನಾ
ആകൃഥീ	ಆಕೃಥೀ
ആക്ഷ്യാ	ಆಕ್ಷ್ಯಾ
ആചാര്യ	ಆಚಾರ್ಯ
ആത്മയ	ಆತ್ಮಯ
ആദി	ಆದಿ
ആദിമ	ಆದಿಮ
ആദീവ	ಆದೀವ
ആധീരേന	ಆಧೀರೇನ
ആധ്യാ	ಆಧ್ಯಾ
ആനംദീനീ	ಆನಂದೀನೀ
ആനീകാ	ಆನೀಕಾ
ആന്തീകാ	ಆನ್ತೀಕಾ
ആന്വീ	ಆನ್ವೀ
ആപ്ത	ಆಪ್ತ
ആപ്തി	ಆಪ್ತಿ
ആമാംനീ	ಆಮಾಂನೀ
ആമിഷ	ಆಮಿಷ
ആമുക്ഥാ	ಆಮುಕ್ಥಾ
ആയുസ	ಆಯುಸ
ആയോദ	ಆಯೋದ
ആരംഭീ	ಆರಂಭೀ
ആരതീ	ಆರತೀ
ആരസീ	ಆರಸೀ
ആര്യ	ಆರ್ಯ
ആര്യക	ಆರ್ಯಕ
ആര്യനാ	ಆರ್ಯನಾ
ആര്യമാനീ	ಆರ್ಯಮಾನೀ
ആലേഃയാ	ಆಲೇಃಯಾ
ആവംശ	ಆವಂಶ
ആവേശ	ಆವೇಶ
ആശകാ	ಆಶಕಾ
ആശിയാനാ	ಆಶಿಯಾನಾ
ആശുതോഷ	ಆಶುತೋಷ
ആശ്മീന	ಆಶ್ಮೀನ
ആശ്വിത	ಆಶ್ವಿತ
ആസവ	ಆಸವ
ആസ്തിക	ಆಸ್ತಿಕ
ഇക്ശാനാ	ಇಕ್ಶಾನಾ
ഇജയാ	ಇಜಯಾ
ഇനീയന	ಇನೀಯನ
ഇനോദയ	ಇನೋದಯ
ഇന്ദരകാന്ത	ಇನ್ದರಕಾನ್ತ
ഇന്ദിവാരസ	ಇನ್ದಿವಾರಸ
ഇന്ദുശിതാലാ	ಇನ್ದುಶಿತಾಲಾ
ഇന്ദ്രജാ	ಇನ್ದ್ರಜಾ
ഇന്ദ്രതന	ಇನ್ದ್ರತನ
ഇന്ദ്രദയുമ്ന	ಇನ್ದ್ರದಯುಮ್ನ
ഇന്ദ്രവദന	ಇನ್ದ್ರವದನ
ഇന്ദ്രാണീ	ಇನ್ದ್ರಾಣೀ
ഇബ്ബാനീ	ಇಬ್ಬಾನೀ
ഇയുരേശ	ಇಯುರೇಶ
ഇയേനഗര	ಇಯೇನಗರ
ഇരാജ	ಇರಾಜ
ഇരിത	ಇರಿತ
ഇരേശ	ಇರೇಶ
ഇലിസാ	ಇಲಿಸಾ
ഇശിതാ	ಇಶಿತಾ
ഇശ്വാര്യ	ಇಶ್ವಾರ್ಯ
ഇഷ്ടാ	ಇಷ್ಟಾ
ഇഷ്ടി	ಇಷ್ಟಿ
ഇസാര	ಇಸಾರ
ഇസ്ശും	ಇಸ್ಶುಂ
ഈതന	ಈತನ
ഈതികാ	ಈತಿಕಾ
ഈരേന്പ്രിത	ಈರೇನ್ಪ್ರಿತ
ഈര്ശീതാ	ಈರ್ಶೀತಾ
ഈലാക്കീയാ	ಈಲಾಕ್ಕೀಯಾ
ഈലികാ	ಈಲಿಕಾ
ഈലേശാ	ಈಲೇಶಾ
ഈശാര	ಈಶಾರ
ഈശിക	ಈಶಿಕ
ഈശ്വരദത്ത	ಈಶ್ವರದತ್ತ
ഈഹാ	ಈಹಾ
ഉഗ്രസ്രവാസ	ಉಗ್ರಸ್ರವಾಸ
ഉജവണീ	ಉಜವಣೀ
ഉജേശാ	ಉಜೇಶಾ
ഉജ്ജന	ಉಜ್ಜನ
ഉജ്ജവല	ಉಜ್ಜವಲ
ഉജ്ജവാലാ	ಉಜ್ಜವಾಲಾ
ഉജ്ജ്വലാ /ഉജ്വലാ	ಉಜ್ಜ್ವಲಾ /ಉಜ್ವಲಾ
ഉജ്ജ്വാലാ	ಉಜ್ಜ್ವಾಲಾ
ഉത്കര്ഷ	ಉತ್ಕರ್ಷ
ഉത്കലാ	ಉತ್ಕಲಾ
ഉത്തര	ಉತ್ತರ
ഉത്പര	ಉತ್ಪರ
ഉത്സര്ഗ	ಉತ್ಸರ್ಗ
ഉദയ കുമാര	ಉದಯ ಕುಮಾರ
ഉദരഥീ	ಉದರಥೀ
ഉദാന്തികാ	ಉದಾನ್ತಿಕಾ
ഉദേയ	ಉದೇಯ
ഉദ്ധാര	ಉದ್ಧಾರ
ഉദ്യത	ಉದ್ಯತ
ഉദ്യമീ	ಉದ್ಯಮೀ
ഉദ്യോത	ಉದ್ಯೋತ
ഉധവ	ಉಧವ
ഉപംഗ	ಉಪಂಗ
ഉപദാ	ಉಪದಾ
ഉപാധ്രീതീ	ಉಪಾಧ್ರೀತೀ
ഉപ്പാസ	ಉಪ್ಪಾಸ
ഉമാ	ಉಮಾ
ഉമേശ്വര	ಉಮೇಶ್ವರ
ഉരിശിതാ	ಉರಿಶಿತಾ
ഉര്ജാ	ಉರ್ಜಾ
ഉര്ജീകാ	ಉರ್ಜೀಕಾ
ഉര്ജീതാ	ಉರ್ಜೀತಾ
ഉര്ദാഹാവ	ಉರ್ದಾಹಾವ
ഉര്മികാ	ಉರ್ಮಿಕಾ
ഉര്മിമാലാ	ಉರ್ಮಿಮಾಲಾ
ഉര്വീനാഥ	ಉರ್ವೀನಾಥ
ഉല്പേശ	ಉಲ್ಪೇಶ
ഉശേന്യ	ಉಶೇನ್ಯ
ഉഷാശി	ಉಷಾಶಿ
ഉഷ്മാ	ಉಷ್ಮಾ
ഉസരീ	ಉಸರೀ
ഊതരാ	ಊತರಾ
ഊര്വേശ	ಊರ್ವೇಶ
ഏകംശീ	ಏಕಂಶೀ
ഏകക്ഷരപരാ	ಏಕಕ್ಷರಪರಾ
ഏകതന	ಏಕತನ
ഏകതാ	ಏಕತಾ
ഏകാംശ	ಏಕಾಂಶ
ഏകാകാന്യ	ಏಕಾಕಾನ್ಯ
ഏകാനീ	ಏಕಾನೀ
ഏകാപര്നികാ	ಏಕಾಪರ್ನಿಕಾ
ഏകേസ്വാര	ಏಕೇಸ್ವಾರ
ഏത്തന	ಏತ್ತನ
ഏധിത	ಏಧಿತ
ഏമാ	ಏಮಾ
ഏലനാ	ಏಲನಾ
ഏലാ	ಏಲಾ
ഏലീലവേംദന	ಏಲೀಲವೇಂದನ
ഏലീലീ	ಏಲೀಲೀ
ഓഈസീന	ಓಈಸೀನ
ഓജസ്വീ	ಓಜಸ್ವೀ
ഓജാ	ಓಜಾ
ഓജീസ	ಓಜೀಸ
ഓനിശ	ಓನಿಶ
ഓമപ്രകാശ	ಓಮಪ್ರಕಾಶ
ഓവീന	ಓವೀನ
ഓവൈസ	ಓವೈಸ
കംജ	ಕಂಜ
കംജന	ಕಂಜನ
കംഠന	ಕಂಠನ
കംദര്പ	ಕಂದರ್ಪ
കംപനാ	ಕಂಪನಾ
കകോന	ಕಕೋನ
കതകീ	ಕತಕೀ
കതേല്യ്ന	ಕತೇಲ್ಯ್ನ
കനക	ಕನಕ
കനദ	ಕನದ
കനാകംഗീ	ಕನಾಕಂಗೀ
കനീജാ	ಕನೀಜಾ
കനീരാ	ಕನೀರಾ
കനീസാ	ಕನೀಸಾ
കനുഷ	ಕನುಷ
കന്വക	ಕನ್ವಕ
കന്ശീകാ	ಕನ್ಶೀಕಾ
കപാലീന	ಕಪಾಲೀನ
കപിലാശ്വര	ಕಪಿಲಾಶ್ವರ
കമലാപതി	ಕಮಲಾಪತಿ
കമലിനീ	ಕಮಲಿನೀ
കമലേക്ഷണ	ಕಮಲೇಕ್ಷಣ
കമ്നാ	ಕಮ್ನಾ
കരാലാ	ಕರಾಲಾ
കരീസമാം	ಕರೀಸಮಾಂ
കരുനാസ്രീ	ಕರುನಾಸ್ರೀ
കരുപ്പസമ്യ	ಕರುಪ್ಪಸಮ್ಯ
കര്ണ	ಕರ್ಣ
കര്തീഗാ	ಕರ್ತೀಗಾ
കര്മദീപ	ಕರ್ಮದೀಪ
കര്മാശ	ಕರ್ಮಾಶ
കലരനീ	ಕಲರನೀ
കലശ	ಕಲಶ
കലാധര	ಕಲಾಧರ
കലാനിധി	ಕಲಾನಿಧಿ
കലാപരണ	ಕಲಾಪರಣ
കലാപീന	ಕಲಾಪೀನ
കലാപ്രിയാ	ಕಲಾಪ್ರಿಯಾ
കലൈസേലവീ	ಕಲೈಸೇಲವೀ
കവന	ಕವನ
കവിപ  പ്രിയ	ಕವಿಪ  ಪ್ರಿಯ
കവീനാഥ	ಕವೀನಾಥ
കശ്തീ	ಕಶ್ತೀ
കാജല	ಕಾಜಲ
കാജീശ	ಕಾಜೀಶ
കാദമ്ബരീ	ಕಾದಮ್ಬರೀ
കാധിരോലീ	ಕಾಧಿರೋಲೀ
കാനീ	ಕಾನೀ
കാന്ജീരാ	ಕಾನ್ಜೀರಾ
കാന്തീ	ಕಾನ್ತೀ
കാമത	ಕಾಮತ
കാമിഷാ	ಕಾಮಿಷಾ
കാമേശ	ಕಾಮೇಶ
കാരുണ്യ പ്രകാശ	ಕಾರುಣ್ಯ ಪ್ರಕಾಶ
കാരൂകാ	ಕಾರೂಕಾ
കാര്നിക	ಕಾರ್ನಿಕ
കാലിക	ಕಾಲಿಕ
കാലിപദാ	ಕಾಲಿಪದಾ
കാലിയാ	ಕಾಲಿಯಾ
കാലീതാ	ಕಾಲೀತಾ
കാവ്യ ശ്രീ	ಕಾವ್ಯ ಶ್ರೀ
കിന്നേരാ	ಕಿನ್ನೇರಾ
കീഅനാ	ಕೀಅನಾ
കീജല	ಕೀಜಲ
കീനാരീ	ಕೀನಾರೀ
കീന്ചനാ	ಕೀನ್ಚನಾ
കേകലാ	ಕೇಕಲಾ
കേതന	ಕೇತನ
കേനിഷാ	ಕೇನಿಷಾ
കേളവ്യ	ಕೇಳವ್ಯ
കൈരവീ	ಕೈರವೀ
കൈലാശ	ಕೈಲಾಶ
കോശേല	ಕೋಶೇಲ
കൌശികാ	ಕೌಶಿಕಾ
ഖഗേശ	ಖಗೇಶ
ഖമീശ	ಖಮೀಶ
ഖാതീരാവണ	ಖಾತೀರಾವಣ
ഖാത്വന്ഗീന	ಖಾತ್ವನ್ಗೀನ
ഖീലതീ	ಖೀಲತೀ
ഖുസീ	ಖುಸೀ
ഗംഗാ	ಗಂಗಾ
ഗംദേശാ	ಗಂದೇಶಾ
ഗംധാര	ಗಂಧಾರ
ഗംധാരാ	ಗಂಧಾರಾ
ഗംധാലീ	ಗಂಧಾಲೀ
ഗഗന	ಗಗನ
ഗജവദന	ಗಜವದನ
ഗജേന്ദ്ര	ಗಜೇನ್ದ್ರ
ഗണക	ಗಣಕ
ഗണനാ പംഡിതന	ಗಣನಾ ಪಂಡಿತನ
ഗണനാഥ	ಗಣನಾಥ
ഗണ്യാ	ಗಣ್ಯಾ
ഗതി	ಗತಿ
ഗനേസന	ಗನೇಸನ
ഗന്ഗസീരുവന	ಗನ್ಗಸೀರುವನ
ഗയാലികാ	ಗಯಾಲಿಕಾ
ഗരിമാ	ಗರಿಮಾ
ഗരിഷ്ട	ಗರಿಷ್ಟ
ഗരുല	ಗರುಲ
ഗാഇശ	ಗಾಇಶ
ഗാന്ഗമൈന്ദന	ಗಾನ್ಗಮೈನ್ದನ
ഗാമിനീ	ಗಾಮಿನೀ
ഗായത്രീ	ಗಾಯತ್ರೀ
ഗായലേ	ಗಾಯಲೇ
ഗിഅന	ಗಿಅನ
ഗിയാ	ಗಿಯಾ
ഗിരിവര	ಗಿರಿವರ
ഗീതി	ಗೀತಿ
ഗീതീശാ	ಗೀತೀಶಾ
ഗുംജാ	ಗುಂಜಾ
ഗുനാജാ	ಗುನಾಜಾ
ഗുനാരത്നാ	ಗುನಾರತ್ನಾ
ഗുനാശേകാര	ಗುನಾಶೇಕಾರ
ഗുനീന	ಗುನೀನ
ഗുന്ജീതാ	ಗುನ್ಜೀತಾ
ഗുപ്തക	ಗುಪ್ತಕ
ഗുരദയാല	ಗುರದಯಾಲ
ഗുരദേവ	ಗುರದೇವ
ഗുരബാനീ	ಗುರಬಾನೀ
ഗുരമാന	ಗುರಮಾನ
ഗുരുത്തമ	ಗುರುತ್ತಮ
ഗുര്നാന്ഡീശ	ಗುರ್ನಾನ್ಡೀಶ
ഗുലമോഹര	ಗುಲಮೋಹರ
ഗുവീദ	ಗುವೀದ
ഗൂംജീതാ	ಗೂಂಜೀತಾ
ഗൂഹാരീ	ಗೂಹಾರೀ
ഗേനേലിയാ	ಗೇನೇಲಿಯಾ
ഗേശനാ	ಗೇಶನಾ
ഗോപാല	ಗೋಪಾಲ
ഗോപീ നാഥ	ಗೋಪೀ ನಾಥ
ഗോഭില	ಗೋಭಿಲ
ഗോരഖ-നാഥ	ಗೋರಖ-ನಾಥ
ഗൌരവീ	ಗೌರವೀ
ഗൌരീകാംത	ಗೌರೀಕಾಂತ
ഗൌരീശ	ಗೌರೀಶ
ഗൌര്പ്രിയാ	ಗೌರ್ಪ್ರಿಯಾ
ഗ്രീതേശ	ಗ್ರೀತೇಶ
ഗ്രീവാ	ಗ್ರೀವಾ
ഗ്രീശ്മീതാ	ಗ್ರೀಶ್ಮೀತಾ
ഗ്രീഷ്മ	ಗ್ರೀಷ್ಮ
ഘടോതകത്ചാ	ಘಟೋತಕತ್ಚಾ
ചംചലാ	ಚಂಚಲಾ
ചംദേര്ഭാന	ಚಂದೇರ್ಭಾನ
ചംദ്രകാംത	ಚಂದ್ರಕಾಂತ
ചംദ്രകാംതാ	ಚಂದ್ರಕಾಂತಾ
ചംദ്രചുര	ಚಂದ್ರಚುರ
ചംദ്രപുശ്പാ	ಚಂದ್ರಪುಶ್ಪಾ
ചംദ്രപ്രകാശ	ಚಂದ್ರಪ್ರಕಾಶ
ചംദ്രമതി	ಚಂದ್ರಮತಿ
ചംദ്രലേഖാ	ಚಂದ್ರಲೇಖಾ
ചംദ്രഹാസ	ಚಂದ್ರಹಾಸ
ചംദ്രാനന	ಚಂದ್ರಾನನ
ചംദ്രാഭാ	ಚಂದ್ರಾಭಾ
ചംദ്രേശ	ಚಂದ್ರೇಶ
ചകേശ	ಚಕೇಶ
ചകോര	ಚಕೋರ
ചക്ഷസ	ಚಕ್ಷಸ
ചതുര	ಚತುರ
ചതുരാ	ಚತುರಾ
ചതുര്ഭുജാ	ಚತುರ್ಭುಜಾ
ചതുര്വേദീ	ಚತುರ್ವೇದೀ
ചത്രീയാ	ಚತ್ರೀಯಾ
ചന്ദ്രകേതു	ಚನ್ದ್ರಕೇತು
ചരണ	ಚರಣ
ചരന്യാ	ಚರನ್ಯಾ
ചലാമാ	ಚಲಾಮಾ
ചാംദ	ಚಾಂದ
ചാനാസ്യാ	ಚಾನಾಸ್ಯಾ
ചാനേ	ಚಾನೇ
ചാന്ദനികാ	ಚಾನ್ದನಿಕಾ
ചാരുന	ಚಾರುನ
ചാരുവീ	ಚಾರುವೀ
ചാര്മീ	ಚಾರ್ಮೀ
ചാര്വീ	ಚಾರ್ವೀ
ചാവ്രിക	ಚಾವ್ರಿಕ
ചിത്കലാ	ಚಿತ್ಕಲಾ
ചിത്ത	ಚಿತ್ತ
ചിത്തപ്രസാദ	ಚಿತ್ತಪ್ರಸಾದ
ചിത്തരംജന	ಚಿತ್ತರಂಜನ
ചിത്തരംജനീ	ಚಿತ್ತರಂಜನೀ
ചിത്രകുന്ധാലാ	ಚಿತ್ರಕುನ್ಧಾಲಾ
ചിത്രകേതു	ಚಿತ್ರಕೇತು
ചിത്രഗംധാ	ಚಿತ್ರಗಂಧಾ
ചിത്രബാനാ	ಚಿತ್ರಬಾನಾ
ചിത്രമാലാ	ಚಿತ್ರಮಾಲಾ
ചിത്രര്ത	ಚಿತ್ರರ್ತ
ചിത്രല	ಚಿತ್ರಲ
ചിത്രലേഖാ	ಚಿತ್ರಲೇಖಾ
ചിത്രാദീപ	ಚಿತ್ರಾದೀಪ
ചിത്രീനീ	ಚಿತ್ರೀನೀ
ചിദംബര	ಚಿದಂಬರ
ചിദാനംദാ	ಚಿದಾನಂದಾ
ചിനാര	ಚಿನಾರ
ചിന്നാദുരാഈ	ಚಿನ್ನಾದುರಾಈ
ചിമന	ಚಿಮನ
ചീദാര്ത	ಚೀದಾರ್ತ
ചീന്മയേ	ಚೀನ್ಮಯೇ
ചീരുഷ	ಚೀರುಷ
ചേതന്ദീപ	ಚೇತನ್ದೀಪ
ചേതള	ಚೇತಳ
ചേഥാസാ	ಚೇಥಾಸಾ
ചേമ്മല	ಚೇಮ್ಮಲ
ചേര്വിക	ಚೇರ್ವಿಕ
ചേലന	ಚೇಲನ
ചേലിയാഁ	ಚೇಲಿಯಾഁ
ചൈതന്യാ	ಚೈತನ್ಯಾ
ചൈത്രാ	ಚೈತ್ರಾ
ചൈരാവലീ	ಚೈರಾವಲೀ
ഛായാംക	ಛಾಯಾಂಕ
ജക്ഷ	ಜಕ್ಷ
ജക്ഷാനീ	ಜಕ್ಷಾನೀ
ജഗതപ്രകാശ	ಜಗತಪ್ರಕಾಶ
ജഗദഗുരു	ಜಗದಗುರು
ജഗദമ്ബാ	ಜಗದಮ್ಬಾ
ജഗനമോഹിനീ	ಜಗನಮೋಹಿನೀ
ജഗന്മയീ	ಜಗನ್ಮಯೀ
ജഗ്വീ	ಜಗ್ವೀ
ജഗ്വീര	ಜಗ್ವೀರ
ജജ്വാല്യാ	ಜಜ್ವಾಲ್ಯಾ
ജടായു	ಜಟಾಯು
ജനഹിതാ	ಜನಹಿತಾ
ജനാദേവ	ಜನಾದೇವ
ജനാവ	ಜನಾವ
ജനിത	ಜನಿತ
ജമാംദാഗ്ന്യ മഹാദാര്പാ	ಜಮಾಂದಾಗ್ನ್ಯ ಮಹಾದಾರ್ಪಾ
ജമ്ബവതപ്രീതി	ಜಮ್ಬವತಪ್ರೀತಿ
ജയംത	ಜಯಂತ
ജയചംദ	ಜಯಚಂದ
ജയപാല	ಜಯಪಾಲ
ജയമാലാ	ಜಯಮಾಲಾ
ജയശ്രീ	ಜಯಶ್ರೀ
ജയാകീര്തന	ಜಯಾಕೀರ್ತನ
ജയാകേതന	ಜಯಾಕೇತನ
ജയാപാദമാം	ಜಯಾಪಾದಮಾಂ
ജയായ	ಜಯಾಯ
ജയിത	ಜಯಿತ
ജയേശ	ಜಯೇಶ
ജലദ	ಜಲದ
ജല്പേശ	ಜಲ್ಪೇಶ
ജശവംത	ಜಶವಂತ
ജസീത്താ	ಜಸೀತ್ತಾ
ജസ്സീ	ಜಸ್ಸೀ
ജാനകീ	ಜಾನಕೀ
ജാനകീദാസ	ಜಾನಕೀದಾಸ
ജാനകീനാഥ	ಜಾನಕೀನಾಥ
ജാനകീഭൂഷണ	ಜಾನಕೀಭೂಷಣ
ജാനഹിതാ	ಜಾನಹಿತಾ
ജാപക	ಜಾಪಕ
ജായിത്രീ	ಜಾಯಿತ್ರೀ
ജിനേശ്വര	ಜಿನೇಶ್ವರ
ജിഹാന	ಜಿಹಾನ
ജീതേശ	ಜೀತೇಶ
ജീന്ദാല	ಜೀನ್ದಾಲ
ജീവനകലാ	ಜೀವನಕಲಾ
ജീവനീ	ಜೀವನೀ
ജീവന്തീനീ	ಜೀವನ್ತೀನೀ
ജുഷ്ടി	ಜುಷ್ಟಿ
ജേനീശാ	ಜೇನೀಶಾ
ജേര്ശീകാ	ಜೇರ್ಶೀಕಾ
ജൈകാപിശ	ಜೈಕಾಪಿಶ
ജൈചരണ	ಜೈಚರಣ
ജൈനീശ	ಜೈನೀಶ
ജൈപ്രകാശ	ಜೈಪ್ರಕಾಶ
ജൈവംത	ಜೈವಂತ
ജൈസല	ಜೈಸಲ
ജൈഹാസീനീ	ಜೈಹಾಸೀನೀ
ജോംഫീ	ಜೋಂಫೀ
ജോശനീകാ	ಜೋಶನೀಕಾ
ജോശീതാ	ಜೋಶೀತಾ
ജ്വാലാ	ಜ್ವಾಲಾ
ജ്ഹില	ಜ್ಹಿಲ
ജ്ഹീണൂക	ಜ್ಹೀಣೂಕ
ഝഹനവീ	ಝಹನವೀ
ഝാനീശാ	ಝಾನೀಶಾ
ഝാരാ	ಝಾರಾ
ഝീയാ	ಝೀಯಾ
ഝേനീശാ	ಝೇನೀಶಾ
ഝ്യാനനീ	ಝ್ಯಾನನೀ
ടീംകു	ಟೀಂಕು
ഠുമരീ	ಠುಮರೀ
തക്ശീ	ತಕ್ಶೀ
തക്ശീല	ತಕ್ಶೀಲ
തജജ്ഞ	ತಜಜ್ಞ
തനവീ	ತನವೀ
തനിഷ്ക	ತನಿಷ್ಕ
തനുംജാശ്രീ	ತನುಂಜಾಶ್ರೀ
തനുംശ്കാ	ತನುಂಶ್ಕಾ
തനോജ	ತನೋಜ
തപസ	ತಪಸ
തപസ്വിനീ	ತಪಸ್ವಿನೀ
തമില  സേല്വീ	ತಮಿಲ  ಸೇಲ್ವೀ
തമിശ	ತಮಿಶ
തമോഘ്നാ	ತಮೋಘ್ನಾ
തമോനഷ	ತಮೋನಷ
തരംജോത	ತರಂಜೋತ
തരനീ	ತರನೀ
തരലാ	ತರಲಾ
തരീനീ	ತರೀನೀ
തരുശ്രീ	ತರುಶ್ರೀ
തരൂണീ	ತರೂಣೀ
തവലീന :	ತವಲೀನ :
തവിഷാ	ತವಿಷಾ
തസ്യ	ತಸ್ಯ
താക്ഷ്യാ	ತಾಕ್ಷ್ಯಾ
താജേന്ദര	ತಾಜೇನ್ದರ
താനാരുപീ	ತಾನಾರುಪೀ
താനിയാ	ತಾನಿಯಾ
താന്വീഥാ	ತಾನ್ವೀಥಾ
താപീ	ತಾಪೀ
താരികാ	ತಾರಿಕಾ
താരീനീ	ತಾರೀನೀ
താരൂശ	ತಾರೂಶ
താലംക	ತಾಲಂಕ
താലീന	ತಾಲೀನ
താലേശ	ತಾಲೇಶ
താവന	ತಾವನ
താവീശാ	ತಾವೀಶಾ
തിതലീ	ತಿತಲೀ
തിനാശ	ತಿನಾಶ
തിലക	ತಿಲಕ
തീഈവ്യേശ	ತೀಈವ್ಯೇಶ
തീര്ഥാ	ತೀರ್ಥಾ
തീസ്ചാ	ತೀಸ್ಚಾ
തുത്തീ	ತುತ್ತೀ
തുനാവാ	ತುನಾವಾ
തുന്ഗാര	ತುನ್ಗಾರ
തുപമ	ತುಪಮ
തുരഗ	ತುರಗ
തുശീഥാ	ತುಶೀಥಾ
തൃപേശ	ತೃಪೇಶ
തേജസ	ತೇಜಸ
തേജസ്വീ	ತೇಜಸ್ವೀ
തേജസ്വീന	ತೇಜಸ್ವೀನ
തേജേനദര	ತೇಜೇನದರ
തേജോമയ	ತೇಜೋಮಯ
തോയേശ	ತೋಯೇಶ
തോശീകാ	ತೋಶೀಕಾ
തൌരുസ	ತೌರುಸ
ത്രികായാ	ತ್ರಿಕಾಯಾ
ത്രിപുരസുംദരീ	ತ್ರಿಪುರಸುಂದರೀ
ത്രിഭുവന	ತ್ರಿಭುವನ
ത്രിമാന	ತ್ರಿಮಾನ
ത്രിമൂര്തി	ತ್ರಿಮೂರ್ತಿ
ത്രിവേണീ	ತ್ರಿವೇಣೀ
ത്രിശല	ತ್ರಿಶಲ
ത്രിശലാനാ	ತ್ರಿಶಲಾನಾ
ത്രീഝ്യാ	ತ್ರೀಝ್ಯಾ
ത്രീതിയാ	ತ್ರೀತಿಯಾ
ത്രീനേശ	ತ್ರೀನೇಶ
ത്രീപന	ತ್ರೀಪನ
ത്രീപ്ത	ತ್ರೀಪ್ತ
ത്രീവീദ	ತ್ರೀವೀದ
ത്വരിതാ	ತ್ವರಿತಾ
ത്വീശീ	ತ್ವೀಶೀ
ത്വേസാ	ತ್ವೇಸಾ
ഥംസീ	ಥಂಸೀ
ഥനീരികാ	ಥನೀರಿಕಾ
ഥാകാപ്പന്സ്വാമീ	ಥಾಕಾಪ್ಪನ್ಸ್ವಾಮೀ
ഥാരികാ	ಥಾರಿಕಾ
ഥാവനീ	ಥಾವನೀ
ഥീരീശ്കാ	ಥೀರೀಶ್ಕಾ
ഥുസീഥാ	ಥುಸೀಥಾ
ഥ്രേശാ	ಥ್ರೇಶಾ
ദംദാപാനീ	ದಂದಾಪಾನೀ
ദക്ഷാഹതാ	ದಕ್ಷಾಹತಾ
ദബീത	ದಬೀತ
ദബ്ന്ശും	ದಬ್ನ್ಶುಂ
ദയാദാ	ದಯಾದಾ
ദയാനിതാ	ದಯಾನಿತಾ
ദരഹാസ	ದರಹಾಸ
ദര്ശ	ದರ್ಶ
ദര്ശക	ದರ್ಶಕ
ദര്ശികാ	ದರ್ಶಿಕಾ
ദര്ശീനീ	ದರ್ಶೀನೀ
ദര്സീകാ	ದರ್ಸೀಕಾ
ദശാഗ്രീവാ ശീരോഹരാ	ದಶಾಗ್ರೀವಾ ಶೀರೋಹರಾ
ദശാഗ്രീവാകുലാന്താകാ	ದಶಾಗ್ರೀವಾಕುಲಾನ್ತಾಕಾ
ദശാനന	ದಶಾನನ
ദഹാ	ದಹಾ
ദാനാസ്വീ	ದಾನಾಸ್ವೀ
ദാനുംശ്രീ	ದಾನುಂಶ್ರೀ
ദാന്ദാകാരാന്യ പുന്യകൃതേ	ದಾನ್ದಾಕಾರಾನ್ಯ ಪುನ್ಯಕೃತೇ
ദാരുല	ದಾರುಲ
ദാഹക	ದಾಹಕ
ദികീശംദ	ದಿಕೀಶಂದ
ദിഗീശാ	ದಿಗೀಶಾ
ദിപംശീ	ದಿಪಂಶೀ
ദിപശീകീ	ದಿಪಶೀಕೀ
ദിപേംദര	ದಿಪೇಂದರ
ദിപ്താ	ದಿಪ್ತಾ
ദിബസരീ	ದಿಬಸರೀ
ദിവീഥാ	ದಿವೀಥಾ
ദിവേനാ	ದಿವೇನಾ
ദീതാ	ದೀತಾ
ദീനബംധു	ದೀನಬಂಧು
ദീപഥീ	ದೀಪಥೀ
ദീപപ്രഭാ	ದೀಪಪ್ರಭಾ
ദീപമാലാ	ದೀಪಮಾಲಾ
ദീപശിഖാ	ದೀಪಶಿಖಾ
ദീപാംജലി	ದೀಪಾಂಜಲಿ
ദീപാശാ	ದೀಪಾಶಾ
ദീപിത	ದೀಪಿತ
ദീവാംശ	ದೀವಾಂಶ
ദേജ	ದೇಜ
ദേബജ്യോതീ	ದೇಬಜ್ಯೋತೀ
ദേബദാത്താ	ದೇಬದಾತ್ತಾ
ദേബദ്രിതാ	ದೇಬದ್ರಿತಾ
ദേബന്ശീ	ದೇಬನ್ಶೀ
ദേയ്വയാനാകാന്തന	ದೇಯ್ವಯಾನಾಕಾನ್ತನ
ദേവഗര്ഭാ	ದೇವಗರ್ಭಾ
ദേവജ്യോതി	ದೇವಜ್ಯೋತಿ
ദേവദാന	ದೇವದಾನ
ദേവന്ദ്ര	ದೇವನ್ದ್ರ
ദേവമദാനാ	ದೇವಮದಾನಾ
ദേവരാജ	ದೇವರಾಜ
ദേവശ്രീ	ದೇವಶ್ರೀ
ദേവാംഗനാ	ದೇವಾಂಗನಾ
ദേവാംഗീ	ದೇವಾಂಗೀ
ദേവാംശു	ದೇವಾಂಶು
ദേവാദീത്യാ	ದೇವಾದೀತ್ಯಾ
ദേവാനീ	ದೇವಾನೀ
ദേവാന്ശാ	ದೇವಾನ್ಶಾ
ദേവാപ്രിയാ	ದೇವಾಪ್ರಿಯಾ
ദേവാമനോഹാരീ	ದೇವಾಮನೋಹಾರೀ
ദേവീന	ದೇವೀನ
ദേവീലാല	ದೇವೀಲಾಲ
ദേവേന	ದೇವೇನ
ദേവേശീ	ದೇವೇಶೀ
ദേവ്യഹ്നാന	ದೇವ್ಯಹ್ನಾನ
ദേശാവംത	ದೇಶಾವಂತ
ദൈത്യാകുലാന്താകാ	ದೈತ್ಯಾಕುಲಾನ್ತಾಕಾ
ദൈവ്യാ	ದೈವ್ಯಾ
ധക്ശീന്യ	ಧಕ್ಶೀನ್ಯ
ധനസുഖ	ಧನಸುಖ
ധനാജീ	ಧನಾಜೀ
ധനിഷ്ഠ	ಧನಿಷ್ಠ
ധനു	ಧನು
ധനുജാ	ಧನುಜಾ
ധനേശീ	ಧನೇಶೀ
ധന്വികാ	ಧನ್ವಿಕಾ
ധരമനിഷ്ഠ	ಧರಮನಿಷ್ಠ
ധരാമാം	ಧರಾಮಾಂ
ധരാഹാസീനീ	ಧರಾಹಾಸೀನೀ
ധരീശ	ಧರೀಶ
ധര്മ  ദുത്ത	ಧರ್ಮ  ದುತ್ತ
ധര്മഅധ്യക്ഷ	ಧರ್ಮಅಧ್ಯಕ್ಷ
ധര്മദിത്യ	ಧರ್ಮದಿತ್ಯ
ധര്മദേവ	ಧರ್ಮದೇವ
ധര്ശീതാ	ಧರ್ಶೀತಾ
ധര്ശീനീ	ಧರ್ಶೀನೀ
ധാമീനീ	ಧಾಮೀನೀ
ധാരാനീ	ಧಾರಾನೀ
ധിതി	ಧಿತಿ
ധിതീ	ಧಿತೀ
ധീപ്ത്ഹാ	ಧೀಪ್ತ್ಹಾ
ധീമാഹീ	ಧೀಮಾಹೀ
ധീര്ഥാ	ಧೀರ್ಥಾ
ധേയാംശീ	ಧೇಯಾಂಶೀ
ധൈര്യ്യാ	ಧೈರ್ಯ್ಯಾ
ധ്യുഥീ	ಧ್ಯುಥೀ
ധ്രുമീ	ಧ್ರುಮೀ
നംദക	ನಂದಕ
നംദു	ನಂದು
നക്ശ	ನಕ್ಶ
നക്സത്രരാജാ	ನಕ್ಸತ್ರರಾಜಾ
നഗമാനീ	ನಗಮಾನೀ
നടവര	ನಟವರ
നത്രീശാ	ನತ್ರೀಶಾ
നദീപ	ನದೀಪ
നഭാ	ನಭಾ
നഭോമാനീ	ನಭೋಮಾನೀ
നമന	ನಮನ
നമനാ	ನಮನಾ
നയന	ನಯನ
നരേന്ദ്രന	ನರೇನ್ದ್ರನ
നരേന്ദ്രനാഥ	ನರೇನ್ದ್ರನಾಥ
നരേശ	ನರೇಶ
നവനീത വിലീപ്തംഗാ	ನವನೀತ ವಿಲೀಪ್ತಂಗಾ
നവമ	ನವಮ
നവരംഗ	ನವರಂಗ
നസീബ	ನಸೀಬ
നാംബീ	ನಾಂಬೀ
നാഗനാഥ	ನಾಗನಾಥ
നാഗപാല	ನಾಗಪಾಲ
നാഗേശ്വരണ	ನಾಗೇಶ್ವರಣ
നാഗൈഃ	ನಾಗೈಃ
നാതാഭൈരവീ	ನಾತಾಭೈರವೀ
നാതിന	ನಾತಿನ
നാന്ധീനീ	ನಾನ್ಧೀನೀ
നാന്നാന	ನಾನ್ನಾನ
നാഭിതാ	ನಾಭಿತಾ
നാഭേംദു	ನಾಭೇಂದು
നാമത	ನಾಮತ
നായകീ	ನಾಯಕೀ
നായാനീ	ನಾಯಾನೀ
നായാനീകാ	ನಾಯಾನೀಕಾ
നാലിനികാംത	ನಾಲಿನಿಕಾಂತ
നാലീനേശയ	ನಾಲೀನೇಶಯ
നാവീന്യ	ನಾವೀನ್ಯ
നാവീല	ನಾವೀಲ
നാവ്യാ ദുര്ഗാ	ನಾವ್ಯಾ ದುರ್ಗಾ
നാവ്രീതാ	ನಾವ್ರೀತಾ
നികാരാ	ನಿಕಾರಾ
നിഖിതാ	ನಿಖಿತಾ
നിഖില	ನಿಖಿಲ
നിജു	ನಿಜು
നിധി	ನಿಧಿ
നിധിപാ	ನಿಧಿಪಾ
നിപാ	ನಿಪಾ
നിരംജനാ	ನಿರಂಜನಾ
നിരമഈ	ನಿರಮಈ
നിരുപമാ	ನಿರುಪಮಾ
നിര്മളാ	ನಿರ್ಮಳಾ
നിര്മിതി	ನಿರ್ಮಿತಿ
നിലാശാ	ನಿಲಾಶಾ
നിശാനഥീ	ನಿಶಾನಥೀ
നീഗീഥാ	ನೀಗೀಥಾ
നീതു	ನೀತು
നീഥീകാ	ನೀಥೀಕಾ
നീധാ	ನೀಧಾ
നീധാര്സനാ	ನೀಧಾರ್ಸನಾ
നീമാംലന	ನೀಮಾಂಲನ
നീരാലികാ	ನೀರಾಲಿಕಾ
നീരൈമാംഥീ	ನೀರೈಮಾಂಥೀ
നീര്മുകതാ	ನೀರ್ಮುಕತಾ
നീല മാധവ	ನೀಲ ಮಾಧವ
നീലംജന	ನೀಲಂಜನ
നീലക്ഷ	ನೀಲಕ್ಷ
നീല്ജാ	ನೀಲ್ಜಾ
നീശാലീ	ನೀಶಾಲೀ
നീശീതീ	ನೀಶೀತೀ
നീശ്മീഥാ	ನೀಶ್ಮೀಥಾ
നീസ്ചീഥാ	ನೀಸ್ಚೀಥಾ
നീഹാ	ನೀಹಾ
നേമീശാ	ನೇಮೀಶಾ
നേയ്സാ	ನೇಯ್ಸಾ
നേരീശാ	ನೇರೀಶಾ
നൈജാ	ನೈಜಾ
നൈരീതീ	ನೈರೀತೀ
നൈവേധീ	ನೈವೇಧೀ
നൌസദ	ನೌಸದ
പംകജന	ಪಂಕಜನ
പംചഭൂതാത്മികാ	ಪಂಚಭೂತಾತ್ಮಿಕಾ
പംഥീനീ	ಪಂಥೀನೀ
പഝ്ഹേനീ	ಪಝ್ಹೇನೀ
പത്താമ്ബരാപരീധാനാ	ಪತ್ತಾಮ್ಬರಾಪರೀಧಾನಾ
പത്ര	ಪತ್ರ
പന്ദാലാവാസന	ಪನ್ದಾಲಾವಾಸನ
പമ്പാ	ಪಮ್ಪಾ
പമ്ഫാ	ಪಮ್ಫಾ
പയാസ	ಪಯಾಸ
പയോധീ	ಪಯೋಧೀ
പരംതാപാ	ಪರಂತಾಪಾ
പരമാംത്മികാ	ಪರಮಾಂತ್ಮಿಕಾ
പരമാംന്ത്ര	ಪರಮಾಂನ್ತ್ರ
പരമിലാ	ಪರಮಿಲಾ
പരമേശ്വരീ	ಪರಮೇಶ್ವರೀ
പരമ്വാര്ദാന	ಪರಮ್ವಾರ್ದಾನ
പരവാനീ	ಪರವಾನೀ
പരവിംദര	ಪರವಿಂದರ
പരാകാഷ	ಪರಾಕಾಷ
പരാവീ	ಪರಾವೀ
പരിഹാ	ಪರಿಹಾ
പര്തീബന	ಪರ್ತೀಬನ
പര്ലീ	ಪರ್ಲೀ
പര്വ	ಪರ್ವ
പലാക്ഷ	ಪಲಾಕ್ಷ
പലാശീനീ	ಪಲಾಶೀನೀ
പവന	ಪವನ
പവനസുത	ಪವನಸುತ
പശുപതി	ಪಶುಪತಿ
പഹലാജ	ಪಹಲಾಜ
പാടലാ	ಪಾಟಲಾ
പാന്ദുരംഗാ	ಪಾನ್ದುರಂಗಾ
പായല	ಪಾಯಲ
പാരു	ಪಾರು
പാര്ഥിക	ಪಾರ್ಥಿಕ
പാര്ഥീവീ	ಪಾರ್ಥೀವೀ
പാര്ഥോ	ಪಾರ್ಥೋ
പാളവീ	ಪಾಳವೀ
പാവകീ	ಪಾವಕೀ
പാവനാ	ಪಾವನಾ
പാവാനാ	ಪಾವಾನಾ
പാഹീ	ಪಾಹೀ
പിവാല	ಪಿವಾಲ
പൂജന	ಪೂಜನ
പൂരതീ	ಪೂರತೀ
പൂരികാ	ಪೂರಿಕಾ
പൂര്വജാ	ಪೂರ್ವಜಾ
പൂര്വികാ	ಪೂರ್ವಿಕಾ
പേഖമ	ಪೇಖಮ
പേത്ചീ	ಪೇತ್ಚೀ
പേരാരസീ	ಪೇರಾರಸೀ
പ്രകൃഥീ	ಪ್ರಕೃಥೀ
പ്രഗന്യാ	ಪ್ರಗನ್ಯಾ
പ്രഗ്യപരാമിതാ	ಪ್ರಗ್ಯಪರಾಮಿತಾ
പ്രജാനാ	ಪ್ರಜಾನಾ
പ്രനാദാ	ಪ್ರನಾದಾ
പ്രനീധാനാ	ಪ್ರನೀಧಾನಾ
പ്രബകരണ	ಪ್ರಬಕರಣ
പ്രഭാകര	ಪ್ರಭಾಕರ
പ്രഭാകരന	ಪ್ರಭಾಕರನ
പ്രഭാത	ಪ್ರಭಾತ
പ്രഭാവ	ಪ್ರಭಾವ
പ്രാതീകാ	ಪ್ರಾತೀಕಾ
ഫനീ	ಫನೀ
ഫനീഭുഷണ	ಫನೀಭುಷಣ
ഫാല്ഗുനീ	ಫಾಲ್ಗುನೀ
ഫൂലന	ಫೂಲನ
ഫ്രാന്ചീസ	ಫ್ರಾನ್ಚೀಸ
ബംദിശ	ಬಂದಿಶ
ബംധൂല	ಬಂಧೂಲ
ബംശീ	ಬಂಶೀ
ബംസീധര	ಬಂಸೀಧರ
ബകുലാ	ಬಕುಲಾ
ബകൂല	ಬಕೂಲ
ബദ്രീ	ಬದ್ರೀ
ബനജ	ಬನಜ
ബനവാരീ	ಬನವಾರೀ
ബബന	ಬಬನ
ബബിശ	ಬಬಿಶ
ബര്ഹന	ಬರ್ಹನ
ബലബീര	ಬಲಬೀರ
ബഹവാസ്യ	ಬಹವಾಸ್ಯ
ബാബു	ಬಾಬು
ബാബുല	ಬಾಬುಲ
ബാല മുകുന്ദ	ಬಾಲ ಮುಕುನ್ದ
ബാലധി	ಬಾಲಧಿ
ബാലാമോഹന	ಬಾಲಾಮೋಹನ
ബാലാരാജ	ಬಾಲಾರಾಜ
ബാലാശംകര	ಬಾಲಾಶಂಕರ
ബാലു	ಬಾಲು
ബാലേന്ദു	ಬಾಲೇನ್ದು
ബാസ്കാര	ಬಾಸ್ಕಾರ
ബിനീതാ	ಬಿನೀತಾ
ബീനും	ಬೀನುಂ
ബീന്ദുശ്രീ	ಬೀನ್ದುಶ್ರೀ
ബീന്നീകേര	ಬೀನ್ನೀಕೇರ
ബീപുല	ಬೀಪುಲ
ബീബീന	ಬೀಬೀನ
ബീരത	ಬೀರತ
ബീഹാന	ಬೀಹಾನ
ബേനീതാ	ಬೇನೀತಾ
ബേനും	ಬೇನುಂ
ബേലുരമീ	ಬೇಲುರಮೀ
ബേല്ലീ	ಬೇಲ್ಲೀ
ബൈവാവീ	ಬೈವಾವೀ
ബൈസാഖീ	ಬೈಸಾಖೀ
ബ്രീഥ്ഹീ	ಬ್ರೀಥ್ಹೀ
ബ്ലേസ്സീ	ಬ್ಲೇಸ್ಸೀ
ഭഗവാന	ಭಗವಾನ
ഭദ്രക്ഷ	ಭದ್ರಕ್ಷ
ഭദ്രനിധി	ಭದ್ರನಿಧಿ
ഭദ്രപ്രിയാ	ಭದ್ರಪ್ರಿಯಾ
ഭദ്രിക	ಭದ್ರಿಕ
ഭദ്രീശാ	ಭದ್ರೀಶಾ
ഭവാനീ	ಭವಾನೀ
ഭവ്യരാജ	ಭವ್ಯರಾಜ
ഭാഗവംതീ	ಭಾಗವಂತೀ
ഭാദരന	ಭಾದರನ
ഭാനുമിത്ര	ಭಾನುಮಿತ್ರ
ഭാരഥീ	ಭಾರಥೀ
ഭാര്ഗവന	ಭಾರ್ಗವನ
ഭാര്ഗവാ	ಭಾರ್ಗವಾ
ഭാര്ഘവീ	ಭಾರ್ಘವೀ
ഭാര്ദ്ദ്വാജ	ಭಾರ್ದ್ದ್ವಾಜ
ഭാലേംദ്ര	ಭಾಲೇಂದ್ರ
ഭാവതീ	ಭಾವತೀ
ഭാവീഗുരും	ಭಾವೀಗುರುಂ
ഭാവ്യമ	ಭಾವ್ಯಮ
ഭാശ്വീനീ	ಭಾಶ್ವೀನೀ
ഭാസു	ಭಾಸು
ഭാസ്കാരീ	ಭಾಸ್ಕಾರೀ
ഭാസ്കേര	ಭಾಸ್ಕೇರ
ഭീമശംകര	ಭೀಮಶಂಕರ
ഭൂദേവ	ಭೂದೇವ
ഭൂപത	ಭೂಪತ
ഭൂപാല	ಭೂಪಾಲ
ഭൂമാ	ಭೂಮಾ
ഭൂമാം	ಭೂಮಾಂ
ഭേരേശ	ಭೇರೇಶ
ഭൈരവീ	ಭೈರವೀ
മംഗലമ	ಮಂಗಲಮ
മംഗേശ	ಮಂಗೇಶ
മംജു  പ്രസന്ന	ಮಂಜು  ಪ್ರಸನ್ನ
മംജുനാഥ	ಮಂಜುನಾಥ
മംജുലാ	ಮಂಜುಲಾ
മംത	ಮಂತ
മംതോഷ	ಮಂತೋಷ
മംദിഥാ	ಮಂದಿಥಾ
മംദിരാ	ಮಂದಿರಾ
മകാലീ	ಮಕಾಲೀ
മകുര	ಮಕುರ
മഗന	ಮಗನ
മണികാംത	ಮಣಿಕಾಂತ
മദുരാ	ಮದುರಾ
മധുനിഷാ	ಮಧುನಿಷಾ
മധുമാംലീ	ಮಧುಮಾಂಲೀ
മധുരിമാ	ಮಧುರಿಮಾ
മധുവംതീ	ಮಧುವಂತೀ
മനജീത	ಮನಜೀತ
മനപ	ಮನಪ
മനസ്വിന	ಮನಸ್ವಿನ
മനാല്പ	ಮನಾಲ್ಪ
മനീതാ	ಮನೀತಾ
മനീഷ	ಮನೀಷ
മനോജ	ಮನೋಜ
മനോരനജനീ	ಮನೋರನಜನೀ
മനോരിഥാ	ಮನೋರಿಥಾ
മന്നത	ಮನ್ನತ
മന്മായീ	ಮನ್ಮಾಯೀ
മല്ലികാ	ಮಲ್ಲಿಕಾ
മഹംത	ಮಹಂತ
മഹാതപസ്വീ	ಮಹಾತಪಸ್ವೀ
മഹാദുര്ഗാ	ಮಹಾದುರ್ಗಾ
മഹാദേവാ	ಮಹಾದೇವಾ
മഹാദേവാദീപുജീതാ	ಮಹಾದೇವಾದೀಪುಜೀತಾ
മഹാന്തേശ	ಮಹಾನ್ತೇಶ
മഹാബാലാ	ಮಹಾಬಾಲಾ
മഹാസ്വേതാ	ಮಹಾಸ್ವೇತಾ
മഹിപതി	ಮಹಿಪತಿ
മഹിഷാസുരമര്ദിനീ	ಮಹಿಷಾಸುರಮರ್ದಿನೀ
മഹീജിത	ಮಹೀಜಿತ
മഹേംദ്രാ	ಮಹೇಂದ್ರಾ
മഹേശ	ಮಹೇಶ
മഹേശനീ	ಮಹೇಶನೀ
മഹേശീ	ಮಹೇಶೀ
മാംതിക	ಮಾಂತಿಕ
മാംനീമോഝ്ഹീ	ಮಾಂನೀಮೋಝ್ಹೀ
മാംനുസരീ	ಮಾಂನುಸರೀ
മാംന്ക്ഷ	ಮಾಂನ್ಕ್ಷ
മാംന്ഗീരീ	ಮಾಂನ್ಗೀರೀ
മാംന്താവ്യാഹ	ಮಾಂನ್ತಾವ್ಯಾಹ
മാംന്തീകാ	ಮಾಂನ್ತೀಕಾ
മാംന്ദീതാ	ಮಾಂನ್ದೀತಾ
മാംലാമാംകാല മകാന	ಮಾಂಲಾಮಾಂಕಾಲ ಮಕಾನ
മാഇല	ಮಾಇಲ
മാനകാ	ಮಾನಕಾ
മാനജ	ಮಾನಜ
മാനശ	ಮಾನಶ
മാനിക	ಮಾನಿಕ
മാനീശീന	ಮಾನೀಶೀನ
മാനോരിത	ಮಾನೋರಿತ
മാന്കന	ಮಾನ್ಕನ
മാന്ദാവിക	ಮಾನ್ದಾವಿಕ
മായാ	ಮಾಯಾ
മാര്ഗശീ	ಮಾರ್ಗಶೀ
മാര്ഗീ	ಮಾರ್ಗೀ
മാര്തംദ	ಮಾರ್ತಂದ
മാര്ഥീകാ	ಮಾರ್ಥೀಕಾ
മാര്യ	ಮಾರ್ಯ
മാര്യാ	ಮಾರ್ಯಾ
മാര്ഷാ	ಮಾರ್ಷಾ
മാലാര്കോഡീ	ಮಾಲಾರ್ಕೋಡೀ
മാലിനീ	ಮಾಲಿನೀ
മാല്ലേശാ	ಮಾಲ್ಲೇಶಾ
മാസൂമ	ಮಾಸೂಮ
മാസൂമീ	ಮಾಸೂಮೀ
മാഹിയാ	ಮಾಹಿಯಾ
മാഹിരാജ	ಮಾಹಿರಾಜ
മാഹുലീ	ಮಾಹುಲೀ
മിലീ	ಮಿಲೀ
മിഹീകാ	ಮಿಹೀಕಾ
മീനാ	ಮೀನಾ
മേധ	ಮೇಧ
മേധീനീ	ಮೇಧೀನೀ
മൈത്രായ	ಮೈತ್ರಾಯ
മൌലീശാ	ಮೌಲೀಶಾ
മ്യ്ഥിലീ	ಮ್ಯ್ಥಿಲೀ
യംശ	ಯಂಶ
യക്ഷ	ಯಕ್ಷ
യജും	ಯಜುಂ
യജുസ	ಯಜುಸ
യജ്നേശ	ಯಜ್ನೇಶ
യഥാര്ഥ	ಯಥಾರ್ಥ
യദുനംദന	ಯದುನಂದನ
യശസ്വിനീ	ಯಶಸ್ವಿನೀ
യശാശ്രീ	ಯಶಾಶ್ರೀ
യശ്ദീപ	ಯಶ್ದೀಪ
യശ്മിത	ಯಶ್ಮಿತ
യശ്മിതാ	ಯಶ್ಮಿತಾ
യശ്വാര്ധാനാ	ಯಶ್ವಾರ್ಧಾನಾ
യശ്വീന	ಯಶ್ವೀನ
യശ്വീനീ	ಯಶ್ವೀನೀ
യസ്വംഥ	ಯಸ್ವಂಥ
യാക്സീനീ	ಯಾಕ್ಸೀನೀ
യാഗ്നാകായാ	ಯಾಗ್ನಾಕಾಯಾ
യാഗ്നീഥാ	ಯಾಗ್ನೀಥಾ
യാചന	ಯಾಚನ
യാതീരാജു	ಯಾತೀರಾಜು
യാദവീ	ಯಾದವೀ
യാദവേന്ദ്ര	ಯಾದವೇನ್ದ್ರ
യാന്തി	ಯಾನ್ತಿ
യാശ്രീഥാ	ಯಾಶ್ರೀಥಾ
യാഷ്ക	ಯಾಷ್ಕ
യാസസ്വീ	ಯಾಸಸ್ವೀ
യുഗന്തീകാ	ಯುಗನ್ತೀಕಾ
യുഗപ	ಯುಗಪ
യുഗാന്ധര	ಯುಗಾನ್ಧರ
യുതി	ಯುತಿ
യുവംശ	ಯುವಂಶ
യുവനാഥ	ಯುವನಾಥ
യുവല	ಯುವಲ
യുവാഥീ	ಯುವಾಥೀ
യുവാന  സൂര്യ	ಯುವಾನ  ಸೂರ್ಯ
യുവ്നീക	ಯುವ್ನೀಕ
യേര്രപ്പാ	ಯೇರ್ರಪ್ಪಾ
യേശനാ	ಯೇಶನಾ
യേശാസ്വീനീ	ಯೇಶಾಸ್ವೀನೀ
യേസസരീ	ಯೇಸಸರೀ
യോഗദേവാ	ಯೋಗದೇವಾ
യോഗരാജ	ಯೋಗರಾಜ
യോഗാനംദ	ಯೋಗಾನಂದ
യോഗിത	ಯೋಗಿತ
യോഗിതാ	ಯೋಗಿತಾ
യോഗിഥ	ಯೋಗಿಥ
യോഗേശ്വര	ಯೋಗೇಶ್ವರ
യോഗ്ദീപ	ಯೋಗ್ದೀಪ
യോത്ശനാ	ಯೋತ್ಶನಾ
യോനേന്ദ്ര	ಯೋನೇನ್ದ್ರ
യോഹ്ശീനീ	ಯೋಹ್ಶೀನೀ
യൌവാനീ	ಯೌವಾನೀ
രംഗനാഥ	ರಂಗನಾಥ
രംജന	ರಂಜನ
രംജികാ	ರಂಜಿಕಾ
രംജീവ	ರಂಜೀವ
രഈര്ഥ	ರಈರ್ಥ
രക്ത	ರಕ್ತ
രക്തകമള	ರಕ್ತಕಮಳ
രക്ഷികാ	ರಕ್ಷಿಕಾ
രക്ഷിത	ರಕ್ಷಿತ
രഘവാ	ರಘವಾ
രഘവേന്ദര	ರಘವೇನ್ದರ
രഘുനാഥ	ರಘುನಾಥ
രജത	ರಜತ
രജനീശ	ರಜನೀಶ
രജനേശ	ರಜನೇಶ
രജീത	ರಜೀತ
രതന	ರತನ
രതാംജലി	ರತಾಂಜಲಿ
രതീക	ರತೀಕ
രതുല	ರತುಲ
രത്നാകര	ರತ್ನಾಕರ
രത്നാബലീ	ರತ್ನಾಬಲೀ
രഥനാ	ರಥನಾ
രന്യ	ರನ್ಯ
രന്വിഥാ	ರನ್ವಿಥಾ
രബേക	ರಬೇಕ
രമാംസ്വമ്യ	ರಮಾಂಸ್ವಮ್ಯ
രമ്ബേശ	ರಮ್ಬೇಶ
രയാന	ರಯಾನ
രര്ശ്മീതാ	ರರ್ಶ್ಮೀತಾ
രവി കാന്ത	ರವಿ ಕಾನ್ತ
രവികാംത	ರವಿಕಾಂತ
രവിത	ರವಿತ
രവീജാ	ರವೀಜಾ
രവീനാ	ರವೀನಾ
രവ്യംകീ	ರವ್ಯಂಕೀ
രശീലാ	ರಶೀಲಾ
രസവംത	ರಸವಂತ
രസ്മീന	ರಸ್ಮೀನ
രാഈ കുമാര	ರಾಈ ಕುಮಾರ
രാഖീ	ರಾಖೀ
രാഗാവ	ರಾಗಾವ
രാഗിനീ	ರಾಗಿನೀ
രാഗേശ	ರಾಗೇಶ
രാഗ്വേദ	ರಾಗ್ವೇದ
രാജക	ರಾಜಕ
രാജകന്യാ	ರಾಜಕನ್ಯಾ
രാജഗോപാല	ರಾಜಗೋಪಾಲ
രാജയവര്ദന	ರಾಜಯವರ್ದನ
രാജാ	ರಾಜಾ
രാജാര്ശീ	ರಾಜಾರ್ಶೀ
രാജികാ	ರಾಜಿಕಾ
രാജീവ	ರಾಜೀವ
രാജേംദ്രമോഹന	ರಾಜೇಂದ್ರಮೋಹನ
രാജേശ്വര	ರಾಜೇಶ್ವರ
രാജ്യശ്രീ	ರಾಜ್ಯಶ್ರೀ
രാധാനീ	ರಾಧಾನೀ
രാനീ	ರಾನೀ
രാമ  കീന്കാര	ರಾಮ  ಕೀನ್ಕಾರ
രാമഗോപാല	ರಾಮಗೋಪಾಲ
രാമചന്ദ്രന	ರಾಮಚನ್ದ್ರನ
രാമനാരായണ	ರಾಮನಾರಾಯಣ
രാമരാ	ರಾಮರಾ
രാമരാജ	ರಾಮರಾಜ
രാമാംസുഗ്രീവാ	ರಾಮಾಂಸುಗ್ರೀವಾ
രാമാനംദ	ರಾಮಾನಂದ
രാമാനുജമ	ರಾಮಾನುಜಮ
രാമോജീ	ರಾಮೋಜೀ
രാഹിത്യ	ರಾಹಿತ್ಯ
രാഹീന്യ	ರಾಹೀನ್ಯ
രാഹുലരാജ	ರಾಹುಲರಾಜ
രിദ്ധി	ರಿದ್ಧಿ
രീചികാ	ರೀಚಿಕಾ
രീതൂ	ರೀತೂ
രീഥേകാ	ರೀಥೇಕಾ
രീദേവ	ರೀದೇವ
രീധമാം	ರೀಧಮಾಂ
രീഭ്യാ	ರೀಭ್ಯಾ
രീശും	ರೀಶುಂ
രീശ്മേഥാ	ರೀಶ್ಮೇಥಾ
രേഖാ	ರೇಖಾ
രേത്വിക	ರೇತ್ವಿಕ
രേധാ	ರೇಧಾ
രേനാ	ರೇನಾ
രേനേശ	ರೇನೇಶ
രേമാംനീകാ	ರೇಮಾಂನೀಕಾ
രേമീ	ರೇಮೀ
രേവാതീ	ರೇವಾತೀ
രേവീഥാ	ರೇವೀಥಾ
രേശമീ	ರೇಶಮೀ
രേശ്വീന	ರೇಶ್ವೀನ
രേഹാംശീ	ರೇಹಾಂಶೀ
രേഹാനാ	ರೇಹಾನಾ
രേഹേഈലാ	ರೇಹೇಈಲಾ
രേഹ്നുഘാ	ರೇಹ್ನುಘಾ
രൈവത	ರೈವತ
രൈവതാ	ರೈವತಾ
ലംഗീത	ಲಂಗೀತ
ലക്ഷ	ಲಕ್ಷ
ലക്ഷാകീ	ಲಕ್ಷಾಕೀ
ലക്ഷിതാ	ಲಕ್ಷಿತಾ
ലക്ഷ്മീകാനതമ	ಲಕ್ಷ್ಮೀಕಾನತಮ
ലജ്ജാ	ಲಜ್ಜಾ
ലജ്ജാകാ	ಲಜ್ಜಾಕಾ
ലതാ	ಲತಾ
ലതേശ	ಲತೇಶ
ലവപാല	ಲವಪಾಲ
ലവലീന	ಲವಲೀನ
ലഹരീ	ಲಹರೀ
ലാക്ശേതാ	ಲಾಕ್ಶೇತಾ
ലാജവംതീ	ಲಾಜವಂತೀ
ലാതീശ	ಲಾತೀಶ
ലാനീബന	ಲಾನೀಬನ
ലാഭാ	ಲಾಭಾ
ലാമ്ബോധാര	ಲಾಮ್ಬೋಧಾರ
ലാരീനാ	ಲಾರೀನಾ
ലാര്മികാ	ಲಾರ್ಮಿಕಾ
ലാര്രാജ	ಲಾರ್ರಾಜ
ലാര്ശന	ಲಾರ್ಶನ
ലാവനീ	ಲಾವನೀ
ലാവിനാ	ಲಾವಿನಾ
ലീകേശ	ಲೀಕೇಶ
ലീത്സാ	ಲೀತ್ಸಾ
ലീനാശാ	ಲೀನಾಶಾ
ലീനീത	ಲೀನೀತ
ലീപാക്ഷീ	ಲೀಪಾಕ್ಷೀ
ലീപ്സീകാ	ಲೀಪ್ಸೀಕಾ
ലീമനാ	ಲೀಮನಾ
ലീലാമഈ	ಲೀಲಾಮಈ
ലീശാംത	ಲೀಶಾಂತ
ലുസിയാ	ಲುಸಿಯಾ
ലേഈവീനാ	ಲೇಈವೀನಾ
ലേഖീശാ	ಲೇಖೀಶಾ
ലേമാര	ಲೇಮಾರ
ലോകനേത്ര	ಲೋಕನೇತ್ರ
ലോകാജനാനീ	ಲೋಕಾಜನಾನೀ
ലോകാമാത്രീ	ಲೋಕಾಮಾತ್ರೀ
ലോകീഥാ	ಲೋಕೀಥಾ
ലോകേന്ദ്ര	ಲೋಕೇನ್ದ್ರ
ലോഗീനീ	ಲೋಗೀನೀ
ലോഗേശ്വരണ	ಲೋಗೇಶ್ವರಣ
ലോചനാ	ಲೋಚನಾ
ലോനാ	ಲೋನಾ
ലോമാംകേശ	ಲೋಮಾಂಕೇಶ
ലോഹിത	ಲೋಹಿತ
ലോഹിതാശ്വാ	ಲೋಹಿತಾಶ್ವಾ
ലൌക്യ	ಲೌಕ್ಯ
വംദിതാ	ವಂದಿತಾ
വംസികൃഷ്ണ	ವಂಸಿಕೃಷ್ಣ
വനദ	ವನದ
വനമാംഥീ	ವನಮಾಂಥೀ
വനസ	ವನಸ
വനിനാധ	ವನಿನಾಧ
വന്ജുല	ವನ್ಜುಲ
വപുസ	ವಪುಸ
വയദീശ	ವಯದೀಶ
വരലീ	ವರಲೀ
വരിന	ವರಿನ
വരിയാസ	ವರಿಯಾಸ
വരുന	ವರುನ
വരുനികാ	ವರುನಿಕಾ
വര്ണിത	ವರ್ಣಿತ
വര്ധമാന	ವರ್ಧಮಾನ
വര്ധാനീ	ವರ್ಧಾನೀ
വര്ധീമൈനകാപുജീതാ	ವರ್ಧೀಮೈನಕಾಪುಜೀತಾ
വര്നീശാ	ವರ್ನೀಶಾ
വര്ശനേയാ	ವರ್ಶನೇಯಾ
വര്ശീകാ	ವರ್ಶೀಕಾ
വര്ശീതാ	ವರ್ಶೀತಾ
വര്ശീദ	ವರ್ಶೀದ
വര്ഷനീ	ವರ್ಷನೀ
വല്ലികാ	ವಲ್ಲಿಕಾ
വസംതാ	ವಸಂತಾ
വസംതീ	ವಸಂತೀ
വസീസതാ	ವಸೀಸತಾ
വസുമിത്ര	ವಸುಮಿತ್ರ
വസുസേന	ವಸುಸೇನ
വാക്പതി	ವಾಕ್ಪತಿ
വാക്ഷു	ವಾಕ್ಷು
വാച്യ	ವಾಚ್ಯ
വാജ്രക്ഷ	ವಾಜ್ರಕ್ಷ
വാതത്മാജ	ವಾತತ್ಮಾಜ
വാത്സല്യ	ವಾತ್ಸಲ್ಯ
വാദിവേലും	ವಾದಿವೇಲುಂ
വാനര	ವಾನರ
വാന്ശുല	ವಾನ್ಶುಲ
വാമന	ವಾಮನ
വാമാംക്ഷീ	ವಾಮಾಂಕ್ಷೀ
വാമീല	ವಾಮೀಲ
വാരനാ	ವಾರನಾ
വാരുനീ	ವಾರುನೀ
വാലാരമാംഥീ	ವಾಲಾರಮಾಂಥೀ
വാല്ല്മാംനാലന	ವಾಲ್ಲ್ಮಾಂನಾಲನ
വാശു	ವಾಶು
വാസുമന	ವಾಸುಮನ
വാഹിനീ	ವಾಹಿನೀ
വികീശാ	ವಿಕೀಶಾ
വിക്ഷിത	ವಿಕ್ಷಿತ
വിജയാലക്ഷ്മീ	ವಿಜಯಾಲಕ್ಷ್ಮೀ
വിജയാശാനഥീ	ವಿಜಯಾಶಾನಥೀ
വിജീതാ	ವಿಜೀತಾ
വിദിശാ	ವಿದಿಶಾ
വിദ്യാ	ವಿದ್ಯಾ
വിദ്യുല	ವಿದ್ಯುಲ
വിധാഥരീ	ವಿಧಾಥರೀ
വിന്ധുജാ	ವಿನ್ಧುಜಾ
വിബാലീ	ವಿಬಾಲೀ
വിഭാവാ	ವಿಭಾವಾ
വിഭൂതി	ವಿಭೂತಿ
വിഭൂഷ	ವಿಭೂಷ
വിയാമര്ശ	ವಿಯಾಮರ್ಶ
വിരഗനാപതീ	ವಿರಗನಾಪತೀ
വിരഭാദ്രപ്പാ	ವಿರಭಾದ್ರಪ್ಪಾ
വിരാജ	ವಿರಾಜ
വിലാശീനീ	ವಿಲಾಶೀನೀ
വീണാ	ವೀಣಾ
വീണാധാരീ	ವೀಣಾಧಾರೀ
വേക്രാംത	ವೇಕ್ರಾಂತ
വേഗ	ವೇಗ
വേഗവാഹീനീ	ವೇಗವಾಹೀನೀ
വേഗീ	ವೇಗೀ
വേണു	ವೇಣು
വേത്ത്രീ	ವೇತ್ತ್ರೀ
വേത്രിവാല	ವೇತ್ರಿವಾಲ
വേത്രീവേല	ವೇತ್ರೀವೇಲ
വേദകാര്തിക	ವೇದಕಾರ್ತಿಕ
വേദവല്ലീ	ವೇದವಲ್ಲೀ
വേദാ	ವೇದಾ
വേദാ ശ്രീ	ವೇದಾ ಶ್ರೀ
വേധാംത	ವೇಧಾಂತ
വേന്കാത്രമണ	ವೇನ್ಕಾತ್ರಮಣ
വേന്തന	ವೇನ್ತನ
വേന്നേലാ	ವೇನ್ನೇಲಾ
വേന്മതീ	ವೇನ್ಮತೀ
വേലു	ವೇಲು
വേഹംത	ವೇಹಂತ
വൈകുംഠ	ವೈಕುಂಠ
വൈജീനാഥ	ವೈಜೀನಾಥ
വൈദത	ವೈದತ
വൈദേഹീ	ವೈದೇಹೀ
വൈദ്യുംത	ವೈದ್ಯುಂತ
വൈധേ	ವೈಧೇ
വൈധ്യാത	ವೈಧ್ಯಾತ
വൈരാഗ	ವೈರಾಗ
വൈരോചന	ವೈರೋಚನ
വൈശാലീ	ವೈಶಾಲೀ
വൈശ്വീ	ವೈಶ್ವೀ
വൈഷ്ണവീ	ವೈಷ್ಣವೀ
വൈസകാ	ವೈಸಕಾ
സംക്രാംതി	ಸಂಕ್ರಾಂತಿ
സംഗമിത്ര	ಸಂಗಮಿತ್ರ
സംഗമീധീരാ	ಸಂಗಮೀಧೀರಾ
സംചയ	ಸಂಚಯ
സംചീതീ	ಸಂಚೀತೀ
സംജേനാ	ಸಂಜೇನಾ
സംജോലീ	ಸಂಜೋಲೀ
സംതോക	ಸಂತೋಕ
സംദിപോന	ಸಂದಿಪೋನ
സംദീപ	ಸಂದೀಪ
സംദേശ	ಸಂದೇಶ
സംധരാ	ಸಂಧರಾ
സംധ്യാ	ಸಂಧ್ಯಾ
സംബീതാ	ಸಂಬೀತಾ
സംമീതാ	ಸಂಮೀತಾ
സംയുക്ത	ಸಂಯುಕ್ತ
സംവിധാ	ಸಂವಿಧಾ
സംവീഥാ	ಸಂವೀಥಾ
സംസ്കൃതി	ಸಂಸ್ಕೃತಿ
സംഹിത	ಸಂಹಿತ
സക്ശീന്യാ	ಸಕ್ಶೀನ್ಯಾ
സഖ്യാ	ಸಖ್ಯಾ
സഗന	ಸಗನ
സഗുനാ	ಸಗುನಾ
സചിതാ	ಸಚಿತಾ
സചിദാനംദ വിഗ്രഹ	ಸಚಿದಾನಂದ ವಿಗ್ರಹ
സചേതന	ಸಚೇತನ
സച്ചിദാനംദാ	ಸಚ್ಚಿದಾನಂದಾ
സജീത	ಸಜೀತ
സജീലീ	ಸಜೀಲೀ
സദഗതി	ಸದಗತಿ
സദഗുനാ	ಸದಗುನಾ
സദാശിവ	ಸದಾಶಿವ
സദിശ	ಸದಿಶ
സപനാ	ಸಪನಾ
സപുഷ്പാ	ಸಪುಷ್ಪಾ
സപ്താബീ	ಸಪ್ತಾಬೀ
സപ്തോര്ശീ	ಸಪ್ತೋರ್ಶೀ
സമജാ	ಸಮಜಾ
സമദര്ശീ	ಸಮದರ್ಶೀ
സമഭ്ദ്ധാ	ಸಮಭ್ದ್ಧಾ
സമരേശ	ಸಮರೇಶ
സമാംദ്രിതാ	ಸಮಾಂದ್ರಿತಾ
സമാംര്ധ	ಸಮಾಂರ್ಧ
സമാജസ	ಸಮಾಜಸ
സമാരാസ്യാ	ಸಮಾರಾಸ್ಯಾ
സമിക	ಸಮಿಕ
സമിരന	ಸಮಿರನ
സമേംദ്ര	ಸಮೇಂದ್ರ
സമേശ	ಸಮೇಶ
സമ്പൂര്ണ	ಸಮ್ಪೂರ್ಣ
സമ്പ്രഥ്യ	ಸಮ್ಪ್ರಥ್ಯ
സമ്പ്രീതീ	ಸಮ್ಪ್ರೀತೀ
സമ്രാട	ಸಮ್ರಾಟ
സമ്രീധ	ಸಮ್ರೀಧ
സരസംഗീ	ಸರಸಂಗೀ
സലീജ	ಸಲೀಜ
സഹര്സീതാ	ಸಹರ್ಸೀತಾ
സഹശ്രദ	ಸಹಶ್ರದ
സഹസ്ത്രജീത	ಸಹಸ್ತ್ರಜೀತ
സഹസ്ത്രബാഹു	ಸಹಸ್ತ್ರಬಾಹು
സഹീത	ಸಹೀತ
സഹീരാമ	ಸಹೀರಾಮ
സഹ്യ	ಸಹ್ಯ
സാംജ	ಸಾಂಜ
സാഇ രാമ	ಸಾಇ ರಾಮ
സാഈനാഥ	ಸಾಈನಾಥ
സാചീ	ಸಾಚೀ
സാജന	ಸಾಜನ
സാദ്രീശീ	ಸಾದ್ರೀಶೀ
സാദ്വിഥാ	ಸಾದ್ವಿಥಾ
സാധന	ಸಾಧನ
സാധ്യാ	ಸಾಧ್ಯಾ
സാനിധ്യ	ಸಾನಿಧ್ಯ
സാമംതാ	ಸಾಮಂತಾ
സാമ്ഭാ	ಸಾಮ್ಭಾ
സാരണീ	ಸಾರಣೀ
സാരഥീ	ಸಾರಥೀ
സാരികാ	ಸಾರಿಕಾ
സാലവീ	ಸಾಲವೀ
സാലസാ	ಸಾಲಸಾ
സൈകത	ಸೈಕತ
സൈനീത്യ	ಸೈನೀತ್ಯ
സൈന്ധന്യ	ಸೈನ್ಧನ್ಯ
സൈലീ	ಸೈಲೀ
സൈഹാര്സന	ಸೈಹಾರ್ಸನ
ഹംസമാലാ	ಹಂಸಮಾಲಾ
ഹംസാവാഥ്യ	ಹಂಸಾವಾಥ್ಯ
ഹനാര്വീന	ಹನಾರ್ವೀನ
ഹനീതാ	ಹನೀತಾ
ഹനുപ	ಹನುಪ
ഹനുമാന	ಹನುಮಾನ
ഹബീതാ	ಹಬೀತಾ
ഹമസാദീപികാ	ಹಮಸಾದೀಪಿಕಾ
ഹമസാനംദീനീ	ಹಮಸಾನಂದೀನೀ
ഹമീര	ಹಮೀರ
ഹരജീത	ಹರಜೀತ
ഹരജീവന	ಹರಜೀವನ
ഹരനാധ	ಹರನಾಧ
ഹരശും	ಹರಶುಂ
ഹരികിശന	ಹರಿಕಿಶನ
ഹരിഗംഗാ	ಹರಿಗಂಗಾ
ഹരിഗോപാല	ಹರಿಗೋಪಾಲ
ഹരിദാസ	ಹರಿದಾಸ
ഹരിദ്വാര	ಹರಿದ್ವಾರ
ഹരിപ്രീത	ಹರಿಪ್ರೀತ
ഹരിമംതീ	ಹರಿಮಂತೀ
ഹരീ	ಹರೀ
ഹരേശ്വര	ಹರೇಶ್ವರ
ഹര്മീന	ಹರ್ಮೀನ
ഹര്ഷണ	ಹರ್ಷಣ
ഹര്സികാ	ಹರ್ಸಿಕಾ
ഹശ്മീതാ	ಹಶ್ಮೀತಾ
ഹസമുഖ	ಹಸಮುಖ
ഹസീതാ	ಹಸೀತಾ
ഹസ്വീഥാ	ಹಸ್ವೀಥಾ
ഹാര്ദീനീ	ಹಾರ್ದೀನೀ
ഹാര്ശീനീ	ಹಾರ್ಶೀನೀ
ഹാലിക	ಹಾಲಿಕ
ഹിംഡോള	ಹಿಂಡೋಳ
ഹിംദോലാ	ಹಿಂದೋಲಾ
ഹിതാക്ഷീ	ಹಿತಾಕ್ಷೀ
ഹിതീ	ಹಿತೀ
ഹിഥീക്സാ	ಹಿಥೀಕ್ಸಾ
ഹിമാംശു	ಹಿಮಾಂಶು
ഹിമാക്ഷ	ಹಿಮಾಕ್ಷ
ഹിമാലയ	ಹಿಮಾಲಯ
ഹിരംയക	ಹಿರಂಯಕ
ഹിരവ	ಹಿರವ
ഹിരവാ	ಹಿರವಾ
ഹിരുധായാ	ಹಿರುಧಾಯಾ
ഹിവാ	ಹಿವಾ
ഹീരാനമാം	ಹೀರಾನಮಾಂ
ഹീരാന്യാപ്രകാഈ	ಹೀರಾನ್ಯಾಪ್ರಕಾಈ
ഹീര്നാക്ഷീ	ಹೀರ್ನಾಕ್ಷೀ
ഹുവീശ്കാ	ಹುವೀಶ್ಕಾ
ഹൃദയനാഥ	ಹೃದಯನಾಥ
ഹേഈദീ	ಹೇಈದೀ
ഹേജല	ಹೇಜಲ
ഹേതാ	ಹೇತಾ
ഹേതാശ	ಹೇತಾಶ
ഹേത്ശ്രീ	ಹೇತ್ಶ್ರೀ
ഹേഥാന്ശ്രീ	ಹೇಥಾನ್ಶ್ರೀ
ഹേനീത	ಹೇನೀತ
ഹേനീല	ಹೇನೀಲ
ഹേമനാഥ	ಹೇಮನಾಥ
ഹേമലതാ	ಹೇಮಲತಾ
ഹേമാ	ಹೇಮಾ
ഹേമാംദ്രികാ	ಹೇಮಾಂದ್ರಿಕಾ
ഹേമാഗൌരീ	ಹೇಮಾಗೌರೀ
ഹേമാനംദ	ಹೇಮಾನಂದ
ഹേമാലാ	ಹೇಮಾಲಾ
ഹേമാവതീ	ಹೇಮಾವತೀ
ഹേമാവാതിനംദന	ಹೇಮಾವಾತಿನಂದನ
ഹേമേംദു	ಹೇಮೇಂದು
ഹേയന	ಹೇಯನ
ഹേയാംശ	ಹೇಯಾಂಶ
ഹേരീത	ಹೇರೀತ
ഹേലീ	ಹೇಲೀ
ഹോന്നേശാ	ಹೋನ್ನೇಶಾ
ഹോമാ	ಹೋಮಾ
ഹ്രീത്വിക	ಹ್ರೀತ್ವಿಕ
ഹ്രീദാന്ക്ഷ	ಹ್ರೀದಾನ್ಕ್ಷ
ഹ്രീധാന	ಹ್ರೀಧಾನ
ഹ്രീശന	ಹ್ರೀಶನ
ഹ്രീശാംത	ಹ್ರೀಶಾಂತ
ഹ്രീഷിത	ಹ್ರೀಷಿತ
ഹ്രുദയ	ಹ್ರುದಯ
ഹ്രുശാല	ಹ್ರುಶಾಲ
ഹ്രേയാംശ	ಹ್ರೇಯಾಂಶ
ഹ്ര്യ്ദയേശ	ಹ್ರ್ಯ್ದಯೇಶ
#
#
# Territory names from CLDR
അസൻഷൻ ദ്വീപ്	ಅಸನ್ಷನ್ ದ್ವೀಪ್
അന്റോറ	ಅನ್ಱೋಱ
യുണൈറ്റഡ് അറബ് എമിറൈറ്റ്‌സ്	ಯುಣೈಱ್ಱಡ್ ಅಱಬ್ ಎಮಿಱೈಱ್ಱ್‌ಸ್
അഫ്‌ഗാനിസ്ഥാൻ	ಅಫ್‌ಗಾನಿಸ್ಥಾನ್
ആൻറിഗ്വയും ബർബുഡയും	ಆನ್ಱಿಗ್ವಯುಂ ಬರ್ಬುಡಯುಂ
ആൻഗ്വില്ല	ಆನ್ಗ್ವಿಲ್ಲ
അൽബേനിയ	ಅಲ್ಬೇನಿಯ
അർമേനിയ	ಅರ್ಮೇನಿಯ
അംഗോള	ಅಂಗೋಳ
അൻറാർട്ടിക്ക	ಅನ್ಱಾರ್ಟ್ಟಿಕ್ಕ
അർജൻറീന	ಅರ್ಜನ್ಱೀನ
അമേരിക്കൻ സമോവ	ಅಮೇರಿಕ್ಕನ್ ಸಮೋವ
ഓസ്ട്രിയ	ಓಸ್ಟ್ರಿಯ
ഓസ്‌ട്രേലിയ	ಓಸ್‌ಟ್ರೇಲಿಯ
അറൂബ	ಅಱೂಬ
അലൻഡ് ദ്വീപുകൾ	ಅಲನ್ಡ್ ದ್ವೀಪುಕಳ್
അസർബൈജാൻ	ಅಸರ್ಬೈಜಾನ್
ബോസ്നിയയും ഹെർസഗോവിനയും	ಬೋಸ್ನಿಯಯುಂ ಹೆರ್ಸಗೋವಿನಯುಂ
ബാർബഡോസ്	ಬಾರ್ಬಡೋಸ್
ബംഗ്ലാദേശ്	ಬಂಗ್ಲಾದೇಶ್
ബെൽജിയം	ಬೆಲ್ಜಿಯಂ
ബുർക്കിനാ ഫാസോ	ಬುರ್ಕ್ಕಿನಾ ಫಾಸೋ
ബൾഗേറിയ	ಬಳ್ಗೇಱಿಯ
ബഹ്റിൻ	ಬಹ್ಱಿನ್
ബറുണ്ടി	ಬಱುಣ್ಟಿ
ബെനിൻ	ಬೆನಿನ್
സെന്റ് ബാർത്തലമി	ಸೆನ್ಱ್ ಬಾರ್ತ್ತಲಮಿ
ബർമുഡ	ಬರ್ಮುಡ
ബ്രൂണൈ	ಬ್ರೂಣೈ
ബൊളീവിയ	ಬೊಳೀವಿಯ
ബൊണെയ്ർ, സിന്റ് യുസ്റ്റേഷ്യസ്, സാബ എന്നിവ	ಬೊಣೆಯ್ರ್, ಸಿನ್ಱ್ ಯುಸ್ಱ್ಱೇಷ್ಯಸ್, ಸಾಬ ಎನ್ನಿವ
ബ്രസീൽ	ಬ್ರಸೀಲ್
ബഹാമാസ്	ಬಹಾಮಾಸ್
ഭൂട്ടാൻ	ಭೂಟ್ಟಾನ್
ബൗവെട്ട് ദ്വീപ്	ಬೌವೆಟ್ಟ್ ದ್ವೀಪ್
ബോട്സ്വാന	ಬೋಟ್ಸ್ವಾನ
ബെലറൂസ്	ಬೆಲಱೂಸ್
ബെലീസ്	ಬೆಲೀಸ್
കാനഡ	ಕಾನಡ
കോക്കസ് (കീലിംഗ്) ദ്വീപുകൾ	ಕೋಕ್ಕಸ್ (ಕೀಲಿಂಗ್) ದ್ವೀಪುಕಳ್
കോംഗോ - കിൻഷാസ	ಕೋಂಗೋ - ಕಿನ್ಷಾಸ
കോംഗോ (DRC)	ಕೋಂಗೋ (DRC)
സെൻട്രൽ ആഫ്രിക്കൻ റിപ്പബ്ലിക്	ಸೆನ್ಟ್ರಲ್ ಆಫ್ರಿಕ್ಕನ್ ಱಿಪ್ಪಬ್ಲಿಕ್
കോംഗോ - ബ്രാസവില്ലി	ಕೋಂಗೋ - ಬ್ರಾಸವಿಲ್ಲಿ
കോംഗോ (റിപ്പബ്ലിക്ക്)	ಕೋಂಗೋ (ಱಿಪ್ಪಬ್ಲಿಕ್ಕ್)
സ്വിറ്റ്സർലാൻഡ്	ಸ್ವಿಱ್ಱ್ಸರ್ಲಾನ್ಡ್
കോട്ട് ഡി വാർ	ಕೋಟ್ಟ್ ಡಿ ವಾರ್
ഐവറി കോസ്റ്റ്	ಐವಱಿ ಕೋಸ್ಱ್ಱ್
കുക്ക് ദ്വീപുകൾ	ಕುಕ್ಕ್ ದ್ವೀಪುಕಳ್
ചിലി	ಚಿಲಿ
കാമറൂൺ	ಕಾಮಱೂಣ್
ചൈന	ಚೈನ
കൊളംബിയ	ಕೊಳಂಬಿಯ
ക്ലിപ്പെർട്ടൻ ദ്വീപ്	ಕ್ಲಿಪ್ಪೆರ್ಟ್ಟನ್ ದ್ವೀಪ್
കോസ്റ്ററിക്ക	ಕೋಸ್ಱ್ಱಱಿಕ್ಕ
ക്യൂബ	ಕ್ಯೂಬ
കേപ്പ് വെർദെ	ಕೇಪ್ಪ್ ವೆರ್ದೆ
കുറാകാവോ	ಕುಱಾಕಾವೋ
ക്രിസ്മസ് ദ്വീപ്	ಕ್ರಿಸ್ಮಸ್ ದ್ವೀಪ್
സൈപ്രസ്	ಸೈಪ್ರಸ್
ചെക്ക് റിപ്പബ്ലിക്	ಚೆಕ್ಕ್ ಱಿಪ್ಪಬ್ಲಿಕ್
ജർമനി	ಜರ್ಮನಿ
ഡീഗോ ഗ്രാഷ്യ	ಡೀಗೋ ಗ್ರಾಷ್ಯ
ദിജിബൗട്ടി	ದಿಜಿಬೌಟ್ಟಿ
ഡെൻമാർക്ക്	ಡೆನ್ಮಾರ್ಕ್ಕ್
ഡൊമിനിക്ക	ಡೊಮಿನಿಕ್ಕ
ഡൊമിനിക്കൻ റിപ്പബ്ലിക്	ಡೊಮಿನಿಕ್ಕನ್ ಱಿಪ್ಪಬ್ಲಿಕ್
അൾജീരിയ	ಅಳ್ಜೀರಿಯ
സെയൂത്ത ആൻഡ് മെലിയ	ಸೆಯೂತ್ತ ಆನ್ಡ್ ಮೆಲಿಯ
ഇക്വഡോർ	ಇಕ್ವಡೋರ್
എസ്റ്റോണിയ	ಎಸ್ಱ್ಱೋಣಿಯ
ഈജിപ്ത്	ಈಜಿಪ್ತ್
പശ്ചിമ സഹാറ	ಪಶ್ಚಿಮ ಸಹಾಱ
എറിത്രിയ	ಎಱಿತ್ರಿಯ
സ്‌പെയിൻ	ಸ್‌ಪೆಯಿನ್
എത്യോപ്യ	ಎತ್ಯೋಪ್ಯ
യൂറോപ്യൻ യൂണിയൻ	ಯೂಱೋಪ್ಯನ್ ಯೂಣಿಯನ್
ഫിൻലാൻഡ്	ಫಿನ್ಲಾನ್ಡ್
ഫിജി	ಫಿಜಿ
ഫാക്ക്‌ലാന്റ് ദ്വീപുകൾ	ಫಾಕ್ಕ್‌ಲಾನ್ಱ್ ದ್ವೀಪುಕಳ್
ഫോക്ക്‌ലാൻഡ് ദ്വീപുകൾ (ഐലാസ് മാൽവിനാസ്)	ಫೋಕ್ಕ್‌ಲಾನ್ಡ್ ದ್ವೀಪುಕಳ್ (ಐಲಾಸ್ ಮಾಲ್ವಿನಾಸ್)
മൈക്രോനേഷ്യ	ಮೈಕ್ರೋನೇಷ್ಯ
ഫറോ ദ്വീപുകൾ	ಫಱೋ ದ್ವೀಪುಕಳ್
ഫ്രാൻസ്	ಫ್ರಾನ್ಸ್
ഗാബൺ	ಗಾಬಣ್
യുണൈറ്റഡ് കിംഗ്ഡം	ಯುಣೈಱ್ಱಡ್ ಕಿಂಗ್ಡಂ
ഗ്രനേഡ	ಗ್ರನೇಡ
ജോർജ്ജിയ	ಜೋರ್ಜ್ಜಿಯ
ഫ്രഞ്ച് ഗയാന	ಫ್ರಞ್ಚ್ ಗಯಾನ
ഗേൺസി	ಗೇಣ್ಸಿ
ഘാന	ಘಾನ
ജിബ്രാൾട്ടർ	ಜಿಬ್ರಾಳ್ಟ್ಟರ್
ഗ്രീൻലാൻറ്	ಗ್ರೀನ್ಲಾನ್ಱ್
ഗാംബിയ	ಗಾಂಬಿಯ
ഗിനിയ	ಗಿನಿಯ
ഗ്വാഡലൂപ്പ്	ಗ್ವಾಡಲೂಪ್ಪ್
ഇക്വറ്റോറിയൽ ഗിനിയ	ಇಕ್ವಱ್ಱೋಱಿಯಲ್ ಗಿನಿಯ
ഗ്രീസ്	ಗ್ರೀಸ್
ദക്ഷിണ ജോർജ്ജിയയും ദക്ഷിണ സാൻഡ്‌വിച്ച് ദ്വീപുകളും	ದಕ್ಷಿಣ ಜೋರ್ಜ್ಜಿಯಯುಂ ದಕ್ಷಿಣ ಸಾನ್ಡ್‌ವಿಚ್ಚ್ ದ್ವೀಪುಕಳುಂ
ഗ്വാട്ടിമാല	ಗ್ವಾಟ್ಟಿಮಾಲ
ഗ്വാം	ಗ್ವಾಂ
ഗിനിയ-ബിസൗ	ಗಿನಿಯ-ಬಿಸೌ
ഗയാന	ಗಯಾನ
ഹോങ്കോങ്ങ് (SAR) ചൈന	ಹೋಙ್ಕೋಙ್ಙ್ (SAR) ಚೈನ
ഹോങ്കോങ്ങ്	ಹೋಙ್ಕೋಙ್ಙ್
ഹിയേർഡും മക്‌ഡൊണാൾഡ് ദ്വീപുകളും	ಹಿಯೇರ್ಡುಂ ಮಕ್‌ಡೊಣಾಳ್ಡ್ ದ್ವೀಪುಕಳುಂ
ഹോണ്ടുറാസ്	ಹೋಣ್ಟುಱಾಸ್
ക്രൊയേഷ്യ	ಕ್ರೊಯೇಷ್ಯ
ഹെയ്തി	ಹೆಯ್ತಿ
ഹംഗറി	ಹಂಗಱಿ
കാനറി ദ്വീപുകൾ	ಕಾನಱಿ ದ್ವೀಪುಕಳ್
ഇന്തോനേഷ്യ	ಇನ್ತೋನೇಷ್ಯ
അയർലാൻഡ്	ಅಯರ್ಲಾನ್ಡ್
ഇസ്രായേൽ	ಇಸ್ರಾಯೇಲ್
ഐൽ ഓഫ് മാൻ	ಐಲ್ ಓಫ್ ಮಾನ್
ഇന്ത്യ	ಇನ್ತ್ಯ
ബ്രിട്ടീഷ് ഇന്ത്യൻ മഹാസമുദ്ര പ്രദേശം	ಬ್ರಿಟ್ಟೀಷ್ ಇನ್ತ್ಯನ್ ಮಹಾಸಮುದ್ರ ಪ್ರದೇಶಂ
ഇറാഖ്	ಇಱಾಖ್
ഇറാൻ	ಇಱಾನ್
ഐസ്‌ലാന്റ്	ಐಸ್‌ಲಾನ್ಱ್
ഇറ്റലി	ಇಱ್ಱಲಿ
ജേഴ്സി	ಜೇೞ್ಸಿ
ജമൈക്ക	ಜಮೈಕ್ಕ
ജോർദ്ദാൻ	ಜೋರ್ದ್ದಾನ್
ജപ്പാൻ	ಜಪ್ಪಾನ್
കെനിയ	ಕೆನಿಯ
കിർഗിസ്ഥാൻ	ಕಿರ್ಗಿಸ್ಥಾನ್
കംബോഡിയ	ಕಂಬೋಡಿಯ
കിരിബാട്ടി	ಕಿರಿಬಾಟ್ಟಿ
കോമൊറോസ്	ಕೋಮೊಱೋಸ್
സെന്റ് കിറ്റ്‌സും നെവിസും	ಸೆನ್ಱ್ ಕಿಱ್ಱ್‌ಸುಂ ನೆವಿಸುಂ
ഉത്തരകൊറിയ	ಉತ್ತರಕೊಱಿಯ
ദക്ഷിണകൊറിയ	ದಕ್ಷಿಣಕೊಱಿಯ
കുവൈറ്റ്	ಕುವೈಱ್ಱ್
കേമാൻ ദ്വീപുകൾ	ಕೇಮಾನ್ ದ್ವೀಪುಕಳ್
കസാഖിസ്ഥാൻ	ಕಸಾಖಿಸ್ಥಾನ್
ലാവോസ്	ಲಾವೋಸ್
ലെബനൻ	ಲೆಬನನ್
സെൻറ് ലൂസിയ	ಸೆನ್ಱ್ ಲೂಸಿಯ
ലിച്ചൺസ്റ്റൈൻ	ಲಿಚ್ಚಣ್ಸ್ಱ್ಱೈನ್
ശ്രീലങ്ക	ಶ್ರೀಲಙ್ಕ
ലൈബീരിയ	ಲೈಬೀರಿಯ
ലെസോതോ	ಲೆಸೋತೋ
ലിത്വാനിയ	ಲಿತ್ವಾನಿಯ
ലക്സംബർഗ്	ಲಕ್ಸಂಬರ್ಗ್
ലാറ്റ്വിയ	ಲಾಱ್ಱ್ವಿಯ
ലിബിയ	ಲಿಬಿಯ
മൊറോക്കൊ	ಮೊಱೋಕ್ಕೊ
മൊണാക്കോ	ಮೊಣಾಕ್ಕೋ
മൾഡോവ	ಮಳ್ಡೋವ
മോണ്ടെനെഗ്രോ	ಮೋಣ್ಟೆನೆಗ್ರೋ
സെൻറ് മാർട്ടിൻ	ಸೆನ್ಱ್ ಮಾರ್ಟ್ಟಿನ್
മഡഗാസ്കർ	ಮಡಗಾಸ್ಕರ್
മാർഷൽ ദ്വീപുകൾ	ಮಾರ್ಷಲ್ ದ್ವೀಪುಕಳ್
മാസിഡോണിയ	ಮಾಸಿಡೋಣಿಯ
മാസിഡോണിയ (FYROM)	ಮಾಸಿಡೋಣಿಯ (FYROM)
മാലി	ಮಾಲಿ
മ്യാൻമാർ (ബർമ്മ)	ಮ್ಯಾನ್ಮಾರ್ (ಬರ್ಮ್ಮ)
മംഗോളിയ	ಮಂಗೋಳಿಯ
മക്കാവു (SAR) ചൈന	ಮಕ್ಕಾವು (SAR) ಚೈನ
മക്കാവു	ಮಕ್ಕಾವು
ഉത്തര മറിയാനാ ദ്വീപുകൾ	ಉತ್ತರ ಮಱಿಯಾನಾ ದ್ವೀಪುಕಳ್
മാർട്ടിനിക്ക്	ಮಾರ್ಟ್ಟಿನಿಕ್ಕ್
മൗറിറ്റാനിയ	ಮೌಱಿಱ್ಱಾನಿಯ
മൊണ്ടെസരത്ത്	ಮೊಣ್ಟೆಸರತ್ತ್
മാൾട്ട	ಮಾಳ್ಟ್ಟ
മൗറീഷ്യസ്	ಮೌಱೀಷ್ಯಸ್
മാലിദ്വീപ്	ಮಾಲಿದ್ವೀಪ್
മലാവി	ಮಲಾವಿ
മെക്സിക്കോ	ಮೆಕ್ಸಿಕ್ಕೋ
മലേഷ്യ	ಮಲೇಷ್ಯ
മൊസാംബിക്ക്	ಮೊಸಾಂಬಿಕ್ಕ್
നമീബിയ	ನಮೀಬಿಯ
പുതിയ കാലിഡോണിയ	ಪುತಿಯ ಕಾಲಿಡೋಣಿಯ
നൈജർ	ನೈಜರ್
നോർഫോക് ദ്വീപ്	ನೋರ್ಫೋಕ್ ದ್ವೀಪ್
നൈജീരിയ	ನೈಜೀರಿಯ
നിക്കരാഗ്വ	ನಿಕ್ಕರಾಗ್ವ
നെതർലാൻഡ്‌സ്	ನೆತರ್ಲಾನ್ಡ್‌ಸ್
നോർവെ	ನೋರ್ವೆ
നേപ്പാൾ	ನೇಪ್ಪಾಳ್
നൗറു	ನೌಱು
ന്യൂയി	ನ್ಯೂಯಿ
ന്യൂസിലാൻറ്	ನ್ಯೂಸಿಲಾನ್ಱ್
ഒമാൻ	ಒಮಾನ್
പനാമ	ಪನಾಮ
പെറു	ಪೆಱು
ഫ്രഞ്ച് പോളിനേഷ്യ	ಫ್ರಞ್ಚ್ ಪೋಳಿನೇಷ್ಯ
പാപ്പുവ ന്യൂ ഗിനിയ	ಪಾಪ್ಪುವ ನ್ಯೂ ಗಿನಿಯ
ഫിലിപ്പൈൻസ്	ಫಿಲಿಪ್ಪೈನ್ಸ್
പാക്കിസ്ഥാൻ	ಪಾಕ್ಕಿಸ್ಥಾನ್
പോളണ്ട്	ಪೋಳಣ್ಟ್
സെന്റ് പിയറിയും മിക്കലണും	ಸೆನ್ಱ್ ಪಿಯಱಿಯುಂ ಮಿಕ್ಕಲಣುಂ
പിറ്റ്‌കെയ്‌ൻ ദ്വീപുകൾ	ಪಿಱ್ಱ್‌ಕೆಯ್‌ನ್ ದ್ವೀಪುಕಳ್
പ്യൂർട്ടോ റിക്കോ	ಪ್ಯೂರ್ಟ್ಟೋ ಱಿಕ್ಕೋ
പാലസ്‌തീൻ പ്രദേശങ്ങൾ	ಪಾಲಸ್‌ತೀನ್ ಪ್ರದೇಶಙ್ಙಳ್
പലസ്‌തീൻ	ಪಲಸ್‌ತೀನ್
പോർച്ചുഗൽ	ಪೋರ್ಚ್ಚುಗಲ್
പലാവു	ಪಲಾವು
പരാഗ്വേ	ಪರಾಗ್ವೇ
ഖത്തർ	ಖತ್ತರ್
ദ്വീപസമൂഹം	ದ್ವೀಪಸಮೂಹಂ
റീയൂണിയൻ	ಱೀಯೂಣಿಯನ್
റൊമാനിയ	ಱೊಮಾನಿಯ
സെർബിയ	ಸೆರ್ಬಿಯ
റഷ്യ	ಱಷ್ಯ
റുവാണ്ട	ಱುವಾಣ್ಟ
സൗദി അറേബ്യ	ಸೌದಿ ಅಱೇಬ್ಯ
സോളമൻ ദ്വീപുകൾ	ಸೋಳಮನ್ ದ್ವೀಪುಕಳ್
സെയ്‌ഷെൽസ്	ಸೆಯ್‌ಷೆಲ್ಸ್
സുഡാൻ	ಸುಡಾನ್
സ്വീഡൻ	ಸ್ವೀಡನ್
സിംഗപ്പുർ	ಸಿಂಗಪ್ಪುರ್
സെൻറ് ഹെലീന	ಸೆನ್ಱ್ ಹೆಲೀನ
സ്ലോവേനിയ	ಸ್ಲೋವೇನಿಯ
സ്വാൽബാഡും ജാൻ മായേനും	ಸ್ವಾಲ್ಬಾಡುಂ ಜಾನ್ ಮಾಯೇನುಂ
സ്ലോവാക്യ	ಸ್ಲೋವಾಕ್ಯ
സിയെറ ലിയോൺ	ಸಿಯೆಱ ಲಿಯೋಣ್
സാൻ മറിനോ	ಸಾನ್ ಮಱಿನೋ
സെനഗൽ	ಸೆನಗಲ್
സോമാലിയ	ಸೋಮಾಲಿಯ
സുരിനെയിം	ಸುರಿನೆಯಿಂ
ദക്ഷിണ സുഡാൻ	ದಕ್ಷಿಣ ಸುಡಾನ್
സാവോ ടോമും പ്രിൻസിപെയും	ಸಾವೋ ಟೋಮುಂ ಪ್ರಿನ್ಸಿಪೆಯುಂ
എൽ സാൽവദോർ	ಎಲ್ ಸಾಲ್ವದೋರ್
സിന്റ് മാർട്ടെൻ	ಸಿನ್ಱ್ ಮಾರ್ಟ್ಟೆನ್
സിറിയ	ಸಿಱಿಯ
സ്വാസിലാൻറ്	ಸ್ವಾಸಿಲಾನ್ಱ್
ട്രസ്റ്റൻ ഡ കൂന	ಟ್ರಸ್ಱ್ಱನ್ ಡ ಕೂನ
ടർക്ക്‌സും കെയ്‌ക്കോ ദ്വീപുകളും	ಟರ್ಕ್ಕ್‌ಸುಂ ಕೆಯ್‌ಕ್ಕೋ ದ್ವೀಪುಕಳುಂ
ഛാഡ്	ಛಾಡ್
ഫ്രഞ്ച് ദക്ഷിണ ഭൂപ്രദേശം	ಫ್ರಞ್ಚ್ ದಕ್ಷಿಣ ಭೂಪ್ರದೇಶಂ
ടോഗോ	ಟೋಗೋ
തായ്‌ലാൻഡ്	ತಾಯ್‌ಲಾನ್ಡ್
താജിക്കിസ്ഥാൻ	ತಾಜಿಕ್ಕಿಸ್ಥಾನ್
ടോക്കെലൂ	ಟೋಕ್ಕೆಲೂ
തിമോർ-ലെസ്റ്റെ	ತಿಮೋರ್-ಲೆಸ್ಱ್ಱೆ
കിഴക്കൻ തിമോർ	ಕಿೞಕ್ಕನ್ ತಿಮೋರ್
തുർക്ക്മെനിസ്ഥാൻ	ತುರ್ಕ್ಕ್ಮೆನಿಸ್ಥಾನ್
ടുണീഷ്യ	ಟುಣೀಷ್ಯ
ടോംഗ	ಟೋಂಗ
തുർക്കി	ತುರ್ಕ್ಕಿ
ട്രിനിഡാഡും ടുബാഗോയും	ಟ್ರಿನಿಡಾಡುಂ ಟುಬಾಗೋಯುಂ
ടുവാലു	ಟುವಾಲು
തായ്‌വാൻ	ತಾಯ್‌ವಾನ್
ടാൻസാനിയ	ಟಾನ್ಸಾನಿಯ
ഉക്രെയ്‌ൻ	ಉಕ್ರೆಯ್‌ನ್
ഉഗാണ്ട	ಉಗಾಣ್ಟ
അമേരിക്കൻ ഐക്യനാടുകൾ	ಅಮೇರಿಕ್ಕನ್ ಐಕ್ಯನಾಟುಕಳ್
ഉറുഗ്വേ	ಉಱುಗ್ವೇ
ഉസ്‌ബെക്കിസ്ഥാൻ	ಉಸ್‌ಬೆಕ್ಕಿಸ್ಥಾನ್
വത്തിക്കാൻ	ವತ್ತಿಕ್ಕಾನ್
സെന്റ് വിൻസെന്റും ഗ്രനെഡൈൻസും	ಸೆನ್ಱ್ ವಿನ್ಸೆನ್ಱುಂ ಗ್ರನೆಡೈನ್ಸುಂ
വെനിസ്വേല	ವೆನಿಸ್ವೇಲ
ബ്രിട്ടീഷ് വെർജിൻ ദ്വീപുകൾ	ಬ್ರಿಟ್ಟೀಷ್ ವೆರ್ಜಿನ್ ದ್ವೀಪುಕಳ್
വിയറ്റ്നാം	ವಿಯಱ್ಱ್ನಾಂ
വന്വാതു	ವನ್ವಾತು
വാലിസ് ആന്റ് ഫ്യൂച്യുന	ವಾಲಿಸ್ ಆನ್ಱ್ ಫ್ಯೂಚ್ಯುನ
സമോവ	ಸಮೋವ
കൊസോവൊ	ಕೊಸೋವೊ
യെമൻ	ಯೆಮನ್
മയോട്ടി	ಮಯೋಟ್ಟಿ
ദക്ഷിണാഫ്രിക്ക	ದಕ್ಷಿಣಾಫ್ರಿಕ್ಕ
സാംബിയ	ಸಾಂಬಿಯ
സിംബാബ്‌വേ	ಸಿಂಬಾಬ್‌ವೇ
അജ്ഞാത പ്രദേശം	ಅಜ್ಞಾತ ಪ್ರದೇಶಂ
#
#
# Miscellaneous
എഩ്ഩാൽ	ಎನ್ನಾಲ್
പതിറ്റുപ്പത്തു	ಪತಿಱ್ಱುಪ್ಪತ್ತು
തമിഴ്	ತಮಿೞ್
ആലപ്പുഴ	ಆಲಪ್ಪುೞ
ദുഃഖം	ದುಃಖಂ
ഊഃ	ಊಃ
ഗൌതമ	ಗೌತಮ
ഗൗതമ	ಗೌತಮ
ശിവോഽഹം	ಶಿವೋಽಹಂ
നിൎവാണം	ನಿರ್ವಾಣಂ
സൂര്യൻ	ಸೂರ್ಯನ್
ഋഷി	ಋಷಿ
൦൧൨൩൪൫൬൭൮൯	೦೧೨೩೪೫೬೭೮೯
൰	೧೦
൱	೧೦೦
൲	೧೦೦೦
