# Baby names
അകര്ശാനാ	akarśānā
അക്ശൈനീഏ	akśainī'ē
അഗജാ	agajā
അചിംത	acinta
അചിത	acita
അച്ചിന്ദ്ര	accindra
അഡ്യാദവൈതാ	aḍyādavaitā
അദഭുതഃ	adabhutaḥ
അദേന്യ	adēn'ya
അദേല	adēla
അദ്രിതീ	adritī
അദ്രീഥീ	adrīthī
അദ്രീമാം	adrīmāṁ
അദ്വൈയാ	advaiyā
അധര്ഷ	adharṣa
അധിപാ	adhipā
അധീരതാ	adhīratā
അധ്യുത	adhyuta
അനംതാമായാ	anantāmāyā
അബരനാ	abaranā
അബിനയ	abinaya
അബിനാ	abinā
അബീനംദാ	abīnandā
അബീശാ	abīśā
അഭയ	abhaya
അഭയന	abhayana
അഭിഗ്ന്യാ	abhign'yā
അഭിജീതാ	abhijītā
അഭിനിവേശ	abhinivēśa
അഭിമ	abhima
അഭിമാനീ	abhimānī
അഭിമോദാ	abhimēādā
അഭിരാ	abhirā
അഭിരാത	abhirāta
അഭീരല	abhīrala
അഭീശ്രേയ	abhīśrēya
അഭീസുമത	abhīsumata
അഭ്യപ്സീത	abhyapsīta
അഭ്യുദയാ	abhyudayā
അമൃതാ	amr̥tā
അലകനംദാ	alakanandā
അലക്ഷാ	alakṣā
അല്കാ	alkā
അശവ	aśava
അശ്നേഇല	aśnē'ila
ആകാശലീനാ	ākāśalīnā
ആകൃഥീ	ākr̥thī
ആക്ഷ്യാ	ākṣyā
ആചാര്യ	ācārya
ആത്മയ	ātmaya
ആദി	ādi
ആദിമ	ādima
ആദീവ	ādīva
ആധീരേന	ādhīrēna
ആധ്യാ	ādhyā
ആനംദീനീ	ānandīnī
ആനീകാ	ānīkā
ആന്തീകാ	āntīkā
ആന്വീ	ānvī
ആപ്ത	āpta
ആപ്തി	āpti
ആമാംനീ	āmānnī
ആമിഷ	āmiṣa
ആമുക്ഥാ	āmukthā
ആയുസ	āyusa
ആയോദ	āyēāda
ആരംഭീ	ārambhī
ആരതീ	āratī
ആരസീ	ārasī
ആര്യ	ārya
ആര്യക	āryaka
ആര്യനാ	āryanā
ആര്യമാനീ	āryamānī
ആലേഃയാ	ālēḥyā
ആവംശ	āvanśa
ആവേശ	āvēśa
ആശകാ	āśakā
ആശിയാനാ	āśiyānā
ആശുതോഷ	āśutēāṣa
ആശ്മീന	āśmīna
ആശ്വിത	āśvita
ആസവ	āsava
ആസ്തിക	āstika
ഇക്ശാനാ	ikśānā
ഇജയാ	ijayā
ഇനീയന	inīyana
ഇനോദയ	inēādaya
ഇന്ദരകാന്ത	indarakānta
ഇന്ദിവാരസ	indivārasa
ഇന്ദുശിതാലാ	induśitālā
ഇന്ദ്രജാ	indrajā
ഇന്ദ്രതന	indratana
ഇന്ദ്രദയുമ്ന	indradayumna
ഇന്ദ്രവദന	indravadana
ഇന്ദ്രാണീ	indrāṇī
ഇബ്ബാനീ	ibbānī
ഇയുരേശ	iyurēśa
ഇയേനഗര	iyēnagara
ഇരാജ	irāja
ഇരിത	irita
ഇരേശ	irēśa
ഇലിസാ	ilisā
ഇശിതാ	iśitā
ഇശ്വാര്യ	iśvārya
ഇഷ്ടാ	iṣṭā
ഇഷ്ടി	iṣṭi
ഇസാര	isāra
ഇസ്ശും	is'śuṁ
ഈതന	ītana
ഈതികാ	ītikā
ഈരേന്പ്രിത	īrēnprita
ഈര്ശീതാ	īrśītā
ഈലാക്കീയാ	īlākkīyā
ഈലികാ	īlikā
ഈലേശാ	īlēśā
ഈശാര	īśāra
ഈശിക	īśika
ഈശ്വരദത്ത	īśvaradatta
ഈഹാ	īhā
ഉഗ്രസ്രവാസ	ugrasravāsa
ഉജവണീ	ujavaṇī
ഉജേശാ	ujēśā
ഉജ്ജന	ujjana
ഉജ്ജവല	ujjavala
ഉജ്ജവാലാ	ujjavālā
ഉജ്ജ്വലാ /ഉജ്വലാ	ujjvalā /ujvalā
ഉജ്ജ്വാലാ	ujjvālā
ഉത്കര്ഷ	utkarṣa
ഉത്കലാ	utkalā
ഉത്തര	uttara
ഉത്പര	utpara
ഉത്സര്ഗ	utsarga
ഉദയ കുമാര	udaya kumāra
ഉദരഥീ	udarathī
ഉദാന്തികാ	udāntikā
ഉദേയ	udēya
ഉദ്ധാര	ud'dhāra
ഉദ്യത	udyata
ഉദ്യമീ	udyamī
ഉദ്യോത	udyēāta
ഉധവ	udhava
ഉപംഗ	upaṅga
ഉപദാ	upadā
ഉപാധ്രീതീ	upādhrītī
ഉപ്പാസ	uppāsa
ഉമാ	umā
ഉമേശ്വര	umēśvara
ഉരിശിതാ	uriśitā
ഉര്ജാ	urjā
ഉര്ജീകാ	urjīkā
ഉര്ജീതാ	urjītā
ഉര്ദാഹാവ	urdāhāva
ഉര്മികാ	urmikā
ഉര്മിമാലാ	urmimālā
ഉര്വീനാഥ	urvīnātha
ഉല്പേശ	ulpēśa
ഉശേന്യ	uśēn'ya
ഉഷാശി	uṣāśi
ഉഷ്മാ	uṣmā
ഉസരീ	usarī
ഊതരാ	ūtarā
ഊര്വേശ	ūrvēśa
ഏകംശീ	ēkanśī
ഏകക്ഷരപരാ	ēkakṣaraparā
ഏകതന	ēkatana
ഏകതാ	ēkatā
ഏകാംശ	ēkānśa
ഏകാകാന്യ	ēkākān'ya
ഏകാനീ	ēkānī
ഏകാപര്നികാ	ēkāparnikā
ഏകേസ്വാര	ēkēsvāra
ഏത്തന	ēttana
ഏധിത	ēdhita
ഏമാ	ēmā
ഏലനാ	ēlanā
ഏലാ	ēlā
ഏലീലവേംദന	ēlīlavēndana
ഏലീലീ	ēlīlī
ഓഈസീന	ō'īsīna
ഓജസ്വീ	ōjasvī
ഓജാ	ōjā
ഓജീസ	ōjīsa
ഓനിശ	ōniśa
ഓമപ്രകാശ	ōmaprakāśa
ഓവീന	ōvīna
ഓവൈസ	ōvaisa
കംജ	kan̄ja
കംജന	kan̄jana
കംഠന	kaṇṭhana
കംദര്പ	kandarpa
കംപനാ	kampanā
കകോന	kakēāna
കതകീ	katakī
കതേല്യ്ന	katēlyna
കനക	kanaka
കനദ	kanada
കനാകംഗീ	kanākaṅgī
കനീജാ	kanījā
കനീരാ	kanīrā
കനീസാ	kanīsā
കനുഷ	kanuṣa
കന്വക	kanvaka
കന്ശീകാ	kanśīkā
കപാലീന	kapālīna
കപിലാശ്വര	kapilāśvara
കമലാപതി	kamalāpati
കമലിനീ	kamalinī
കമലേക്ഷണ	kamalēkṣaṇa
കമ്നാ	kamnā
കരാലാ	karālā
കരീസമാം	karīsamāṁ
കരുനാസ്രീ	karunāsrī
കരുപ്പസമ്യ	karuppasamya
കര്ണ	karṇa
കര്തീഗാ	kartīgā
കര്മദീപ	karmadīpa
കര്മാശ	karmāśa
കലരനീ	kalaranī
കലശ	kalaśa
കലാധര	kalādhara
കലാനിധി	kalānidhi
കലാപരണ	kalāparaṇa
കലാപീന	kalāpīna
കലാപ്രിയാ	kalāpriyā
കലൈസേലവീ	kalaisēlavī
കവന	kavana
കവിപ  പ്രിയ	kavipa  priya
കവീനാഥ	kavīnātha
കശ്തീ	kaśtī
കാജല	kājala
കാജീശ	kājīśa
കാദമ്ബരീ	kādambarī
കാധിരോലീ	kādhirēālī
കാനീ	kānī
കാന്ജീരാ	kānjīrā
കാന്തീ	kāntī
കാമത	kāmata
കാമിഷാ	kāmiṣā
കാമേശ	kāmēśa
കാരുണ്യ പ്രകാശ	kāruṇya prakāśa
കാരൂകാ	kārūkā
കാര്നിക	kārnika
കാലിക	kālika
കാലിപദാ	kālipadā
കാലിയാ	kāliyā
കാലീതാ	kālītā
കാവ്യ ശ്രീ	kāvya śrī
കിന്നേരാ	kinnērā
കീഅനാ	kī'anā
കീജല	kījala
കീനാരീ	kīnārī
കീന്ചനാ	kīncanā
കേകലാ	kēkalā
കേതന	kētana
കേനിഷാ	kēniṣā
കേളവ്യ	kēḷavya
കൈരവീ	kairavī
കൈലാശ	kailāśa
കോശേല	kēāśēla
കൌശികാ	keśikā
ഖഗേശ	khagēśa
ഖമീശ	khamīśa
ഖാതീരാവണ	khātīrāvaṇa
ഖാത്വന്ഗീന	khātvan'gīna
ഖീലതീ	khīlatī
ഖുസീ	khusī
ഗംഗാ	gaṅgā
ഗംദേശാ	gandēśā
ഗംധാര	gandhāra
ഗംധാരാ	gandhārā
ഗംധാലീ	gandhālī
ഗഗന	gagana
ഗജവദന	gajavadana
ഗജേന്ദ്ര	gajēndra
ഗണക	gaṇaka
ഗണനാ പംഡിതന	gaṇanā paṇḍitana
ഗണനാഥ	gaṇanātha
ഗണ്യാ	gaṇyā
ഗതി	gati
ഗനേസന	ganēsana
ഗന്ഗസീരുവന	gan'gasīruvana
ഗയാലികാ	gayālikā
ഗരിമാ	garimā
ഗരിഷ്ട	gariṣṭa
ഗരുല	garula
ഗാഇശ	gā'iśa
ഗാന്ഗമൈന്ദന	gān'gamaindana
ഗാമിനീ	gāminī
ഗായത്രീ	gāyatrī
ഗായലേ	gāyalē
ഗിഅന	gi'ana
ഗിയാ	giyā
ഗിരിവര	girivara
ഗീതി	gīti
ഗീതീശാ	gītīśā
ഗുംജാ	gun̄jā
ഗുനാജാ	gunājā
ഗുനാരത്നാ	gunāratnā
ഗുനാശേകാര	gunāśēkāra
ഗുനീന	gunīna
ഗുന്ജീതാ	gunjītā
ഗുപ്തക	guptaka
ഗുരദയാല	guradayāla
ഗുരദേവ	guradēva
ഗുരബാനീ	gurabānī
ഗുരമാന	guramāna
ഗുരുത്തമ	guruttama
ഗുര്നാന്ഡീശ	gurnānḍīśa
ഗുലമോഹര	gulamēāhara
ഗുവീദ	guvīda
ഗൂംജീതാ	gūn̄jītā
ഗൂഹാരീ	gūhārī
ഗേനേലിയാ	gēnēliyā
ഗേശനാ	gēśanā
ഗോപാല	gēāpāla
ഗോപീ നാഥ	gēāpī nātha
ഗോഭില	gēābhila
ഗോരഖ-നാഥ	gēārakha-nātha
ഗൌരവീ	geravī
ഗൌരീകാംത	gerīkānta
ഗൌരീശ	gerīśa
ഗൌര്പ്രിയാ	gerpriyā
ഗ്രീതേശ	grītēśa
ഗ്രീവാ	grīvā
ഗ്രീശ്മീതാ	grīśmītā
ഗ്രീഷ്മ	grīṣma
ഘടോതകത്ചാ	ghaṭēātakatcā
ചംചലാ	can̄calā
ചംദേര്ഭാന	candērbhāna
ചംദ്രകാംത	candrakānta
ചംദ്രകാംതാ	candrakāntā
ചംദ്രചുര	candracura
ചംദ്രപുശ്പാ	candrapuśpā
ചംദ്രപ്രകാശ	candraprakāśa
ചംദ്രമതി	candramati
ചംദ്രലേഖാ	candralēkhā
ചംദ്രഹാസ	candrahāsa
ചംദ്രാനന	candrānana
ചംദ്രാഭാ	candrābhā
ചംദ്രേശ	candrēśa
ചകേശ	cakēśa
ചകോര	cakēāra
ചക്ഷസ	cakṣasa
ചതുര	catura
ചതുരാ	caturā
ചതുര്ഭുജാ	caturbhujā
ചതുര്വേദീ	caturvēdī
ചത്രീയാ	catrīyā
ചന്ദ്രകേതു	candrakētu
ചരണ	caraṇa
ചരന്യാ	caran'yā
ചലാമാ	calāmā
ചാംദ	cānda
ചാനാസ്യാ	cānāsyā
ചാനേ	cānē
ചാന്ദനികാ	cāndanikā
ചാരുന	cāruna
ചാരുവീ	cāruvī
ചാര്മീ	cārmī
ചാര്വീ	cārvī
ചാവ്രിക	cāvrika
ചിത്കലാ	citkalā
ചിത്ത	citta
ചിത്തപ്രസാദ	cittaprasāda
ചിത്തരംജന	cittaran̄jana
ചിത്തരംജനീ	cittaran̄janī
ചിത്രകുന്ധാലാ	citrakundhālā
ചിത്രകേതു	citrakētu
ചിത്രഗംധാ	citragandhā
ചിത്രബാനാ	citrabānā
ചിത്രമാലാ	citramālā
ചിത്രര്ത	citrarta
ചിത്രല	citrala
ചിത്രലേഖാ	citralēkhā
ചിത്രാദീപ	citrādīpa
ചിത്രീനീ	citrīnī
ചിദംബര	cidambara
ചിദാനംദാ	cidānandā
ചിനാര	cināra
ചിന്നാദുരാഈ	cinnādurā'ī
ചിമന	cimana
ചീദാര്ത	cīdārta
ചീന്മയേ	cīnmayē
ചീരുഷ	cīruṣa
ചേതന്ദീപ	cētandīpa
ചേതള	cētaḷa
ചേഥാസാ	cēthāsā
ചേമ്മല	cēm'mala
ചേര്വിക	cērvika
ചേലന	cēlana
ചേലിയാഁ	cēliyāഁ
ചൈതന്യാ	caitan'yā
ചൈത്രാ	caitrā
ചൈരാവലീ	cairāvalī
ഛായാംക	chāyāṅka
ജക്ഷ	jakṣa
ജക്ഷാനീ	jakṣānī
ജഗതപ്രകാശ	jagataprakāśa
ജഗദഗുരു	jagadaguru
ജഗദമ്ബാ	jagadambā
ജഗനമോഹിനീ	jaganamēāhinī
ജഗന്മയീ	jaganmayī
ജഗ്വീ	jagvī
ജഗ്വീര	jagvīra
ജജ്വാല്യാ	jajvālyā
ജടായു	jaṭāyu
ജനഹിതാ	janahitā
ജനാദേവ	janādēva
ജനാവ	janāva
ജനിത	janita
ജമാംദാഗ്ന്യ മഹാദാര്പാ	jamāndāgn'ya mahādārpā
ജമ്ബവതപ്രീതി	jambavataprīti
ജയംത	jayanta
ജയചംദ	jayacanda
ജയപാല	jayapāla
ജയമാലാ	jayamālā
ജയശ്രീ	jayaśrī
ജയാകീര്തന	jayākīrtana
ജയാകേതന	jayākētana
ജയാപാദമാം	jayāpādamāṁ
ജയായ	jayāya
ജയിത	jayita
ജയേശ	jayēśa
ജലദ	jalada
ജല്പേശ	jalpēśa
ജശവംത	jaśavanta
ജസീത്താ	jasīttā
ജസ്സീ	jas'sī
ജാനകീ	jānakī
ജാനകീദാസ	jānakīdāsa
ജാനകീനാഥ	jānakīnātha
ജാനകീഭൂഷണ	jānakībhūṣaṇa
ജാനഹിതാ	jānahitā
ജാപക	jāpaka
ജായിത്രീ	jāyitrī
ജിനേശ്വര	jinēśvara
ജിഹാന	jihāna
ജീതേശ	jītēśa
ജീന്ദാല	jīndāla
ജീവനകലാ	jīvanakalā
ജീവനീ	jīvanī
ജീവന്തീനീ	jīvantīnī
ജുഷ്ടി	juṣṭi
ജേനീശാ	jēnīśā
ജേര്ശീകാ	jērśīkā
ജൈകാപിശ	jaikāpiśa
ജൈചരണ	jaicaraṇa
ജൈനീശ	jainīśa
ജൈപ്രകാശ	jaiprakāśa
ജൈവംത	jaivanta
ജൈസല	jaisala
ജൈഹാസീനീ	jaihāsīnī
ജോംഫീ	jēāmphī
ജോശനീകാ	jēāśanīkā
ജോശീതാ	jēāśītā
ജ്വാലാ	jvālā
ജ്ഹില	j'hila
ജ്ഹീണൂക	j'hīṇūka
ഝഹനവീ	jhahanavī
ഝാനീശാ	jhānīśā
ഝാരാ	jhārā
ഝീയാ	jhīyā
ഝേനീശാ	jhēnīśā
ഝ്യാനനീ	jhyānanī
ടീംകു	ṭīṅku
ഠുമരീ	ṭhumarī
തക്ശീ	takśī
തക്ശീല	takśīla
തജജ്ഞ	tajajña
തനവീ	tanavī
തനിഷ്ക	taniṣka
തനുംജാശ്രീ	tanun̄jāśrī
തനുംശ്കാ	tanunśkā
തനോജ	tanēāja
തപസ	tapasa
തപസ്വിനീ	tapasvinī
തമില  സേല്വീ	tamila  sēlvī
തമിശ	tamiśa
തമോഘ്നാ	tamēāghnā
തമോനഷ	tamēānaṣa
തരംജോത	taran̄jēāta
തരനീ	taranī
തരലാ	taralā
തരീനീ	tarīnī
തരുശ്രീ	taruśrī
തരൂണീ	tarūṇī
തവലീന :	tavalīna :
തവിഷാ	taviṣā
തസ്യ	tasya
താക്ഷ്യാ	tākṣyā
താജേന്ദര	tājēndara
താനാരുപീ	tānārupī
താനിയാ	tāniyā
താന്വീഥാ	tānvīthā
താപീ	tāpī
താരികാ	tārikā
താരീനീ	tārīnī
താരൂശ	tārūśa
താലംക	tālaṅka
താലീന	tālīna
താലേശ	tālēśa
താവന	tāvana
താവീശാ	tāvīśā
തിതലീ	titalī
തിനാശ	tināśa
തിലക	tilaka
തീഈവ്യേശ	tī'īvyēśa
തീര്ഥാ	tīrthā
തീസ്ചാ	tīscā
തുത്തീ	tuttī
തുനാവാ	tunāvā
തുന്ഗാര	tun'gāra
തുപമ	tupama
തുരഗ	turaga
തുശീഥാ	tuśīthā
തൃപേശ	tr̥pēśa
തേജസ	tējasa
തേജസ്വീ	tējasvī
തേജസ്വീന	tējasvīna
തേജേനദര	tējēnadara
തേജോമയ	tējēāmaya
തോയേശ	tēāyēśa
തോശീകാ	tēāśīkā
തൌരുസ	terusa
ത്രികായാ	trikāyā
ത്രിപുരസുംദരീ	tripurasundarī
ത്രിഭുവന	tribhuvana
ത്രിമാന	trimāna
ത്രിമൂര്തി	trimūrti
ത്രിവേണീ	trivēṇī
ത്രിശല	triśala
ത്രിശലാനാ	triśalānā
ത്രീഝ്യാ	trījhyā
ത്രീതിയാ	trītiyā
ത്രീനേശ	trīnēśa
ത്രീപന	trīpana
ത്രീപ്ത	trīpta
ത്രീവീദ	trīvīda
ത്വരിതാ	tvaritā
ത്വീശീ	tvīśī
ത്വേസാ	tvēsā
ഥംസീ	thansī
ഥനീരികാ	thanīrikā
ഥാകാപ്പന്സ്വാമീ	thākāppansvāmī
ഥാരികാ	thārikā
ഥാവനീ	thāvanī
ഥീരീശ്കാ	thīrīśkā
ഥുസീഥാ	thusīthā
ഥ്രേശാ	thrēśā
ദംദാപാനീ	dandāpānī
ദക്ഷാഹതാ	dakṣāhatā
ദബീത	dabīta
ദബ്ന്ശും	dabnśuṁ
ദയാദാ	dayādā
ദയാനിതാ	dayānitā
ദരഹാസ	darahāsa
ദര്ശ	darśa
ദര്ശക	darśaka
ദര്ശികാ	darśikā
ദര്ശീനീ	darśīnī
ദര്സീകാ	darsīkā
ദശാഗ്രീവാ ശീരോഹരാ	daśāgrīvā śīrēāharā
ദശാഗ്രീവാകുലാന്താകാ	daśāgrīvākulāntākā
ദശാനന	daśānana
ദഹാ	dahā
ദാനാസ്വീ	dānāsvī
ദാനുംശ്രീ	dānunśrī
ദാന്ദാകാരാന്യ പുന്യകൃതേ	dāndākārān'ya pun'yakr̥tē
ദാരുല	dārula
ദാഹക	dāhaka
ദികീശംദ	dikīśanda
ദിഗീശാ	digīśā
ദിപംശീ	dipanśī
ദിപശീകീ	dipaśīkī
ദിപേംദര	dipēndara
ദിപ്താ	diptā
ദിബസരീ	dibasarī
ദിവീഥാ	divīthā
ദിവേനാ	divēnā
ദീതാ	dītā
ദീനബംധു	dīnabandhu
ദീപഥീ	dīpathī
ദീപപ്രഭാ	dīpaprabhā
ദീപമാലാ	dīpamālā
ദീപശിഖാ	dīpaśikhā
ദീപാംജലി	dīpān̄jali
ദീപാശാ	dīpāśā
ദീപിത	dīpita
ദീവാംശ	dīvānśa
ദേജ	dēja
ദേബജ്യോതീ	dēbajyēātī
ദേബദാത്താ	dēbadāttā
ദേബദ്രിതാ	dēbadritā
ദേബന്ശീ	dēbanśī
ദേയ്വയാനാകാന്തന	dēyvayānākāntana
ദേവഗര്ഭാ	dēvagarbhā
ദേവജ്യോതി	dēvajyēāti
ദേവദാന	dēvadāna
ദേവന്ദ്ര	dēvandra
ദേവമദാനാ	dēvamadānā
ദേവരാജ	dēvarāja
ദേവശ്രീ	dēvaśrī
ദേവാംഗനാ	dēvāṅganā
ദേവാംഗീ	dēvāṅgī
ദേവാംശു	dēvānśu
ദേവാദീത്യാ	dēvādītyā
ദേവാനീ	dēvānī
ദേവാന്ശാ	dēvānśā
ദേവാപ്രിയാ	dēvāpriyā
ദേവാമനോഹാരീ	dēvāmanēāhārī
ദേവീന	dēvīna
ദേവീലാല	dēvīlāla
ദേവേന	dēvēna
ദേവേശീ	dēvēśī
ദേവ്യഹ്നാന	dēvyahnāna
ദേശാവംത	dēśāvanta
ദൈത്യാകുലാന്താകാ	daityākulāntākā
ദൈവ്യാ	daivyā
ധക്ശീന്യ	dhakśīn'ya
ധനസുഖ	dhanasukha
ധനാജീ	dhanājī
ധനിഷ്ഠ	dhaniṣṭha
ധനു	dhanu
ധനുജാ	dhanujā
ധനേശീ	dhanēśī
ധന്വികാ	dhanvikā
ധരമനിഷ്ഠ	dharamaniṣṭha
ധരാമാം	dharāmāṁ
ധരാഹാസീനീ	dharāhāsīnī
ധരീശ	dharīśa
ധര്മ  ദുത്ത	dharma  dutta
ധര്മഅധ്യക്ഷ	dharma'adhyakṣa
ധര്മദിത്യ	dharmaditya
ധര്മദേവ	dharmadēva
ധര്ശീതാ	dharśītā
ധര്ശീനീ	dharśīnī
ധാമീനീ	dhāmīnī
ധാരാനീ	dhārānī
ധിതി	dhiti
ധിതീ	dhitī
ധീപ്ത്ഹാ	dhīpt'hā
ധീമാഹീ	dhīmāhī
ധീര്ഥാ	dhīrthā
ധേയാംശീ	dhēyānśī
ധൈര്യ്യാ	dhairyyā
ധ്യുഥീ	dhyuthī
ധ്രുമീ	dhrumī
നംദക	nandaka
നംദു	nandu
നക്ശ	nakśa
നക്സത്രരാജാ	naksatrarājā
നഗമാനീ	nagamānī
നടവര	naṭavara
നത്രീശാ	natrīśā
നദീപ	nadīpa
നഭാ	nabhā
നഭോമാനീ	nabhēāmānī
നമന	namana
നമനാ	namanā
നയന	nayana
നരേന്ദ്രന	narēndrana
നരേന്ദ്രനാഥ	narēndranātha
നരേശ	narēśa
നവനീത വിലീപ്തംഗാ	navanīta vilīptaṅgā
നവമ	navama
നവരംഗ	navaraṅga
നസീബ	nasība
നാംബീ	nāmbī
നാഗനാഥ	nāganātha
നാഗപാല	nāgapāla
നാഗേശ്വരണ	nāgēśvaraṇa
നാഗൈഃ	nāgaiḥ
നാതാഭൈരവീ	nātābhairavī
നാതിന	nātina
നാന്ധീനീ	nāndhīnī
നാന്നാന	nānnāna
നാഭിതാ	nābhitā
നാഭേംദു	nābhēndu
നാമത	nāmata
നായകീ	nāyakī
നായാനീ	nāyānī
നായാനീകാ	nāyānīkā
നാലിനികാംത	nālinikānta
നാലീനേശയ	nālīnēśaya
നാവീന്യ	nāvīn'ya
നാവീല	nāvīla
നാവ്യാ ദുര്ഗാ	nāvyā durgā
നാവ്രീതാ	nāvrītā
നികാരാ	nikārā
നിഖിതാ	nikhitā
നിഖില	nikhila
നിജു	niju
നിധി	nidhi
നിധിപാ	nidhipā
നിപാ	nipā
നിരംജനാ	niran̄janā
നിരമഈ	nirama'ī
നിരുപമാ	nirupamā
നിര്മളാ	nirmaḷā
നിര്മിതി	nirmiti
നിലാശാ	nilāśā
നിശാനഥീ	niśānathī
നീഗീഥാ	nīgīthā
നീതു	nītu
നീഥീകാ	nīthīkā
നീധാ	nīdhā
നീധാര്സനാ	nīdhārsanā
നീമാംലന	nīmānlana
നീരാലികാ	nīrālikā
നീരൈമാംഥീ	nīraimānthī
നീര്മുകതാ	nīrmukatā
നീല മാധവ	nīla mādhava
നീലംജന	nīlan̄jana
നീലക്ഷ	nīlakṣa
നീല്ജാ	nīljā
നീശാലീ	nīśālī
നീശീതീ	nīśītī
നീശ്മീഥാ	nīśmīthā
നീസ്ചീഥാ	nīscīthā
നീഹാ	nīhā
നേമീശാ	nēmīśā
നേയ്സാ	nēysā
നേരീശാ	nērīśā
നൈജാ	naijā
നൈരീതീ	nairītī
നൈവേധീ	naivēdhī
നൌസദ	nesada
പംകജന	paṅkajana
പംചഭൂതാത്മികാ	pan̄cabhūtātmikā
പംഥീനീ	panthīnī
പഝ്ഹേനീ	pajhhēnī
പത്താമ്ബരാപരീധാനാ	pattāmbarāparīdhānā
പത്ര	patra
പന്ദാലാവാസന	pandālāvāsana
പമ്പാ	pampā
പമ്ഫാ	pamphā
പയാസ	payāsa
പയോധീ	payēādhī
പരംതാപാ	parantāpā
പരമാംത്മികാ	paramāntmikā
പരമാംന്ത്ര	paramānntra
പരമിലാ	paramilā
പരമേശ്വരീ	paramēśvarī
പരമ്വാര്ദാന	paramvārdāna
പരവാനീ	paravānī
പരവിംദര	paravindara
പരാകാഷ	parākāṣa
പരാവീ	parāvī
പരിഹാ	parihā
പര്തീബന	partībana
പര്ലീ	parlī
പര്വ	parva
പലാക്ഷ	palākṣa
പലാശീനീ	palāśīnī
പവന	pavana
പവനസുത	pavanasuta
പശുപതി	paśupati
പഹലാജ	pahalāja
പാടലാ	pāṭalā
പാന്ദുരംഗാ	pānduraṅgā
പായല	pāyala
പാരു	pāru
പാര്ഥിക	pārthika
പാര്ഥീവീ	pārthīvī
പാര്ഥോ	pārthēā
പാളവീ	pāḷavī
പാവകീ	pāvakī
പാവനാ	pāvanā
പാവാനാ	pāvānā
പാഹീ	pāhī
പിവാല	pivāla
പൂജന	pūjana
പൂരതീ	pūratī
പൂരികാ	pūrikā
പൂര്വജാ	pūrvajā
പൂര്വികാ	pūrvikā
പേഖമ	pēkhama
പേത്ചീ	pētcī
പേരാരസീ	pērārasī
പ്രകൃഥീ	prakr̥thī
പ്രഗന്യാ	pragan'yā
പ്രഗ്യപരാമിതാ	pragyaparāmitā
പ്രജാനാ	prajānā
പ്രനാദാ	pranādā
പ്രനീധാനാ	pranīdhānā
പ്രബകരണ	prabakaraṇa
പ്രഭാകര	prabhākara
പ്രഭാകരന	prabhākarana
പ്രഭാത	prabhāta
പ്രഭാവ	prabhāva
പ്രാതീകാ	prātīkā
ഫനീ	phanī
ഫനീഭുഷണ	phanībhuṣaṇa
ഫാല്ഗുനീ	phālgunī
ഫൂലന	phūlana
ഫ്രാന്ചീസ	phrāncīsa
ബംദിശ	bandiśa
ബംധൂല	bandhūla
ബംശീ	banśī
ബംസീധര	bansīdhara
ബകുലാ	bakulā
ബകൂല	bakūla
ബദ്രീ	badrī
ബനജ	banaja
ബനവാരീ	banavārī
ബബന	babana
ബബിശ	babiśa
ബര്ഹന	bar'hana
ബലബീര	balabīra
ബഹവാസ്യ	bahavāsya
ബാബു	bābu
ബാബുല	bābula
ബാല മുകുന്ദ	bāla mukunda
ബാലധി	bāladhi
ബാലാമോഹന	bālāmēāhana
ബാലാരാജ	bālārāja
ബാലാശംകര	bālāśaṅkara
ബാലു	bālu
ബാലേന്ദു	bālēndu
ബാസ്കാര	bāskāra
ബിനീതാ	binītā
ബീനും	bīnuṁ
ബീന്ദുശ്രീ	bīnduśrī
ബീന്നീകേര	bīnnīkēra
ബീപുല	bīpula
ബീബീന	bībīna
ബീരത	bīrata
ബീഹാന	bīhāna
ബേനീതാ	bēnītā
ബേനും	bēnuṁ
ബേലുരമീ	bēluramī
ബേല്ലീ	bēllī
ബൈവാവീ	baivāvī
ബൈസാഖീ	baisākhī
ബ്രീഥ്ഹീ	brīthhī
ബ്ലേസ്സീ	blēs'sī
ഭഗവാന	bhagavāna
ഭദ്രക്ഷ	bhadrakṣa
ഭദ്രനിധി	bhadranidhi
ഭദ്രപ്രിയാ	bhadrapriyā
ഭദ്രിക	bhadrika
ഭദ്രീശാ	bhadrīśā
ഭവാനീ	bhavānī
ഭവ്യരാജ	bhavyarāja
ഭാഗവംതീ	bhāgavantī
ഭാദരന	bhādarana
ഭാനുമിത്ര	bhānumitra
ഭാരഥീ	bhārathī
ഭാര്ഗവന	bhārgavana
ഭാര്ഗവാ	bhārgavā
ഭാര്ഘവീ	bhārghavī
ഭാര്ദ്ദ്വാജ	bhārddvāja
ഭാലേംദ്ര	bhālēndra
ഭാവതീ	bhāvatī
ഭാവീഗുരും	bhāvīguruṁ
ഭാവ്യമ	bhāvyama
ഭാശ്വീനീ	bhāśvīnī
ഭാസു	bhāsu
ഭാസ്കാരീ	bhāskārī
ഭാസ്കേര	bhāskēra
ഭീമശംകര	bhīmaśaṅkara
ഭൂദേവ	bhūdēva
ഭൂപത	bhūpata
ഭൂപാല	bhūpāla
ഭൂമാ	bhūmā
ഭൂമാം	bhūmāṁ
ഭേരേശ	bhērēśa
ഭൈരവീ	bhairavī
മംഗലമ	maṅgalama
മംഗേശ	maṅgēśa
മംജു  പ്രസന്ന	man̄ju  prasanna
മംജുനാഥ	man̄junātha
മംജുലാ	man̄julā
മംത	manta
മംതോഷ	mantēāṣa
മംദിഥാ	mandithā
മംദിരാ	mandirā
മകാലീ	makālī
മകുര	makura
മഗന	magana
മണികാംത	maṇikānta
മദുരാ	madurā
മധുനിഷാ	madhuniṣā
മധുമാംലീ	madhumānlī
മധുരിമാ	madhurimā
മധുവംതീ	madhuvantī
മനജീത	manajīta
മനപ	manapa
മനസ്വിന	manasvina
മനാല്പ	manālpa
മനീതാ	manītā
മനീഷ	manīṣa
മനോജ	manēāja
മനോരനജനീ	manēāranajanī
മനോരിഥാ	manēārithā
മന്നത	mannata
മന്മായീ	manmāyī
മല്ലികാ	mallikā
മഹംത	mahanta
മഹാതപസ്വീ	mahātapasvī
മഹാദുര്ഗാ	mahādurgā
മഹാദേവാ	mahādēvā
മഹാദേവാദീപുജീതാ	mahādēvādīpujītā
മഹാന്തേശ	mahāntēśa
മഹാബാലാ	mahābālā
മഹാസ്വേതാ	mahāsvētā
മഹിപതി	mahipati
മഹിഷാസുരമര്ദിനീ	mahiṣāsuramardinī
മഹീജിത	mahījita
മഹേംദ്രാ	mahēndrā
മഹേശ	mahēśa
മഹേശനീ	mahēśanī
മഹേശീ	mahēśī
മാംതിക	māntika
മാംനീമോഝ്ഹീ	mānnīmēājhhī
മാംനുസരീ	mānnusarī
മാംന്ക്ഷ	mānnkṣa
മാംന്ഗീരീ	mānn'gīrī
മാംന്താവ്യാഹ	mānntāvyāha
മാംന്തീകാ	mānntīkā
മാംന്ദീതാ	mānndītā
മാംലാമാംകാല മകാന	mānlāmāṅkāla makāna
മാഇല	mā'ila
മാനകാ	mānakā
മാനജ	mānaja
മാനശ	mānaśa
മാനിക	mānika
മാനീശീന	mānīśīna
മാനോരിത	mānēārita
മാന്കന	mānkana
മാന്ദാവിക	māndāvika
മായാ	māyā
മാര്ഗശീ	mārgaśī
മാര്ഗീ	mārgī
മാര്തംദ	mārtanda
മാര്ഥീകാ	mārthīkā
മാര്യ	mārya
മാര്യാ	māryā
മാര്ഷാ	mārṣā
മാലാര്കോഡീ	mālārkēāḍī
മാലിനീ	mālinī
മാല്ലേശാ	māllēśā
മാസൂമ	māsūma
മാസൂമീ	māsūmī
മാഹിയാ	māhiyā
മാഹിരാജ	māhirāja
മാഹുലീ	māhulī
മിലീ	milī
മിഹീകാ	mihīkā
മീനാ	mīnā
മേധ	mēdha
മേധീനീ	mēdhīnī
മൈത്രായ	maitrāya
മൌലീശാ	melīśā
മ്യ്ഥിലീ	mythilī
യംശ	yanśa
യക്ഷ	yakṣa
യജും	yajuṁ
യജുസ	yajusa
യജ്നേശ	yajnēśa
യഥാര്ഥ	yathārtha
യദുനംദന	yadunandana
യശസ്വിനീ	yaśasvinī
യശാശ്രീ	yaśāśrī
യശ്ദീപ	yaśdīpa
യശ്മിത	yaśmita
യശ്മിതാ	yaśmitā
യശ്വാര്ധാനാ	yaśvārdhānā
യശ്വീന	yaśvīna
യശ്വീനീ	yaśvīnī
യസ്വംഥ	yasvantha
യാക്സീനീ	yāksīnī
യാഗ്നാകായാ	yāgnākāyā
യാഗ്നീഥാ	yāgnīthā
യാചന	yācana
യാതീരാജു	yātīrāju
യാദവീ	yādavī
യാദവേന്ദ്ര	yādavēndra
യാന്തി	yānti
യാശ്രീഥാ	yāśrīthā
യാഷ്ക	yāṣka
യാസസ്വീ	yāsasvī
യുഗന്തീകാ	yugantīkā
യുഗപ	yugapa
യുഗാന്ധര	yugāndhara
യുതി	yuti
യുവംശ	yuvanśa
യുവനാഥ	yuvanātha
യുവല	yuvala
യുവാഥീ	yuvāthī
യുവാന  സൂര്യ	yuvāna  sūrya
യുവ്നീക	yuvnīka
യേര്രപ്പാ	yērrappā
യേശനാ	yēśanā
യേശാസ്വീനീ	yēśāsvīnī
യേസസരീ	yēsasarī
യോഗദേവാ	yēāgadēvā
യോഗരാജ	yēāgarāja
യോഗാനംദ	yēāgānanda
യോഗിത	yēāgita
യോഗിതാ	yēāgitā
യോഗിഥ	yēāgitha
യോഗേശ്വര	yēāgēśvara
യോഗ്ദീപ	yēāgdīpa
യോത്ശനാ	yēātśanā
യോനേന്ദ്ര	yēānēndra
യോഹ്ശീനീ	yēāhśīnī
യൌവാനീ	yevānī
രംഗനാഥ	raṅganātha
രംജന	ran̄jana
രംജികാ	ran̄jikā
രംജീവ	ran̄jīva
രഈര്ഥ	ra'īrtha
രക്ത	rakta
രക്തകമള	raktakamaḷa
രക്ഷികാ	rakṣikā
രക്ഷിത	rakṣita
രഘവാ	raghavā
രഘവേന്ദര	raghavēndara
രഘുനാഥ	raghunātha
രജത	rajata
രജനീശ	rajanīśa
രജനേശ	rajanēśa
രജീത	rajīta
രതന	ratana
രതാംജലി	ratān̄jali
രതീക	ratīka
രതുല	ratula
രത്നാകര	ratnākara
രത്നാബലീ	ratnābalī
രഥനാ	rathanā
രന്യ	ran'ya
രന്വിഥാ	ranvithā
രബേക	rabēka
രമാംസ്വമ്യ	ramānsvamya
രമ്ബേശ	rambēśa
രയാന	rayāna
രര്ശ്മീതാ	rarśmītā
രവി കാന്ത	ravi kānta
രവികാംത	ravikānta
രവിത	ravita
രവീജാ	ravījā
രവീനാ	ravīnā
രവ്യംകീ	ravyaṅkī
രശീലാ	raśīlā
രസവംത	rasavanta
രസ്മീന	rasmīna
രാഈ കുമാര	rā'ī kumāra
രാഖീ	rākhī
രാഗാവ	rāgāva
രാഗിനീ	rāginī
രാഗേശ	rāgēśa
രാഗ്വേദ	rāgvēda
രാജക	rājaka
രാജകന്യാ	rājakan'yā
രാജഗോപാല	rājagēāpāla
രാജയവര്ദന	rājayavardana
രാജാ	rājā
രാജാര്ശീ	rājārśī
രാജികാ	rājikā
രാജീവ	rājīva
രാജേംദ്രമോഹന	rājēndramēāhana
രാജേശ്വര	rājēśvara
രാജ്യശ്രീ	rājyaśrī
രാധാനീ	rādhānī
രാനീ	rānī
രാമ  കീന്കാര	rāma  kīnkāra
രാമഗോപാല	rāmagēāpāla
രാമചന്ദ്രന	rāmacandrana
രാമനാരായണ	rāmanārāyaṇa
രാമരാ	rāmarā
രാമരാജ	rāmarāja
രാമാംസുഗ്രീവാ	rāmānsugrīvā
രാമാനംദ	rāmānanda
രാമാനുജമ	rāmānujama
രാമോജീ	rāmēājī
രാഹിത്യ	rāhitya
രാഹീന്യ	rāhīn'ya
രാഹുലരാജ	rāhularāja
രിദ്ധി	rid'dhi
രീചികാ	rīcikā
രീതൂ	rītū
രീഥേകാ	rīthēkā
രീദേവ	rīdēva
രീധമാം	rīdhamāṁ
രീഭ്യാ	rībhyā
രീശും	rīśuṁ
രീശ്മേഥാ	rīśmēthā
രേഖാ	rēkhā
രേത്വിക	rētvika
രേധാ	rēdhā
രേനാ	rēnā
രേനേശ	rēnēśa
രേമാംനീകാ	rēmānnīkā
രേമീ	rēmī
രേവാതീ	rēvātī
രേവീഥാ	rēvīthā
രേശമീ	rēśamī
രേശ്വീന	rēśvīna
രേഹാംശീ	rēhānśī
രേഹാനാ	rēhānā
രേഹേഈലാ	rēhē'īlā
രേഹ്നുഘാ	rēhnughā
രൈവത	raivata
രൈവതാ	raivatā
ലംഗീത	laṅgīta
ലക്ഷ	lakṣa
ലക്ഷാകീ	lakṣākī
ലക്ഷിതാ	lakṣitā
ലക്ഷ്മീകാനതമ	lakṣmīkānatama
ലജ്ജാ	lajjā
ലജ്ജാകാ	lajjākā
ലതാ	latā
ലതേശ	latēśa
ലവപാല	lavapāla
ലവലീന	lavalīna
ലഹരീ	laharī
ലാക്ശേതാ	lākśētā
ലാജവംതീ	lājavantī
ലാതീശ	lātīśa
ലാനീബന	lānībana
ലാഭാ	lābhā
ലാമ്ബോധാര	lāmbēādhāra
ലാരീനാ	lārīnā
ലാര്മികാ	lārmikā
ലാര്രാജ	lārrāja
ലാര്ശന	lārśana
ലാവനീ	lāvanī
ലാവിനാ	lāvinā
ലീകേശ	līkēśa
ലീത്സാ	lītsā
ലീനാശാ	līnāśā
ലീനീത	līnīta
ലീപാക്ഷീ	līpākṣī
ലീപ്സീകാ	līpsīkā
ലീമനാ	līmanā
ലീലാമഈ	līlāma'ī
ലീശാംത	līśānta
ലുസിയാ	lusiyā
ലേഈവീനാ	lē'īvīnā
ലേഖീശാ	lēkhīśā
ലേമാര	lēmāra
ലോകനേത്ര	lēākanētra
ലോകാജനാനീ	lēākājanānī
ലോകാമാത്രീ	lēākāmātrī
ലോകീഥാ	lēākīthā
ലോകേന്ദ്ര	lēākēndra
ലോഗീനീ	lēāgīnī
ലോഗേശ്വരണ	lēāgēśvaraṇa
ലോചനാ	lēācanā
ലോനാ	lēānā
ലോമാംകേശ	lēāmāṅkēśa
ലോഹിത	lēāhita
ലോഹിതാശ്വാ	lēāhitāśvā
ലൌക്യ	lekya
വംദിതാ	vanditā
വംസികൃഷ്ണ	vansikr̥ṣṇa
വനദ	vanada
വനമാംഥീ	vanamānthī
വനസ	vanasa
വനിനാധ	vaninādha
വന്ജുല	vanjula
വപുസ	vapusa
വയദീശ	vayadīśa
വരലീ	varalī
വരിന	varina
വരിയാസ	variyāsa
വരുന	varuna
വരുനികാ	varunikā
വര്ണിത	varṇita
വര്ധമാന	vardhamāna
വര്ധാനീ	vardhānī
വര്ധീമൈനകാപുജീതാ	vardhīmainakāpujītā
വര്നീശാ	varnīśā
വര്ശനേയാ	varśanēyā
വര്ശീകാ	varśīkā
വര്ശീതാ	varśītā
വര്ശീദ	varśīda
വര്ഷനീ	varṣanī
വല്ലികാ	vallikā
വസംതാ	vasantā
വസംതീ	vasantī
വസീസതാ	vasīsatā
വസുമിത്ര	vasumitra
വസുസേന	vasusēna
വാക്പതി	vākpati
വാക്ഷു	vākṣu
വാച്യ	vācya
വാജ്രക്ഷ	vājrakṣa
വാതത്മാജ	vātatmāja
വാത്സല്യ	vātsalya
വാദിവേലും	vādivēluṁ
വാനര	vānara
വാന്ശുല	vānśula
വാമന	vāmana
വാമാംക്ഷീ	vāmāṅkṣī
വാമീല	vāmīla
വാരനാ	vāranā
വാരുനീ	vārunī
വാലാരമാംഥീ	vālāramānthī
വാല്ല്മാംനാലന	vāllmānnālana
വാശു	vāśu
വാസുമന	vāsumana
വാഹിനീ	vāhinī
വികീശാ	vikīśā
വിക്ഷിത	vikṣita
വിജയാലക്ഷ്മീ	vijayālakṣmī
വിജയാശാനഥീ	vijayāśānathī
വിജീതാ	vijītā
വിദിശാ	vidiśā
വിദ്യാ	vidyā
വിദ്യുല	vidyula
വിധാഥരീ	vidhātharī
വിന്ധുജാ	vindhujā
വിബാലീ	vibālī
വിഭാവാ	vibhāvā
വിഭൂതി	vibhūti
വിഭൂഷ	vibhūṣa
വിയാമര്ശ	viyāmarśa
വിരഗനാപതീ	viraganāpatī
വിരഭാദ്രപ്പാ	virabhādrappā
വിരാജ	virāja
വിലാശീനീ	vilāśīnī
വീണാ	vīṇā
വീണാധാരീ	vīṇādhārī
വേക്രാംത	vēkrānta
വേഗ	vēga
വേഗവാഹീനീ	vēgavāhīnī
വേഗീ	vēgī
വേണു	vēṇu
വേത്ത്രീ	vēttrī
വേത്രിവാല	vētrivāla
വേത്രീവേല	vētrīvēla
വേദകാര്തിക	vēdakārtika
വേദവല്ലീ	vēdavallī
വേദാ	vēdā
വേദാ ശ്രീ	vēdā śrī
വേധാംത	vēdhānta
വേന്കാത്രമണ	vēnkātramaṇa
വേന്തന	vēntana
വേന്നേലാ	vēnnēlā
വേന്മതീ	vēnmatī
വേലു	vēlu
വേഹംത	vēhanta
വൈകുംഠ	vaikuṇṭha
വൈജീനാഥ	vaijīnātha
വൈദത	vaidata
വൈദേഹീ	vaidēhī
വൈദ്യുംത	vaidyunta
വൈധേ	vaidhē
വൈധ്യാത	vaidhyāta
വൈരാഗ	vairāga
വൈരോചന	vairēācana
വൈശാലീ	vaiśālī
വൈശ്വീ	vaiśvī
വൈഷ്ണവീ	vaiṣṇavī
വൈസകാ	vaisakā
സംക്രാംതി	saṅkrānti
സംഗമിത്ര	saṅgamitra
സംഗമീധീരാ	saṅgamīdhīrā
സംചയ	san̄caya
സംചീതീ	san̄cītī
സംജേനാ	san̄jēnā
സംജോലീ	san̄jēālī
സംതോക	santēāka
സംദിപോന	sandipēāna
സംദീപ	sandīpa
സംദേശ	sandēśa
സംധരാ	sandharā
സംധ്യാ	sandhyā
സംബീതാ	sambītā
സംമീതാ	sammītā
സംയുക്ത	sanyukta
സംവിധാ	sanvidhā
സംവീഥാ	sanvīthā
സംസ്കൃതി	sanskr̥ti
സംഹിത	sanhita
സക്ശീന്യാ	sakśīn'yā
സഖ്യാ	sakhyā
സഗന	sagana
സഗുനാ	sagunā
സചിതാ	sacitā
സചിദാനംദ വിഗ്രഹ	sacidānanda vigraha
സചേതന	sacētana
സച്ചിദാനംദാ	saccidānandā
സജീത	sajīta
സജീലീ	sajīlī
സദഗതി	sadagati
സദഗുനാ	sadagunā
സദാശിവ	sadāśiva
സദിശ	sadiśa
സപനാ	sapanā
സപുഷ്പാ	sapuṣpā
സപ്താബീ	saptābī
സപ്തോര്ശീ	saptēārśī
സമജാ	samajā
സമദര്ശീ	samadarśī
സമഭ്ദ്ധാ	samabhd'dhā
സമരേശ	samarēśa
സമാംദ്രിതാ	samāndritā
സമാംര്ധ	samānrdha
സമാജസ	samājasa
സമാരാസ്യാ	samārāsyā
സമിക	samika
സമിരന	samirana
സമേംദ്ര	samēndra
സമേശ	samēśa
സമ്പൂര്ണ	sampūrṇa
സമ്പ്രഥ്യ	samprathya
സമ്പ്രീതീ	samprītī
സമ്രാട	samrāṭa
സമ്രീധ	samrīdha
സരസംഗീ	sarasaṅgī
സലീജ	salīja
സഹര്സീതാ	saharsītā
സഹശ്രദ	sahaśrada
സഹസ്ത്രജീത	sahastrajīta
സഹസ്ത്രബാഹു	sahastrabāhu
സഹീത	sahīta
സഹീരാമ	sahīrāma
സഹ്യ	sahya
സാംജ	sān̄ja
സാഇ രാമ	sā'i rāma
സാഈനാഥ	sā'īnātha
സാചീ	sācī
സാജന	sājana
സാദ്രീശീ	sādrīśī
സാദ്വിഥാ	sādvithā
സാധന	sādhana
സാധ്യാ	sādhyā
സാനിധ്യ	sānidhya
സാമംതാ	sāmantā
സാമ്ഭാ	sāmbhā
സാരണീ	sāraṇī
സാരഥീ	sārathī
സാരികാ	sārikā
സാലവീ	sālavī
സാലസാ	sālasā
സൈകത	saikata
സൈനീത്യ	sainītya
സൈന്ധന്യ	saindhan'ya
സൈലീ	sailī
സൈഹാര്സന	saihārsana
ഹംസമാലാ	hansamālā
ഹംസാവാഥ്യ	hansāvāthya
ഹനാര്വീന	hanārvīna
ഹനീതാ	hanītā
ഹനുപ	hanupa
ഹനുമാന	hanumāna
ഹബീതാ	habītā
ഹമസാദീപികാ	hamasādīpikā
ഹമസാനംദീനീ	hamasānandīnī
ഹമീര	hamīra
ഹരജീത	harajīta
ഹരജീവന	harajīvana
ഹരനാധ	haranādha
ഹരശും	haraśuṁ
ഹരികിശന	harikiśana
ഹരിഗംഗാ	harigaṅgā
ഹരിഗോപാല	harigēāpāla
ഹരിദാസ	haridāsa
ഹരിദ്വാര	haridvāra
ഹരിപ്രീത	hariprīta
ഹരിമംതീ	harimantī
ഹരീ	harī
ഹരേശ്വര	harēśvara
ഹര്മീന	harmīna
ഹര്ഷണ	harṣaṇa
ഹര്സികാ	harsikā
ഹശ്മീതാ	haśmītā
ഹസമുഖ	hasamukha
ഹസീതാ	hasītā
ഹസ്വീഥാ	hasvīthā
ഹാര്ദീനീ	hārdīnī
ഹാര്ശീനീ	hārśīnī
ഹാലിക	hālika
ഹിംഡോള	hiṇḍēāḷa
ഹിംദോലാ	hindēālā
ഹിതാക്ഷീ	hitākṣī
ഹിതീ	hitī
ഹിഥീക്സാ	hithīksā
ഹിമാംശു	himānśu
ഹിമാക്ഷ	himākṣa
ഹിമാലയ	himālaya
ഹിരംയക	hiranyaka
ഹിരവ	hirava
ഹിരവാ	hiravā
ഹിരുധായാ	hirudhāyā
ഹിവാ	hivā
ഹീരാനമാം	hīrānamāṁ
ഹീരാന്യാപ്രകാഈ	hīrān'yāprakā'ī
ഹീര്നാക്ഷീ	hīrnākṣī
ഹുവീശ്കാ	huvīśkā
ഹൃദയനാഥ	hr̥dayanātha
ഹേഈദീ	hē'īdī
ഹേജല	hējala
ഹേതാ	hētā
ഹേതാശ	hētāśa
ഹേത്ശ്രീ	hētśrī
ഹേഥാന്ശ്രീ	hēthānśrī
ഹേനീത	hēnīta
ഹേനീല	hēnīla
ഹേമനാഥ	hēmanātha
ഹേമലതാ	hēmalatā
ഹേമാ	hēmā
ഹേമാംദ്രികാ	hēmāndrikā
ഹേമാഗൌരീ	hēmāgerī
ഹേമാനംദ	hēmānanda
ഹേമാലാ	hēmālā
ഹേമാവതീ	hēmāvatī
ഹേമാവാതിനംദന	hēmāvātinandana
ഹേമേംദു	hēmēndu
ഹേയന	hēyana
ഹേയാംശ	hēyānśa
ഹേരീത	hērīta
ഹേലീ	hēlī
ഹോന്നേശാ	hēānnēśā
ഹോമാ	hēāmā
ഹ്രീത്വിക	hrītvika
ഹ്രീദാന്ക്ഷ	hrīdānkṣa
ഹ്രീധാന	hrīdhāna
ഹ്രീശന	hrīśana
ഹ്രീശാംത	hrīśānta
ഹ്രീഷിത	hrīṣita
ഹ്രുദയ	hrudaya
ഹ്രുശാല	hruśāla
ഹ്രേയാംശ	hrēyānśa
ഹ്ര്യ്ദയേശ	hrydayēśa
#
#
# Territory names from CLDR
അസൻഷൻ ദ്വീപ്	asanṣan dvīp
അന്റോറ	anṟēāṟa
യുണൈറ്റഡ് അറബ് എമിറൈറ്റ്‌സ്	yuṇaiṟṟaḍ aṟab emiṟaiṟṟ‌s
അഫ്‌ഗാനിസ്ഥാൻ	aph‌gānisthān
ആൻറിഗ്വയും ബർബുഡയും	ānṟigvayuṁ barbuḍayuṁ
ആൻഗ്വില്ല	ān'gvilla
അൽബേനിയ	albēniya
അർമേനിയ	armēniya
അംഗോള	aṅgēāḷa
അൻറാർട്ടിക്ക	anṟārṭṭikka
അർജൻറീന	arjanṟīna
അമേരിക്കൻ സമോവ	amērikkan samēāva
ഓസ്ട്രിയ	ōsṭriya
ഓസ്‌ട്രേലിയ	ōs‌ṭrēliya
അറൂബ	aṟūba
അലൻഡ് ദ്വീപുകൾ	alanḍ dvīpukaḷ
അസർബൈജാൻ	asarbaijān
ബോസ്നിയയും ഹെർസഗോവിനയും	bēāsniyayuṁ hersagēāvinayuṁ
ബാർബഡോസ്	bārbaḍēās
ബംഗ്ലാദേശ്	baṅglādēś
ബെൽജിയം	beljiyaṁ
ബുർക്കിനാ ഫാസോ	burkkinā phāsēā
ബൾഗേറിയ	baḷgēṟiya
ബഹ്റിൻ	bahṟin
ബറുണ്ടി	baṟuṇṭi
ബെനിൻ	benin
സെന്റ് ബാർത്തലമി	senṟ bārttalami
ബർമുഡ	barmuḍa
ബ്രൂണൈ	brūṇai
ബൊളീവിയ	beāḷīviya
ബൊണെയ്ർ, സിന്റ് യുസ്റ്റേഷ്യസ്, സാബ എന്നിവ	beāṇeyr, sinṟ yusṟṟēṣyas, sāba enniva
ബ്രസീൽ	brasīl
ബഹാമാസ്	bahāmās
ഭൂട്ടാൻ	bhūṭṭān
ബൗവെട്ട് ദ്വീപ്	baveṭṭ dvīp
ബോട്സ്വാന	bēāṭsvāna
ബെലറൂസ്	belaṟūs
ബെലീസ്	belīs
കാനഡ	kānaḍa
കോക്കസ് (കീലിംഗ്) ദ്വീപുകൾ	kēākkas (kīliṅg) dvīpukaḷ
കോംഗോ - കിൻഷാസ	kēāṅgēā - kinṣāsa
കോംഗോ (DRC)	kēāṅgēā (DRC)
സെൻട്രൽ ആഫ്രിക്കൻ റിപ്പബ്ലിക്	senṭral āphrikkan ṟippablik
കോംഗോ - ബ്രാസവില്ലി	kēāṅgēā - brāsavilli
കോംഗോ (റിപ്പബ്ലിക്ക്)	kēāṅgēā (ṟippablikk)
സ്വിറ്റ്സർലാൻഡ്	sviṟṟsarlānḍ
കോട്ട് ഡി വാർ	kēāṭṭ ḍi vār
ഐവറി കോസ്റ്റ്	aivaṟi kēāsṟṟ
കുക്ക് ദ്വീപുകൾ	kukk dvīpukaḷ
ചിലി	cili
കാമറൂൺ	kāmaṟūṇ
ചൈന	caina
കൊളംബിയ	keāḷambiya
ക്ലിപ്പെർട്ടൻ ദ്വീപ്	klipperṭṭan dvīp
കോസ്റ്ററിക്ക	kēāsṟṟaṟikka
ക്യൂബ	kyūba
കേപ്പ് വെർദെ	kēpp verde
കുറാകാവോ	kuṟākāvēā
ക്രിസ്മസ് ദ്വീപ്	krismas dvīp
സൈപ്രസ്	saipras
ചെക്ക് റിപ്പബ്ലിക്	cekk ṟippablik
ജർമനി	jarmani
ഡീഗോ ഗ്രാഷ്യ	ḍīgēā grāṣya
ദിജിബൗട്ടി	dijibaṭṭi
ഡെൻമാർക്ക്	ḍenmārkk
ഡൊമിനിക്ക	ḍeāminikka
ഡൊമിനിക്കൻ റിപ്പബ്ലിക്	ḍeāminikkan ṟippablik
അൾജീരിയ	aḷjīriya
സെയൂത്ത ആൻഡ് മെലിയ	seyūtta ānḍ meliya
ഇക്വഡോർ	ikvaḍēār
എസ്റ്റോണിയ‍	esṟṟēāṇiya‍
ഈജിപ്ത്	ījipt
പശ്ചിമ സഹാറ	paścima sahāṟa
എറിത്രിയ	eṟitriya
സ്‌പെയിൻ	s‌peyin
എത്യോപ്യ	etyēāpya
യൂറോപ്യൻ യൂണിയൻ	yūṟēāpyan yūṇiyan
ഫിൻലാൻഡ്	phinlānḍ
ഫിജി	phiji
ഫാക്ക്‌ലാന്റ് ദ്വീപുകൾ	phākk‌lānṟ dvīpukaḷ
ഫോക്ക്‌ലാൻഡ് ദ്വീപുകൾ (ഐലാസ് മാൽവിനാസ്)	phēākk‌lānḍ dvīpukaḷ (ailās mālvinās)
മൈക്രോനേഷ്യ	maikrēānēṣya
ഫറോ ദ്വീപുകൾ	phaṟēā dvīpukaḷ
ഫ്രാൻസ്	phrāns
ഗാബൺ	gābaṇ
യുണൈറ്റഡ് കിംഗ്ഡം	yuṇaiṟṟaḍ kiṅgḍaṁ
ഗ്രനേഡ	granēḍa
ജോർജ്ജിയ	jēārjjiya
ഫ്രഞ്ച് ഗയാന	phrañc gayāna
ഗേൺസി	gēṇsi
ഘാന	ghāna
ജിബ്രാൾട്ടർ	jibrāḷṭṭar
ഗ്രീൻലാൻറ്	grīnlānṟ
ഗാംബിയ	gāmbiya
ഗിനിയ	giniya
ഗ്വാഡലൂപ്പ്	gvāḍalūpp
ഇക്വറ്റോറിയൽ ഗിനിയ	ikvaṟṟēāṟiyal giniya
ഗ്രീസ്	grīs
ദക്ഷിണ ജോർജ്ജിയയും ദക്ഷിണ സാൻഡ്‌വിച്ച് ദ്വീപുകളും	dakṣiṇa jēārjjiyayuṁ dakṣiṇa sānḍ‌vicc dvīpukaḷuṁ
ഗ്വാട്ടിമാല	gvāṭṭimāla
ഗ്വാം	gvāṁ
ഗിനിയ-ബിസൗ	giniya-bisa
ഗയാന	gayāna
ഹോങ്കോങ്ങ് (SAR) ചൈന	hēāṅkēāṅṅ (SAR) caina
ഹോങ്കോങ്ങ്	hēāṅkēāṅṅ
ഹിയേർഡും മക്‌ഡൊണാൾഡ് ദ്വീപുകളും	hiyērḍuṁ mak‌ḍeāṇāḷḍ dvīpukaḷuṁ
ഹോണ്ടുറാസ്	hēāṇṭuṟās
ക്രൊയേഷ്യ	kreāyēṣya
ഹെയ്തി	heyti
ഹംഗറി	haṅgaṟi
കാനറി ദ്വീപുകൾ	kānaṟi dvīpukaḷ
ഇന്തോനേഷ്യ	intēānēṣya
അയർലാൻഡ്	ayarlānḍ
ഇസ്രായേൽ	isrāyēl
ഐൽ ഓഫ് മാൻ	ail ōph mān
ഇന്ത്യ	intya
ബ്രിട്ടീഷ് ഇന്ത്യൻ മഹാസമുദ്ര പ്രദേശം	briṭṭīṣ intyan mahāsamudra pradēśaṁ
ഇറാഖ്	iṟākh
ഇറാൻ	iṟān
ഐസ്‌ലാന്റ്	ais‌lānṟ
ഇറ്റലി	iṟṟali
ജേഴ്സി	jēḻsi
ജമൈക്ക	jamaikka
ജോർദ്ദാൻ	jēārddān
ജപ്പാൻ	jappān
കെനിയ	keniya
കിർഗിസ്ഥാൻ	kirgisthān
കംബോഡിയ	kambēāḍiya
കിരിബാട്ടി	kiribāṭṭi
കോമൊറോസ്	kēāmeāṟēās
സെന്റ് കിറ്റ്‌സും നെവിസും	senṟ kiṟṟ‌suṁ nevisuṁ
ഉത്തരകൊറിയ	uttarakeāṟiya
ദക്ഷിണകൊറിയ	dakṣiṇakeāṟiya
കുവൈറ്റ്	kuvaiṟṟ
കേമാൻ ദ്വീപുകൾ	kēmān dvīpukaḷ
കസാഖിസ്ഥാൻ	kasākhisthān
ലാവോസ്	lāvēās
ലെബനൻ	lebanan
സെൻറ് ലൂസിയ	senṟ lūsiya
ലിച്ചൺസ്റ്റൈൻ	liccaṇsṟṟain
ശ്രീലങ്ക	śrīlaṅka
ലൈബീരിയ	laibīriya
ലെസോതോ	lesēātēā
ലിത്വാനിയ	litvāniya
ലക്സംബർഗ്	laksambarg
ലാറ്റ്വിയ	lāṟṟviya
ലിബിയ	libiya
മൊറോക്കൊ	meāṟēākkeā
മൊണാക്കോ	meāṇākkēā
മൾഡോവ	maḷḍēāva
മോണ്ടെനെഗ്രോ	mēāṇṭenegrēā
സെൻറ് മാർട്ടിൻ	senṟ mārṭṭin
മഡഗാസ്കർ	maḍagāskar
മാർഷൽ‍‍ ദ്വീപുകൾ	mārṣal‍‍ dvīpukaḷ
മാസിഡോണിയ	māsiḍēāṇiya
മാസിഡോണിയ (FYROM)	māsiḍēāṇiya (FYROM)
മാലി	māli
മ്യാൻമാർ (ബർമ്മ)	myānmār (barm'ma)
മംഗോളിയ	maṅgēāḷiya
മക്കാവു (SAR) ചൈന	makkāvu (SAR) caina
മക്കാവു	makkāvu
ഉത്തര മറിയാനാ ദ്വീപുകൾ	uttara maṟiyānā dvīpukaḷ
മാർട്ടിനിക്ക്	mārṭṭinikk
മൗറിറ്റാനിയ	maṟiṟṟāniya
മൊണ്ടെസരത്ത്	meāṇṭesaratt
മാൾട്ട	māḷṭṭa
മൗറീഷ്യസ്	maṟīṣyas
മാലിദ്വീപ്	mālidvīp
മലാവി	malāvi
മെക്സിക്കോ	meksikkēā
മലേഷ്യ	malēṣya
മൊസാംബിക്ക്	meāsāmbikk
നമീബിയ	namībiya
പുതിയ കാലിഡോണിയ	putiya kāliḍēāṇiya
നൈജർ	naijar
നോർഫോക് ദ്വീപ്	nēārphēāk dvīp
നൈജീരിയ	naijīriya
നിക്കരാഗ്വ	nikkarāgva
നെതർലാൻഡ്‌സ്	netarlānḍ‌s
നോർവെ	nēārve
നേപ്പാൾ	nēppāḷ
നൗറു	naṟu
ന്യൂയി	n'yūyi
ന്യൂസിലാൻറ്	n'yūsilānṟ
ഒമാൻ	omān
പനാമ	panāma
പെറു	peṟu
ഫ്രഞ്ച് പോളിനേഷ്യ	phrañc pēāḷinēṣya
പാപ്പുവ ന്യൂ ഗിനിയ	pāppuva n'yū giniya
ഫിലിപ്പൈൻസ്	philippains
പാക്കിസ്ഥാൻ	pākkisthān
പോളണ്ട്	pēāḷaṇṭ
സെന്റ് പിയറിയും മിക്കലണും	senṟ piyaṟiyuṁ mikkalaṇuṁ
പിറ്റ്‌കെയ്‌ൻ ദ്വീപുകൾ	piṟṟ‌key‌n dvīpukaḷ
പ്യൂർട്ടോ റിക്കോ	pyūrṭṭēā ṟikkēā
പാലസ്‌തീൻ പ്രദേശങ്ങൾ	pālas‌tīn pradēśaṅṅaḷ
പലസ്‌തീൻ	palas‌tīn
പോർച്ചുഗൽ	pēārccugal
പലാവു	palāvu
പരാഗ്വേ	parāgvē
ഖത്തർ	khattar
ദ്വീപസമൂഹം	dvīpasamūhaṁ
റീയൂണിയൻ	ṟīyūṇiyan
റൊമാനിയ	ṟeāmāniya
സെർബിയ	serbiya
റഷ്യ	ṟaṣya
റുവാണ്ട	ṟuvāṇṭa
സൗദി അറേബ്യ	sadi aṟēbya
സോളമൻ‍ ദ്വീപുകൾ	sēāḷaman‍ dvīpukaḷ
സെയ്‌ഷെൽസ്	sey‌ṣels
സുഡാൻ	suḍān
സ്വീഡൻ	svīḍan
സിംഗപ്പുർ	siṅgappur
സെൻറ് ഹെലീന	senṟ helīna
സ്ലോവേനിയ	slēāvēniya
സ്വാൽബാഡും ജാൻ മായേനും	svālbāḍuṁ jān māyēnuṁ
സ്ലോവാക്യ	slēāvākya
സിയെറ ലിയോൺ	siyeṟa liyēāṇ
സാൻ മറിനോ	sān maṟinēā
സെനഗൽ	senagal
സോമാലിയ	sēāmāliya
സുരിനെയിം	surineyiṁ
ദക്ഷിണ സുഡാൻ	dakṣiṇa suḍān
സാവോ ടോമും പ്രിൻസിപെയും	sāvēā ṭēāmuṁ prinsipeyuṁ
എൽ സാൽവദോർ	el sālvadēār
സിന്റ് മാർട്ടെൻ	sinṟ mārṭṭen
സിറിയ	siṟiya
സ്വാസിലാൻറ്	svāsilānṟ
ട്രസ്റ്റൻ ഡ കൂന	ṭrasṟṟan ḍa kūna
ടർക്ക്‌സും കെയ്‌ക്കോ ദ്വീപുകളും	ṭarkk‌suṁ key‌kkēā dvīpukaḷuṁ
ഛാഡ്	chāḍ
ഫ്രഞ്ച് ദക്ഷിണ ഭൂപ്രദേശം	phrañc dakṣiṇa bhūpradēśaṁ
ടോഗോ	ṭēāgēā
തായ്‌ലാൻഡ്	tāy‌lānḍ
താജിക്കിസ്ഥാൻ	tājikkisthān
ടോക്കെലൂ	ṭēākkelū
തിമോർ-ലെസ്റ്റെ	timēār-lesṟṟe
കിഴക്കൻ തിമോർ	kiḻakkan timēār
തുർക്ക്മെനിസ്ഥാൻ	turkkmenisthān
ടുണീഷ്യ	ṭuṇīṣya
ടോംഗ	ṭēāṅga
തുർക്കി	turkki
ട്രിനിഡാഡും ടുബാഗോയും	ṭriniḍāḍuṁ ṭubāgēāyuṁ
ടുവാലു	ṭuvālu
തായ്‌വാൻ	tāy‌vān
ടാൻസാനിയ	ṭānsāniya
ഉക്രെയ്‌ൻ	ukrey‌n
ഉഗാണ്ട	ugāṇṭa
അമേരിക്കൻ ഐക്യനാടുകൾ	amērikkan aikyanāṭukaḷ
ഉറുഗ്വേ	uṟugvē
ഉസ്‌ബെക്കിസ്ഥാൻ	us‌bekkisthān
വത്തിക്കാൻ	vattikkān
സെന്റ് വിൻസെന്റും ഗ്രനെഡൈൻസും	senṟ vinsenṟuṁ graneḍainsuṁ
വെനിസ്വേല	venisvēla
ബ്രിട്ടീഷ് വെർജിൻ ദ്വീപുകൾ	briṭṭīṣ verjin dvīpukaḷ
വിയറ്റ്നാം	viyaṟṟnāṁ
വന്വാതു	vanvātu
വാലിസ് ആന്റ് ഫ്യൂച്യുന	vālis ānṟ phyūcyuna
സമോവ	samēāva
കൊസോവൊ	keāsēāveā
യെമൻ	yeman
മയോട്ടി	mayēāṭṭi
ദക്ഷിണാഫ്രിക്ക	dakṣiṇāphrikka
സാംബിയ	sāmbiya
സിംബാബ്‌വേ	simbāb‌vē
അജ്ഞാത പ്രദേശം	ajñāta pradēśaṁ
