# Baby names
অকার্যতানাযা	akāryatānāyā
অগল্যা	agalyā
অগ্রাজা	agrājā
অড্যাত্রযী	aḍyātrayī
অদ্বিথা	adbithā
অদ্বৈথী	adbaithī
অদ্রিতা	adritā
অদ্রীত্যা	adrītyā
অদ্শযা	adśayā
অধুজা	adhujā
অবীনাযা	abīnāyā
অবীলাশীনী	abīlāśīnī
অবীষেক	abīṣēka
অব্জিত	abjita
অব্ব্য্নায্হা	abbynāyhā
অভাতী	abhātī
অভিজিত	abhijita
অভিজ্ঞান	abhijñāna
অভিনন্দন	abhinandana
অভিমান	abhimāna
অভিসোকা	abhisōkā
অভিহীতা	abhihītā
অভীনাশ	abhīnāśa
অভ্থা	abhthā
অভ্যান্কর	abhyānkara
অভ্রনীলা	abhranīlā
অহংতী	ahantī
অহিল্যা	ahilyā
অহেলী	ahēlī
আংজনেয	ān̄janēya
আকর	ākara
আকার	ākāra
আঘোশ	āghōśa
আচমন	ācamana
আতিশ	ātiśa
আত্রব	ātraba
আথী	āthī
আদিতা	āditā
আদিম	ādima
আদিযা	ādiyā
আদীজয	ādījaya
আদীত্রী	ādītrī
আদ্রিকা	ādrikā
আনংদতা	ānandatā
আনংদিত	ānandita
আনল	ānala
আনাধীতা	ānādhītā
আনাযা	ānāyā
আন্শাল	ānśāla
আপেক্ষা	āpēkṣā
আবীশ	ābīśa
আভাস	ābhāsa
আভীর	ābhīra
আমিষ	āmiṣa
আমোদ	āmōda
আযুষ্মান	āyuṣmāna
আরংভী	ārambhī
আরব	āraba
আরা	ārā
আরিনী	ārinī
আরিযা	āriyā
আরীন	ārīna
আরুষী	āruṣī
আরোন	ārōna
আর্থী	ārthī
আর্যমন	āryamana
আর্যমিক	āryamika
আর্য্থ্য	ārythya
আর্শ্বী	ārśbī
আলংব	ālamba
আলোক	ālōka
আলোকা	ālōkā
আশাকিরণ	āśākiraṇa
আশীতা	āśītā
আষ্নী	āṣnī
আসিত	āsita
আহলাদ	āhalāda
ইংদুমতী	indumatī
ইংদুলেক্ষ	indulēkṣa
ইংবনাথন	imbanāthana
ইক্ষিত	ikṣita
ইক্সুরা	iksurā
ইদুম	iduma
ইধাযা	idhāyā
ইনকী	inakī
ইন্দ্রদযুম্ন	indradayumna
ইন্দ্রন	indrana
ইন্দ্রসেন	indrasēna
ইন্দ্রিনা	indrinā
ইবাংকা	ibāṅkā
ইব্বানী	ibbānī
ইযুরেশ	iyurēśa
ইরাজা	irājā
ইরী	irī
ইলা	ilā
ইশান্য	iśān'ya
ইসকী	isakī
ইহিনা	ihinā
ঈজ্যা	ījyā
ঈরীন	īrīna
ঈলাক্ষী	īlākṣī
ঈশা	īśā
ঈশাংত	īśānta
ঈশিকা	īśikā
ঈসাঈ	īsā'ī
উগন	ugana
উগ্রসাঈ	ugrasā'ī
উজযাতী	ujayātī
উজাযন	ujāyana
উজ্জম	ujjama
উজ্জয	ujjaya
উত্তরা	uttarā
উত্পত্তি	utpatti
উত্সা	utsā
উথামী	uthāmī
উদযন	udayana
উদযা	udayā
উধায	udhāya
উধাযারনী	udhāyāranī
উনীনাজ	unīnāja
উন্নত	unnata
উন্নতীশ	unnatīśa
উন্নাথী	unnāthī
উপল	upala
উপেক্ষ	upēkṣa
উপ্জস	upjasa
উপ্পাস	uppāsa
উফ্তম	uphtama
উভয	ubhaya
উর্জানী	urjānī
উর্দাহাব	urdāhāba
উর্বিক	urbika
উর্বীনাথ	urbīnātha
উশ্নীক	uśnīka
উষা	uṣā
উষাশি	uṣāśi
উষাশ্রী	uṣāśrī
উস্রা	usrā
একাকান্য	ēkākān'ya
একাক্ষা	ēkākṣā
একাগ্রহ	ēkāgraha
একান্তিকা	ēkāntikā
এচ্চুমতি	ēccumati
এবেলিন	ēbēlina
এবোন	ēbōna
এব্বনী	ēbbanī
এরীন	ērīna
এলীনা	ēlīnā
এলীলরাসন	ēlīlarāsana
এশমাং	ēśamāṁ
এশানিকা	ēśānikā
এহিমাযা	ēhimāyā
ওংদ্রিলা	ōndrilā
ওঈশী	ō'īśī
ওজস	ōjasa
ওজস্বী	ōjasbī
ওজস্বীন	ōjasbīna
ওজা	ōjā
ওজীস	ōjīsa
ওদিতী	ōditī
ওবীএ	ōbī'ē
ওমাজা	ōmājā
ওমীশ	ōmīśa
ওমেশ	ōmēśa
ওশ্মী	ōśmī
ঔশিগ	auśiga
কংচ	kan̄ca
কংচনভা	kan̄canabhā
কংজন	kan̄jana
কক্ষাপ	kakṣāpa
কদংবন	kadambana
কদান্ম্বরী	kadānmbarī
কনিতা	kanitā
কনীজা	kanījā
কনীরা	kanīrā
কনীষা	kanīṣā
কন্তারব	kantāraba
কন্হৈযা	kanhaiyā
কপার্দিনী	kapārdinī
কপিল	kapila
কবচ	kabaca
কবিনযা	kabinayā
কবীযাসরী	kabīyāsarī
কবীলান	kabīlāna
কমলা সমভাব	kamalā samabhāba
কমলাপতি	kamalāpati
কমোদ	kamōda
করীশা	karīśā
করুণা সাগর	karuṇā sāgara
করুণানিধি	karuṇānidhi
করুনাশংকর	karunāśaṅkara
করূলী	karūlī
কর্তিযন	kartiyana
কর্দমাং	kardamāṁ
কল-হংস	kala-hansa
কলাকাংতী	kalākāntī
কলাপীন	kalāpīna
কলাপ্রিযা	kalāpriyā
কলীযাহ	kalīyāha
কল্প	kalpa
কল্যাণ	kalyāṇa
কল্লোলা	kallōlā
কল্হার	kal'hāra
কশীনাতন	kaśīnātana
কশ্বী	kaśbī
কহ্কাশন	kahkāśana
কাঁচী	kām̐cī
কাংতব	kāntaba
কাংতা	kāntā
কাজল	kājala
কাজোল	kājōla
কাতীত	kātīta
কানাকাবাল্লী	kānākābāllī
কানাসু	kānāsu
কানীমোঝ্হী	kānīmōjhhī
কানীল	kānīla
কাব্য শ্রী	kābya śrī
কাব্যস্রী	kābyasrī
কামক্যা	kāmakyā
কামদা	kāmadā
কামরাজ	kāmarāja
কামুনা	kāmunā
কারথী	kārathī
কারীন	kārīna
কার্লা	kārlā
কালিদাস	kālidāsa
কাশী	kāśī
কাশ্যপ	kāśyapa
কাহীনী	kāhīnī
কৌটিল্য	kauṭilya
কৌশ	kauśa
কৌশ্লেন্দর	kauślēndara
কৌসল্যা	kausalyā
গংগিকা	gaṅgikā
গংগী	gaṅgī
গংধারা	gandhārā
গজপতি	gajapati
গজরা	gajarā
গজরূপ	gajarūpa
গজেংদ্রনাথ	gajēndranātha
গতিক	gatika
গদাধর	gadādhara
গনেসা	ganēsā
গন্গেযন	gan'gēyana
গহনা	gahanā
গাথা	gāthā
গাথিকা	gāthikā
গাব্যা	gābyā
গাযকাপ্রিযা	gāyakāpriyā
গীতাম্রীতা মহোদধি	gītāmrītā mahōdadhi
গীতাশ্রী	gītāśrī
গীতি	gīti
গীনা	gīnā
গীরীনাথ	gīrīnātha
গীরীশরণ	gīrīśaraṇa
গুংজা	gun̄jā
গুগন	gugana
গুণাজী	guṇājī
গুনাশেকরণ	gunāśēkaraṇa
গুনীত	gunīta
গুন্জীতা	gunjītā
গুরদযাল	guradayāla
গুরব	guraba
গুরীশ	gurīśa
গুরু	guru
গুরুচরণ	gurucaraṇa
গুরুপদা	gurupadā
গুরুরাজ	gururāja
গুরুরাজা	gururājā
গুরুশরণ	guruśaraṇa
গুল	gula
গূহারী	gūhārī
গেশনা	gēśanā
গোউংতামান	gō'untāmāna
গোউংথমী	gō'unthamī
গোউংসিক	gō'unsika
গোকুল	gōkula
গোপান	gōpāna
গোপাল কৃষ্ণন	gōpāla kr̥ṣṇana
গোপীচংদ	gōpīcanda
গোপেশ	gōpēśa
গোমাংতক	gōmāntaka
গোমীনী	gōmīnī
গোম্যাসরী	gōmyāsarī
গোরল	gōrala
গোশীতা	gōśītā
গৌর	gaura
গৌরবী	gaurabī
গৌরাংশ	gaurānśa
গৌরীতা	gaurītā
গৌর্যনবী	gauryanabī
গ্নানেন্দের	gnānēndēra
গ্যানবী	gyānabī
গ্রাহ্য	grāhya
গ্রিষ্মা	griṣmā
গ্রীশ্মীতা	grīśmītā
গ্রীসমাং	grīsamāṁ
ঘটোতকত্চা	ghaṭōtakatcā
ঘুংগরূ	ghuṅgarū
চংদসরী	candasarī
চংদের্ভান	candērbhāna
চংদ্রকংতী	candrakantī
চংদ্রকিশোর	candrakiśōra
চংদ্রকীর্তী	candrakīrtī
চংদ্রন	candrana
চংদ্রন্শুং	candranśuṁ
চংদ্রমতি	candramati
চংদ্রমনী	candramanī
চংদ্রা	candrā
চংদ্রিকা	candrikā
চংদ্রেযী	candrēyī
চংধু	candhu
চক্রপাণী	cakrapāṇī
চতুর্বী	caturbī
চনক	canaka
চনাস্যা	canāsyā
চন্দ্রকলী	candrakalī
চন্দ্রসহোদারী	candrasahōdārī
চপলা	capalā
চযাংক	cayāṅka
চরণ	caraṇa
চরীতাব্যা	carītābyā
চরীথা	carīthā
চরুশীল	caruśīla
চানাস্যা	cānāsyā
চাব্রিক	cābrika
চামীনী	cāmīnī
চিত্তেশ	cittēśa
চিত্রকূট সমাংশ্রাযা	citrakūṭa samānśrāyā
চিত্রবাহূ	citrabāhū
চিত্রমালা	citramālā
চিত্রযুদ্ধ	citrayud'dha
চিত্রিকা	citrikā
চিত্রিতা	citritā
চিমাযী	cimāyī
চিরংজীব	ciran̄jība
চিরংতন	cirantana
চীথরা	cītharā
চীন্নীঃ	cīnnīḥ
চীস্থা	cīsthā
চুংবন	cumbana
চুটকী	cuṭakī
চুন্নী	cunnī
চুমকী	cumakī
চেতন্সাঈ	cētansā'ī
চৈতাল	caitāla
চৈত্রী	caitrī
চৈনীকা	cainīkā
চৈসরণ	caisaraṇa
জক্ষানী	jakṣānī
জগতপ্রকাশ	jagataprakāśa
জগদগুরুবে	jagadagurubē
জগদীপ	jagadīpa
জগদেশা	jagadēśā
জগাতী	jagātī
জগ্সনা	jagsanā
জতন	jatana
জনামেজয	janāmējaya
জনিতা	janitā
জবিনে	jabinē
জযকিশন	jayakiśana
জযগোপাল	jayagōpāla
জযনা	jayanā
জযাজীত	jayājīta
জযানংদ	jayānanda
জরুল	jarula
জলজ়া	jalazā
জশ্বীথা	jaśbīthā
জশ্মীথা	jaśmīthā
জসরাজ	jasarāja
জস্টীন	jasṭīna
জহাংগীর	jahāṅgīra
জাংবুবন	jāmbubana
জাগচংদ্রা	jāgacandrā
জানকীবল্লভ	jānakīballabha
জানকীভূষণ	jānakībhūṣaṇa
জানবী	jānabī
জানহিতা	jānahitā
জানীশ	jānīśa
জাবা	jābā
জারন	jārana
জালেংদু	jālēndu
জিগ্নাসা	jignāsā
জীজ্ঞাশা	jījñāśā
জীতেশী	jītēśī
জীন্ষা	jīnṣā
জীমী	jīmī
জেনীকা	jēnīkā
জের্শীকা	jērśīkā
জেসরী	jēsarī
জৈক্রীশ	jaikrīśa
জৈন	jaina
জৈনিল	jainila
জৈনীত	jainīta
জৈমীনী	jaimīnī
জৈহাসীনী	jaihāsīnī
জ্ঞানী	jñānī
জ্ঞানেশ্বর	jñānēśbara
জ্হুমাং	j'humāṁ
ঝারা	jhārā
ঝিনূক	jhinūka
ঝিযন	jhiyana
ঝীল	jhīla
ঝীহান	jhīhāna
ঝেনীল	jhēnīla
ঝেনীশা	jhēnīśā
ঠাকুর	ṭhākura
ঠুমরী	ṭhumarī
তংত্র	tantra
তজজ্ঞ	tajajña
তনিশ্ক	taniśka
তনিষ	taniṣa
তনুংগ্না	tanuṅgnā
তনেশ	tanēśa
তনোজ	tanōja
তন্বিকা	tanbikā
তন্মাযা	tanmāyā
তপেন্দ্র	tapēndra
তবলীন :	tabalīna :
তব্বু	tabbu
তমসী	tamasī
তরুণ  বিজয	taruṇa  bijaya
তরুন্সীবা	tarunsībā
তরুশ্রী	taruśrī
তরুসা	tarusā
তলংক	talaṅka
তাত্বিক	tātbika
তানুংমালয	tānummālaya
তানুংশ্সী	tānunśsī
তাপিত	tāpita
তামাংশ্রী	tāmānśrī
তারকনাথ	tārakanātha
তারকা	tārakā
তারকেশ	tārakēśa
তারকেশ্বর	tārakēśbara
তারচংদ	tāracanda
তারা প্রশাদ	tārā praśāda
তারাকিনী	tārākinī
তারীশী	tārīśī
তারুষ	tāruṣa
তালংক	tālaṅka
তালিকা	tālikā
তালীন	tālīna
তিনাশ	tināśa
তিরবিকা	tirabikā
তিলক	tilaka
তিস্যা	tisyā
তীম্মাং	tīm'māṁ
তীযাসা	tīyāsā
তীলাকারতনা	tīlākāratanā
তীস্তা	tīstā
তুমীর	tumīra
তেজপাল	tējapāla
তেজম	tējama
তেজস্মীতা	tējasmītā
তেজ়	tēza
তেজুস	tējusa
তেজোভাদ্র	tējōbhādra
তেনুং	tēnuṁ
তের্ষম	tērṣama
তোযেশ	tōyēśa
তোশাল	tōśāla
তোশী	tōśī
ত্রিলোক	trilōka
ত্রীলূকামন	trīlūkāmana
ত্রীশ	trīśa
থমারাঈ	thamārā'ī
থারা	thārā
থেন্মোলী	thēnmōlī
থ্রানীসা	thrānīsā
দক্শিনযন	dakśinayana
দক্শীন্য	dakśīn'ya
দক্ষেশ্বর	dakṣēśbara
দক্ষেষ	dakṣēṣa
দত্তাত্রী	dattātrī
দত্তাত্রেয	dattātrēya
দনীলা	danīlā
দনুংসীযা	danunsīyā
দন্যতা	dan'yatā
দবাশীশ	dabāśīśa
দবীত	dabīta
দযাল	dayāla
দযাস্বরূপ	dayāsbarūpa
দর্মীনী	darmīnī
দর্শনী	darśanī
দর্শিক	darśika
দর্শীল	darśīla
দলাপথী	dalāpathī
দশাবহবে	daśābahabē
দানবেন্দ্রবিনাশকা	dānabēndrabināśakā
দান্দাপানী	dāndāpānī
দাব	dāba
দামন	dāmana
দারুণ	dāruṇa
দাল্ভযা	dālbhayā
দাস	dāsa
দিক্ষীন	dikṣīna
দিন দযাল	dina dayāla
দিনাবংধাবে	dinābandhābē
দিপন্ষা	dipanṣā
দিপ্তিকা	diptikā
দিবেনা	dibēnā
দিযা	diyā
দিরাজ	dirāja
দীক্ষিতা	dīkṣitā
দীতা	dītā
দীপক	dīpaka
দীপনা	dīpanā
দীপশিখা	dīpaśikhā
দীপালী	dīpālī
দীপ্তা	dīptā
দীপ্তিকানা	dīptikānā
দেনীষ	dēnīṣa
দেন্সী	dēnsī
দেবগর্ভা	dēbagarbhā
দেবর্পীতা	dēbarpītā
দেবা	dēbā
দেবাগাংধারী	dēbāgāndhārī
দেবারতী	dēbāratī
দেবারীশী	dēbārīśī
দেবিক	dēbika
দেবীন	dēbīna
দেব্প্রসাদ	dēbprasāda
দেব্প্রীতা	dēbprītā
দেম্ধেন্দ্র	dēmdhēndra
দেযাশীনী	dēyāśīnī
দেস্পীনা	dēspīnā
দৈবত	daibata
দৈবী	daibī
দৈবেয	daibēya
ধনশ্রী	dhanaśrī
ধনিযা	dhaniyā
ধন্যতা	dhan'yatā
ধন্যশ্রী	dhan'yaśrī
ধরনী	dharanī
ধরাহাসীনী	dharāhāsīnī
ধারিকা	dhārikā
ধারীত্রী	dhārītrī
ধার্শীকা	dhārśīkā
নংদ-নংদন	nanda-nandana
নংদপাল	nandapāla
নংধা	nandhā
নচিকেতা	nacikētā
নটরাজ	naṭarāja
নবকুংজ	nabakun̄ja
নবরাতনা	nabarātanā
নবেংদু	nabēndu
নমনা	namanā
নর্মদা	narmadā
নাংবী	nāmbī
নাগবেনী	nāgabēnī
নাগভুষণ	nāgabhuṣaṇa
নাগমমাং	nāgamamāṁ
নাগরাজু	nāgarāju
নাগেস্বারী	nāgēsbārī
নাতন	nātana
নাতিন	nātina
নাতীক	nātīka
নান্দীথা	nāndīthā
নাবেতা	nābētā
নাবেশা	nābēśā
নাভ্যা	nābhyā
নামাংহা	nāmānhā
নাযসা	nāyasā
নাযানী	nāyānī
নারাযণন	nārāyaṇana
নারাযন	nārāyana
নার্ন্রতা	nārnratā
নাশাল	nāśāla
নিদ্রা	nidrā
নিবা	nibā
নিহারিকা	nihārikā
নীকাশা	nīkāśā
নীচিকা	nīcikā
নীথী	nīthī
নীনা	nīnā
নীবেদীতা	nībēdītā
নীরজ নযন	nīraja nayana
নীরব	nīraba
নীলকাংত্	nīlakānt
নীলযা	nīlayā
নীলাবাথী	nīlābāthī
নীলাম্বর	nīlāmbara
নীলাম্বরী	nīlāmbarī
নেকা	nēkā
নেথ্রা	nēthrā
নেবেধা	nēbēdhā
নেমাংলী	nēmānlī
নেল্বীন	nēlbīna
নেসরা	nēsarā
নৈংশী	nainśī
নৈনীশ	nainīśa
নৈনুষ	nainuṣa
নৈমিষ	naimiṣa
নৈমিষা	naimiṣā
নৈমেষ	naimēṣa
নৌরিন	naurina
পংকজ	paṅkaja
পংকাজধারিণী	paṅkājadhāriṇī
পংখী	paṅkhī
পংচজন্য	pan̄cajan'ya
পংধারী	pandhārī
পট মংজরী	paṭa man̄jarī
পতগ	pataga
পত্তাম্বরাপরীধানা	pattāmbarāparīdhānā
পত্র	patra
পদমাংক্ষ্য	padamāṅkṣya
পদ্মকাংত	padmakānta
পদ্মগ্রিহা	padmagrihā
পদ্মমালিনী	padmamālinī
পদ্মাংকল্যানী	padmāṅkalyānī
পদ্মাজঈ	padmāja'ī
পনিতা	panitā
পন্দালাবাসন	pandālābāsana
পন্দীযারাজ	pandīyārāja
পবন  আদিত্য	pabana  āditya
পবনপুত্র	pabanaputra
পবিত্রণ	pabitraṇa
পবিনা	pabinā
পবীকরণ	pabīkaraṇa
পবীশ্না	pabīśnā
পযোধরা	payōdharā
পরতাপ ; পরতাপ	paratāpa ; paratāpa
পরম-হংস	parama-hansa
পরমাত্মা	paramātmā
পরমার্থ	paramārtha
পরাকাষ	parākāṣa
পরান্জয	parānjaya
পরাসরা	parāsarā
পরিচয	paricaya
পরিসী	parisī
পরেশ	parēśa
পর্কাবী	parkābī
পর্নবী	parnabī
পর্নল	parnala
পর্বতীপ্রিত	parbatīprita
পর্হন	par'hana
পলক	palaka
পলানী	palānī
পলাশ	palāśa
পল্লাবী	pallābī
পহেল	pahēla
পাক	pāka
পানমোলী	pānamōlī
পাব	pāba
পাযোধর	pāyōdhara
পারিতোশ	pāritōśa
পারুল	pārula
পালীত	pālīta
পাহী	pāhī
পীতাংবর	pītāmbara
পীযাশা	pīyāśā
পূজীতা	pūjītā
পূর্বীজ্হা	pūrbīj'hā
পূশীথা	pūśīthā
পোউর্নীমাং	pō'urnīmāṁ
পোর্নীমাং	pōrnīmāṁ
পোশীথা	pōśīthā
পৌরুষ	pauruṣa
ফণীশ	phaṇīśa
ফনিংদ্র	phanindra
ফ্রেযল	phrēyala
ফ্লাবীনা	phlābīnā
বংশজা	banśajā
বংশীধর	banśīdhara
বংসী	bansī
বকা	bakā
বদ্রীনাথ	badrīnātha
বনমালা	banamālā
বনাজ	banāja
বনীলা	banīlā
বন্দীনী	bandīnī
বন্ধানা	bandhānā
বপুন	bapuna
ববয	babaya
ববিশ	babiśa
বরজোত্তামাং	barajōttāmāṁ
বর্টীক	barṭīka
বর্তার	bartāra
বর্শনেযা	barśanēyā
বর্শীতা	barśītā
বর্ষিত	barṣita
বলরাম	balarāma
বলাচান্দ্রণ	balācāndraṇa
বলামানী	balāmānī
বলামুরুগন	balāmurugana
বশীশ্কা	baśīśkā
বষা	baṣā
বসংতী	basantī
বসংথাজা	basanthājā
বসব	basaba
বসুদেবন	basudēbana
বস্তী	bastī
বস্মীহা	basmīhā
বহুলেযন	bahulēyana
বাংসুরী	bānsurī
বাগ-দেবী	bāga-dēbī
বাচাস্য	bācāsya
বাজীনাথ	bājīnātha
বাজ্রহাস্তা	bājrahāstā
বাত্সক	bātsaka
বানাজাক্ষী	bānājākṣī
বানীস্রী	bānīsrī
বানুজা	bānujā
বাপু	bāpu
বাবীন	bābīna
বাযুন	bāyuna
বারীধার	bārīdhāra
বার্গবী	bārgabī
বাল কৃষ্ণ	bāla kr̥ṣṇa
বালচংদ্র	bālacandra
বালাদিত্য	bālāditya
বালামানী	bālāmānī
বালামুরুগন	bālāmurugana
বালার	bālāra
বালারমাংথী	bālāramānthī
বালারাম	bālārāma
বাল্দাস	bāldāsa
বাল্মিক	bālmika
বাশু	bāśu
বাস্তব	bāstaba
বিংদী	bindī
বিনা	binā
বিনাপানী	bināpānī
বিপাশা	bipāśā
বিরাজ	birāja
বীড্যা	bīḍyā
বীণা	bīṇā
বীথীকা	bīthīkā
বীনাবানী	bīnābānī
বীরাজীনী	bīrājīnī
বুলবুল	bulabula
বূমী	būmī
বেথিনা	bēthinā
বেদকার্তিক	bēdakārtika
বেদবিদ্যা	bēdabidyā
বেদা শ্রী	bēdā śrī
বেদাবাথী	bēdābāthī
বেদীথা	bēdīthā
বেনীতা	bēnītā
বেন্শিক	bēnśika
বৈদয	baidaya
বৈদ্যনাথ	baidyanātha
বৈধাঈ	baidhā'ī
বৈরাজ	bairāja
বৈশ্নোব	baiśnōba
ব্রহ্মবাদীনী	brahmabādīnī
ব্রাহ্মী	brāhmī
ব্রিজা	brijā
ব্লেস্সী	blēs'sī
ভক্তি	bhakti
ভদ্রংগ	bhadraṅga
ভবিযা	bhabiyā
ভরনী	bharanī
ভর্গ	bharga
ভাদ্রুষা	bhādruṣā
ভানু রেখা	bhānu rēkhā
ভাব্যংশ	bhābyanśa
ভামিনী	bhāminī
ভার্গবী	bhārgabī
ভালচংদ্র	bhālacandra
ভাস্বন	bhāsbana
ভীবত্সুং	bhībatsuṁ
ভীলানগনা	bhīlānaganā
ভীষ্মা	bhīṣmā
ভুবা	bhubā
ভূমি	bhūmi
ভেরূ	bhērū
ভোজা	bhōjā
ভৌমিক	bhaumika
ভ্রামরী	bhrāmarī
মংদা	mandā
মংদিথ	manditha
মগধ	magadha
মগনা	maganā
মদনীকা	madanīkā
মদির	madira
মধুমাংলী	madhumānlī
মধুল	madhula
মধুলতা	madhulatā
মধুশা	madhuśā
মনিক	manika
মনীদীপ	manīdīpa
মনীবলন	manībalana
মনীষ	manīṣa
মমতা	mamatā
মলাংক	malāṅka
মল্লিকা	mallikā
মহা গণপতি	mahā gaṇapati
মহাতাপ	mahātāpa
মহাদেবাদীপুজীতা	mahādēbādīpujītā
মহাবালা	mahābālā
মহাবীর	mahābīra
মহারাবণমর্দানা	mahārābaṇamardānā
মহালক্ষ্মী	mahālakṣmī
মহালিকা	mahālikā
মহালীংগ	mahālīṅga
মহিমা	mahimā
মহিষাসুরমর্দিনী	mahiṣāsuramardinī
মহীথা	mahīthā
মহুযা	mahuyā
মহেন্দর	mahēndara
মহেলীকা	mahēlīkā
মহেশ	mahēśa
মহেশ্বর	mahēśbara
মহোদরা	mahōdarā
মাংধুমাংন্তী	māndhumānntī
মাংনাশ্যুং	mānnāśyuṁ
মাংনীশোব্র্যা	mānnīśōbryā
মাংন্জুনাতা	mānnjunātā
মাংন্দারিকা	mānndārikā
মাংলার্বীঝ্হী	mānlārbījhhī
মাংলাশ্রী	mānlāśrī
মাগথী	māgathī
মাথুর	māthura
মাধান	mādhāna
মাধ্যম	mādhyama
মানক	mānaka
মানজ	mānaja
মানসিকা	mānasikā
মানিক	mānika
মানিনী	māninī
মানীএ	mānī'ē
মানীসিলা	mānīsilā
মানোবীকা	mānōbīkā
মান্দাবিক	māndābika
মান্ধাতা	māndhātā
মান্মাতন	mānmātana
মান্যসরী	mān'yasarī
মালারাবন	mālārābana
মাল্লেষম	māllēṣama
মাহিত	māhita
মৈথ্রা	maithrā
মৈনাবী	mainābī
যজুর	yajura
যদু	yadu
যদুনংদন	yadunandana
যশস্ব	yaśasba
যশীল	yaśīla
যশ্বী	yaśbī
যাগবী/যহাবী	yāgabī/yahābī
যাগ্নেশ্বারা	yāgnēśbārā
যাতনা	yātanā
যাদবা	yādabā
যামি	yāmi
যামিনী	yāminī
যাশ্রী	yāśrī
যুকাশ্রী	yukāśrī
যুগান্ধর	yugāndhara
যুতি	yuti
যুধ্ধ	yudhdha
যুব	yuba
যুবরাণী	yubarāṇī
যুবানী	yubānī
যুবাসরী	yubāsarī
যেঘরাজ	yēgharāja
যেনাক্ষী	yēnākṣī
যেশাস্বীনী	yēśāsbīnī
যেশ্বীন	yēśbīna
যেস্বীন	yēsbīna
যোগনা	yōganā
যোগী	yōgī
যোগীন	yōgīna
যোগেশ্বর	yōgēśbara
যোচনা	yōcanā
যোত্শনা	yōtśanā
যোশন	yōśana
যোশিতা	yōśitā
যোষিত	yōṣita
যৌষা	yauṣā
রংগনাতন	raṅganātana
রংগিথা	raṅgithā
রংজীব	ran̄jība
রংহ	ranha
রংহিতা	ranhitā
রক্ষা	rakṣā
রক্ষ্য	rakṣya
রগাব	ragāba
রগীশ	ragīśa
রঘবেন্দর	raghabēndara
রজনী	rajanī
রজনীগংধা	rajanīgandhā
রজিত	rajita
রণছোড	raṇachōḍa
রণবিজয	raṇabijaya
রনীত	ranīta
রন্কীনী	rankīnī
রমণীক	ramaṇīka
রমাংভাদ্র	ramāmbhādra
রমাংস্বম্য	ramānsbamya
রসনা	rasanā
রাকীন	rākīna
রাগ	rāga
রাগ্বীনদার	rāgbīnadāra
রাজঋষি	rāja'r̥ṣi
রাজস	rājasa
রাজসূয	rājasūya
রাজসেকরণ	rājasēkaraṇa
রাজান্ন্য	rājānn'ya
রাজাবেলুং	rājābēluṁ
রাজারাম	rājārāma
রাজালক্ষ্মী	rājālakṣmī
রাজীষ	rājīṣa
রাজেন্দর	rājēndara
রাজেশ্রম	rājēśrama
রাজ্বলা	rājbalā
রাধিকা	rādhikā
রাধী	rādhī
রাধেশ	rādhēśa
রাম  কীন্কার	rāma  kīnkāra
রামকথালোলাযা	rāmakathālōlāyā
রামচংদর	rāmacandara
রামচংদ্র	rāmacandra
রামনাথন	rāmanāthana
রামাধুতা	rāmādhutā
রাষীপ	rāṣīpa
রিনী	rinī
রিলা	rilā
রীমা	rīmā
রীষা	rīṣā
রেধা	rēdhā
রেভা	rēbhā
রেমিথা	rēmithā
রেহা	rēhā
রোসাহেব	rōsāhēba
লক্ষণা	lakṣaṇā
লক্ষ্মণ	lakṣmaṇa
লক্ষ্মিবংতা	lakṣmibantā
লক্ষ্মীকা	lakṣmīkā
লক্ষ্মীনাথ	lakṣmīnātha
লক্ষ্মীনারাযনা	lakṣmīnārāyanā
লজীথা	lajīthā
লবিনিযা	labiniyā
লযনা	layanā
ললিতামোহনা	lalitāmōhanā
লাক্শীকা	lākśīkā
লান্কীনীভান্জানা	lānkīnībhānjānā
লালন	lālana
লালনা	lālanā
লালী	lālī
লীজেশ	lījēśa
লীতীশা	lītīśā
লীনেয্ষা	līnēyṣā
লীন্গসম্য	līn'gasamya
লীন্নেত	līnnēta
লীন্সী	līnsī
লীলাকর	līlākara
লীশীথা	līśīthā
লুকেশ্বর	lukēśbara
লুব্যা	lubyā
লুম্বিনী	lumbinī
লুসিযা	lusiyā
লেঈবীনা	lē'ībīnā
লেখিত	lēkhita
লেনীশা	lēnīśā
লেমাং	lēmāṁ
লোকাপতী	lōkāpatī
লোকীথা	lōkīthā
লোকীনী	lōkīnī
লোকেন্দের	lōkēndēra
লোগনাথন	lōganāthana
লোগীতা	lōgītā
লোবীশ	lōbīśa
লোবেযংশ	lōbēyanśa
লোবেলীন	lōbēlīna
লোলাকসী	lōlākasī
লোহেংদ্র	lōhēndra
সংকষ্টী	saṅkaṣṭī
সংকেত	saṅkēta
সংচিতা	san̄citā
সংজাণথী	san̄jāṇathī
সংজীতী	san̄jītī
সংভাজী	sambhājī
সক্তীবেল	saktībēla
সক্ষম	sakṣama
সখ্যা	sakhyā
সচংদ্র	sacandra
সচিদানংদ বিগ্রহ	sacidānanda bigraha
সচিশ	saciśa
সচীনা	sacīnā
সজনী	sajanī
সজলা	sajalā
সজীলী	sajīlī
সদগুনা	sadagunā
সদভুজা	sadabhujā
সনাহ	sanāha
সবরিশ	sabariśa
সমবরণ	samabaraṇa
সমরজীত	samarajīta
সমাংখ্যা	samāṅkhyā
সমান্য	samān'ya
সমাপ্তি	samāpti
সমিতা	samitā
সমীপতা	samīpatā
সমুদীতা	samudītā
সমেধ	samēdha
সম্কীর্তী	samkīrtī
সম্মতি	sam'mati
সম্রীতা	samrītā
সম্হীঠা	samhīṭhā
সম্হীত	samhīta
সলজ	salaja
সলারজুংগ	salārajuṅga
সলীজ	salīja
সলোখ	salōkha
সহজানংদ	sahajānanda
সহস্য	sahasya
সহুরী	sahurī
সহেলী	sahēlī
সহ্রুদী	sahrudī
সাঈ	sā'ī
সাঈ কুমার	sā'ī kumāra
সাঈ চরণ	sā'ī caraṇa
সাঈ সাহস	sā'ī sāhasa
সাকেত  শ্রীরাম	sākēta  śrīrāma
সাগরী	sāgarī
সাগ্নীকা	sāgnīkā
সাচিকা	sācikā
সাজিশ	sājiśa
সাত্বী	sātbī
সাধনা	sādhanā
সাধীন	sādhīna
সাধ্রী	sādhrī
সানাবী	sānābī
সানিযা	sāniyā
সাফল্য	sāphalya
সামলী	sāmalī
সামান	sāmāna
সালন	sālana
সাহিত্য	sāhitya
সাহিল	sāhila
সৈকত	saikata
সৈচারণ	saicāraṇa
সৈলী	sailī
সৈলেশ্বর	sailēśbara
সৈস্বেঠা	saisbēṭhā
হংসিক	hansika
হতিশা	hatiśā
হনীমা	hanīmā
হনীশ	hanīśa
হনুমংত	hanumanta
হন্বীথা	hanbīthā
হবন	habana
হম্সলেখা	hamsalēkhā
হযাতী	hayātī
হরম্যা	haramyā
হরা	harā
হরীআক্ষ	harī'ākṣa
হরীচংদনা	harīcandanā
হরীরাম	harīrāma
হরীশ	harīśa
হরেকৃষ্ণ	harēkr̥ṣṇa
হরেশ	harēśa
হরেহান	harēhāna
হর্থীকা	harthīkā
হর্শত	harśata
হশন	haśana
হশিকা	haśikā
হশ্বর্ধন	haśbardhana
হসিত	hasita
হসীত	hasīta
হসীনী	hasīnī
হস্বীকা	hasbīkā
হস্সীনী	has'sīnī
হাকেশ	hākēśa
হারজীত	hārajīta
হাসীতা	hāsītā
হিডিংবা	hiḍimbā
হিত	hita
হিতেশ	hitēśa
হিথীকা	hithīkā
হিমংজয	himan̄jaya
হিমবংত	himabanta
হিরকনী	hirakanī
হিরণ	hiraṇa
হিরেশ	hirēśa
হিশেথা	hiśēthā
হীমীর	hīmīra
হেতংশ	hētanśa
হেনীত	hēnīta
হেনীশী	hēnīśī
হেপ্পী	hēppī
হেমচংদর	hēmacandara
হেমরাজ	hēmarāja
হেমা লাথী	hēmā lāthī
হেমাংগ	hēmāṅga
হেমাংবিংদু	hēmāmbindu
হেমাংশু	hēmānśu
হেমাগনী	hēmāganī
হেমিল	hēmila
হেম্স	hēmsa
হেরংব	hēramba
হৈমাং	haimāṁ
হৈযা	haiyā
হোমা	hōmā
হ্রাদিনী	hrādinī
হ্রাধা	hrādhā
হ্রীদা	hrīdā
হ্রীদান্ক্ষ	hrīdānkṣa
#
#
# Territory names from CLDR
অ্যাসসেনশন আইল্যান্ড	ayāsasēnaśana ā'ilyānḍa
এ্যান্ডোরা	ēyānḍōrā
সংযুক্ত আরব আমিরাত	sanyukta āraba āmirāta
আফগানিস্তান	āphagānistāna
এন্টিগুয়া ও বারবুডা	ēnṭiguẏā ō bārabuḍā
এ্যাঙ্গুইলা	ēyāṅgu'ilā
আলব্যানিয়া	ālabyāniẏā
আর্মেনিয়া	ārmēniẏā
অ্যাঙ্গোলা	ayāṅgōlā
অ্যান্টার্কটিকা	ayānṭārkaṭikā
আর্জেন্টিনা	ārjēnṭinā
আমেরিকান সামোয়া	āmērikāna sāmōẏā
অস্ট্রিয়া	asṭriẏā
অস্ট্রেলিয়া	asṭrēliẏā
আরুবা	ārubā
আলান্ড দ্বীপপুঞ্জ	ālānḍa dbīpapuñja
আজারবাইজান	ājārabā'ijāna
বসনিয়া ও হার্জেগোভিনা	basaniẏā ō hārjēgōbhinā
বারবাদোস	bārabādōsa
বাংলাদেশ	bānlādēśa
বেলজিয়াম	bēlajiẏāma
বুরকিনা ফাসো	burakinā phāsō
বুলগেরিয়া	bulagēriẏā
বাহরাইন	bāharā'ina
বুরুন্ডি	burunḍi
বেনিন	bēnina
সেন্ট বারথেলিমি	sēnṭa bārathēlimi
বারমুডা	bāramuḍā
ব্রুনেই	brunē'i
বোলিভিয়া	bōlibhiẏā
ক্যারিবিয়ান নেদারল্যান্ডস	kyāribiẏāna nēdāralyānḍasa
ব্রাজিল	brājila
বাহামা দ্বীপপুঞ্জ	bāhāmā dbīpapuñja
ভুটান	bhuṭāna
বোভেট দ্বীপ	bōbhēṭa dbīpa
বতসোয়ানা	batasōẏānā
বেলোরুশিয়া	bēlōruśiẏā
বেলিজ	bēlija
কানাডা	kānāḍā
কোকোস (কিলিং)দ্বীপপুঞ্জ	kōkōsa (kiliṁ)dbīpapuñja
কঙ্গো-কিনশাসা	kaṅgō-kinaśāsā
কঙ্গো(DRC)	kaṅgō(DRC)
মধ্য আফ্রিকার প্রজাতন্ত্র	madhya āphrikāra prajātantra
কঙ্গো - ব্রাজাভিল	kaṅgō - brājābhila
কঙ্গো (প্রজাতন্ত্র)	kaṅgō (prajātantra)
সুইজারল্যান্ড	su'ijāralyānḍa
আইভরি কোস্ট	ā'ibhari kōsṭa
কুক দ্বীপপুঞ্জ	kuka dbīpapuñja
চিলি	cili
ক্যামেরুন	kyāmēruna
চীন	cīna
কোলোম্বিয়া	kōlōmbiẏā
ক্লিপারটন আইল্যান্ড	klipāraṭana ā'ilyānḍa
কোস্টারিকা	kōsṭārikā
কিউবা	ki'ubā
কেপভার্দে	kēpabhārdē
কিউরাসাও	ki'urāsā'ō
ক্রিসমাস দ্বীপ	krisamāsa dbīpa
সাইপ্রাস	sā'iprāsa
চেক প্রজাতন্ত্র	cēka prajātantra
জার্মানি	jārmāni
দিয়েগো গার্সিয়া	diẏēgō gārsiẏā
জিবুতি	jibuti
ডেনমার্ক	ḍēnamārka
ডোমিনিকা	ḍōminikā
ডোমেনিকান প্রজাতন্ত্র	ḍōmēnikāna prajātantra
আলজেরিয়া	ālajēriẏā
কুউটা এবং মেলিলা	ku'uṭā ēbaṁ mēlilā
ইকুয়েডর	ikuẏēḍara
এস্তোনিয়া	ēstōniẏā
মিশর	miśara
পশ্চিম সাহারা	paścima sāhārā
ইরিত্রিয়া	iritriẏā
স্পেন	spēna
ইফিওপিয়া	iphi'ōpiẏā
ইউরোপীয় ইউনিয়ন	i'urōpīẏa i'uniẏana
ফিনল্যান্ড	phinalyānḍa
ফিজি	phiji
ফকল্যান্ড দ্বীপপুঞ্জ	phakalyānḍa dbīpapuñja
ফকল্যান্ড আইল্যান্ড ( ইসল্যাস মাসভেনিস)	phakalyānḍa ā'ilyānḍa ( isalyāsa māsabhēnisa)
মাইক্রোনেশিয়া	mā'ikrōnēśiẏā
ফ্যারও দ্বীপপুঞ্জ	phyāra'ō dbīpapuñja
ফ্রান্স	phrānsa
গ্যাবন	gyābana
যুক্তরাজ্য	yuktarājya
গ্রেনেডা	grēnēḍā
জর্জিয়া	jarjiẏā
ফরাসী গায়ানা	pharāsī gāẏānā
গ্রাঞ্জি	grāñji
ঘানা	ghānā
জিব্রাল্টার	jibrālṭāra
গ্রীনল্যান্ড	grīnalyānḍa
গাম্বিয়া	gāmbiẏā
গিনি	gini
গুয়াদেলৌপ	guẏādēlaupa
নিরক্ষীয় গিনি	nirakṣīẏa gini
গ্রীস	grīsa
দক্ষিণ জর্জিয়া ও দক্ষিণ স্যান্ডউইচ দ্বীপপুঞ্জ	dakṣiṇa jarjiẏā ō dakṣiṇa syānḍa'u'ica dbīpapuñja
গোয়াতেমালা	gōẏātēmālā
গুয়াম	guẏāma
গিনি-বিসাউ	gini-bisā'u
গিয়ানা	giẏānā
হংকং এসএআর চীনা	haṅkaṁ ēsa'ē'āra cīnā
হংকং	haṅkaṁ
হার্ড দ্বীপ এবং ম্যাকডোনাল্ড দ্বীপপুঞ্জ	hārḍa dbīpa ēbaṁ myākaḍōnālḍa dbīpapuñja
হণ্ডুরাস	haṇḍurāsa
ক্রোয়েশিয়া	krōẏēśiẏā
হাইতি	hā'iti
হাঙ্গেরি	hāṅgēri
ক্যানারি দ্বীপপুঞ্জ	kyānāri dbīpapuñja
ইন্দোনেশিয়া	indōnēśiẏā
আয়ারল্যান্ড	āẏāralyānḍa
ইজরায়েল	ijarāẏēla
আইল অফ ম্যান	ā'ila apha myāna
ভারত	bhārata
ব্রিটিশ ভারত মহাসাগরীয় অঞ্চল	briṭiśa bhārata mahāsāgarīẏa añcala
ইরাক	irāka
ইরান	irāna
আইসল্যান্ড	ā'isalyānḍa
ইতালী	itālī
জার্সি	jārsi
জামাইকা	jāmā'ikā
জর্ডন	jarḍana
জাপান	jāpāna
কেনিয়া	kēniẏā
কির্গিজিয়া	kirgijiẏā
কম্বোডিয়া	kambōḍiẏā
কিরিবাতি	kiribāti
কমোরোস	kamōrōsa
সেন্ট কিটস ও নেভিস	sēnṭa kiṭasa ō nēbhisa
উত্তর কোরিয়া	uttara kōriẏā
দক্ষিণ কোরিয়া	dakṣiṇa kōriẏā
কুয়েত	kuẏēta
কেম্যান দ্বীপপুঞ্জ	kēmyāna dbīpapuñja
কাজাখস্তান	kājākhastāna
লাওস	lā'ōsa
লেবানন	lēbānana
সেন্ট লুসিয়া	sēnṭa lusiẏā
লিচেনস্টেইন	licēnasṭē'ina
শ্রীলঙ্কা	śrīlaṅkā
লাইবেরিয়া	lā'ibēriẏā
লেসোথো	lēsōthō
লিথুয়ানিয়া	lithuẏāniẏā
লাক্সেমবার্গ	lāksēmabārga
লাত্ভিয়া	lātbhiẏā
লিবিয়া	libiẏā
মোরক্কো	mōrakkō
মোনাকো	mōnākō
মোল্দাভিয়া	mōldābhiẏā
মন্টিনিগ্রো	manṭinigrō
সেন্ট মার্টিন	sēnṭa mārṭina
মাদাগাস্কার	mādāgāskāra
মার্শাল দ্বীপপুঞ্জ	mārśāla dbīpapuñja
ম্যাসাডোনিয়া	myāsāḍōniẏā
মেসিডোনিয়া(FYROM)	mēsiḍōniẏā(FYROM)
মালি	māli
মায়ানমার (বার্মা)	māẏānamāra (bārmā)
মঙ্গোলিয়া	maṅgōliẏā
ম্যাকাও এস এ আর চায়না	myākā'ō ēsa ē āra cāẏanā
ম্যাকাও	myākā'ō
উত্তরাঞ্চলীয় মারিয়ানা দ্বীপপুঞ্জ	uttarāñcalīẏa māriẏānā dbīpapuñja
মার্টিনিক	mārṭinika
মরিতানিয়া	maritāniẏā
মন্টসেরাট	manṭasērāṭa
মাল্টা	mālṭā
মরিশাস	mariśāsa
মালদ্বীপ	māladbīpa
মালাউই	mālā'u'i
মেক্সিকো	mēksikō
মালয়েশিয়া	mālaẏēśiẏā
মোজাম্বিক	mōjāmbika
নামিবিয়া	nāmibiẏā
নিউ ক্যালেডোনিয়া	ni'u kyālēḍōniẏā
নাইজার	nā'ijāra
নিরফোক দ্বীপ	niraphōka dbīpa
নাইজেরিয়া	nā'ijēriẏā
নিকারাগুয়া	nikārāguẏā
নেদারল্যান্ডস	nēdāralyānḍasa
নরওয়ে	nara'ōẏē
নেপাল	nēpāla
নাউরু	nā'uru
নিউয়ে	ni'uẏē
নিউজিল্যান্ড	ni'ujilyānḍa
ওমান	ōmāna
পানামা	pānāmā
পিরু	piru
ফরাসী পলিনেশিয়া	pharāsī palinēśiẏā
পাপুয়া নিউ গিনি	pāpuẏā ni'u gini
ফিলিপাইন	philipā'ina
পাকিস্তান	pākistāna
পোল্যান্ড	pōlyānḍa
সেন্ট পিয়ের ও মিকুয়েলন	sēnṭa piẏēra ō mikuẏēlana
পিটকেয়ার্ন দ্বীপপুঞ্জ	piṭakēẏārna dbīpapuñja
পুয়ের্তো রিকো	puẏērtō rikō
ফিলিস্তিন অঞ্চলসমূহ	philistina añcalasamūha
ফিলিস্তিন	philistina
পর্তুগাল	partugāla
পালাউ	pālā'u
প্যারাগুয়ে	pyārāguẏē
কাতার	kātāra
আউটলাইনিং ওসানিয়া	ā'uṭalā'iniṁ ōsāniẏā
রিইউনিয়ন	ri'i'uniẏana
রুমানিয়া	rumāniẏā
সার্বিয়া	sārbiẏā
রাশিয়া	rāśiẏā
রুয়ান্ডা	ruẏānḍā
সৌদি আরব	saudi āraba
সলোমন দ্বীপপুঞ্জ	salōmana dbīpapuñja
সিসিলি	sisili
সুদান	sudāna
সুইডেন	su'iḍēna
সিঙ্গাপুর	siṅgāpura
সেন্ট হেলেনা	sēnṭa hēlēnā
স্লোভানিয়া	slōbhāniẏā
স্বালবার্ড ও জান মেয়েন	sbālabārḍa ō jāna mēẏēna
শ্লোভাকিয়া	ślōbhākiẏā
সিয়েরালিওন	siẏērāli'ōna
সান মারিনো	sāna mārinō
সেনেগাল	sēnēgāla
সোমালিয়া	sōmāliẏā
সুরিনাম	surināma
দক্ষিন সুদান	dakṣina sudāna
সাওটোমা ও প্রিন্সিপি	sā'ōṭōmā ō prinsipi
এল সালভেদর	ēla sālabhēdara
সিন্ট মার্টেন	sinṭa mārṭēna
সিরিয়া	siriẏā
সোয়াজিল্যান্ড	sōẏājilyānḍa
ট্রিস্টান ডা কুনহা	ṭrisṭāna ḍā kunahā
তুর্কস ও কাইকোস দ্বীপপুঞ্জ	turkasa ō kā'ikōsa dbīpapuñja
চাদ	cāda
ফরাসী দক্ষিণাঞ্চল	pharāsī dakṣiṇāñcala
টোগো	ṭōgō
থাইল্যান্ড	thā'ilyānḍa
তাজিকস্থান	tājikasthāna
টোকেলাউ	ṭōkēlā'u
তিমুর-লেস্তে	timura-lēstē
পূর্ব তিমুর	pūrba timura
তুর্কমেনিস্তান	turkamēnistāna
তিউনিশিয়া	ti'uniśiẏā
টোঙ্গা	ṭōṅgā
তুরস্ক	turaska
ত্রিনিনাদ ও টোব্যাগো	trinināda ō ṭōbyāgō
টুভালু	ṭubhālu
তাইওয়ান	tā'i'ōẏāna
তাঞ্জানিয়া	tāñjāniẏā
ইউক্রেইন	i'ukrē'ina
উগান্ডা	ugānḍā
যুক্তরাষ্ট্রের পার্শ্ববর্তী দ্বীপপুঞ্জ	yuktarāṣṭrēra pārśbabartī dbīpapuñja
মার্কিন যুক্তরাষ্ট্র	mārkina yuktarāṣṭra
ইউ এস	i'u ēsa
উরুগুয়ে	uruguẏē
উজবেকিস্তান	ujabēkistāna
ভ্যাটিকান সিটি	bhyāṭikāna siṭi
সেন্ট ভিনসেন্ট ও দ্যা গ্রেনাডিনস	sēnṭa bhinasēnṭa ō dyā grēnāḍinasa
ভেনেজুয়েলা	bhēnējuẏēlā
ব্রিটিশ ভার্জিন দ্বীপপুঞ্জ	briṭiśa bhārjina dbīpapuñja
মার্কিন ভার্জিন দ্বীপপুঞ্জ	mārkina bhārjina dbīpapuñja
ভিয়েতনাম	bhiẏētanāma
ভানুয়াটু	bhānuẏāṭu
ওয়ালিস ও ফুটুনা	ōẏālisa ō phuṭunā
সামোয়া	sāmōẏā
কসোভো	kasōbhō
ইয়েমেন	iẏēmēna
মায়োত্তে	māẏōttē
দক্ষিণ আফ্রিকা	dakṣiṇa āphrikā
জাম্বিয়া	jāmbiẏā
জিম্বাবোয়ে	jimbābōẏē
অজানা স্থান	ajānā sthāna
