ሀብታምነት	habetamennät
ሀቻምና	haččamena
ሀች	hačč
ሁለ	hullä
ሁለመና	hullämäna
ሁለተ	hulättä
ሁለቴ	hulätté
ሁለት	hulätt
ሁሉ	hullu
ሁሉም	hullum
ሁሌ	hullé
ሁል	hull
ሁልጊዜ	hullegizé
ሁነኛ	hunäñña
ሁከተኛ	hukätäñña
ሂስና	hisenna
ሃያኛ	hayañña
ሃይማኖተኛ	hayemanotäñña
ህላዌ	hellawé
ህልውና	hellewena
ህክምና	hekkemenna
ሆሳዕና	hossaʿena
ሆነለት	honällät
ሆነበት	honäbbät
ሆኖም	honomm
ሆጃ	hojja
ለመለመ	lämällämä
ለመሰሰ	lämässäsä
ለመነ	lämmänä
ለመዘገ	lämäzzägä
ለመደ	lämmädä
ለመጠ	lämmäṭä
ለመጥ	lämmäṭṭ
ለማ	lämma
ለማመደ	lämammädä
ለማኝ	lämmañ
ለማኝነት	lämmañennät
ለማዳ	lämmada
ለማዳነት	lämmadannät
ለማጣ	lämmaṭa
ለምነት	lämennät
ለሰለሰ	läsälläsä
ለሰሰ	lässäsä
ለሰነ	lässänä
ለሱ	lässu
ለሳኝ	lässañ
ለስ	läss
ለስላሳ	läselassa
ለስላሳነት	läselassannät
ለሸለሸ	läšälläšä
ለቀለቀ	läqälläqä
ለቀመ	läqqämä
ለቀም	läqämm
ለቀስተኛ	läqqäsetäñña
ለቀቀ	läqqäqä
ለቀቅ	läqqäq
ለቃቀመ	läqaqqämä
ለቅለቅ	läqeläqq
ለቅላቂ	läqellaqi
ለበለበ	läbälläbä
ለበሰ	läbässä
ለበቀ	läbbäqä
ለበበ	läbbäbä
ለበደ	läbbädä
ለበጠ	läbbäṭä
ለባቃ	läbbaqqa
ለባበሰ	läbabbäsä
ለብ	läbb
ለብታ	läbbeta
ለብቻ	läbbečča
ለተመ	lättämä
ለካ	läkka
ለኮሰ	läkkosä
ለኮፈ	läkkofä
ለወሰ	läwässä
ለወጠ	läwwäṭä
ለዋሳ	läwwassa
ለዘበ	läzzäbä
ለዘብተኛ	läzzäbetäñña
ለዛ	läzza
ለዛው	läzzaw
ለየ	läyyä
ለየብቻ	läyyäbečča
ለያየ	läyayyä
ለይስሙላ	läyesemulla
ለጅ	läjj
ለገመ	läggämä
ለገሰ	läggäsä
ለጋ	lägga
ለጋስ	läggas
ለጋስነት	läggasennät
ለግላጋ	lägelagga
ለጎን	lägonn
ለጎደ	läggodä
ለጐመ	läggʷämä
ለጠለጠ	läṭälläṭä
ለጫካ	läč̣akka
ለፈለፈ	läfälläfä
ለፈፈ	läffäfä
ለፋ	läffa
ሊቅነት	liqennät
ላላ	lalla
ላምባ	lamebba
ላሸ	laššä
ላሸቀ	laššäqä
ላቂያ	laqqiya
ላቅ	laqq
ላቆጠ	laqqoṭä
ላከከ	lakkäkä
ላይኛ	layeñña
ላጲስ	lap̣p̣is
ሌብነት	lébennät
ሌጣነት	léṭannät
ልመና	lemmäna
ልማደኛ	lemadäñña
ልምምድ	lememmed
ልምጥ	lemmeṭṭ
ልምጭ	lemmeč̣
ልሳነ	lessanä
ልሳን	lessan
ልስላሴ	lesellassé
ልስን	lessen
ልቃሚ	leqqami
ልቃቂ	leqqaqi
ልቃቂት	leqqaqit
ልቅ	leqq
ልቅም	leqqem
ልቅቅ	leqeqq
ልቅነት	leqqennät
ልበ	lebbä
ልቡ	lebbu
ልቡና	lebbuna
ልባም	lebbam
ልባሽ	lebbaš
ልባዊ	lebbawi
ልብ	lebb
ልብስ	lebbes
ልብቅ	lebbeq
ልብዳት	lebbedat
ልብድ	lebbed
ልብጥ	lebbeṭ
ልኩን	lekkun
ልክ	lekk
ልዋጭ	lewwač̣
ልውውጥ	lewewweṭ
ልዕልና	leʿelenna
ልዝብ	lezzeb
ልዩ	leyyu
ልዩነት	leyyunnät
ልጃገረድነት	lejagärädennät
ልጅነት	lejennät
ልጉም	leggum
ልግመኛ	legemäñña
ልግስና	leggesenna
ልጥፋት	lleṭṭefat
ልጨኛ	leč̣č̣äñña
ልፈፋ	leffäfa
ልፊያ	leffiya
ልፋጫም	leffač̣am
ልፋጭ	leffač̣
ሎሌነት	lolénnät
ሎቲ	lotti
ሐማል	ḥammal
ሐማልነት	ḥammalennät
ሐሜተኛ	ḥamétäñña
ሐሜት	ḥammét
ሐሰተኛ	ḥassätäñña
ሐሰት	ḥassät
ሐሳብ	ḥassab
ሐሳዌ	ḥassawé
ሐቀኛ	ḥaqqäñña
ሐቀኛነት	ḥaqqäññannät
ሐቅ	ḥaqq
ሐተተኛ	ḥatätäñña
ሐች	ḥačč
ሐካይ	ḥakkay
ሐኬተኛ	ḥakétäñña
ሐኬተኝነት	ḥakétäññennät
ሐዋላ	ḥawwala
ሐዋርያነት	ḥawareyannät
ሐዘንተኛ	ḥazänetäñña
ሐዲስ	ḥaddis
ሑር	ḥurr
ሑርነት	ḥurrennät
ሕመምተኛ	ḥemämettäña
ሕቅ	ḥeqq
ሕቅታ	ḥeqqeta
ሕክምና	ḥekkemenna
ሕያውነት	ḥeyawennät
ሕገ	ḥeggä
ሕጋዊ	ḥeggawi
ሕጋዊነት	ḥeggawinnät
ሕግ	ḥegg
ሕጓ	ḥeggʷa
ሕፃንነት	ḥeẓannennät
መሀንዲስነት	mähanedisennät
መሀከለኛ	mähakkäläñña
መሀከል	mähakkäl
መሃይም	mähayyem
መሃይምነት	mähayyemennät
መለለ	mällälä
መለማመጃ	mällämamäja
መለሰ	mälläsä
መለቃለቂያ	mälläqaläqiya
መለኮትነት	mäläkotennät
መለወጫ	mälläwäč̣č̣a
መለዮ	mälläyyo
መለጠ	mälläṭä
መላ	mälla
መላሽ	mällaš
መላክተኛ	mälaketäñña
መላጣነት	mälaṭannät
መልመጃ	mällemäja
መልሶ	mälleso
መልቲነት	mäletinnät
መልእክተኛ	mäleʾeketäñña
መልከኛ	mälekäñña
መሐለቅ	mäḥalläq
መሐላ	mäḥalla
መመሪያ	mämmäriya
መመነኛ	mämännäña
መመዘኛ	mämäzzäña
መመዝገቢያ	mämmäzegäbiya
መመጻደቅ	mämmäṣadäq
መማለጃ	mämmaläja
መምህርነት	mämeherennät
መሠሪ	mäśärri
መሠሪነት	mäśärrinnät
መሠዊያ	mäśäwwiya
መሠውር	mäśäwwer
መሣሪያ	mäśśariya
መሥዋዕትነት	mäśewaʿetennät
መረመረ	märämmärä
መረማመጃ	märrämamäja
መረረ	märrärä
መረረው	märräräw
መረቀ	märräqä
መረቀዘ	märäqqäzä
መረባ	märäbba
መረተ	märrätä
መረነ	märränä
መረዋ	märäwwa
መረዘ	märräzä
መረጃ	märräja
መረገ	märrägä
መረገጫ	märrägäč̣a
መረጋገጫ	märrägagäč̣a
መረጠ	märräṭä
መሪነት	märinnät
መራ	märra
መራራነት	märraranät
መራር	märrar
መራርነት	märrarennät
መራቂ	märraqi
መራቢያ	märrabiya
መራዥ	märraž
መራገጫ	märragäč̣a
መራጭነት	märač̣ennät
መር	märr
መርከበኛ	märekäbäñña
መርዘኛ	märezäñña
መሰለ	mässälä
መሰብሰቢያ	mässäbesäbiya
መሰነ	mässänä
መሰናዘሪያ	mässänazäriya
መሰናዶ	mässänado
መሰከረ	mäsäkkärrä
መሰከነ	mäsäkkänä
መሰኪያ	mäsäkkiya
መሰደጃ	mässädäja
መሰገ	mässägä
መሰጠ	mässäṭä
መሳ	mässa
መሳለሚያ	mässalämiya
መሳለቂያ	mässaläqiya
መሳጭ	mässač̣
መሳፍቻ	mässafečča
መስቀልኛ	mäseqäleñña
መስቀልያ	mäseqäleyya
መስተአምር	mäsetäʾammer
መስካሪነት	mäsekarinnät
መስኮብኛ	mäsekobeñña
መስፈሪያ	mässefäriya
መሸ	mäššä
መሸለቻ	mäšälläča
መሸሸጊያ	mäššäšägiya
መሸቀጫ	mäšäqqäč̣a
መሸበቢያ	mäšäbbäbiya
መሸተ	mäššätä
መሸተኛ	mäšätäñña
መሸኛ	mäšäñña
መሸገ	mäššägä
መሸጋሸጊያ	mäššägašägiya
መሸፈቻ	mäšäffäča
መሸፈኛ	mäšäffäña
መሻገሪያ	mäššagäriya
መቀለጃ	mäqälläja
መቀመጫ	mäqqämäč̣a
መቀቀያ	mäqäqqäya
መቀነት	mäqännät
መቀነቻ	mäqännäča
መቀየሻ	mäqäyyäša
መቀጣጫ	mäqqäṭač̣a
መቀጫ	mäqqäč̣a
መቀጮ	mäqqäč̣o
መቃጠሪያ	mäqqaṭäriya
መቆያ	mäqoyya
መቆጣጠሪያ	mäqqoṭaṭäriya
መቆፈሪያ	mäqoffäriya
መቋቋሚያ	mäqqʷaqʷamiya
መቍጠሪያ	mäqqʷǝṭäriya
መበለት	mäbällät
መበላት	mäbbälat
መበየጃ	mäbäyyäja
መበያ	mäbbäya
መበደሪያ	mäbbädäriya
መተላለፊያ	mättälaläfiya
መተማመኛ	mättämamäña
መተረ	mättärä
መተረቻ	mätärräča
መተረክያ	mätärräkeya
መተተኛ	mätätäñña
መተኛ	mätäñña
መተከዣ	mätäkkäža
መተከያ	mättäkäya
መተዳደሪያ	mättädadäriya
መታ	mmäta
መታመኛ	mättamäña
መታሠሪያ	mättaśäriya
መታረቂያ	mättaräqiya
መታሰቢያ	mättasäbiya
መታሻ	mättaša
መታተረ	mätattärä
መታታ	mätatta
መታወቂያ	mättawäqiya
መታጠቂያ	mättaṭäqiya
መታጠቢያ	mättaṭäbiya
መታጠፊያ	mättaṭäfiya
መታጫ	mättač̣a
መትረየስ	mäteräyyäs
መቶኛ	mätoñña
መቼም	mäččém
መቼውንም	mäččéwenem
መነመነ	mänämmänä
መነሣት	männäśat
መነሻ	männäša
መነሾ	männäšo
መነቀረ	mänäqqärä
መነቃቀረ	mänäqaqqärä
መነተፈ	mänättäfä
መነቸከ	mänäččäkä
መነነ	männänä
መነኰሰ	mänäkkʷäsä
መነዘረ	mänäzzärä
መነዛዘረ	mänäzazzärä
መነገገ	mänäggägä
መነጥር	mänäṭṭer
መነጽር	mänäṣṣer
መና	männa
መናኛ	mänañña
መናኝ	männañ
መናገሻ	männagäša
መናፈሻ	männafäša
መንማና	mänemanna
መንቃራ	mäneqarra
መንቻካ	mänečakka
መንደረኛ	mänedäräñña
መንደርተኛ	mänedäretäñña
መንገደኛ	mänegädäñña
መንጠቆ	mäneṭäqqo
መንጫራ	mäneč̣arra
መንጫቃ	mäneč̣č̣aqqa
መንፈሳዊነት	mänefäsawinnät
መኖ	männo
መኝታ	mäññeta
መከለሻ	mäkälläša
መከላከያ	mäkkälakäya
መከማቻ	mäkkämača
መከረ	mäkkärä
መከረኛ	mäkärräña
መከተ	mäkkätä
መከነ	mäkkänä
መከናነቢያ	mäkkänanäbiya
መከዳ	mäkkädda
መከፈኛ	mäkäffäña
መካች	mäkkač
መካን	mäkkan
መካንነት	mäkkanennät
መካከለኛ	mäkakkäläñña
መካከል	mäkakkäl
መካከረ	mäkakkärä
መኰንን	mäkʷännen
መወሰኛ	mäwässäñña
መዋጮ	mäwwač̣o
መዐተኛ	mäʿatäñña
መዘመዘ	mäzämmäzä
መዘምራን	mäzämmeran
መዘምር	mäzämmer
መዘበረ	mäzäbbärä
መዘባበቻ	mäzzäbabäča
መዘነ	mäzzänä
መዘክር	mäzäkker
መዘውር	mäzäwwer
መዘዘኛ	mäzäzäñña
መዘገበ	mäzäggäbä
መዛኝ	mäzzaññ
መደለዣ	mädälläža
መደለያ	mäddäläya
መደመደ	mädämmädä
መደረቢያ	mädärräbiya
መደቆሻ	mädäqqoša
መደበ	mäddäbä
መደበኛ	mädäbäñña
መደብ	mäddäb
መደብር	mädäbber
መደደ	mädäddä
መደገፊያ	mäddägäfiya
መድሃኒተኛ	mädehanitäñña
መድጎሚያ	mädeggomiya
መድፈኛ	mädefäñña
መጀመሪያ	mäjämmäriya
መገለ	mäggälä
መገመገ	mägämmägä
መገበ	mäggäbä
መገነዣ	mägännäža
መገጣጠሚያ	mäggäṭaṭämiya
መጋረጃ	mäggaräja
መጋቢ	mäggabi
መጋቢት	mäggabit
መጋዞ	mäggazo
መጋዣ	mägažža
መጎናጠፊያ	mäggonaṭäfiya
መጎናጸፊ	mäggonaṣäfi
መጓጓዣ	mäggʷagʷaža
መጠመጠ	mäṭämmäṭä
መጠነኛ	mäṭänäñña
መጠወተ	mäṭäwwätä
መጠይቅ	mäṭäyyeq
መጥቼ	mäṭeččé
መጨመጨ	mäč̣ämmäč̣ä
መጫኛ	mäč̣añña
መጸወተ	mäṣäwwätä
መፈተኛ	mäfättäña
መፈናፈኛ	mäffänafäña
መፈክር	mäfäkker
ሙሀቻ	muhačča
ሙላጭ	mullač̣
ሙልል	mulell
ሙረዳ	murräda
ሙሽሪት	mušerrit
ሙሽራ	muššera
ሙትቻ	mutečča
ሙከራ	mukkära
ሙክት	mukket
ሙክክ	mukekk
ሙዋለጠ	muwalläṭä
ሙዋሙዋ	muwammuwa
ሙዋርተኛ	muwaretäñña
ሙዋሸሸ	muwaššäšä
ሙዋጠጠ	muwaṭṭäṭä
ሙዚቀኛ	muziqäñña
ሙዝዝ	muzezz
ሙያሌ	muyyalé
ሙያተኛ	muyatäñña
ሙዳ	mudda
ሙጃ	mujja
ሙጃማ	mujjamma
ሙጅር	mujjer
ሙግት	mugget
ሙግግ	mugegg
ሙጥኝ	muṭṭeññ
ሚሊዮን	milliyon
ሚዳቋ	midaqqʷa
ማለለ	mallälä
ማለቢያ	maläbbiya
ማለደ	mallädä
ማለገ	mallägä
ማላ	malla
ማላጋነት	malagannät
ማሕሌተኛ	maḥelétäñña
ማመላለሻ	mammälaläša
ማመሻ	mammäša
ማሚቴ	mammité
ማሚቶ	mammito
ማማሰያ	mammasäya
ማምረቻና	mameräčanna
ማሞ	mammo
ማሞኛ	mamoñña
ማሟያ	mammʷaya
ማረረ	marrärä
ማረከ	marräkä
ማረገኛ	marägäñña
ማራቢያ	marrabiya
ማራገቢያ	marragäbiya
ማሰሻ	massäša
ማሰፊያ	massäfiya
ማሳመኛ	masammäña
ማሳተሚያ	masattämiya
ማስረጃ	maseräjja
ማስቀመጫ	maseqämmäč̣a
ማስወረድ	masewärräd
ማስጠሎ	maseṭällo
ማሸጊያ	maššägiya
ማሻሻያ	maššašaya
ማሽላ	mašella
ማሾለቂያ	mašolläqiya
ማቀቀ	maqqäqä
ማቋረጫ	maqqʷaräč̣a
ማተሚያ	mattämiya
ማኅበረተኛ	maḫebärätäñña
ማኅበርተኛ	maḫebäretäñña
ማኅበርተኝነት	maḫebäretäññennät
ማነቃቂያ	mannäqaqiya
ማናበቢያ	mannabäbiya
ማን	mann
ማንም	manemm
ማንኛውም	manneññawem
ማእድ	maʾedd
ማከፋፈያ	makkäfafäya
ማካፈል	makkafäl
ማክሰኞ	makesäñño
ማዋሐጃ	mawwaḥaja
ማዕረገኛ	maʿerägäñña
ማዕድ	maʿedd
ማዕድን	maʿedden
ማይክሮስኮፕ	mayekerosekopp
ማደያ	maddäya
ማዳመጫ	maddamäč̣a
ማድጋ	madegga
ማገረ	maggärä
ማገደ	maggädä
ማገጃ	maggäja
ማገጠ	maggäṭä
ማጋጣነት	magaṭannät
ማጋጭነት	magač̣ennät
ማግሰኞ	magesäñño
ማፈኛ	maffäña
ሜዳማ	médamma
ምላሰኛ	melasäñña
ምላሰኝነት	melasäññennät
ምላሽ	mellaš
ምልስ	melles
ምልክት	melekket
ምረቃ	merräqa
ምረት	merrät
ምሩቅ	merruq
ምሪት	merrit
ምራጭ	merrač̣
ምሬት	merrét
ምር	merr
ምርምር	meremmer
ምርር	mererr
ምርቃት	merreqat
ምርኮኛ	merekoñña
ምርጊት	meregitt
ምሰሶ	mesässo
ምሳሌ	messalé
ምሳር	messar
ምስ	mess
ምስሪት	messerit
ምስራች	meseračč
ምስኪንነት	mesekinennät
ምስክር	mesekker
ምስግ	messeg
ምስጢረኛ	meseṭiräñña
ምስፍና	mesefenna
ምሽት	meššet
ምሽግ	meššeg
ምቀኛ	meqqäñña
ምቀኝነት	meqqäññennät
ምትክ	metekk
ምቹ	mečču
ምቹነት	meččunnät
ምች	mečč
ምቾት	meččot
ምነና	mennäna
ምናኔ	mennané
ምንም	menemm
ምንኛ	meneñña
ምንኩስና	menekusenna
ምንደኛ	menedäñña
ምንጅላት	menejellat
ምንጠራ	meneṭṭära
ምኞት	meññot
ምክትል	mekettel
ምደባ	meddäba
ምድጃ	medejja
ምጥዋተኛ	meṭewatäñña
ሞለለ	mollälä
ሞለሞለ	molämmolä
ሞለጨ	molläč̣ä
ሞለፈጠ	moläffäṭä
ሞላ	molla
ሞላላ	molalla
ሞላላነት	molallannät
ሞላጫ	mollač̣č̣a
ሞልሟላ	molemmʷalla
ሞልቃቃ	moleqaqqa
ሞረሞረ	morämmorä
ሞረደ	morrädä
ሞረድ	morräd
ሞሸለቀ	mošälläqä
ሞሸረ	moššärä
ሞሽላቃ	mošelaqqa
ሞቀሞቀ	moqämmoqä
ሞቀኝ	moqäññ
ሞቃት	moqqat
ሞቅሟቃ	moqemʷaqqa
ሞነተፈ	monättäfä
ሞከረ	mokkärä
ሞከተ	mokkätä
ሞከከ	mokkäkä
ሞካሪ	mokkari
ሞካች	mokkač
ሞዘዘ	mozzäzä
ሞዛዛነት	mozazannät
ሞያተኛ	moyatäñña
ሞጀረ	mojjärä
ሞገተ	moggätä
ሞገደኛ	mogäddäñña
ሞገገ	moggägä
ሞጋች	moggač
ሞጨለፈ	moč̣älläfä
ሞጨሞጨ	moč̣ämmoč̣ä
ሟለጠ	mʷalläṭä
ሟሟ	mʷammʷa
ሟሸሸ	mʷaššäšä
ሟከከ	mʷakkäkä
ሟጠጠ	mʷaṭṭäṭä
ሠለሰ	śälläsä
ሠለጠ	śälläṭä
ሠላጤ	śällaṭé
ሠመረ	śämmärä
ሠረሠረ	śäräśśärä
ሠረገ	śärrägä
ሠራ	śärra
ሠራተኛ	śärratäñña
ሠራው	śärraw
ሠራጊ	śärragi
ሠቀሠቀ	śäqäśśäqä
ሠቀቀ	śäqqäqä
ሠናይ	śännay
ሠወረ	śäwwärä
ሠወርዋራ	śäwärewarra
ሠዊ	śäwwi
ሠዋ	śäwwa
ሠዋራ	śäwwarra
ሠዓሊነት	śäʿalinnät
ሠየመ	śäyyämä
ሠያሚ	śäyyami
ሠገረ	śäggärä
ሠጋ	śägga
ሠጋር	śäggar
ሣሣ	śaśśa
ሣርማ	śaremma
ሥሉስ	śellus
ሥሉጥ	śelluṭ
ሥላሴ	śellasé
ሥልጣኔ	śelleṭṭané
ሥሡ	śeśśu
ሥሥት	śeśśet
ሥሥነት	śeśennät
ሥርቻ	śerečča
ሥቅቅ	śeqeqq
ሥያሜ	śeyyamé
ሦስተኛ	śosetäñña
ረመጠ	rämmäṭä
ረሰረሰ	räsärräsä
ረሳ	rässa
ረቀቀ	räqqäqä
ረቂቅነት	räqiqennät
ረበረበ	räbärräbä
ረበሸ	räbbäšä
ረበበ	räbbäbä
ረባ	räbba
ረባዳ	räbbadda
ረብሸኛ	räbešäñña
ረታ	rätta
ረኅብተኛ	räḫebetäñña
ረከሰ	räkkäsä
ረካ	räkka
ረኸጥነት	räxäṭennät
ረዘመ	räzzämä
ረዘረዘ	räzärräzä
ረዘቀ	räzzäqä
ረዥም	räžžem
ረዳ	rädda
ረዳት	räddat
ረጅም	räjjem
ረገመ	räggämä
ረገበ	räggäbä
ረገብ	rägäbb
ረገጠ	räggäṭä
ረገፈ	räggäfä
ረጋ	rägga
ረጋገጠ	rägaggäṭä
ረፈረፈ	räfärräfä
ረፈደ	räffädä
ረፋድ	räffad
ሩሩ	rurru
ሩስኛ	ruseñña
ራራ	rarra
ራብተኛ	rabetäñña
ርሚጦ	remmiṭo
ርቀት	reqqät
ርችት	reččet
ርካሽ	rekkaš
ርክክብ	rekekkeb
ርዝራዥ	rezerraž
ርጋጭ	reggač̣
ርጋፊ	reggafi
ሮሮ	rorro
ሰለለ	sällälä
ሰለመ	sällämä
ሰለሰለ	sälässälä
ሰለቀ	sälläqä
ሰለቀጠ	säläqqäṭä
ሰለበ	sälläbä
ሰለተ	sällätä
ሰለቸ	säläččä
ሰላ	sälla
ሰላላ	sällala
ሰላማዊነት	sälamawinnät
ሰላች	sällač
ሰላይ	sällay
ሰልካካ	sälekakka
ሰልፈኛ	sälefäñña
ሰመመ	sämmämä
ሰመጠ	sämmäṭä
ሰማ	sämma
ሰማዕትነት	sämaʿetennät
ሰምና	sämenna
ሰሞንኛ	sämoneñña
ሰረረ	särrärä
ሰረሰረ	särässärä
ሰረቀ	särräqä
ሰረዘ	särräzä
ሰረገላ	särägälla
ሰረጎደ	säräggodä
ሰራረዘ	särarräzä
ሰሰነ	sässänä
ሰቀለ	säqqälä
ሰቀቀ	säqqäqä
ሰቀቀኝ	säqqäqäññ
ሰቀዘ	säqqäzä
ሰቅ	säqq
ሰበረ	säbbärä
ሰበሰበ	säbässäbä
ሰበቀ	säbbäqä
ሰበበኛ	säbäbäñña
ሰበከ	säbbäkä
ሰባ	säbba
ሰባሰበ	säbassäbä
ሰባበረ	säbabbärä
ሰባተኛ	säbattäñña
ሰባት	säbatt
ሰባኛ	säbañña
ሰብሳባ	säbesabba
ሰተረ	sättärä
ሰተት	sätätt
ሰታራ	sättara
ሰነቀ	sännäqä
ሰነቀረ	sänäqqärä
ሰነበተ	sänäbbätä
ሰነበጠ	sänäbbäṭä
ሰነኘ	sänäññä
ሰነከለ	sänäkkälä
ሰነዘረ	sänäzzärä
ሰነገ	sännägä
ሰነፈ	sännäfä
ሰነፈጠ	sänäffäṭä
ሰኔና	sänénna
ሰንከሎ	sänekällo
ሰንካላ	sänekalla
ሰኞ	säñño
ሰከረ	säkkärä
ሰከሰከ	säkässäkä
ሰከነ	säkkänä
ሰካ	säkka
ሰካራም	säkkaram
ሰውነቱ	säwennätu
ሰውነቱን	säwennätun
ሰውነት	säwennät
ሰውየው	säweyyäw
ሰውየውን	säweyyäwen
ሰውዬ	säweyyé
ሰየመ	säyyämä
ሰየፈ	säyyäfä
ሰያፊ	säyyafi
ሰያፍ	säyyaf
ሰይፈኛ	säyefäñña
ሰደበ	säddäbä
ሰደደ	säddädä
ሰገሰገ	sägässägä
ሰገነት	sägännät
ሰገደ	säggädä
ሰገገ	säggägä
ሰጉዳት	sägguddat
ሰጐደ	säggʷädä
ሰጓዳ	sägʷadda
ሰጠ	säṭṭä
ሰጠመ	säṭṭämä
ሰፈረ	säffärä
ሰፈረተኛ	säfärätäñña
ሰፈርተኛ	säfäretäñña
ሰፈነ	säffänä
ሰፈፈ	säffäfä
ሰፊ	ssäfi
ሰፊው	säffiw
ሰፋ	säffa
ሰፍሳፋ	säfesaffa
ሱረት	surrät
ሱሪ	surri
ሱሰኛ	susäñña
ሱካር	sukkar
ሱፋጭ	suffač̣
ሲል	sill
ሲቀድ	siqädd
ሳሌ	sallé
ሳሎን	sallon
ሳማ	samma
ሳምንታዊ	sammenetawi
ሳምንት	sammenet
ሳቂታ	saqqitta
ሳቅ	saqq
ሳቢያ	sabbiya
ሳንባማ	sanebamma
ሳይንሰኛ	sayenesäñña
ሳዱላ	sadulla
ሴረኛ	séräñña
ሴሰነ	séssänä
ሴሰኛ	sésäñña
ሴሰኛነት	sésäññannät
ሴሰኝነት	sésäññennät
ሴተኛ	sétäñña
ሴትነት	sétennät
ስለላ	selläla
ስለሱ	selässu
ስለዚህ	seläzzih
ስለዚያ	seläzziya
ስሌት	sellét
ስልም	sellem
ስልምልም	selemelemm
ስልሳኛ	selesañña
ስልቅ	selleq
ስልቻ	sellečča
ስልከኛ	selekäñña
ስመኛ	semäñña
ስሜት	semmét
ስምም	sememm
ስምምነት	sememennät
ስምንተኛ	semenetäñña
ስምንት	semmenet
ስሞተኛ	semotäñña
ስረዛ	serräza
ስሪያ	serriya
ስርቅ	serreq
ስርቅታ	serreqeta
ስርዝ	serrez
ስቅላት	seqqelat
ስቅቅ	seqqeq
ስባሪ	sebbari
ስብራት	sebberat
ስብስብ	sebesebb
ስተተኛ	setätäñña
ስትር	setter
ስንባጭ	senebbač̣
ስንተኛ	senetäñña
ስንኝ	seneññ
ስንግ	senneg
ስንጣሪ	senneṭṭari
ስንፍና	senefenna
ስኳር	sekkʷar
ስውር	sewwer
ስያሜ	seyyamé
ስደተኛ	seddätäñña
ስደት	seddät
ስድ	sedd
ስድሳኛ	sedesañña
ስድስተኛ	seddesetäñña
ስድስት	seddeset
ስጋጃ	segajja
ስግስግ	segesegg
ስፋፊ	seffafi
ስፍስፍ	sefeseff
ስፖርተኛ	seporetäñña
ሶመሶመ	somässommä
ሶምሶማ	somessoma
ሸለለ	šällälä
ሸለመ	šällämä
ሸለሸለ	šäläššälä
ሸለቀቀ	šäläqqäqä
ሸለብ	šälläbb
ሸለተ	šällätä
ሸለገ	šällägä
ሸላለመ	šälallämä
ሸላሚ	šällami
ሸላች	šällač
ሸላይ	šällay
ሸመቀ	šämmäqä
ሸመቀቀ	šämäqqäqä
ሸመተ	šämmätä
ሸመታ	šämmäta
ሸመደደ	šämäddädä
ሸመድማዳ	šämädemadda
ሸመገለ	šämäggälä
ሸማቂ	šämmaqi
ሸማች	šämmač
ሸማኔ	šämmané
ሸሜኔ	šämméné
ሸምቀቆ	šämeqäqqo
ሸምቃቃ	šämeqaqqa
ሸምበቆ	šämebäqqo
ሸረሞጠ	šärämmoṭä
ሸረሸረ	šäräššärä
ሸረኛ	šärräña
ሸረኝነት	šäräññennät
ሸረከተ	šäräkkätä
ሸረካከተ	šäräkakkätä
ሸረደደ	šäräddädä
ሸረፈ	šärräfä
ሸራረፈ	šärarräfä
ሸር	šärr
ሸሻጊ	šäššagi
ሸቀለ	šäqqälä
ሸቀሸቀ	šäqäššäqä
ሸቀበ	šäqqäbä
ሸቀጠ	šäqqäṭä
ሸቃቢ	šäqqabi
ሸቃይ	šäqqay
ሸቃጭ	šäqqač̣
ሸበለለ	šäbällälä
ሸበሸበ	šäbäššäbä
ሸበበ	šäbbäbä
ሸበተ	šäbbätä
ሸበቶ	šäbbäto
ሸብ	šäbb
ሸብራቃ	šäberaqqa
ሸተተ	šättätä
ሸተተው	šättätäw
ሸተት	šätätt
ሸተትያ	šätäteyya
ሸነሸነ	šänäššänä
ሸነቀረ	šännäqqärä
ሸነቀጠ	šänäqqäṭä
ሸነቆረ	šänäqqorä
ሸነቆጠ	šänäqqoṭä
ሸነተረ	šänättärä
ሸነታተረ	šänätattärä
ሸነከፈ	šänäkkäfä
ሸነደረ	šänäddärä
ሸነገለ	šänäggälä
ሸነጠ	šännäṭä
ሸና	šänna
ሸንበቆ	šänebäqqo
ሸንተረርማ	šänetäräremma
ሸንከሎ	šänekällo
ሸንካፋ	šänekkafa
ሸንዳራ	šänedarra
ሸኘ	šäññä
ሸኚ	šäññi
ሸከሸከ	šäkäššäkä
ሸከፈ	šäkkäfä
ሸካፋ	šäkkafa
ሸኮተ	šäkkotä
ሸውራራ	šäwerrara
ሸውሻዋ	šäwešawwa
ሸየኛ	šäyäñña
ሸጐረ	šäggʷärä
ሸጐጠ	šäggʷäṭä
ሸጠኝ	šäṭäññ
ሸፈተ	šäffätä
ሸፈነ	šäffänä
ሸፈጠ	šäffäṭä
ሸፈፈ	šäffäfä
ሸፋጭ	šäffač̣
ሸፋፈነ	šäfaffänä
ሸፍጠኛ	šäfeṭäñña
ሹሩባ	šurrubba
ሹራብ	šurrab
ሹርቤ	šurebbé
ሹካ	šukka
ሹክ	šukk
ሹክክ	šukekk
ሺህኛ	šiheñña
ሻምበል	šamebäll
ሻቀለ	šaqqälä
ሻንቅላ	šaneqella
ሻኛ	šañña
ሻከረ	šakkärä
ሻከር	šakärr
ሻገተ	šaggätä
ሻግያ	šageyya
ሻፈደ	šaffädä
ሽለላ	šelläla
ሽልማት	šellemat
ሽልም	šellem
ሽልት	šellet
ሽልግ	šelleg
ሽልጦ	šelleṭo
ሽመቃ	šemmäqa
ሽሚያ	šemmiya
ሽማግሌ	šemagellé
ሽምብራ	šemeberra
ሽምግልና	šemegellena
ሽር	šerr
ሽርሙጥና	šeremuṭenna
ሽርሽር	šerrešerr
ሽርክና	šerekenna
ሽርጥ	šerreṭ
ሽርፋት	šerrefat
ሽሽት	šeššet
ሽሽግ	šeššeg
ሽቀላ	šeqqäla
ሽቀባ	šeqqäba
ሽቅብ	šeqqeb
ሽብልቅ	šebelleq
ሽብር	šebber
ሽቱ	šettu
ሽታ	šetta
ሽታው	šettaw
ሽቶ	šetto
ሽንፍላ	šenefella
ሽክ	šekk
ሽክና	šekkena
ሽክፍ	šekkef
ሽኮኮ	šekokko
ሽው	šeww
ሽውታ	šewweta
ሽያጭ	šeyyač̣
ሽጉር	šeggur
ሽጉጥ	šegguṭṭ
ሽፋች	šeffač
ሽፍ	šeff
ሽፍታ	šeffeta
ሽፍትነት	šefetennät
ሽፍን	šeffen
ሾለከ	šolläkkä
ሾላካ	šollaka
ሾከከ	šokkäkä
ሾጥ	šoṭṭ
ቀለለ	qällälä
ቀለል	qäläll
ቀለመ	qällämä
ቀለሰ	qälläsä
ቀለበ	qälläbä
ቀለበሰ	qäläbbäsä
ቀለብ	qälläb
ቀለብላባ	qäläbellaba
ቀለብተኛ	qälläbetäñña
ቀለደ	qällädä
ቀለጠ	qälläṭä
ቀላ	qälla
ቀላለሰ	qälalläsä
ቀላለደ	qälallädä
ቀላል	qällal
ቀላመደ	qälammädä
ቀላማጅነት	qälamajjennät
ቀላቢ	qällabi
ቀላወጠ	qälawwäṭä
ቀላጅ	qällaj
ቀልማዳ	qälemadda
ቀልቃላ	qäleqalla
ቀልደኛ	qäledäñña
ቀልጠፍ	qäleṭäff
ቀልጣፋ	qäleṭaffa
ቀመለ	qämmälä
ቀመመ	qämmämä
ቀመሰ	qämmäsä
ቀመስ	qämmäs
ቀመቀመ	qämäqqämä
ቀማ	qämma
ቀማመሰ	qämammäsä
ቀማሚ	qämmami
ቀማኛ	qämmañña
ቀሠረ	qäśśärä
ቀሠፈ	qäśśäfä
ቀረ	qärrä
ቀረረ	qärrärä
ቀረሽ	qärräš
ቀረቀረ	qäräqqärä
ቀረቀበ	qäräqqäbä
ቀረበ	qärräbä
ቀረና	qäränna
ቀረደደ	qäräddädä
ቀረጠ	qärräṭä
ቀረጸ	qärräṣä
ቀረፈ	qärräfä
ቀራረመ	qärarrämä
ቀራረፈ	qärarräfä
ቀር	qärr
ቀርፋፋ	qärefaffa
ቀሰመ	qässämä
ቀሰረ	qässärä
ቀሰሰ	qässäsä
ቀሰስተኛ	qäsäsetäñña
ቀሰስተኛነት	qäsäsetäññannät
ቀሰቀሰ	qäsäqqäsä
ቀሰተ	qässätä
ቀሳሰመ	qäsassämä
ቀሳፈተ	qäsaffätä
ቀስ	qäss
ቀስተኛ	qäsetäñña
ቀስታ	qässeta
ቀቀለ	qäqqälä
ቀቃይ	qäqqay
ቀበሌኛ	qäbäléñña
ቀበቀበ	qäbäqqäbä
ቀበተተ	qäbättätä
ቀበቶ	qäbätto
ቀበኛ	qäbäñña
ቀበዝባዛ	qäbäzebazza
ቀበጠ	qäbbäṭä
ቀባ	qäbba
ቀባባ	qäbabba
ቀባጀረ	qäbajjärä
ቀብራራ	qäberarra
ቀብቃባ	qäbeqabba
ቀተረ	qättärä
ቀነሰ	qännäsä
ቀነቀነ	qänäqqänä
ቀነበረ	qänäbbärä
ቀነተ	qännätä
ቀነዘረ	qänäzzärä
ቀነደበ	qänäddäbä
ቀነፈ	qännäfä
ቀና	qänna
ቀናተኛ	qännatäñña
ቀናነሰ	qänannäsä
ቀን	qänn
ቀንደኛ	qänedäñña
ቀኖና	qännona
ቀኛዝማች	qäññazemač
ቀኝ	qäññ
ቀውላላ	qäwelalla
ቀዘቀዘ	qäzäqqäzä
ቀዘቀዘው	qäzäqqäzäw
ቀዘነ	qäzzänä
ቀዘዘ	qäzzäzä
ቀዘፈ	qäzzäfä
ቀዝቃዛ	qäzeqazza
ቀዥቃዣ	qäžeqažža
ቀየሠ	qäyyäśä
ቀየረ	qäyyärä
ቀየደ	qäyyädä
ቀየጠ	qäyyäṭä
ቀያሽ	qäyyaš
ቀያቴ	qäyyaté
ቀያየረ	qäyayyärä
ቀያየጠ	qäyayyäṭä
ቀይ	qäyy
ቀደመ	qäddämä
ቀደምትነት	qäddämetennät
ቀደሰ	qäddäsä
ቀደደ	qäddädä
ቀዳሚነት	qädaminnät
ቀዳሽ	qäddaš
ቀዶ	qäddo
ቀጠቀጠ	qäṭäqqäṭä
ቀጣፊነት	qäṭafinnät
ቀጨቀጨ	qäč̣äqqäč̣ä
ቀፈረረ	qäfärrärä
ቀፈቀፈ	qäfäqqäfä
ቀፈደደ	qäfäddädä
ቀፈፈ	qäffäfä
ቀፍራራ	qäferrara
ቁለላ	qulläla
ቁሌት	qullét
ቁልም	qulemm
ቁልፍ	qulleff
ቁማርተኛ	qumaretäñña
ቁማጭ	qummač̣
ቁምጥ	qummeṭṭ
ቁምጥና	qumeṭenna
ቁራሽ	qurraš
ቁራኛ	qurañña
ቁራጭ	qurrač̣
ቁር	qurr
ቁርጥምጥም	qureṭemeṭemm
ቁስለኛ	quseläñña
ቁቅ	quqq
ቁና	qunna
ቁንን	qunnen
ቁንጅና	qunejenna
ቁጥር	quṭṭer
ቁፈራ	quffära
ቁፋሪ	quffari
ቁፋሮ	quffaro
ቁፍር	quffer
ቂመኛ	qimäñña
ቂጥኝ	qiṭeññ
ቃልቻ	qallečča
ቃረመ	qarrämä
ቃሬ	qarré
ቃበዘ	qabbäzä
ቃተተ	qattätä
ቃኘ	qaññä
ቃዠ	qažžä
ቄንጠኛ	qéneṭäñña
ቅሌተኛ	qellétäñña
ቅሌታም	qellétam
ቅሌት	qellét
ቅልሽስሽ	qelešesešš
ቅልቅል	qeleqqel
ቅልብ	qelleb
ቅልጥ	qelleṭṭ
ቅልጥፍና	qeleṭefenna
ቅልጥፍጥፍ	qeleṭeffeṭef
ቅመማ	qemmäma
ቅሚያ	qemmiya
ቅምምጦሽ	qememmeṭoš
ቅምብቻ	qemebečča
ቅምጥ	qemmeṭ
ቅሥር	qeśśer
ቅሪላ	qerilla
ቅሪት	qerrit
ቅራሪ	qerrari
ቅራፊ	qerrafi
ቅሬታ	qerréta
ቅር	qerr
ቅርጥፍ	qereṭeff
ቅርፊት	qerefitt
ቅርፍፍ	qerefeff
ቅስት	qesset
ቅስና	qessenna
ቅቅል	qeqqel
ቅበላ	qebbäla
ቅባቅዱስ	qebaqeddus
ቅብብል	qebebbel
ቅብብሎሽ	qebebbeloš
ቅነሳ	qennäsa
ቅናሽ	qennaš
ቅንብር	qenebber
ቅንነት	qenennät
ቅንዝረኛ	qenezeräñña
ቅንዲላ	qenedilla
ቅንፍ	qennef
ቅኝ	qeññ
ቅኝት	qeññet
ቅዝቃዜ	qezeqqazé
ቅዝዝ	qezzez
ቅዥቅዥ	qežeqežž
ቅየሣ	qeyyäśa
ቅያሜ	qeyyamé
ቅያሪ	qeyyari
ቅይድ	qeyyed
ቅይጥ	qeyyeṭ
ቅዱሳን	qeddusan
ቅዱስ	qeddus
ቅዱስነት	qeddusennät
ቅዳሴ	qeddasé
ቅዳጅ	qeddaj
ቅድ	qedd
ቅድም	qeddem
ቅድሳት	qeddesat
ቅድስተ	qeddesetä
ቅድስት	qeddeset
ቅድስና	qeddesena
ቅጅ	qejj
ቅጠልያ	qeṭäleyya
ቅጥረኛ	qeṭeräñña
ቅጥቃጤ	qeṭeqqaṭé
ቅፍር	qeferr
ቅፍርር	qefererr
ቆለለ	qollälä
ቆለመመ	qolämmämä
ቆለኛ	qolläñña
ቆላ	qolla
ቆሌ	qollé
ቆልማማ	qolemamma
ቆልቋላ	qoleqʷalla
ቆመጠ	qommäṭä
ቆም	qomm
ቆራረሰ	qorarräsä
ቆራጥ	qorraṭ
ቆርቆሮ	qoreqorro
ቆርጦኝ	qoreṭoññ
ቆሸሸ	qoššäšä
ቆሽማዳ	qošemadda
ቆነጀ	qonäjjä
ቆነጣጠረ	qonäṭṭaṭṭärä
ቆየ	qoyyä
ቆይታ	qoyyeta
ቆጠቆጠ	qoṭäqqoṭä
ቆጶስ	qop̣p̣os
ቆፈረ	qoffärä
ቆፈነነ	qofännänä
ቆፋሪ	qoffari
ቆፋፈረ	qofaffärä
ቈለመመ	qʷälämmämä
ቈለቈለ	qʷäläqqʷälä
ቈለፈ	qʷälläfä
ቈላለፈ	qʷälalläfä
ቈላፋ	qʷällaffa
ቈላፍ	qʷällaf
ቈረመደ	qʷärämmädä
ቈረሰ	qʷärräsä
ቈረቈረ	qʷäräqqʷärä
ቈረቈሰ	qʷäräqqʷäsä
ቈረበ	qʷärräbä
ቈረጠ	qʷärräṭä
ቈረፈደ	qʷäräffädä
ቈራ	qʷärra
ቈራረጠ	qʷärarräṭä
ቈራጥ	qʷärraṭ
ቈርማዳ	qʷäremadda
ቈርቈዘ	qʷäreqqʷäzä
ቈርቋዛ	qʷäreqqʷaza
ቈርፋዳ	qʷärefadda
ቈሰለ	qʷässälä
ቈሰቈሰ	qʷäsäqqʷäsä
ቈነሰ	qʷännäsä
ቈነነ	qʷännänä
ቈነደደ	qʷänäddädä
ቈነጐለ	qʷänäggʷälä
ቈንቋና	qʷäneqʷanna
ቋመጠ	qʷammäṭä
ቋቅ	qʷaqq
ቋቅታ	qʷaqqetta
ቋቍቻ	qʷaqqʷǝčča
ቋያ	qʷayya
ቋጥኝ	qʷaṭṭeññ
ቍልጭ	qʷǝlleč̣č̣
ቍራጭ	qʷǝrrač̣
ቍርጥ	qʷǝrreṭ
ቍስለ	qʷǝsellä
በለቀጠ	bäläqqäṭä
በለተ	bällätä
በለኝ	bäläññ
በለዘ	bälläzä
በለገ	bällägä
በለጠ	bälläṭä
በሉጥ	bälluṭ
በሊታ	bällita
በላ	bälla
በሌለበት	bälélläbät
በል	bäll
በመጀመሪያው	bämäjämmäriyaw
በሞላ	bämolla
በረሃማ	bärähamma
በረረ	bärrärä
በረቀ	bärräqä
በረቀሰ	bäräqqäsä
በረቃቀሰ	bäräqaqqäsä
በረበረ	bäräbbärä
በረታ	bärätta
በረኛ	bärräñña
በረከተ	bäräkkätä
በረኸኛ	bäräxäñña
በረዘ	bärräzä
በረደ	bärrädä
በረደኝ	bärrädäññ
በረገደ	bäräggädä
በረገገ	bäräggägä
በረጋገደ	bärägaggädä
በራ	bärra
በራረዘ	bärarräzä
በራዥ	bärraž
በራድ	bärrad
በራፍ	bärraf
በር	bärr
በርበሬ	bärebärré
በርካታ	bärekatta
በርዳማ	bäredamma
በርጩማ	bäreč̣umma
በሰለ	bässälä
በሰበሰ	bäsäbbäsä
በሰፊው	bäsäffiw
በሳ	bässa
በሳል	bässal
በስባሳ	bäsebassa
በሶ	bässo
በሸቀ	bäššäqä
በሸቀጠ	bäšäqqäṭä
በሽተኛ	bäššetäñña
በሽታ	bäššeta
በቀለ	bäqqälä
በቀለኛ	bäqäläñña
በቀል	bäqqäl
በቀስ	bäqäss
በቀስታ	bäqässeta
በቀተ	bäqqätä
በቀደም	bäqäddäm
በቃ	bäqqa
በቃኝ	bäqqañ
በቅበቃ	bäqebäqqa
በቆሎ	bäqqollo
በቈልት	bäqqʷälet
በቡጢ	bäbuṭṭi
በተለይ	bätäläyy
በተረፈ	bätärräfä
በተነ	bättänä
በተጨማሪ	bätäč̣ämmari
በታተነ	bätattänä
በትር	bätter
በነነ	bännänä
በአጋጣሚ	bäʾagaṭṭami
በከለ	bäkkälä
በከተ	bäkkätä
በኩል	bäkkul
በካይ	bäkkay
በወዘ	bäwwäzä
በዘበዘ	bäzäbbäzä
በዚህ	bäzzih
በዚህም	bäzihemm
በዚያ	bäzziya
በዛ	bäzza
በየሰዓቱ	bäyyäsäʿatu
በየቀኑ	bäyyäqänu
በየተራ	bäyyätära
በየነ	bäyyänä
በየወቅቱ	bäyyäwäqetu
በየዓመቱ	bäyyäʿamätu
በየደ	bäyyädä
በየጊዜው	bäyyägizéw
በየግል	bäyyägell
በየፊናው	bäyyäfinaw
በያለበት	bäyyalläbbät
በያኝ	bäyyaññ
በያጅ	bäyyaj
በደለ	bäddälä
በደለኛ	bädäläñña
በደል	bäddäl
በደዊ	bädäwwi
በዱላ	bädulla
በዳ	bädda
በዳይ	bädday
በድጋሚ	bädeggami
በጀ	bäjjä
በጅምር	bäjemmer
በገነ	bäggänä
በገዛ	bägäzza
በግላጭ	bägellač̣
በግል	bägell
በግምት	bägemmet
በግድ	bägedd
በጐ	bäggʷä
በጐነት	bäggʷännät
በጠቅላላ	bäṭäqelalla
በጠቅላላው	bäṭäqelallaw
በጠበጠ	bäṭäbbäṭä
በጡጫ	bäṭuč̣č̣a
በጥሞና	bäṭemmona
በጥያቄ	bäṭeyyaqé
በጥፊ	bäṭeffi
በጭራሽ	bäč̣erraš
በጭካኔ	bäč̣ekkané
በጭፍን	bäč̣effen
ቡላ	bulla
ቡልቅ	bulleqq
ቡልቅታ	bulleqeta
ቡረቃ	burräqa
ቡራቡሬ	burraburré
ቡራኬ	burraké
ቡሬ	burré
ቡሬማ	burrémma
ቡቃያ	buqayya
ቡቡ	bubbu
ቡትርፍ	butereff
ቡችላ	buččella
ቡና	bunna
ቡናማ	bunnamma
ቡናኝ	bunnañ
ቡን	bunn
ቡንኝ	bunneññ
ቡዳነት	budannät
ቡድስ	buddes
ቡድነት	budennät
ቡግ	bugg
ቡፍ	buff
ቢሆንም	bihonemm
ቢላዋ	billawa
ቢላዎ	billawo
ቢል	bill
ቢልቢላ	bilebilla
ቢራቢሮ	birrabirro
ቢዘገይም	bizägäyyem
ባለሥልጣኖች	baläśeleṭanočč
ባለሳምንት	baläsammenet
ባለስድስት	baläseddeset
ባለብር	baläberr
ባለእጅ	baläʾejj
ባለጅ	baläjj
ባለገ	ballägä
ባለጉዳይ	balägudday
ባለጌነት	balägénnät
ባለጠጋ	baläṭägga
ባለጥግ	baläṭegg
ባለፀጋ	baläẓägga
ባላ	balla
ባላባት	balabbat
ባላባትነት	balabbatennät
ባላንጣነት	balaneṭannät
ባልትና	baletenna
ባልና	balenna
ባልንጀርነት	balenejärennät
ባልጩት	baleč̣utt
ባረቀ	barräqä
ባረከ	barräkä
ባርማሽላ	baremašella
ባርነት	barennät
ባሻ	bašša
ባባ	babba
ባነነ	bannänä
ባንድነት	banedennät
ባኞ	bañño
ባከነ	bakkänä
ባዘቀ	bazzäqä
ባዘተ	bazzätä
ቤተኛ	bétäñña
ቤዛ	bézza
ብላታ	belatta
ብላቴና	belatténa
ብላቴን	belattén
ብላጊ	bellagi
ብልሃተኛ	belehatäñña
ብልሹ	beleššu
ብልት	bellet
ብልኮ	bellekko
ብልዝ	bellezz
ብልግ	bellegg
ብልግና	belegenna
ብልጥግና	beleṭeggenna
ብልጫ	belleč̣a
ብልጭ	belleč̣
ብልጭታ	belleč̣eta
ብልፅግና	beleẓeggenna
ብሎት	bellot
ብሔረተኛ	beḥérätäñña
ብሕትውና	beḥetewenna
ብረድስት	beräddeset
ብራ	berra
ብራቢሮ	berabirro
ብራና	beranna
ብራኳ	berakkʷa
ብር	berr
ብርሌ	berellé
ብርቅስቅስ	bereqeseqqes
ብርኩማ	berekumma
ብርካቴ	berekkaté
ብርግድ	beregedd
ብርጭቆ	bereč̣eqqo
ብስባሽ	besebbaš
ብስጭትጭት	beseč̣eteč̣č̣et
ብቁነት	beqqunnät
ብቅ	beqq
ብቡ	bebbu
ብብት	bebbet
ብትቶ	betetto
ብትቷም	betettʷam
ብትን	betten
ብቸኛ	beččäñña
ብቸኝነት	beččäññennät
ብቻ	bečča
ብናኝ	bennaññ
ብኩርና	bekurenna
ብኩንነት	bekunennät
ብካች	bekkač
ብክል	bekkel
ብክት	bekket
ብው	beww
ብየዳ	beyyädda
ብያኔ	beyyané
ብዬ	beyyé
ብይ	beyy
ብይን	beyyen
ብይድ	beyyed
ብድር	bedder
ብድግ	bedegg
ብጥብጥ	beṭebbeṭ
ቦሎቄ	bolloqé
ቦረቀ	borräqä
ቦረቦረ	boräbborä
ቦራቂ	borraqi
ቦርቃቃ	boreqaqqa
ቦቃማ	boqamma
ቦተረፈ	botärräfä
ቦታ	botta
ቦነነ	bonnänä
ቦከቦከ	bokäbbokä
ቦካ	bokka
ቦዘነ	bozzänä
ቦዘንተኛ	bozänetäñña
ቦደሰ	boddäsä
ቦግ	bogg
ቦግታ	boggeta
ቦጨቅ	boč̣č̣äq
ቦጫጨረ	boč̣č̣ač̣ärä
ቦጭ	boč̣č̣
ቧገተ	bʷaggätä
ተለመ	tällämä
ተለመለመ	tälämällämä
ተለመሰሰ	tälämässäsä
ተለመነ	tälämmänä
ተለመዘገ	tälämäzzägä
ተለመደ	tälämmädä
ተለመጠ	tälämmäṭä
ተለማመነ	tälämammänä
ተለማመደ	tälämammädä
ተለማመጠ	tälämammäṭä
ተለማኝ	tälämmañ
ተለማጅ	tälämmaj
ተለማጭ	tälämmač̣
ተለሰነ	tälässänä
ተለሳለሰ	täläsalläsä
ተለቀ	tälläqä
ተለቀለቀ	täläqälläqä
ተለቀመ	täläqqämä
ተለቀቀ	tälläqqäqä
ተለቃለቀ	täläqalläqä
ተለበለበ	täläbälläbä
ተለበቀ	täläbbäqä
ተለበበ	täläbbäbä
ተለበደ	täläbbädä
ተለበጠ	täläbbäṭä
ተለባቂ	täläbbaqi
ተለባበሰ	täläbabbäsä
ተለተለ	tälättälä
ተለተመ	tälättämä
ተለወጠ	täläwwäṭä
ተለዋወጠ	täläwawwäṭä
ተለዋጭ	täläwwač̣
ተለየ	täläyyä
ተለያየ	täläyayyä
ተለጠለጠ	täläṭälläṭä
ተለፈፈ	täläffäfä
ተለፋለፈ	täläfalläfä
ተለፋላፊ	täläfallafi
ተላ	tälla
ተላለቀ	tälalläqä
ተላለፈ	tälalläfä
ተላላኪነት	tälalakinnät
ተላላፊ	tälallafi
ተላመደ	tälammädä
ተላመጠ	tälammäṭä
ተላቀሰ	tälaqqäsä
ተላቀቀ	tälaqqäqä
ተላከከ	tälakkäkä
ተላወሰ	tälawässä
ተላፋ	tälaffa
ተልከስከሰ	tälekäsekkäsä
ተልከፈከፈ	tälekäfäkkäfä
ተልካሳ	tälekassa
ተልፈሰፈሰ	tälefäsäffäsä
ተመለሰ	tämälläsä
ተመለከ	tämälläkä
ተመለከተ	tämäläkkätä
ተመለጠ	tämälläṭä
ተመላለሰ	tämälalläsä
ተመላለጠ	tämälalläṭä
ተመላሽ	tämällaš
ተመላኪ	tämällaki
ተመመ	tämmämä
ተመሠረተ	tämäśśärätä
ተመሠጠ	tämmäśśäṭä
ተመሥጦ	tämäśśeṭo
ተመረመረ	tämärämmärä
ተመረረ	tämärrärä
ተመረቀ	tämärräqä
ተመረኰዘ	tämäräkkʷäzä
ተመረዘ	tämärräzä
ተመረገ	tämärrägä
ተመረጠ	tämärräṭä
ተመራ	tämärra
ተመራመረ	tämärammärä
ተመራቂ	tämärraqi
ተመራጭ	tämärrač̣
ተመራጭነት	tämärrač̣ennät
ተመሰለ	tämässälä
ተመሰቃቀለ	tämäsäqaqqälä
ተመሰከረ	tämäsäkkärä
ተመሰገነ	tämäsäggänä
ተመሰጠ	tämässäṭä
ተመሳቀለ	tämäsaqqälä
ተመሳከረ	tämäsakkärä
ተመተመ	tämättämä
ተመተረ	tämättärä
ተመታ	tämätta
ተመቸ	tämäččä
ተመቻቸ	tämäčaččä
ተመነ	tämmänä
ተመነቃቀረ	tämänäqaqqärä
ተመነተፈ	tämänättäfä
ተመነዘረ	tämänäzzärä
ተመናቀረ	tämänaqqärä
ተመኘ	tämäññä
ተመከረ	tämäkkärä
ተመከተ	tämäkkätä
ተመካ	tämäkka
ተመካከረ	tämäkakkärä
ተመዘመዘ	tämäzämmäzä
ተመዘበረ	tämäzäbbärä
ተመዘነ	tämäzzänä
ተመዘዘ	tämäzzäzä
ተመዘገበ	tämäzäggäbä
ተመዛዘነ	tämäzazzänä
ተመደበ	tämäddäbä
ተመገበ	tämäggäbä
ተመጋቢ	tämäggabbi
ተመጠወተ	tämäṭäwwätä
ተመጻደቀ	tämäṣaddäqä
ተማለደ	tämallädä
ተማመነ	tämammänä
ተማማ	tämamma
ተማረረ	tämarrärä
ተማረከ	tämarräkä
ተማረዘ	tämarräzä
ተማራ	tämarra
ተማሰለ	tämassälä
ተማታ	tämatta
ተማከረ	tämakkärä
ተማዘዘ	tämazzäzä
ተማገረ	tämaggärä
ተማገደ	tämaggädä
ተምቦጫቦጨ	tämeboč̣abboč̣ä
ተምታታ	tämetatta
ተምነሸነሸ	tämenäšännäšä
ተምዘአዘገ	tämezäʾazzägä
ተምዘገዘገ	tämezägäzzägä
ተሞለጨ	tämolläč̣ä
ተሞላ	tämolla
ተሞላቀቀ	tämolaqqäqä
ተሞላፈጠ	tämolaffäṭä
ተሞረደ	tämorrädä
ተሞሸለቀ	tämošälläqä
ተሞሸረ	tämoššärä
ተሞከረ	tämokkärä
ተሞከተ	tämokkätä
ተሞካከረ	tämokakkärä
ተሞክሮ	tämokkero
ተሞጀረ	tämojjärä
ተሞገሰ	tämoggäsä
ተሞጋሽ	tämoggaš
ተሞጋገሰ	tämogaggäsä
ተሞጨለፈ	tämoč̣älläfä
ተሟላ	tämʷalla
ተሟሸ	tämʷaššä
ተሟከረ	tämʷakkärä
ተሟገተ	tämʷaggätä
ተሟጋች	tämʷaggač
ተሠረሠረ	täśäräśśärä
ተሠረገ	täśärrägä
ተሠቀሠቀ	täśäqäśśäqä
ተሠወረ	täśäwwärä
ተሠዋሪ	täśäwwari
ተሠየመ	täśäyyämä
ተሣሠረ	täśaśśärä
ተረማመደ	tärämammädä
ተረሳ	tärässa
ተረሳሳ	täräsassa
ተረበ	tärräbä
ተረበረበ	täräbärräbä
ተረበኛ	täräbäñña
ተረባረበ	täräbarräbä
ተረተ	tärrätä
ተረተረ	tärättärä
ተረታ	tärätta
ተረኛ	täräñña
ተረከበ	täräkkäbä
ተረከከ	täräkkäkä
ተረካቢ	täräkkabi
ተረካከበ	täräkakkäbä
ተረኰሰ	täräkkʷäsä
ተረዳ	tärädda
ተረዳዳ	tärädadda
ተረገመ	täräggämä
ተረገረገ	tärägärrägä
ተረገዘ	täräggäzä
ተረገጠ	täräggäṭä
ተረጋጋ	tärägagga
ተረጐመ	täräggʷämä
ተረፈ	tärräfä
ተራመደ	tärammädä
ተራረመ	tärarrämä
ተራረደ	tärarrädä
ተራራማ	täraramma
ተራቀቀ	täraqqäqä
ተራቢ	tärrabi
ተራባ	tärabba
ተራች	tärrač
ተራኪ	tärraki
ተራኰተ	tärakkʷätä
ተራገመ	täraggämä
ተራገጠ	täraggäṭä
ተራገፈ	täraggäfä
ተርመሰመሰ	täremäsämmäsä
ተርመጠመጠ	täremäṭämmäṭä
ተርበተበተ	tärebätäbbätä
ተርበደበደ	tärebädäbbädä
ተርከፈከፈ	tärekäfäkkäfä
ተርካካ	tärekakka
ተርገበገበ	täregäbäggäbä
ተሰለለ	täsällälä
ተሰለቀ	täsälläqä
ተሰለበ	täsälläbä
ተሰለቸ	täsäläččä
ተሰለቻቸ	täsäläčaččä
ተሰለፈ	täsälläfä
ተሰላቸ	täsälaččä
ተሰላፊ	täsällafi
ተሰሚነት	täsäminnät
ተሰማ	täsämma
ተሰማማ	täsämamma
ተሰረረ	täsärrärä
ተሰረሰረ	täsärässärä
ተሰረቀ	täsärräqä
ተሰረነቀ	täsärännäqä
ተሰረዘ	täsärräzä
ተሰረጐደ	täsäräggʷäddä
ተሰራረቀ	täsärarräqä
ተሰቀለ	täsäqqälä
ተሰቀቀ	täsäqqäqä
ተሰቃየ	täsäqayyä
ተሰቃይ	täsäqqay
ተሰበረ	täsäbbärä
ተሰበሰበ	täsäbässäbä
ተሰበከ	täsäbbäkä
ተሰባሪ	täsäbbari
ተሰባበረ	täsäbabbärä
ተሰተረ	täsättärä
ተሰነቀ	täsännäqä
ተሰነቀረ	täsänäqqärä
ተሰነቀረብኝ	täsänäqqäräbeññ
ተሰነባበተ	täsänäbabbätä
ተሰነከለ	täsänäkkälä
ተሰነዳዳ	täsänädadda
ተሰነገ	täsännägä
ተሰናበተ	täsänabbätä
ተሰናከለ	täsänakkälä
ተሰናዘረ	täsänazzärä
ተሰናዳ	täsänadda
ተሰኘ	täsäññä
ተሰካ	täsäkka
ተሰወጠ	täsäwwäṭä
ተሰየፈ	täsäyyäfä
ተሰደበ	täsäddäbä
ተሰደደ	täsäddädä
ተሰዳደበ	täsädaddäbä
ተሰገሰገ	täsägässägä
ተሳለመ	täsallämä
ተሳለቀ	täsalläqä
ተሳረረ	tässarrärä
ተሳረቀ	täsarräqä
ተሳሰበ	täsassäbä
ተሳቀቀ	täsaqqäqä
ተሳበበ	täsabbäbä
ተሳተፈ	täsattäfä
ተሳከረ	täsakkärä
ተሳካ	täsakka
ተሳደበ	täsaddäbä
ተሳደደ	täsaddädä
ተስለመለመ	täselämällämä
ተስለከለከ	täseläkälläkä
ተስማማ	täsemamma
ተስገበገበ	täsegäbäggäbä
ተስፋፋ	täsefaffa
ተሸለመ	täšällämä
ተሸለቀቀ	täšäläqqäqä
ተሸለተ	täšällätä
ተሸላለመ	täšälallämä
ተሸላሚ	täšällami
ተሸመቀቀ	täšämäqqäqä
ተሸመተ	täšämmätä
ተሸማቀቀ	täšämaqqäqä
ተሸረሸረ	täšäräššärä
ተሸረከተ	täšäräkkätä
ተሸረካከተ	täšäräkakkätä
ተሸረፈ	täšärräfä
ተሸራረፈ	täšärarräfä
ተሸራፊ	täšärrafi
ተሸሸገ	täšäššägä
ተሸቀበ	täšäqqäbä
ተሸበረ	täšäbbärä
ተሸበበ	täšäbbäbä
ተሸነሸነ	täšänäššänä
ተሸነተረ	täšänättärä
ተሸናነፈ	täšänannäfä
ተሸናፊ	täšännafi
ተሸኘ	täšäññä
ተሸከመ	täšäkkämä
ተሸከሸከ	täšäkäššäkä
ተሸካሚ	täšäkkami
ተሸካከመ	täšäkakkämä
ተሸጋሸገ	täššägaššägä
ተሸጋገረ	täšägaggärä
ተሸጐረ	täšäggʷärä
ተሸጐጠ	täšäggʷäṭä
ተሸፈነ	täšäffänä
ተሸፋፈነ	täšäfaffänä
ተሹለከለከ	täšuläkälläkä
ተሻማ	täšamma
ተሻረከ	täšarräkä
ተሻሸ	täšaššä
ተሻኰተ	täšakkʷätä
ተሻገረ	täšaggärä
ተሽመደመደ	täšemädämmädä
ተሽቀዳደመ	täšeqädaddämä
ተሽቆጠቆጠ	täšeqoṭäqqoṭä
ተሽበለበለ	täšebäläbbälä
ተሽከረከረ	täšekäräkkärä
ተሽኮረመመ	täšekorämmämä
ተቀለሰ	täqälläsä
ተቀለበ	täqälläbä
ተቀለበሰ	täqäläbbäsä
ተቀላ	täqälla
ተቀላለደ	täqälallädä
ተቀላቀለ	täqälaqqälä
ተቀላቢ	täqällabi
ተቀመለ	täqämmälä
ተቀመመ	täqämmämä
ተቀመሰ	täqämmäsä
ተቀመጠ	täqämmäṭä
ተቀማ	täqämma
ተቀማጭ	täqämmač̣
ተቀረቀረ	täqäräqqärä
ተቀረቀበ	täqäräqqäbä
ተቀረደደ	täqäräddädä
ተቀረጠ	täqärräṭä
ተቀረጸ	täqärräṣä
ተቀረፈ	täqärräfä
ተቀራረፈ	täqärarräfä
ተቀሰመ	täqässämä
ተቀሰረ	täqässärä
ተቀሰቀሰ	täqäsäqqäsä
ተቀሰተ	täqässätä
ተቀቀለ	täqäqqälä
ተቀበለ	täqäbbälä
ተቀበረ	täqäbbärä
ተቀበቀበ	täqäbäqqäbä
ተቀበተተ	täqäbättätä
ተቀባ	täqäbba
ተቀባበለ	täqäbabbälä
ተቀባይ	täqäbbay
ተቀተረ	täqättärä
ተቀነሰ	täqännäsä
ተቀነባበረ	täqqänäbabbärä
ተቀነፈ	täqännäfä
ተቀናሽ	täqännaš
ተቀናቀነ	täqänaqqänä
ተቀናቃኝ	täqänaqaññ
ተቀናበረ	täqänabbärä
ተቀናነሰ	täqänannäsä
ተቀናና	täqännana
ተቀኘ	täqäññä
ተቀዘፈ	täqäzzäfä
ተቀዛቀዘ	täqäzaqqäzä
ተቀየመ	täqäyyämä
ተቀየሠ	täqäyyäśä
ተቀየረ	täqäyyärä
ተቀየደ	täqäyyädä
ተቀየጠ	täqäyyäṭä
ተቀደመ	täqäddämä
ተቀደሰ	täqäddäsä
ተቀደደ	täqäddädä
ተቀዳ	täqädda
ተቀዳሚ	täqäddami
ተቀዳደመ	täqädaddämä
ተቀዳደደ	täqädaddädä
ተቀዳጀ	täqädajjä
ተቀጠቀጠ	täqäṭäqqäṭä
ተቀፈረረ	täqäfärrärä
ተቀፈቀፈ	täqäfäqqäfä
ተቀፈደደ	täqäfäddädä
ተቀፈፈ	täqäffäfä
ተቁለጨለጨ	täquläč̣älläč̣č̣ä
ተቁነጠነጠ	täqunäṭännäṭä
ተቃለለ	täqallälä
ተቃለደ	täqallädä
ተቃመሰ	täqammäsä
ተቃማ	täqamma
ተቃረመ	täqarrämä
ተቃረበ	täqarräbä
ተቃረነ	täqarränä
ተቃቀፈ	täqaqqäfä
ተቃባ	täqabba
ተቃና	täqanna
ተቃኘ	täqaññä
ተቃወመ	täqawwämä
ተቃወሰ	täqawwäsä
ተቅለሰለሰ	täqeläsälläsä
ተቅለበለበ	täqeläbälläbä
ተቅለጠለጠ	täqeläṭälläṭä
ተቅበዘበዘ	täqebäzäbbäzä
ተቅነዘነዘ	täqenäzännäzä
ተቆለለ	täqollälä
ተቆላ	täqolla
ተቆረሰ	täqorräsä
ተቆረቆረ	täqoräqqorä
ተቆረጠ	täqorräṭä
ተቆራረሰ	täqorarräsä
ተቆራኘ	täqoraññä
ተቆፈረ	täqoffärä
ተቈለመመ	täqʷälämmämä
ተቈለፈ	täqʷälläfä
ተቈረቈረ	täqʷäräqqʷärä
ተቈረጠ	täqʷärräṭä
ተቈራ	täqʷärra
ተቈራመደ	täqʷärammädä
ተቈራረጠ	täqʷärarräṭä
ተቈራቈሰ	täqʷäraqqʷäsä
ተቈራጭ	täqʷärrač̣
ተቈሰቈሰ	täqʷäsäqqʷäsä
ተቈነነ	täqʷännänä
ተቈነደደ	täqʷänäddädä
ተቈናኝ	täqʷännaññ
ተቋለፈ	täqʷalläfä
ተቋላ	täqʷalla
ተቋረጠ	täqʷarräṭä
ተቋራጭ	täqʷarrač̣
ተበለቀጠ	täbäläqqäṭä
ተበለጠ	täbälläṭä
ተበላ	täbälla
ተበላለጠ	täbälalläṭä
ተበላሸ	täbälaššä
ተበላቀጠ	täbälaqqäṭä
ተበረቀሰ	täbäräqqäsä
ተበረቃቀሰ	täbäräqaqqäsä
ተበረበረ	täbäräbbärä
ተበረዘ	täbärräzä
ተበረጋገደ	täbärägaggädä
ተበራከተ	täbärakkätä
ተበሳ	täbässa
ተበሳሳ	täbäsassa
ተበሳበሰ	täbäsabbäsä
ተበሻቀጠ	täbäšaqqäṭä
ተበቀለ	täbäqqälä
ተበቃይ	täbäqqay
ተበተበ	täbättäbä
ተበታተነ	täbätattänä
ተበከለ	täbäkkälä
ተበካከለ	täbäkakkälä
ተበዘበዘ	täbäzäbbäzä
ተበየነ	täbäyyänä
ተበየደ	täbäyyädä
ተበያጅ	täbäyyaj
ተበደለ	täbäddälä
ተበደረ	täbäddärä
ተበዳ	täbädda
ተበዳሪ	täbäddari
ተበዳይ	täbädday
ተበዳደረ	täbädaddärä
ተበጀ	täbäjjä
ተበጃጀ	täbäjajjä
ተበገረ	täbäggärä
ተበጠበጠ	täbäṭäbbäṭä
ተበጣበጠ	täbäṭabbäṭä
ተባ	täbba
ተባላ	täballa
ተባረረ	täbarrärä
ተባረከ	täbarräkä
ተባረደ	täbarrädä
ተባሸቀ	täbaššäqä
ተባቃ	täbaqqa
ተባበረ	täbabbärä
ተባዛ	täbazza
ተብለጠለጠ	täbeläṭälläṭä
ተብለጨለጨ	täbeläč̣älläč̣ä
ተብላላ	täbelalla
ተብረቀረቀ	täberäqärräqä
ተብረከረከ	täberäkärräkä
ተብራራ	täberarra
ተብሰለሰለ	täbesälässälä
ተብታባ	täbetabba
ተብከነከነ	täbekänäkkänä
ተቦረቦረ	täboräbborä
ተቦተረፈ	täbotärräfä
ተቦካ	täbokka
ተቦደሰ	täboddäsä
ተቧደነ	täbʷaddänä
ተተለተለ	tätälättälä
ተተመተመ	tätämättämä
ተተመነ	tätämmänä
ተተረማመሰ	tätärämammäsä
ተተረተረ	tätärättärä
ተተረከ	tätärräkä
ተተረከከ	tätäräkkäkä
ተተረኰሰ	tätäräkkʷäsä
ተተረጐመ	tätäräggʷämä
ተተራመሰ	tätärammäsä
ተተበተበ	tätäbättäbä
ተተቸ	tätäččä
ተተነተነ	tätänättänä
ተተናኮለ	tätänakkolä
ተተከለ	tätäkkälä
ተተካ	tätäkka
ተተካይ	tätäkkay
ተተኰሰ	tätäkkʷäsä
ተታለለ	tätallälä
ተታኰሰ	tätakkʷäsä
ተታፋ	tätaffa
ተትረፈረፈ	täteräfärräfä
ተቸ	täččä
ተቸለሰ	täčälläsä
ተቸበቸበ	täčäbäččäbä
ተቸነከረ	täčänäkkärä
ተቸከለ	täčäkkälä
ተቸገረ	täčäggärä
ተቸፈቸፈ	täčäfäččäfä
ተቸፈገ	täčäffägä
ተቺ	täčči
ተቻኰለ	täčakkʷälä
ተነሣ	tänäśśa
ተነሣሣ	tänäśśaśśa
ተነሰነሰ	tänäsännäsä
ተነሳ	tännäsa
ተነቀለ	tänäqqälä
ተነቀሰ	tänäqqäsä
ተነቀነቀ	tänäqännäqä
ተነቀፈ	tänäqqäfä
ተነቃቀፈ	tänäqaqqäfä
ተነቃቃ	tänäqaqqa
ተነቃነቀ	tänäqannäqä
ተነበበ	tänäbbäbä
ተነበየ	tänäbbäyä
ተነባበረ	tänäbabbärä
ተነባቢ	tänäbbabi
ተነተነ	tänättänä
ተነተገ	tänättägä
ተነታረከ	tänätarräkä
ተነነ	tännänä
ተነከረ	tänäkkärä
ተነከሰ	tänäkkäsä
ተነካ	tänäkka
ተነካከሰ	tänäkakkäsä
ተነካካ	tänäkakka
ተነኰሰ	tänäkkʷäsä
ተነኰተ	tänäkkʷätä
ተነዘነዘ	tänäzännäzä
ተነዛ	tänäzza
ተነዛነዘ	tänäzannäzä
ተነደፈ	tänäddäfä
ተነዳ	tänädda
ተነዳደፈ	tänädaddäfä
ተነገተ	tänäggätä
ተነጋገረ	tänägaggärä
ተነጋገደ	tänägaggädä
ተነጐረ	tänäggʷärä
ተነጫነጨ	tänäč̣annäč̣ä
ተነፈሰ	tänäffäsä
ተነፈገ	tänäffägä
ተነፋ	tänäffa
ተነፋረቀ	tänäfarräqä
ተነፋነፈ	tänäfannäfä
ተነፋፈሰ	tänäfaffäsä
ተነፋፈቀ	tänäfaffäqä
ተነፋፈገ	tänäfaffägä
ተነፋፋ	tänäfaffa
ተናበበ	tänabbäbä
ተናባቢ	tänabbabi
ተናነቀ	tänannäqä
ተናነቀው	tänannäqäw
ተናኘ	tänaññä
ተናከሰ	tänakkäsä
ተናዘዘ	tänazzäzä
ተናደደ	tänaddädä
ተናገሠ	tänaggäśä
ተናገረ	tänaggärä
ተናጋ	tänagga
ተናፈሰ	tänaffäsä
ተናፈቀ	tänaffäqä
ተናፈጠ	tänaffäṭä
ተናፋ	tänaffa
ተን	tänn
ተንሠቀሠቀ	täneśäqäśśäqä
ተንሰቀሰቀ	tänesäqässäqä
ተንሰፈሰፈ	tänesäfässäfä
ተንሳፈፈ	tänesaffäfä
ተንሶለሶለ	tänesolässolä
ተንሸረሸረ	tänešäräššärä
ተንሸራተተ	tänešärattätä
ተንሸዋረረ	tänešäwarrärä
ተንሻተተ	tänešattätä
ተንቀለቀለ	täneqäläqqälä
ተንቀረበበ	täneqäräbbäbä
ተንቀረፈፈ	täneqäräffäffä
ተንቀሳቀሰ	täneqäsaqqäsä
ተንቀበቀበ	täneqäbäqqäbä
ተንቀበደደ	täneqäbäddädä
ተንቀባረረ	täneqäbarrärä
ተንቀባደደ	täneqäbaddädä
ተንቀዋለለ	täneqäwallälä
ተንቀዠቀዠ	täneqäžäqqäžä
ተንቀጠቀጠ	täneqäṭäqqäṭä
ተንቀፈደደ	täneqäfäddädä
ተንበለበለ	tänebäläbbälä
ተንበረከከ	tänebäräkkäkä
ተንበሸበሸ	tänebäššäbbäšä
ተንቦለቦለ	täneboläbbolä
ተንቦረቀቀ	täneboräqqäqä
ተንቦራቀቀ	täneboraqqäqä
ተንቦገቦገ	tänebogäbbogä
ተንቦጨቦጨ	täneboč̣äbboč̣ä
ተንቦጫበጨ	täneboč̣abbäč̣ä
ተንቦጫቦጨ	täneboč̣abboč̣ä
ተንተረከከ	tänetäräkkäkä
ተንተባተበ	tänetäbattäbä
ተንተከተከ	tänetäkättäkä
ተንቶሰቶሰ	tänetosättosä
ተንቻቻ	tänečačča
ተንከላወሰ	tänekälawwäsä
ተንከረፈፈ	tänekäräffäfä
ተንከራተተ	tänekärattätä
ተንከባለለ	tänekäballälä
ተንከባከበ	tänekäbakkäbä
ተንከተከተ	tänekätäkkätä
ተንከታከተ	tänekätakkätä
ተንከዋተተ	tänekäwattätä
ተንከፈረረ	tänekäfärrärä
ተንኮለኛ	tänekoläñña
ተንኳኳ	tänekʷakkʷa
ተንኳፈፈ	tänekʷaffäfä
ተንዘረፈጠ	tänezäräffäṭä
ተንዘረፈፈ	tänezäräffäfä
ተንዘራፈጠ	tänezäraffäṭä
ተንዘፈዘፈ	tänezäffäzäfä
ተንዛዛ	tänezazza
ተንዠረገገ	tänežäräggägä
ተንዠቀዠቀ	tänežäqäžžäqä
ተንዠባረረ	tänežäbarrärä
ተንዣበበ	tänežabbäbä
ተንደላቀቀ	tänedälaqqäqä
ተንደረበበ	tänedäräbbäbä
ተንደረከከ	tänedäräkkäkä
ተንደረደረ	tänedäräddärä
ተንደቀደቀ	tänedäqäddäqä
ተንደበደበ	tänedäbäddäbä
ተንደባለለ	tänedäballälä
ተንደባደበ	tänedäbaddäbä
ተንደከደ	tänedäkkädä
ተንደፋደፈ	tänedäfaddäfä
ተንዶለዶለ	tänedoläddolä
ተንጀላጀለ	tänejälajjälä
ተንጀረገገ	tänejäräggägä
ተንገላታ	tänegälatta
ተንገላወደ	tänegälawwädä
ተንገላጀጀ	tänegälajjäjä
ተንገረገበ	tänegäräggäbä
ተንገሸገሸ	tänegäšäggäšä
ተንገበገበ	tänegäbäggäbä
ተንገዋለለ	tänegäwallälä
ተንገደገደ	tänegädäggädä
ተንገዳገደ	tänegädaggädä
ተንገጫገጨ	tänegäč̣aggäč̣ä
ተንገፈገፈ	tänegäfäggäfä
ተንጋለለ	tänegallälä
ተንጋደደ	tänegaddädä
ተንጋጋ	tänegagga
ተንጎራደደ	tänegoraddädä
ተንጐራደደ	tänegʷäraddädä
ተንጓለለ	tänegʷallälä
ተንጓደደ	tänegʷaddädä
ተንጠረበበ	täneṭäräbbäbä
ተንጠረዘዘ	täneṭäräzzäzä
ተንጠራራ	täneṭärrara
ተንጠራወዘ	täneṭärawwäzä
ተንጣለለ	täneṭallälä
ተንጸባረቀ	täneṣäbarräqä
ተንፈላሰሰ	tänefälassäsä
ተንፈራገጠ	tänefäraggäṭä
ተንፈራፈረ	tänefäraffärä
ተንፈስ	tänefäss
ተንፈቀፈቀ	tänefäqäffäqä
ተንፋነፈ	tänefannäfä
ተንፏቀቀ	tänefʷaqqäqä
ተንፏፏ	tänefʷaffʷa
ተኛ	täñña
ተኛት	täññat
ተኝቶ	täññeto
ተኝቷል	täññetʷal
ተአምረኛ	täʾammeräñña
ተአምራታዊ	täʾammeratawi
ተአምር	täʾammer
ተከለ	täkkälä
ተከለለ	täkällälä
ተከለሰ	täkälläsä
ተከለበሰ	täkäläbbäsä
ተከለከለ	täkäläkkälä
ተከላከለ	täkälakkälä
ተከመቻቸ	täkämäčaččä
ተከመከመ	täkämäkkämä
ተከማቸ	täkämmačä
ተከሠተ	täkäśśätä
ተከረበተ	täkäräbbätä
ተከረተፈ	täkärättäfä
ተከረከመ	täkäräkkämä
ተከራከረ	täkärakkärä
ተከራየ	täkärayyä
ተከሰሰ	täkässäsä
ተከሰከሰ	täkäsäkkäsä
ተከሳሽ	täkässaš
ተከሳከሰ	täkäsakkäsä
ተከበረ	täkäbbärä
ተከበበ	täkäbbäbä
ተከባበረ	täkäbabbärä
ተከተለ	täkättälä
ተከተለበ	täkätälläbä
ተከተል	täkättäl
ተከተረ	täkättärä
ተከተበ	täkättäbä
ተከተተ	täkättätä
ተከተከ	täkättäkä
ተከተከተ	täkätäkkätä
ተከተፈ	täkättäfä
ተከታተለ	täkätattälä
ተከታከተ	täkätakkätä
ተከታይ	täkättay
ተከነ	täkkänä
ተከናነበ	täkänannäbä
ተከናወነ	täkänawwänä
ተከካ	täkäkka
ተከዘ	täkkäzä
ተከደነ	täkäddänä
ተከፈለ	täkäffälä
ተከፈተ	täkäffätä
ተከፈነ	täkäffänä
ተከፈከፈ	täkäfäkkäfä
ተከፈፈ	täkäffäfä
ተከፋ	täkäffa
ተከፋች	täkäffač
ተከፋይ	täkäffay
ተከፋፈለ	täkäfaffälä
ተከፋፈተ	täkäfaffätä
ተኩረፈረፈ	täkuräfärräfä
ተኩራራ	täkurarra
ተኩስ	täkkus
ተኩነሰነሰ	täkunäsännäsä
ተካ	täkka
ተካለለ	täkallälä
ተካለሰ	täkalläsä
ተካረረ	täkarrärä
ተካሰሰ	täkassäsä
ተካበደ	täkabbädä
ተካከለ	täkkakkälä
ተካዥ	täkkaž
ተካፈለ	täkaffälä
ተካፈተ	täkaffätä
ተክለፈለፈ	täkeläfälläfä
ተክበሰበሰ	täkebäsäbbäsä
ተኮላሸ	täkolaššä
ተኮማተረ	täkomattärä
ተኮረተመ	täkorättämä
ተኮረጀ	täkorräjä
ተኮረፈ	täkorräfä
ተኮራመተ	täkorammätä
ተኮራፊ	täkorrafi
ተኮሳተረ	täkosattärä
ተኮተኮተ	täkotäkkotä
ተኮፈሰ	täkoffäsä
ተኮፋሽ	täkoffaš
ተኰላተፈ	täkʷälattäfä
ተኰረተመ	täkʷärättämä
ተኰረታተመ	täkʷärätattämä
ተኰሰ	täkkʷäsä
ተኰሳተረ	täkʷäsattärä
ተኰነነ	täkʷännänä
ተኳረፈ	täkʷarräfä
ተኳሽ	täkkʷaš
ተኳሽነት	täkʷašennät
ተኳኰሰ	täkʷakkʷäsä
ተወለደ	täwällädä
ተወለጋገደ	täwälägaggädä
ተወላመመ	täwälammämä
ተወላከፈ	täwälakkäfä
ተወላጅ	täwällaj
ተወላገደ	täwälaggädä
ተወረረ	täwärrärä
ተወረሰ	täwärräsä
ተወረወረ	täwäräwwärä
ተወረደ	täwärrädä
ተወራ	täwärra
ተወራረሰ	täwärarräsä
ተወራረደ	täwärarrädä
ተወራሽ	täwärraš
ተወራወረ	täwärawwärä
ተወራጅ	täwärraj
ተወሰነ	täwässänä
ተወሰወሰ	täwäsäwwäsä
ተወሰደ	täwässädä
ተወሳ	täwässa
ተወቀሰ	täwäqqäsä
ተወቀጠ	täwäqqäṭä
ተወቃ	täwäqqa
ተወቃቀሰ	täwäqaqqäsä
ተወተፈ	täwättäfä
ተወነባበደ	täwänäbabbädä
ተወነጃጀለ	täwänäjajjälä
ተወናበደ	täwänabbädä
ተወናፈለ	täwänaffälä
ተወንጀለ	täwänejjälä
ተወከለ	täwäkkälä
ተወካይ	täwäkkay
ተወዘፈ	täwäzzäfä
ተወዛወዘ	täwäzawwäzä
ተወደደ	täwäddädä
ተወዳደረ	täwädaddärä
ተወዳጀ	täwädajjä
ተወዳጅ	täwäddaj
ተወገረ	täwäggärä
ተወገደ	täwäggädä
ተወጋ	täwägga
ተወጫመደ	täwäč̣ammädä
ተዋለደ	täwallädä
ተዋልቀ	täwalleqä
ተዋረደ	täwarrädä
ተዋሰነ	täwassänä
ተዋቀረ	täwaqqärä
ተዋቀሰ	täwaqqäsä
ተዋከበ	täwakkäbä
ተዋወቀ	täwawwäqä
ተዋደቀ	täwaddäqä
ተዋደደ	täwaddädä
ተዋጋ	täwagga
ተውለበለበ	täweläbälläbä
ተውረገረገ	täwerägärrägä
ተውተረተረ	täwetärättärä
ተውተበተበ	täwetäbättäbä
ተውተፈተፈ	täwetäfättäfä
ተዘለለ	täzällälä
ተዘለቀ	täzälläqä
ተዘመዘመ	täzämäzzämä
ተዘረረ	täzärrärä
ተዘረነቀ	täzärränäqä
ተዘረከተ	täzäräkkätä
ተዘረካከተ	täzäräkakkätä
ተዘረዘረ	täzäräzzärä
ተዘረገፈ	täzäräggäfä
ተዘረጋ	täzärägga
ተዘረፈ	täzärräfä
ተዘረፈጠ	täzäräffäṭä
ተዘራ	täzärra
ተዘራረፈ	täzärarräfä
ተዘቀዘቀ	täzäqäzzäqä
ተዘበራረቀ	täzäbärarräqä
ተዘባረቀ	täzäbarräqä
ተዘባበተ	täzäbabbätä
ተዘባነነ	täzäbannänä
ተዘነቀ	täzännäqä
ተዘነተረ	täzänättärä
ተዘነጋ	täzänägga
ተዘነጋጋ	täzänägagga
ተዘናከተ	täzänakkätä
ተዘናጋ	täzänagga
ተዘናፈለ	täzänaffälä
ተዘከረ	täzäkkärä
ተዘከዘከ	täzäkäzzäkä
ተዘካሪ	täzäkkari
ተዘወተረ	täzäwättärä
ተዘዋወረ	täzäwawwärä
ተዘያየረ	täzäyayyärä
ተዘገረረ	täzägärrärä
ተዘገጃጀ	täzägäjajjä
ተዘጋ	täzzägga
ተዘጋጀ	täzägajjä
ተዘፈቀ	täzäffäqä
ተዘፈዘፈ	täzäfäzzäfä
ተዛለለ	täzallälä
ተዛለፈ	täzalläfä
ተዛመተ	täzammätä
ተዛመደ	täzammädä
ተዛባ	täzzabba
ተዛነቀ	täzannäqä
ተዛነፈ	täzannäfä
ተዛና	täzanna
ተዛናና	täzananna
ተዛወረ	täzawwärä
ተዛዘበ	täzazzäbä
ተዛዘነ	täzazzänä
ተዛፈቀ	täzaffäqä
ተዝለገለገ	täzelägällägä
ተዝለፈለፈ	täzeläfälläfä
ተዝረበረበ	täzeräbärräbä
ተዝረከረከ	täzeräkärräkä
ተዝረጠረጠ	täzeräṭärräṭä
ተዝረፈረፈ	täzeräfärräfä
ተዝናና	täzenanna
ተዝጎረጎረ	täzegoräggorä
ተዝጐረጐረ	täzegʷäräggʷärä
ተዠለጠ	täžälläṭä
ተዥጎረገረ	täžegoräggärä
ተዥጎደጎደ	täžegodäggodä
ተያየ	täyayyä
ተደለለ	tädällälä
ተደለቀ	täddälläqä
ተደለደለ	tädäläddälä
ተደላደለ	tädäladdälä
ተደመመ	tädämmämä
ተደመረ	tädämmärä
ተደመሰሰ	tädämässäsä
ተደመደመ	tädämäddämä
ተደመጠ	tädämmäṭä
ተደማመጠ	tädämammäṭä
ተደማሪ	tädämmari
ተደማጭ	tädämmač̣
ተደረሰ	tädärräsä
ተደረሰመ	tädärässämä
ተደረበ	tädärräbä
ተደረተ	tädärrätä
ተደረደረ	tädäräddärä
ተደረገ	tädärrägä
ተደረገመ	tädäräggämä
ተደራረበ	tädärarräbä
ተደራረገ	tädärarrägä
ተደራቢ	tädärrabi
ተደራደረ	tädäraddärä
ተደራጀ	tädärajjä
ተደራጊ	tädärragi
ተደሰተ	tädässätä
ተደሳች	tädässač
ተደቀነ	tädäqqänä
ተደቆሰ	tädäqqosä
ተደበለለ	tädäbällälä
ተደበለቀ	tädäbälläqä
ተደበላለቀ	tädäbälalläqä
ተደበቀ	tädäbbäqä
ተደበደበ	tädäbäddäbä
ተደባለቀ	tädäballäqä
ተደባበቀ	tädäbabbäqä
ተደባደበ	tädäbaddäbä
ተደነቀ	tädännäqä
ተደነቀረ	tädänäqqärä
ተደነቀረብኝ	tädänäqqäräbeññ
ተደናቀፈ	tädänaqqäfä
ተደናቂ	tädännaqi
ተደናበረ	tädänabbärä
ተደናበዘ	tädänabbäzä
ተደናገረ	tädännaggärä
ተደናገጠ	tädänaggäṭä
ተደከመ	tädäkkämä
ተደወለ	tädäwwälä
ተደገመ	tädäggämä
ተደገሰ	tädäggäsä
ተደገነ	tädäggänä
ተደገፈ	tädäggäfä
ተደጋገመ	tädägaggämä
ተደጋገፈ	tädägaggäfä
ተደጎመ	tädäggomä
ተደፈረ	tädäffärä
ተደፈቀ	tädäffäqä
ተደፈነ	tädäffänä
ተደፋ	tädäffa
ተደፋፈረ	tädäfaffärä
ተዳመረ	tädammärä
ተዳመጠ	tädammäṭä
ተዳረሰ	tädarräsä
ተዳረቀ	tädarräqä
ተዳረገ	tädarrägä
ተዳራ	tädarra
ተዳቀለ	tädaqqälä
ተዳቀቀ	tädaqqäqä
ተዳበለ	tädabbälä
ተዳነቀ	tädannäqä
ተዳኘ	tädaññä
ተዳከመ	tädakkämä
ተዳደረ	tädaddärä
ተዳፈረ	tädaffärä
ተዳፈቀ	tädaffäqä
ተዳፈነ	tädaffänä
ተዳፋ	tädaffa
ተድረቀረቀ	täderäqärräqä
ተድበለበለ	tädebäläbbälä
ተድበሰበሰ	tädebäsäbbäsä
ተድቦለቦለ	tädeboläbbolä
ተድፈነፈነ	tädefänäffänä
ተጀመረ	täjämmärä
ተጀነነ	täjännänä
ተገለለ	tägällälä
ተገለማመጠ	tägälämammäṭä
ተገለበጠ	tägäläbbäṭä
ተገለባበጠ	tägäläbabbäṭä
ተገለጠ	tägälläṭä
ተገለፈፈ	tägäläffäfä
ተገላመጠ	tägälammäṭä
ተገላበጠ	tägälabbäṭä
ተገላገለ	tägälaggälä
ተገመሰ	tägämmäsä
ተገመተ	tägämmätä
ተገመደለ	tägämäddälä
ተገመገመ	tägämäggämä
ተገረመ	tägärrämä
ተገረዘ	tägärräzä
ተገረፈ	tägärräfä
ተገራ	tägärra
ተገሰሰ	tägässäsä
ተገሸለጠ	tägäšälläṭä
ተገሸረ	tägäššärä
ተገበያየ	tägäbäyayyä
ተገቢ	tägäbbi
ተገባደደ	tägäbaddädä
ተገታ	tägätta
ተገታተረ	tägätattärä
ተገነዘበ	tägänäzzäbä
ተገነጣጠለ	tägänäṭaṭṭälä
ተገናኘ	tägänaññä
ተገናዘበ	tägänazzäbä
ተገኘ	tägäññä
ተገዘተ	tägäzzätä
ተገዛ	tägäzza
ተገዛዛ	tägäzzazza
ተገደለ	tägäddälä
ተገደደ	tägäddädä
ተገፈፈ	tägäffäfä
ተገፋ	tägäffa
ተገፋተረ	tägäfattärä
ተገፋፋ	tägäfaffa
ተጉመጠመጠ	tägumäṭämmäṭä
ተጉረበረበ	täguräbärräbä
ተጋ	tägga
ተጋለጠ	tägalläṭä
ተጋመሰ	tägammäsä
ተጋማ	tägamma
ተጋረደ	tägarrädä
ተጋረጠ	tägarräṭä
ተጋራ	tägarra
ተጋበዘ	tägabbäzä
ተጋባ	tägabba
ተጋተረ	tägattärä
ተጋነነ	tägannänä
ተጋዘ	tägazzä
ተጋዛ	tägazza
ተጋደለ	tägaddälä
ተጋገረ	tägaggärä
ተጋገዘ	tägaggäzä
ተጋፈጠ	tägaffäṭä
ተጋፋ	tägaffa
ተግ	tägg
ተግማማ	tägemamma
ተግባባ	tägebabba
ተግተለተለ	tägetälättälä
ተግተረተረ	tägetärättärä
ተግደረደረ	tägedäräddärä
ተግፈለፈለ	tägefäläffälä
ተጎማለለ	tägomallälä
ተጎማዘዘ	tägomazzäzä
ተጎራበተ	tägorabbätä
ተጎዳ	tägodda
ተጎዳኘ	tägodaññä
ተጐለተ	tägʷällätä
ተጐላመመ	tägʷälammämä
ተጐላደፈ	tägʷäladdäfä
ተጐሳቈለ	tägʷäsaqqʷälä
ተጐተተ	tägʷättätä
ተጐታች	tägʷättač
ተጐነጐነ	tägʷänäggʷänä
ተጐናዘለ	tägʷänazzälä
ተጓተተ	tägʷattätä
ተጓደለ	tägʷaddälä
ተጓደደ	tägʷaddädä
ተጕመጠመጠ	tägʷǝmäṭämmäṭä
ተጠለለ	täṭällälä
ተጠለፈ	täṭälläfä
ተጠላ	täṭälla
ተጠላላፊ	täṭälallafi
ተጠመቀ	täṭämmäqä
ተጠመዘዘ	täṭämäzzäzä
ተጠመደ	täṭämmädä
ተጠማ	täṭämma
ተጠማዘዘ	täṭämazzäzä
ተጠረመሰ	täṭärämmäsä
ተጠረቃቀመ	täṭäräqaqqämä
ተጠራ	täṭärra
ተጠራቀመ	täṭäraqqämä
ተጠቀመ	täṭäqqämä
ተጠቃ	täṭäqqa
ተጠቃለለ	täṭäqallälä
ተጠቃሚ	täṭäqqami
ተጠቃሽ	täṭäqqaš
ተጠቃቀሰ	täṭäqaqqäsä
ተጠቆመ	täṭäqqomä
ተጠበቀ	täṭäbbäqä
ተጠበበ	täṭäbbäbä
ተጠባበቀ	täṭäbabbäqä
ተጠነቀቀ	täṭänäqqäqä
ተጠና	täṭänna
ተጠናቀቀ	täṭänaqqäqä
ተጠናቆለ	täṭänaqqolä
ተጠናበሰ	täṭänabbäsä
ተጠናከረ	täṭänakkärä
ተጠናወተ	täṭänawwätä
ተጠየቀ	täṭäyyäqä
ተጠየቅ	täṭäyyäq
ተጠየፈ	täṭäyyäfä
ተጠያቂ	täṭäyyaqi
ተጠያየቀ	täṭäyayyäqä
ተጠያፊ	täṭäyyafi
ተጠጋ	täṭägga
ተጠጋገነ	täṭägaggänä
ተጠጋጋ	täṭägagga
ተጠፋፋ	täṭäfaffa
ተጣላ	täṭṭala
ተጣመመ	täṭammämä
ተጣመረ	täṭammärä
ተጣመደ	täṭammädä
ተጣረረ	täṭarrärä
ተጣራ	täṭarra
ተጣበቀ	täṭabbäqä
ተጣበበ	täṭabbäbä
ተጣባ	täṭabba
ተጣደፈ	täṭaddäfä
ተጣዳ	täṭadda
ተጣፋ	täṭaffa
ተጥለቀለቀ	täṭeläqälläqä
ተጥመለመለ	täṭemälämmälä
ተጥመሰመሰ	täṭemäsämmäsä
ተጥመዘመዘ	täṭemäzämmäzä
ተጥናና	täṭenanna
ተጧጧፈ	täṭʷaṭṭʷafä
ተጨለጠ	täč̣älläṭä
ተጨመላለቀ	täč̣ämälalläqä
ተጨመረ	täč̣č̣ämmärä
ተጨመቀ	täč̣ämmäqä
ተጨመታተረ	täč̣ämätattärä
ተጨማለቀ	täč̣ämalläqä
ተጨማሪ	täč̣ämmari
ተጨማተረ	täč̣ämattärä
ተጨማደደ	täč̣ämaddädä
ተጨረሰ	täč̣č̣ärräsä
ተጨራመመ	täč̣ärammämä
ተጨራመተ	täč̣ärammätä
ተጨራመደ	täč̣ärammädä
ተጨቆነ	täč̣äqqonä
ተጨቋኝ	täč̣äqqʷañ
ተጨበተ	täč̣äbbätä
ተጨበጨበለት	täč̣äbäč̣č̣äbällät
ተጨባበጠ	täč̣äbabbäṭä
ተጨባበጡ	täč̣äbabbäṭu
ተጨባጭ	täč̣äbbač̣
ተጨነቀ	täč̣ännäqä
ተጨናነቀ	täč̣änannäqä
ተጨናገፈ	täč̣änaggäfä
ተጨናጎለ	täč̣änaggolä
ተጨካከነ	täč̣äkakkänä
ተጨዋወተ	täč̣äwawwätä
ተጨፈለቀ	täč̣äfälläqä
ተጨፋጨፈ	täč̣äfač̣č̣äffä
ተጨፋፈቀ	täč̣äfaffäqä
ተጫማ	täč̣amma
ተጫረሰ	täč̣č̣arräsä
ተጫወተ	täč̣awwätä
ተጫወተበት	täč̣awwätäbbät
ተጫፈረ	täč̣affärä
ተጭበረበረ	täč̣ebäräbbärä
ተጸለየ	täṣälläyä
ተጸናወተ	täṣänawwätä
ተጸየፈ	täṣäyyäfä
ተጸዳዳ	täṣädadda
ተጻረረ	täṣarrärä
ተጽናና	täṣenanna
ተፀነሰ	täẓännäsä
ተፈለቀቀ	täfäläqqäqä
ተፈለገ	täfällägä
ተፈለጠ	täfälläṭä
ተፈለፈለ	täfäläffälä
ተፈላ	täfälla
ተፈላለገ	täfälallägä
ተፈላሰፈ	täfälassäfä
ተፈላጊ	täfällagi
ተፈላጭ	täfällač̣
ተፈረመ	täfärrämä
ተፈረከሰ	täfäräkkäsä
ተፈረደ	täfärrädä
ተፈረፈረ	täfäräffärä
ተፈራ	täfärra
ተፈራረመ	täfärarrämä
ተፈራራ	täfärarra
ተፈቃቀረ	täfäqaqqärä
ተፈቃቀደ	täfäqaqqädä
ተፈተለ	täfättälä
ተፈተለከ	täfätälläkä
ተፈተሸ	täfättäšä
ተፈተነ	täfättänä
ተፈተገ	täfättägä
ተፈታ	täfätta
ተፈታተሸ	täfätattäšä
ተፈታተነ	täfättatänä
ተፈታኝ	täfättañ
ተፈነቀለ	täfänäqqälä
ተፈነቸረ	täfänäččärä
ተፈነከተ	täfänäkkätä
ተፈነገለ	täfänäggälä
ተፈናቀለ	täfänaqqälä
ተፈናከተ	täfänakkätä
ተፈናፈነ	täfänaffänä
ተፈወሰ	täfäwwäsä
ተፈጀ	täfäjjä
ተፈገፈገ	täfägäffägä
ተፈጋፈገ	täfägaffägä
ተፋ	täffa
ተፋለመ	täfallämä
ተፋለሰ	täfalläsä
ተፋረሰ	täfarräsä
ተፋረደ	täfarrädä
ተፋሰሰ	täfassäsä
ተፋቀረ	täfaqqärä
ተፋተገ	täfattägä
ተፋታ	täfatta
ተፋዘዘ	täfazzäzä
ተፋጀ	täfajjä
ተፋፈነ	täfaffänä
ተፋፈገ	täfaffägä
ተፌ	täffé
ተፍ	täff
ተፍለቀለቀ	täfeläqälläqä
ተፍለከለከ	täfeläkälläkä
ተፍረቀረቀ	täferäqärräqä
ተፍረከረከ	täferäkärräkä
ተፍረጠረጠ	täferäṭärräṭä
ተፍታታ	täfetatta
ተፎካከረ	täfokakkärä
ቱር	turr
ቱስ	tuss
ቱሽ	tušš
ቱባ	tubba
ቱቦ	tubbo
ቱታ	tutta
ቱግ	tugg
ቱፋሕ	tuffaḥ
ታለበ	talläbä
ታለፈ	talläfä
ታላቅ	tallaq
ታመመ	tammämä
ታመሰ	tammäsä
ታመቀ	tammäqä
ታመነ	tammänä
ታማ	tamma
ታማኝ	tammañ
ታምረኛ	tammeräñña
ታምራታዊ	tammeratawi
ታምር	tammer
ታሠሠ	taśśäśä
ታሠረ	taśśärä
ታረመ	tarrämä
ታረሰ	tarräsä
ታረቀ	tarräqä
ታረዘ	tarräzä
ታረደ	tarrädä
ታሪከኛ	tarikäñña
ታሰበ	tassäbä
ታስቦ	tassebo
ታሸ	taššä
ታሸመ	taššämä
ታሸገ	taššägä
ታቀደ	taqqädä
ታቀፈ	taqqäfä
ታበለ	tabbälä
ታበየ	tabbäyä
ታተመ	tattämä
ታተረ	tattärä
ታተተ	tattätä
ታታ	tatta
ታነቀ	tannäqä
ታነጠ	tannäṭä
ታናሽ	tannaš
ታንከኛ	tanekäñña
ታኘከ	taññäkä
ታከለ	takkälä
ታከመ	takkämä
ታከተ	takkätä
ታከከ	takkäkä
ታካሚ	takkami
ታወረ	tawwärä
ታወሰው	tawwäsäw
ታወቀ	tawwäqä
ታወከ	tawwäkä
ታዘለ	tazzälä
ታዘበ	tazzäbä
ታዘዘ	tazzäzä
ታዛቢ	tazzabi
ታዛዥ	tazzaž
ታየ	tayyä
ታደለ	taddälä
ታደመ	taddämä
ታደገ	taddägä
ታዲያሳ	tadiyassa
ታዲያስ	tadiyass
ታዳጊ	taddagi
ታጀለ	tajjälä
ታጀበ	tajjäbä
ታገለ	taggälä
ታገሠ	taggäśä
ታገደ	taggädä
ታጋሽ	taggaš
ታጐረ	taggʷärä
ታፈረ	taffärä
ታፈነ	taffänä
ታፈገ	taffägä
ታፋሪ	taffari
ቴሌስኮፕ	télésekopp
ቴፕ	tépp
ትሉግሉግ	telugelugg
ትላንትና	telanetenna
ትልቅ	telleq
ትልቅነት	telleqennät
ትሕትና	teḥetenna
ትምቡሽ	temebušš
ትምትም	temetemm
ትምክህተኛ	temekehetäñña
ትራፊ	terrafi
ትር	terr
ትርምስ	teremmes
ትርታ	terreta
ትርክክ	terekekk
ትርኳሽ	terekkʷaš
ትሻለህ	tešalläh
ትቢተኛ	tebitäñña
ትቢያ	tebbiya
ትብብር	tebebber
ትብትብ	tebetebb
ትችት	teččet
ትናንትና	tenanetenna
ትናጋ	tennaga
ትንሽ	tenneš
ትንቢተኛ	tenebitäñña
ትንኝ	teneññ
ትንፋሽ	teneffaš
ትእቢተኛ	teʾebitäñña
ትእግሥተኛ	teʾegeśetäñña
ትከሻ	tekäšša
ትከሻማ	tekäššamma
ትከሻም	tekäššam
ትኩሳት	tekkusat
ትኩስ	tekkus
ትካዜ	tekkazé
ትክ	tekk
ትክለኛ	tekeläñña
ትክል	tekkel
ትክት	tekket
ትክዝ	tekkezz
ትውልድ	teweledd
ትዕይንት	teʿeyyenet
ትዝ	tezz
ትዝብት	tezzebet
ትዝታ	tezzeta
ትይዩ	teyeyyu
ትግሥተኛ	tegeśetäñña
ትግርኛ	tegereñña
ትግያ	tegeyya
ትጥቅና	teṭeqenna
ቶስቷሳ	tosetʷassa
ቸለል	čäläll
ቸለሰ	čälläsä
ቸል	čäll
ቸልተኛ	čälletäñña
ቸልታ	čälleta
ቸረቸመ	čäräččämä
ቸረቸረ	čäräččärä
ቸርቻማ	čärečamma
ቸርነት	čärennät
ቸሰሰ	čässäsä
ቸበቸበ	čäbäččäbä
ቸብቸቦ	čäbečäbbo
ቸነከረ	čänäkkärä
ቸከለ	čäkkälä
ቸኰለ	čäkkʷälä
ቸኳይ	čäkkʷay
ቸገረ	čäggärä
ቸፈቸፈ	čäfäččäfä
ቸፈገ	čäffägä
ቸፍግ	čäffegg
ችላ	čella
ችስ	čess
ችቦ	čebbo
ችኩል	čekkul
ችክ	čekk
ችክል	čekkell
ችኮ	čekko
ችኰላ	čekkʷäla
ችግረኛ	čeggeräñña
ችግር	čegger
ችግኝ	čeggeñ
ችፍ	čeff
ችፍርግ	čeferegg
ችፍቻፊ	čefeččafi
ችፍግ	čeffeg
ኅሊና	ḫellina
ኅብረተሰብአዊነት	ḫeberätäsäbeʾawinnät
ኅያል	ḫeyyal
ኅይለኛ	ḫeyeläñña
ኅይለኝነት	ḫeyeläññennät
ኅዳግ	ḫeddag
ኅጢአተኛ	ḫeṭiʾatäñña
ኅጢአተኝነት	ḫeṭiʾatäññennät
ኋለኛ	ḫʷaläñña
ነሣ	näśśa
ነረተ	närrätä
ነሰረ	nässärä
ነሰነሰ	näsännäsä
ነሳነሰ	näsannäsä
ነሸጠ	näššäṭä
ነቀለ	näqqälä
ነቀሰ	näqqäsä
ነቀዘ	näqqäzä
ነቃ	näqqa
ነቃቀለ	näqaqqälä
ነቃቀዘ	näqaqqäzä
ነቃቀፈ	näqaqqäfä
ነቃቃ	näqaqqa
ነቈጠ	näqqʷäṭä
ነበረ	näbbärä
ነበር	näbbär
ነበበ	näbbäbä
ነበዘ	näbbäzä
ነቢይ	näbiyy
ነባር	näbbar
ነብርማ	näberemma
ነቦጨ	näbboč̣č̣ä
ነተረከ	nätärräkä
ነተበ	nättäbä
ነኁላላ	näḫulalla
ነኈለለ	näḫʷällälä
ነኝ	näññ
ነከረ	näkkärä
ነከሰ	näkkäsä
ነከስ	näkäss
ነከተ	näkkätä
ነካ	näkka
ነካከሰ	näkakkäsä
ነካካ	näkakka
ነክ	näkk
ነኰተ	näkkʷätä
ነውረኛ	näweräñña
ነዘረ	näzzärä
ነዘነዘ	näzännäzä
ነዛ	näzza
ነዝናዛ	näzenazza
ነደለ	näddälä
ነደደ	näddädä
ነደፈ	näddäfä
ነዳ	nädda
ነዳደለ	nädaddälä
ነዳደፈ	nädaddäfä
ነገሠ	näggäśä
ነገረ	näggärä
ነገረኛ	nägäräñña
ነገረኝ	näggäräññ
ነገረው	näggäräw
ነገደ	näggädä
ነጋ	nägga
ነጋዴ	näggadé
ነጋድራስ	näggaderas
ነጋገረ	nägaggärä
ነጋገደ	nägaggädä
ነጋጋ	nägagga
ነጐረ	näggʷärä
ነጻነት	näṣannät
ነፈለለ	näfällälä
ነፈረ	näffärä
ነፈረቀ	näfärräqä
ነፈሰ	näffäsä
ነፈሰበት	näffäsäbbät
ነፈነፈ	näfännäfä
ነፈገ	näffägä
ነፊ	näffi
ነፋ	näffa
ነፋሻ	näffašša
ነፋፈሰ	näfaffäsä
ነፋፋ	näfaffa
ነፍላላ	näfelalla
ነፍራቃ	näferaqqa
ነፍናፋ	näfenaffa
ነፍጠኛ	näfeṭäñña
ናሙና	nammuna
ናቸው	naččäw
ናችሁ	naččehu
ናኘ	naññä
ናወዘ	nawwäzä
ናዋዥ	nawwaž
ናፈቀ	naffäqä
ንስሐ	nesseḥa
ንቃሽ	neqqaš
ንቃይ	neqqay
ንቅል	neqqel
ንቅሳታም	neqqesatam
ንቅሳት	neqqesat
ንቅናቄ	neqennaqé
ንብብር	nebebber
ንብዝ	nebbez
ንብዝብዝ	nebezebezz
ንትርክ	neterrek
ንክሳት	nekkesat
ንክስ	nekkes
ንክኪት	nekekkit
ንክክ	nekekk
ንኳቸ	nekkʷačä
ንዝራት	nezzerat
ንዴተኛ	nedétäñña
ንዴታም	neddétam
ንዴት	neddét
ንገዳ	neggäda
ንግር	negger
ንግርተኛ	neggeretäñña
ንግርት	neggeret
ንግግር	negegger
ንጹሕነት	neṣuḥennät
ንጽሕና	neṣeḥenna
ንፊት	neffit
ንፋሽ	neffaš
አሁኑኑ	ahunnunu
አሁንም	ahunemm
አሁንስ	ahuness
አህያ	aheyya
አለ	allä
አለሁ	allähu
አለለ	allälä
አለል	aläll
አለሎ	alällo
አለመ	allämä
አለመለመ	alämällämä
አለመደ	alämmädä
አለመጠ	alämmäṭä
አለማ	alämma
አለማለም	allämalläm
አለማመነ	allämammänä
አለማመደ	allämammädä
አለሳለስ	alläsaläs
አለቀ	alläqä
አለቀለቀ	aläqälläqä
አለቀመ	aläqqämä
አለቀሰ	aläqqäsä
አለቃለቀ	alläqalläqä
አለቃቀሰ	aläqaqqäsä
አለቅነት	aläqennät
አለበ	alläbä
አለበለዚያ	aläbälläzziya
አለበሰ	alläbbäsä
አለበት	alläbät
አለባበሰ	aläbabbäsä
አለብኝ	alläbbeññ
አለኝታ	alläññeta
አለከለከ	aläkälläkä
አለው	alläw
አለዘበ	aläzzäbä
አለያየ	alläyyayä
አለጎመ	aläggomä
አለጐመ	aläggʷämä
አለጠ	alläṭä
አለጠለጠ	aläṭälläṭä
አለፈ	alläfä
አለፈበት	alläfäbbät
አለፋ	aläffa
አለፋጨቀ	alläfač̣č̣äqä
አላላ	alalla
አላላም	allalam
አላላከ	allalakä
አላመነ	allammänä
አላመደ	allamädä
አላመጠ	allammäṭä
አላሚ	allami
አላማኝ	allamañ
አላሰነ	allassänä
አላሸ	alaššä
አላሸቀ	alaššäqä
አላቀመ	allaqqämä
አላቀሰ	allaqqäsä
አላቀቀ	allaqqäqä
አላቃሽ	allaqaš
አላቆጠ	alaqqoṭä
አላጋ	allagga
አላጋጭ	allagač̣
አላፊነት	alafinnät
አልቃሻ	aleqašša
አልባሌ	alebbalé
አልባነት	alebannät
አልከሰከሰ	alekäsäkkäsä
አልኮሰኮሰ	alekosäkkosä
አልገባኝም	alegäbbaññem
አልጐመጐመ	alegʷämäggʷämä
አልጨረሰም	aleč̣ärräsäm
አልጫ	alleč̣č̣a
አልፈሰፈሰ	alefäsäffäsä
አሎሎ	alollo
አመለመለ	amälämmälä
አመለኛ	amäläñña
አመለከ	amälläkä
አመለከተ	amäläkkätä
አመለጠ	amälläṭä
አመለጠው	amälläṭäw
አመላለስ	ammälalläs
አመላላሽ	ammälallaš
አመመ	ammämä
አመሠራረት	ammäśärarät
አመረረ	amärrärä
አመረቀዘ	amäräqqäzä
አመረተ	amärrätä
አመራ	amärra
አመራመረ	ammärammärä
አመራመር	ammäramär
አመራማሪ	ammäramari
አመራር	ammärar
አመሰ	ammäsä
አመሰቃቀለ	ammäsäqaqqälä
አመሰቃቃይ	ammäsäqaqay
አመሰኳ	amäsäkkʷa
አመሰገነ	amäsäggänä
አመሰጋገነ	amäsägaggänä
አመሳሰል	ammäsasäl
አመሳቀለ	ammäsaqqälä
አመሳከረ	ammäsakkärä
አመሳካሪ	ammäsakari
አመሸ	ammäššä
አመሸህ	amäššäh
አመቀ	ammäqä
አመቸ	amäččä
አመቺ	amäčči
አመቻቸ	ammäčaččä
አመነ	ammänä
አመነመነ	amänämmänä
አመነቃቀረ	ammänäqaqqärä
አመነታ	amänätta
አመነታታ	amänätatta
አመነቸከ	amänäččäkä
አመነኰሰ	amänäkkʷäsä
አመነዘረ	amänäzzärä
አመነጫጨቀ	ammänäč̣ač̣č̣äqqä
አመናቀረ	ammänaqqärä
አመናጨቀ	ammänač̣č̣äqä
አመከነ	amäkkänä
አመካኘ	ammäkañä
አመዘነ	amäzzänä
አመዛዘነ	ammäzazzänä
አመዛዛኝ	ammäzazañ
አመገ	ammägä
አመገለ	ammäggälä
አመጋገብ	ammägagäb
አመጣጠነ	ammäṭaṭṭänä
አመጻደቀ	ammäṣaddäqä
አማ	amma
አማለደ	ammalädä
አማላጅ	ammalaj
አማላጅነት	ammalajennät
አማመመ	amammämä
አማረረ	ammarrärä
አማረዘ	ammarräzä
አማረገ	ammarrägä
አማረጠ	ammarräṭä
አማሪኛው	amariññaw
አማራሪ	ammarari
አማራጭ	ammarač̣
አማርኛ	amareñña
አማሰለ	ammassälä
አማሸ	ammaššä
አማሺ	ammaši
አማሽ	ammaš
አማተበ	ammattäbä
አማታ	ammata
አማች	ammač
አማከረ	amakkärä
አማካሪ	ammakari
አማካኝ	ammakañ
አማገረ	ammaggärä
አማገጠ	amaggäṭä
አማጣ	ammaṭa
አማጭ	ammač̣
አሜተኛ	amétäñña
አምሳኛ	amesañña
አምሳያ	amesayya
አምስተኛ	ammesetäñña
አምስት	ammeset
አምበል	amebäll
አምቡላ	amebulla
አምባረቀ	amebarräqä
አምባሻ	amebašša
አምባጋሮኛ	amebagaroñña
አምቦልክ	amebolekk
አምቦረቀቀ	ameboräqqäqä
አምቦጨቦጨ	ameboč̣äbboč̣ä
አምቧቧ	amebʷabbʷa
አምታታ	ametatta
አምነሸነሸ	amenäšännäšä
አምዘገዘገ	amezägäzzägä
አሞለጨ	amolläč̣ä
አሞላ	amolla
አሞላላ	ammolalla
አሞላቀቀ	amolaqqäqä
አሞቀሞቀ	amoqämmoqä
አሞኘ	amoññä
አሞካከረ	ammokakkärä
አሞገሰ	amoggäsä
አሞጋሽ	amoggaš
አሞጋገሰ	amogaggäsä
አሞጠሞጠ	amoṭämmoṭä
አሟላ	ammʷalla
አሟሟቀ	ammʷamʷaqä
አሟሟቂ	ammʷamʷaqi
አሟረተ	amʷarrätä
አሟሸ	amʷaššä
አሟከረ	ammʷakkärä
አሟገተ	ammʷaggätä
አሟጋች	ammʷagač
አሠለሰ	aśälläsä
አሠልጣኝ	aśäleṭaññ
አሠመረ	aśämmärä
አሠማመረ	aśämammärä
አሠሠ	aśśäśä
አሠረ	aśśärä
አሠዋ	aśśäwwa
አሠየመ	aśäyyämä
አሠገረ	aśäggärä
አሠጋ	aśägga
አሠጋገር	aśśägagär
አሣሣ	aśaśśa
አሣረኛ	aśaräñña
አረመ	arrämä
አረመኔነት	arämänénnät
አረሰ	arräsä
አረሳሳ	aräsassa
አረቀ	arräqä
አረቀቀ	aräqqäqä
አረበደ	arräbbädä
አረባ	aräbba
አረባጅ	aräbbaj
አረከሰ	aräkkäsä
አረካ	aräkka
አረካከበ	arräkakkäbä
አረካካቢ	arräkakabi
አረዘመ	aräzzämä
አረደ	arrädä
አረዳ	arädda
አረጀ	aräjjä
አረገረገ	arägärrägä
አረገበ	aräggäbä
አረገዘ	aräggäzä
አረገደ	aräggädä
አረገፈ	aräggäfä
አረጋ	arägga
አረጋገጠ	arrägaggäṭä
አረጋገፈ	arrägaggäfä
አረጋጋ	arrägagga
አረጠ	arräṭä
አረጠረጠ	aräṭärräṭä
አረፈደ	aräffädä
አረፋፈደ	aräffafädä
አራ	arra
አራመደ	arrammädä
አራሙቻ	arramučča
አራሚ	arrami
አራረሰ	ararräsä
አራራ	ararra
አራራቀ	arraraqä
አራቈተ	arraqʷätä
አራባ	arraba
አራተኛ	arattäñña
አራት	aratt
አራገበ	arraggäbä
አራገፈ	arraggäfä
አራጋፊ	arraggafi
አርመጠመጠ	aremäṭämmäṭä
አርበተበተ	arebätäbbätä
አርበኛ	arebäñña
አርበኛነት	arebäññanät
አርበኝነት	arebäññennät
አርበደበደ	arebädäbbädä
አርባኛ	arebañña
አርነት	arennät
አርአያነት	areʾayannät
አርከፈከፈ	arekäfäkkäfä
አርገበገበ	aregäbäggäbä
አርጩሜ	areč̣ummé
አሯሯጠ	arrʷarʷaṭä
አሰለለ	assällälä
አሰለመ	asällämä
አሰለሰለ	asälässälä
አሰለበ	assäläbä
አሰለቸ	asäläččä
አሰለፈ	asälläfä
አሰላ	asälla
አሰላሰለ	assälassälä
አሰላይ	assällay
አሰላፊ	assällafi
አሰማ	assämma
አሰረ	assärä
አሰረቀ	assäräqä
አሰረዘ	assärräzä
አሰራጨ	assärač̣ä
አሰሰ	assäsä
አሰሳ	assäsa
አሰቀለ	assäqqälä
አሰቀቀ	assäqqäqä
አሰቃቂ	assäqqaqi
አሰቃየ	assäqayyä
አሰበ	assäbä
አሰበረ	assäbbärä
አሰበከ	asäbbäkä
አሰበጣጠረ	assäbäṭaṭṭärä
አሰባ	asäbba
አሰባሰበ	assäbassäbä
አሰባጠረ	assäbaṭṭärä
አሰት	assät
አሰነቀ	assännäqä
አሰነበተ	asänäbbätä
አሰነካከለ	assänäkakkälä
አሰነዳዳ	assänädadda
አሰነጠቀ	assänäṭṭäqä
አሰነፈ	asännäfä
አሰናበተ	assänabbätä
አሰናከለ	assänakkälä
አሰናካይ	assänakay
አሰናዳ	assänadda
አሰናጅ	assänaj
አሰኘ	assäññä
አሰኘው	assäññäw
አሰከረ	asäkkärä
አሰከነ	asäkkänä
አሰካ	assäkka
አሰየፈ	assäyyäfä
አሰደበ	assäddäbä
አሰዳቢ	asäddabi
አሰገደ	assägäddä
አሰገገ	asäggägä
አሰጠ	assäṭṭä
አሰፈረ	assäffärä
አሰፈሰፈ	asäfässäfä
አሰፈፈ	asäffäfä
አሰፋ	assäffa
አሳለ	assalä
አሳለበ	asalläbä
አሳለፈ	asalläfä
አሳመ	assamä
አሳመመ	asammämä
አሳመሰ	asammäsä
አሳመቀ	asammäqä
አሳመነ	asammänä
አሳማኝ	asammañ
አሳሠረ	asaśśärä
አሳረመ	asarrämä
አሳረረ	assarrärä
አሳረሰ	asarräsä
አሳረደ	asarrädä
አሳረፈ	asarräfä
አሳራ	asarra
አሳራሪ	assarari
አሳራሽ	asarraš
አሳሰበ	asassäbä
አሳሳመ	assasamä
አሳሳቀ	assasaqä
አሳሳበ	assasabä
አሳሳቢ	asassabi
አሳሳተ	assasatä
አሳሳች	assasač
አሳሸ	asaššä
አሳሸገ	asaššägä
አሳቀ	assaqä
አሳቀለ	assaqqälä
አሳቀቀ	assaqqäqä
አሳቀደ	asaqqädä
አሳቀፈ	asaqqäfä
አሳበ	assabä
አሳበረ	assabbärä
አሳበቀ	assabbäqä
አሳበበ	assabbäbä
አሳበደ	asabbädä
አሳበጠ	asabbäṭä
አሳቢ	assabi
አሳባሪ	assabari
አሳባቂ	assabaqi
አሳብ	assab
አሳተ	assatä
አሳተመ	asattämä
አሳተፈ	assattäfä
አሳታሚ	asattami
አሳቻ	assačča
አሳች	assač
አሳነሰ	asannäsä
አሳነቀ	asannäqä
አሳነጠ	asannäṭä
አሳነፈ	assannäfä
አሳከለ	asakkälä
አሳከመ	asakkämä
አሳከረ	assakkärä
አሳከተ	asakkätä
አሳከከ	asakkäkä
አሳካ	assakka
አሳካሚ	asakkami
አሳወቀ	asawwäqä
አሳዘነ	asazzänä
አሳዘዘ	asazzäzä
አሳዛኝ	asazzaññ
አሳየ	asayyä
አሳደለ	asaddälä
አሳደደ	assaddädä
አሳደገ	asaddägä
አሳደፈ	asaddäfä
አሳዳጅ	assadaj
አሳዳጊ	asaddagi
አሳጀለ	asajjälä
አሳጀበ	asajjäbä
አሳገደ	asaggädä
አሳጣ	assaṭṭa
አሳጪ	assač̣i
አሳፈረ	assaffärä
አሳፈሰ	asaffäsä
አሳፈነ	asaffänä
አሳፋሪ	assafari
አስለመነ	aselämmänä
አስለመደ	aselämmädä
አስለማ	aselämma
አስለማጅ	aselämmaj
አስለሰነ	aselässänä
አስለቀለቀ	aseläqälläqä
አስለቀመ	aseläqqämä
አስለቀሰ	aseläqqäsä
አስለቀቀ	aseläqqäqä
አስለቃሽ	aseläqqaš
አስለበለበ	aseläbälläbä
አስለበሰ	aseläbbäsä
አስለበበ	aseläbbäbä
አስለበደ	aseläbbädä
አስለበጠ	aseläbbäṭä
አስለጎመ	aseläggomä
አስለፈለፈ	aseläfälläfä
አስለፈፈ	aseläffäfä
አስለፋ	aseläffa
አስመለሰ	asemälläsä
አስመለከተ	asemäläkkätä
አስመለጠ	asemälläṭä
አስመሠረተ	asemäśśärätä
አስመረመረ	asemärämmärä
አስመረረ	asemärrärä
አስመረቀ	asemärräqä
አስመረዘ	asemärräzä
አስመረገ	asemärrägä
አስመረጠ	asemärräṭä
አስመራ	asemärra
አስመሰለ	asemässälä
አስመሰከረ	asemäsäkkärä
አስመሰገነ	asemäsäggänä
አስመሳይ	asemässay
አስመሸ	asemäššä
አስመሸገ	asemäššägä
አስመተረ	asemättärä
አስመታ	asemätta
አስመነታ	asemänätta
አስመነነ	asemännänä
አስመነኰሰ	asemänäkkʷäsä
አስመነዘረ	asemänäzzärä
አስመኘ	asemäññä
አስመከረ	asemäkkärä
አስመዘነ	asemäzzänä
አስመዘዘ	asemäzzäzä
አስመዘገበ	asemäzäggäbä
አስመደበ	asemäddäbä
አስመገበ	asemäggäbä
አስመጠወተ	asemäṭäwwätä
አስማማ	asemamma
አስማተኛ	asematäñña
አስማገረ	asemaggärä
አስሞላ	asemolla
አስሞረደ	asemorrädä
አስሞከተ	asemokkätä
አስሞገተ	asemoggätä
አስሞጨለፈ	asemoč̣älläfä
አስረረ	asserrärä
አስረሳ	aserässa
አስረቀቀ	aseräqqäqä
አስረበረበ	aseräbärräbä
አስረከበ	aseräkkäbä
አስረካቢ	aseräkkabi
አስረዳ	aserädda
አስረጀ	aseräjjä
አስረገመ	aseräggämä
አስረገዘ	aseräggäzä
አስረገጠ	aseräggäṭä
አስረገፈ	aseräggäfä
አስረፈደ	aseräffädä
አስቀለሰ	aseqälläsä
አስቀለበሰ	aseqäläbbäsä
አስቀለጠ	aseqälläṭä
አስቀመለ	aseqämmälä
አስቀመመ	aseqämmämä
አስቀመሰ	aseqämmäsä
አስቀመቀመ	aseqämäqqämä
አስቀመጠ	aseqämmäṭä
አስቀማ	aseqämma
አስቀሠፈ	aseqäśśäfä
አስቀረ	aseqärrä
አስቀረደደ	aseqäräddädä
አስቀረጠ	aseqärräṭä
አስቀረጸ	aseqärräṣä
አስቀረፈ	aseqärräfä
አስቀሰተ	aseqässätä
አስቀሳፈተ	aseqäsaffätä
አስቀቀለ	aseqäqqälä
አስቀበለ	aseqäbbälä
አስቀበረ	aseqäbbärä
አስቀበቀበ	aseqäbäqqäbä
አስቀባ	aseqäbba
አስቀነሰ	aseqännäsä
አስቀና	aseqänna
አስቀዘነ	aseqäzzänä
አስቀዘፈ	aseqäzzäfä
አስቀየመ	aseqäyyämä
አስቀየሠ	aseqäyyäśä
አስቀየደ	aseqäyyädä
አስቀየጠ	aseqäyyäṭä
አስቀያሚ	aseqäyyami
አስቀደመ	aseqäddämä
አስቀደሰ	aseqäddäsä
አስቀደደ	aseqäddädä
አስቀዳ	aseqädda
አስቀዳሽ	aseqäddaš
አስቀድሞ	aseqäddemo
አስቀጠቀጠ	aseqäṭäqqäṭä
አስቀፈቀፈ	aseqäfäqqäfä
አስቀፈደደ	aseqäfäddädä
አስቂኝ	asseqiññ
አስቃረመ	aseqarrämä
አስቆለለ	aseqollälä
አስቆለፈ	aseqolläfä
አስቆላ	aseqolla
አስቆረሰ	aseqorräsä
አስቆየ	aseqoyyä
አስቆፈረ	aseqoffärä
አስቈለመመ	aseqʷälämmämä
አስቈረቈረ	aseqʷäräqqʷärä
አስቈረበ	aseqʷärräbä
አስቈረጠ	aseqʷärräṭä
አስቈራ	aseqʷärra
አስበላ	asebälla
አስበረቀሰ	asebäräqqäsä
አስበረበረ	asebäräbbärä
አስበረዘ	asebärräzä
አስበረደ	asebärrädä
አስበረገገ	asebäräggägä
አስበራ	asebärra
አስበሰለ	asebässälä
አስበተነ	asebättänä
አስበከለ	asebäkkälä
አስበዘበዘ	asebäzäbbäzä
አስበየነ	asebäyyänä
አስበየደ	asebäyyädä
አስበደለ	asebäddälä
አስበዳ	asebädda
አስበጂ	asebäjji
አስበጠበጠ	asebäṭäbbäṭä
አስባረከ	asebarräkä
አስተለተለ	asetälättälä
አስተላለቀ	asetälalläqä
አስተላለፈ	asetälalläfä
አስተመተመ	asetämättämä
አስተማመነ	asetämammänä
አስተማረ	asetämmarä
አስተሣሠረ	asetäśaśśärä
አስተረተረ	asetärättärä
አስተረጐመ	asetäräggʷämä
አስተራረሰ	asetärarräsä
አስተሳሰበ	asetäsassäbä
አስተሻሸ	asetäšaššä
አስተባበለ	asetäbabbälä
አስተባበረ	asetäbabbärä
አስተቸ	asetäččä
አስተነተነ	asetänättänä
አስተነፈሰ	asetänäffäsä
አስተናበረ	asetänabbärä
አስተናገደ	asetänaggädä
አስተኛ	asettäña
አስተከዘ	asetäkkäzä
አስተካከለ	asetäkakkälä
አስተኰሰ	asetäkkʷäsä
አስተዋወቀ	asetäwawwäqä
አስተዛዘበ	asetäzazzäbä
አስተያየ	asetäyayyä
አስተዳደረ	asetädaddärä
አስተጋባ	asetägabba
አስተፋ	asetäffa
አስታረቀ	asetarräqä
አስታቀፈ	asetaqqäfä
አስታከከ	asetakkäkä
አስታወሰ	asetawwäsä
አስታወቀ	asetawwäqä
አስታገሠ	asetaggäśä
አስታጐለ	asetaggʷälä
አስቸረቸረ	aseččäräččärä
አስቸነከረ	asečänäkkärä
አስቸከለ	asečäkkälä
አስቸኰለ	asečäkkʷälä
አስቸኳይ	asečäkkʷay
አስቸገረ	asečäggärä
አስቸጋሪ	asečäggari
አስነሣ	asennäśa
አስነረተ	asenärrätä
አስነሰነሰ	asenäsännäsä
አስነሺ	asenäšši
አስነቀለ	asenäqqälä
አስነቀሰ	asenäqqäsä
አስነቀፈ	asenäqqäfä
አስነቃፊ	asenäqqafi
አስነበበ	asenäbbäbä
አስነከረ	asenäkkärä
አስነከሰ	asenäkkäsä
አስነካ	asenäkka
አስነወረ	asenäwwärä
አስነዋሪ	asenäwwari
አስነደለ	asenäddälä
አስነደፈ	asenäddäfä
አስነዳ	asenädda
አስነገረ	asenäggärä
አስነገተ	asenäggätä
አስነገደ	asenäggädä
አስነጋ	asenägga
አስነጐረ	asenäggʷärä
አስነፈሰ	asenäffäsä
አስነፋ	asenäffa
አስከለለ	asekällälä
አስከለበሰ	asekäläbbäsä
አስከለከለ	asekäläkkälä
አስከመረ	asekämmärä
አስከረተፈ	asekärättäfä
አስከረከመ	asekäräkkämä
አስከሰለ	asekässälä
አስከሰሰ	asekässäsä
አስከሰከሰ	asekäsäkkäsä
አስከበረ	asekäbbärä
አስከበበ	asekäbbäbä
አስከባሪ	asekäbbari
አስከተለ	asekättälä
አስከተረ	asekättärä
አስከተበ	asekättäbä
አስከተተ	asekättätä
አስከተከተ	asekätäkkätä
አስከነዳ	asekännäda
አስከደነ	asekäddänä
አስከዳ	asekädda
አስከፈለ	asekäffälä
አስከፈነ	asekäffänä
አስከፈከፈ	asekäfäkkäfä
አስከፈፈ	asekäffäfä
አስከፊ	asekäffi
አስከፋ	asekäffa
አስካካ	asekakka
አስኮላሸ	asekolaššä
አስኮረጀ	asekorräjä
አስኮረፈ	asekorräfä
አስኮበለለ	asekobällälä
አስኮተኮተ	asekotäkkotä
አስኰነነ	asekʷännänä
አስኰናኝ	asekʷännañ
አስወለቀ	asewälläqä
አስወለደ	asewällädä
አስወረረ	asewärrärä
አስወረወረ	asewäräwwärä
አስወረደ	asewärrädä
አስወራ	asewärra
አስወሰነ	asewässänä
አስወሰደ	asewässädä
አስወቀረ	asewäqqärä
አስወቀጠ	asewäqqäṭä
አስወቃ	asewäqqa
አስወተፈ	asewättäfä
አስወነጀለ	asewänäjjälä
አስወደደ	asewäddädä
አስወገረ	asewäggärä
አስወገደ	asewäggädä
አስወጋ	asewägga
አስዋኘ	asewaññä
አስደለደለ	asedäläddälä
አስደመረ	asedämmärä
አስደመሰሰ	asedämässäsä
አስደረተ	asedärrätä
አስደረደረ	asedäräddärä
አስደረገ	asedärrägä
አስደራጊ	asedärragi
አስደሰተ	asedässätä
አስደሳች	asedässač
አስደቀቀ	asedäqqäqä
አስደበለቀ	asedäbälläqä
አስደበቀ	asedäbbäqä
አስደባለቀ	asedäballäqä
አስደነሰ	asedännäsä
አስደነቀ	asedännäqä
አስደነበረ	asedänäbbärä
አስደነገጠ	asedänäggäṭä
አስደናቂ	asedännaqi
አስደወለ	asedäwwälä
አስደገመ	asedäggämä
አስደገሰ	asedäggäsä
አስደገደገ	asedägäddägä
አስደፈረ	asedäffärä
አስደፈቀ	asedäffäqä
አስደፈነ	asedäffänä
አስደፈጠ	asedäffäṭä
አስጀመረ	asejämmärä
አስገለበጠ	asegäläbbäṭä
አስገመሰ	asegämmäsä
አስገመተ	asegämmätä
አስገመገመ	asegämäggämä
አስገረመ	asegärrämä
አስገረዘ	asegärräzä
አስገራ	asegärra
አስገራሚ	asegärrami
አስገባ	asegäbba
አስገነዘበ	asegänäzzäbä
አስገኘ	asegäññä
አስገዘተ	asegäzzätä
አስገደለ	asegäddälä
አስገደደ	asegäddädä
አስገደፈ	asegäddäfä
አስጎመጀ	asegomäjjä
አስጐበኘ	asegʷäbäññä
አስጐነበሰ	asegʷänäbbäsä
አስጠለለ	aseṭällälä
አስጠላ	aseṭälla
አስጠመደ	aseṭämmädä
አስጠማ	aseṭämma
አስጠራ	aseṭärra
አስጠቃ	aseṭäqqa
አስጠነቀቀ	aseṭänäqqäqä
አስጠና	aseṭänna
አስጠኚ	aseṭäññi
አስጠየፈ	aseṭäyyäfä
አስጠያፊ	aseṭäyyafi
አስጠይ	aseṭäyy
አስጠገነ	aseṭäggänä
አስጠጋ	aseṭägga
አስጨመረ	aseč̣ämmärä
አስጨመቀ	aseč̣ämmäqä
አስጨበጨበ	aseč̣äbäč̣č̣äbä
አስጨነቀ	aseč̣ännäqä
አስጨናቂ	aseč̣ännaqi
አስጨፈለቀ	aseč̣äfälläqä
አስጨፈረ	aseč̣äffärä
አስጸየፈ	aseṣṣäyyäfä
አስጸያፊ	aseṣṣäyyafi
አስፈለገ	asefällägä
አስፈለገኝ	asefällägäññ
አስፈለፈለ	asefäläffälä
አስፈላ	asefälla
አስፈረመ	asefärrämä
አስፈረደ	aseffärädä
አስፈሪ	asefärri
አስፈራ	asefärra
አስፈራራ	asefärarra
አስፈሳ	asefässa
አስፈሳው	asefässaw
አስፈቀደ	asefäqqädä
አስፈተሸ	asefättäšä
አስፈተነ	asefättänä
አስፈተገ	asefättägä
አስፈታ	asefätta
አስፈጀ	asefäjjä
አስፋፋ	asefaffa
አሶመሰመ	asomässämä
አሸ	aššä
አሸለለ	aššällälä
አሸለመ	ašällämä
አሸለቀቀ	aššäläqqäqä
አሸለበ	ašälläbä
አሸለተ	aššällätä
አሸመ	aššämä
አሸመተ	ašämmätä
አሸመገለ	ašämäggälä
አሸመጠጠ	aššämäṭṭäṭä
አሸረሞጠ	ašärämmoṭä
አሸረጠ	ašärräṭä
አሸረፈ	ašärräfä
አሸሸ	aššäšä
አሸሸገ	aššäššägä
አሸቀለ	aššäqqälä
አሸቀበ	ašäqqäbä
አሸበረ	aššäbbärä
አሸበረቀ	ašäbärräqä
አሸበሸበ	ašäbäššäbä
አሸበበ	aššäbbäbä
አሸበተ	ašäbbätä
አሸባሪ	aššäbbari
አሸተተ	ašättätä
አሸነሸነ	aššänäššänä
አሸነፈ	aššännäfä
አሸና	aššänna
አሸናፊ	aššännafi
አሸኘ	aššäññä
አሸኛኘት	aššäñañät
አሸከመ	aššäkkämä
አሸካሸከ	aššäkaššäkä
አሸዋማ	ašäwamma
አሸዋነት	ašäwannät
አሸገ	aššägä
አሸጋሸገ	aššägaššägä
አሸጋገረ	aššägaggärä
አሸጠ	aššäṭä
አሸፈተ	ašäffätä
አሸፈነ	aššäffänä
አሻለ	aššalä
አሻማ	aššamma
አሻረ	aššarä
አሻረከ	aššarräkä
አሻሸ	ašaššä
አሻሻለ	aššašalä
አሻሻጠ	aššašaṭä
አሻሻጭ	aššašač̣
አሻቀበ	ašaqqäbä
አሻንጉሊት	ašanegullit
አሻከረ	ašakkärä
አሻገረ	ašaggärä
አሻገተ	ašaggätä
አሻፈረኝ	ašaffäräñ
አሻፈደ	ašaffädä
አሽሙረኛ	ašemuräñña
አሽሟጣጭነት	ašemʷaṭač̣ennät
አሽቀዳደመ	ašeqädaddämä
አሽቆጠቆጠ	ašeqoṭäqqoṭä
አሽበለበለ	ašebäläbbälä
አሽታ	aššeta
አሽከረከረ	ašekäräkkärä
አሽከርነት	ašekärennät
አሽካካ	ašekkaka
አሽኮረመመ	ašekorämmämä
አሾለቀ	ašolläqä
አሾለከ	ašolläkä
አሾላቂ	ašollaqi
አሾመ	aššomä
አሾከሾከ	ašokäššokä
አቀለለ	aqällälä
አቀለመ	aqällämä
አቀለጠ	aqälläṭä
አቀላ	aqälla
አቀላል	aqqälal
አቀላቀለ	aqqälaqqälä
አቀላጠፈ	aqqälaṭṭäfä
አቀመሰ	aqämmäsä
አቀማመጥ	aqqämamäṭ
አቀማጠለ	aqqämaṭṭälä
አቀረረ	aqärrärä
አቀረቀረ	aqäräqqärä
አቀረበ	aqärräbä
አቀረና	aqäränna
አቀረጣጠፈ	aqqäräṭaṭṭäfä
አቀራረበ	aqqärarräbä
አቀሰሰ	aqässäsä
አቀበለ	aqäbbälä
አቀበጠ	aqäbbäṭä
አቀባበለ	aqqäbabbälä
አቀባበረ	aqqäbabbärä
አቀባባይ	aqqäbabay
አቀባይ	aqäbbay
አቀነቀነ	aqänäqqänä
አቀነበጠ	aqänäbbäṭä
አቀነባበረ	aqqänäbabbärä
አቀነባባሪ	aqqänäbabbari
አቀና	aqänna
አቀናበረ	aqqänabbärä
አቀናበር	aqqänabbär
አቀናባሪ	aqqänabari
አቀናነሰ	aqqänannäsä
አቀዘቀዘ	aqäzäqqäzä
አቀዛቀዘ	aqqäzaqäzä
አቀያየረ	aqqäyayyärä
አቀያየደ	aqäyayyädä
አቀያየጠ	aqqäyayyäṭä
አቀዳጀ	aqädajjä
አቀጣጠረ	aqqäṭaṭärä
አቀጣጠነ	aqqäṭaṭänä
አቀፈ	aqqäfä
አቀፍ	aqqäf
አቁለጨለጨ	aquläč̣älläč̣ä
አቁላላ	aqulalla
አቁነጠነጠ	aqunäṭännäṭä
አቃለለ	aqqallälä
አቃመሰ	aqammäsä
አቃረበ	aqqaräbä
አቃራመ	aqqarramä
አቃሰተ	aqassätä
አቃበረ	aqqabbärä
አቃባ	aqqabba
አቃነሰ	aqqannäsä
አቃና	aqqanna
አቃወሰ	aqawwäsä
አቃዋሽ	aqqawaš
አቃዠ	aqažžä
አቃጠለ	aqqaṭṭälä
አቃጠረ	aqqaṭärä
አቃጠፈ	aqqaṭṭäfä
አቃጣሪ	aqqaṭari
አቅለሸለሸ	aqeläšälläšä
አቅለበለበ	aqeläbälläbä
አቅማማ	aqemamma
አቅራቢያ	aqerabbiya
አቅበዘበዘ	aqebäzäbbäzä
አቅነዘነዘ	aqenäzännäzä
አቅጣጫ	aqeṭač̣č̣a
አቆለቆለ	aqoläqqolä
አቆላለፈ	aqqolalläfä
አቆላመጠ	aqqolammäṭä
አቆራኘ	aqqoraññä
አቆሸሸ	aqoššäšä
አቆነጀ	aqonäjjä
አቆየ	aqoyyä
አቆጠቆጠ	aqoṭäqqoṭä
አቈለቈለ	aqʷäläqqʷälä
አቈላለፈ	aqʷälalläfä
አቈረቈዘ	aqʷäräqqʷäzä
አቈረበ	aqʷärräbä
አቈረፈደ	aqʷäräffädä
አቈራመደ	aqqʷärammädä
አቈራረጠ	aqqʷärarräṭä
አቈሰለ	aqʷässälä
አቈሳሰለ	aqʷäsassälä
አቈነሰ	aqʷännäsä
አቈጣጠረ	aqqʷäṭaṭṭärä
አቋለፈ	aqqʷalläfä
አቋመጠ	aqʷammäṭä
አቋረጠ	aqqʷarräṭä
አቋራጭ	aqqʷarač̣
አቋቋመ	aqqʷaqʷamä
አቋቋሚ	aqqʷaqʷami
አቋቋም	aqqʷaqʷam
አቋፈረ	aqqʷaffärä
አበለ	abbälä
አበለዘ	abälläzä
አበለጠ	abälläṭä
አበላ	abälla
አበላለጠ	abälalläṭä
አበላሸ	abälaššä
አበል	abäll
አበረ	abbärä
አበረረ	abärrärä
አበረታ	abärätta
አበረከተ	abäräkkätä
አበረደ	abärrädä
አበረገገ	abäräggägä
አበራ	abärra
አበራከተ	abbärakkätä
አበራየ	abärayyä
አበር	abbär
አበሰ	abbäsä
አበሰለ	abässälä
አበሰረ	abässärä
አበሰበሰ	abäsäbbäsä
አበሳጨ	abbäsač̣č̣ä
አበሸቀ	abäššäqä
አበሸቀጠ	abbäšäqqäṭä
አበሻቀጠ	abbäšaqqäṭä
አበቀለ	abäqqälä
አበቃ	abäqqa
አበቃቃ	abbäqaqqa
አበበ	abbäbä
አበባማ	abäbamma
አበታተነ	abbätattänä
አበከተ	abäkkätä
አበካከነ	abäkakkänä
አበዛ	abäzza
አበደረ	abäddärä
አበዳሪ	abäddari
አበጀ	abäjjä
አበጃጀ	abäjajjä
አበገነ	abäggänä
አበጠ	abbäṭä
አበጣበጠ	abbäṭabbäṭä
አበጣባጭ	abbäṭabač̣
አባ	abba
አባለገ	aballägä
አባለጠ	aballäṭä
አባላ	aballa
አባልነት	abalennät
አባረረ	abbarrärä
አባረቀ	abarräqä
አባራ	abarra
አባራሪ	abbarari
አባቃ	abaqqa
አባበለ	ababbälä
አባበጠ	ababbäṭä
አባባ	abbabba
አባባለ	abbabalä
አባባል	abbabal
አባባሰ	abbabasä
አባቴ	abbaté
አባት	abbat
አባነነ	abannänä
አባከነ	abakkänä
አባካኝ	abakaññ
አባወራ	abbawärra
አባዛ	abazza
አባዥ	abbaž
አባዬ	abbayé
አባይ	abbay
አባይነት	abayennät
አባዳ	abbada
አባጨጓሬ	abbač̣äggʷarré
አብላላ	abellala
አብረቀረቀ	aberäqärräqä
አብረከረከ	aberäkärräkä
አብራራ	aberarra
አብሰለሰለ	abesälässälä
አብቃቃ	abeqaqqa
አብነት	abennät
አብዛኛው	abezaññaw
አብዛኛውን	abezaññawen
አቦ	abbo
አቦነነ	abonnänä
አቦካ	abokka
አቦዘነ	abozzänä
አቧለተ	abʷallätä
አቧራማ	abʷarrama
አቧደነ	abbʷaddänä
አተላ	atälla
አተመ	attämä
አተመተመ	atämättämä
አተረማመሰ	attärämammäsä
አተረፈ	atärräfä
አተራመሰ	attärammäsä
አተራማሽ	attäramaš
አተራረፈ	atärarräfä
አተራተረ	attärattärä
አተበ	attäbä
አተተ	attätä
አተኛኘት	attäñañät
አተኛኝ	attäñañ
አተከነ	atäkkänä
አተኮረ	atäkkorä
አተኰሰ	atäkkʷäsä
አታለለ	attalälä
አታላይ	attalay
አታሚ	attami
አታቢ	attabi
አታች	attač
አታከለ	attakkälä
አታከተ	atakkätä
አታገለ	attaggälä
አታጋይ	attagay
አትራ	attera
አትክልተኛ	atekelettäña
አትጠራጠር	atteṭṭäraṭär
አቶሰቶሰ	atosättosä
አቶፈቶፈ	atofättofä
አቸነፈ	aččännäfä
አቻ	ačča
አቻምና	aččamena
አቻቻለ	aččačalä
አቻኳይ	aččakʷay
አነሣ	anäśśa
አነሣሣ	annäśaśśa
አነሣሽ	annäśaš
አነሰ	annäsä
አነሰረ	anässärä
አነስተኛ	anäsetäñña
አነቀ	annäqä
አነቀዘ	anäqqäzä
አነቀፈ	anäqqäfä
አነቃ	anäqqa
አነቃቂ	annäqaqi
አነቃቃ	annäqaqqa
አነቃነቀ	annäqannäqä
አነቃናቂ	annäqanaqi
አነቈረ	anäqqʷärä
አነበበ	anäbbäbä
አነበነበ	anäbännäbä
አነበዘ	anäbbäzä
አነባ	anäbba
አነባበረ	annäbabbärä
አነባበሮ	annäbabäro
አነባበበ	anäbabbäbä
አነታረከ	annätarräkä
አነኈለለ	anäḫʷällälä
አነከሰ	anäkkäsä
አነከተ	anäkkätä
አነካከሰ	anäkakkäsä
አነካኪ	annäkaki
አነካካ	annäkakka
አነኰረ	anäkkʷärä
አነኰተ	anäkkʷätä
አነኳኰተ	anäkʷakkʷätä
አነወረ	anäwwärä
አነዘረ	anäzzärä
አነደደ	anäddädä
አነዳድ	annädad
አነገሠ	anäggäśä
አነገበ	anäggäbä
አነገተ	anäggätä
አነጋ	anägga
አነጋገር	annägagär
አነጋጋ	anägagga
አነጋጋሪ	annägagari
አነጐረ	anäggʷärä
አነጐተ	anäggʷätä
አነጐድ	anäggʷäd
አነጠ	annäṭä
አነጠነጠ	anäṭännäṭä
አነጣጠለ	annäṭaṭṭälä
አነጣጠረ	annäṭaṭṭärä
አነጣጣሪ	annäṭaṭari
አነጫነጨ	anäč̣annäč̣ä
አነጻጸረ	annäṣaṣṣärä
አነፈረ	anäffärä
አነፈረቀ	anäfärräqä
አነፈሰ	anäffäsä
አነፈነ	annäfänä
አነፈነፈ	anäfännäfä
አነፋረቀ	annäfarräqä
አነፋፈሰ	anäfaffäsä
አናረ	annarä
አናቀለ	annaqqälä
አናበበ	annabbäbä
አናባቢ	annababi
አናከሰ	annakkäsä
አናኪ	annaki
አናካ	annakka
አናዘዘ	annazzäzä
አናዛዥ	annazaž
አናደደ	annaddädä
አናደፈ	annaddäfä
አናዳ	annadda
አናዳጅ	annadaj
አናገሠ	annaggäśä
አናገረ	annaggärä
አናጊ	annagi
አናጋ	annagga
አናጋሪ	annagari
አናጋሽ	annagaš
አናጠቀ	annaṭṭäqä
አናጠበ	annaṭṭäbä
አናጠፈ	annaṭäfä
አናጢነት	anaṭinnät
አናፈሰ	annaffäsä
አናፋ	anaffa
አንሰፈሰፈ	anesäfässäfä
አንሸረሸረ	anešäräššärä
አንሸዋረረ	anešäwarrärä
አንሻተተ	anešattätä
አንሻፈፈ	anešaffäfä
አንሾካሾከ	anešokašokkä
አንሿከከ	anešʷakkäkä
አንሿካኪ	anešʷakkaki
አንቀለቀለ	aneqäläqqälä
አንቀላፋ	aneqälaffa
አንቀረበበ	aneqäräbbäbä
አንቀረፈፈ	aneqäräffäfä
አንቀሰቀሰ	aneqäsäqqäsä
አንቀሳቀሰ	aneqäsaqqäsä
አንቀባረረ	aneqäbarrärä
አንቀዋለለ	aneqäwallälä
አንቀጠቀጠ	aneqäṭäqqäṭä
አንቃረረ	aneqarrärä
አንቆረቆረ	aneqoräqqorä
አንቋሸሸ	aneqʷaššäšä
አንበለበለ	anebäläbbälä
አንበረከከ	anebäräkkäkä
አንበሳ	anebässa
አንበሸበሸ	anebäšäbbäšä
አንቦራቀቀ	aneboraqqäqä
አንቦገቦገ	anebogäbbogä
አንቦጨቦጨ	aneboč̣č̣äbboč̣ä
አንቦጫቦጨ	aneboč̣č̣abboč̣ä
አንተላከሰ	anetälakkäsä
አንተረከከ	anetäräkkäkä
አንተከተከ	anetäkättäkä
አንተገተገ	anetägättägä
አንቺዬ	anečiyyé
አንከረፈፈ	anekäräffäfä
አንከራተተ	anekärattätä
አንከበከበ	anekäbäkkäbä
አንከባለለ	anekäballälä
አንከባከበ	anekäbakkäbä
አንከተከተ	anekätäkkätä
አንከታከተ	anekätakkätä
አንከፈረረ	anekäfärrärä
አንካላ	anekalla
አንካሳ	anekassa
አንካሴ	anekassé
አንኳሰሰ	anekʷassäsä
አንኳኳ	anekʷakkʷa
አንዘላዘለ	anezälazzälä
አንዘረፈጠ	anezäräffäṭä
አንዘረፈፈ	anezäräffäfä
አንዘፈዘፈ	anezäfäzzäfä
አንዛረጠ	anezarräṭä
አንዛዛ	anezazza
አንዠቀዘቀ	anežäqäzzäqä
አንዠቀዠቀ	anežäqäžžäqä
አንዣበበ	anežabbäbä
አንዣባቢ	anežabbabi
አንደላቀቀ	anedälaqqäqä
አንደረበበ	anedäräbbäbä
አንደቀደቀ	anedäqäddäqä
አንደበደበ	anedäbäddäbä
አንደባለለ	anedäballälä
አንደኛ	anedäñña
አንደፋደፈ	anedäfaddäfä
አንዳች	anedačč
አንድም	anedemm
አንድነት	anedennät
አንጀረገገ	anejäräggägä
አንጀተ	anejjätä
አንገላታ	anegälatta
አንገረገበ	anegäräggäbä
አንገራገረ	anegäraggärä
አንገሸገሸ	anegäšäggäšä
አንገበገበ	anegäbäggäbä
አንገዋለለ	anegäwallälä
አንገደገደ	anegädäggädä
አንገዳገደ	anegädaggädä
አንገጫገጨ	anegäč̣aggäč̣ä
አንገፈገፈ	anegäfäggäfä
አንጋለለ	anegallälä
አንጋሬ	anegarré
አንጋደደ	anegaddädä
አንጋጋ	anegagga
አንጋፋ	anegaffa
አንግዋለለ	anegewallälä
አንጐራደደ	anegʷäraddädä
አንጐራጐረ	anegʷäraggʷärä
አንጐደጐደ	anegʷädäggʷädä
አንጓለለ	anegʷallälä
አንጕራጐረ	anegʷǝraggʷärä
አንጠራራ	aneṭärrara
አንጠራራኝ	aneṭäraraññ
አንጠራወዘ	aneṭärawwäzä
አንጥረኛ	aneṭeräñña
አንጨረፈፈ	aneč̣äräffäfä
አንጸባረቀ	aneṣäbarräqä
አንፈራገጠ	anefäraggäṭä
አንፈራፈረ	anefäraffärä
አንፈቀፈቀ	anefäqäffäqä
አንፏቀቀ	anefʷaqqäqä
አንፏቃቂ	anefʷaqqaqi
አኘከ	aññäkä
አኢሉባቦር	aʾilubbabor
አከለ	akkälä
አከላከለ	akkälakkälä
አከል	akkäl
አከመ	akkämä
አከመቻቸ	akämäčaččä
አከማቸ	akkämaččä
አከረመ	akärrämä
አከረረ	akärrärä
አከረፋ	akäräffa
አከራካሪ	akkärakari
አከራየ	akkärayyä
አከሰለ	akässälä
አከሰመ	akässämä
አከሰረ	akässärä
አከሰከሰ	akäsäkkäsä
አከሳ	akässa
አከበረ	akäbbärä
አከበደ	akäbbädä
አከባበረ	akäbabbärä
አከባበር	akkäbabär
አከተ	akkätä
አከተመ	akättämä
አከታተለ	akkätattälä
አከነነ	akännänä
አከነፈ	akännäfä
አከናነበ	akkänannäbä
አከናወ	akkännawä
አከናወነ	akkänawwänä
አከከ	akkäkä
አከድዬ	akkädeyyé
አከፈለ	akäffälä
አከፋ	akäffa
አከፋፈለ	akkäfaffälä
አከፋፋይ	akkäfafay
አካለለ	akkalälä
አካለሰ	akkalläsä
አካመረ	akkammärä
አካሚ	akkami
አካሰሰ	akkassäsä
አካበበ	akkabbäbä
አካበተ	akabbätä
አካባቢ	akkababi
አካተተ	akkattätä
አካቴ	akkaté
አካከከ	akakkäkä
አካካሰ	akkakasä
አካደነ	akkaddänä
አካፈለ	akkaffälä
አካፋ	akaffa
አካፋይ	akkafay
አክ	akk
አክለፈለፈ	akeläfälläfä
አክታ	akketa
አኮላሸ	akkolaššä
አኮመታተረ	akkomätattärä
አኮማተረ	akkomattärä
አኮረፈ	akorräfä
አኮራ	akorra
አኮራመተ	akkorammätä
አኮሰመነ	akosämmänä
አኮበለለ	akobällälä
አኰረተ	akʷärrätä
አኰሰሰ	akʷässäsä
አኰበኰበ	akʷäbäkkʷäbä
አኰቴት	akkʷätét
አኳሁዋን	akkʷahuwan
አኳሰሰ	akʷassäsä
አወለቀ	awälläqä
አወለወለ	awäläwwälä
አወለጋገደ	awwälägaggädä
አወላለቀ	awälalläqä
አወላመመ	awwälammämä
አወላከፈ	awwälakkäfä
አወላካፊ	awwälakafi
አወላወለ	awwälawwälä
አወላገደ	awwälaggädä
አወረሰ	awärräsä
አወረዛ	awäräzza
አወረደ	awärrädä
አወራ	awärra
አወራረሰ	awärarräsä
አወራረደ	awärarrädä
አወራጨ	awwärač̣ä
አወሰለተ	awäsällätä
አወሳ	awässa
አወበቀ	awäbbäqä
አወናበደ	awwänabbädä
አወናባጅ	awwänabbaj
አወናከረ	awwänakkärä
አወናፈለ	awwänaffälä
አወከ	awwäkä
አወካ	awäkka
አወዛወዘ	awwäzawwäzä
አወደለ	awäddälä
አወደመ	awäddämä
አወደሰ	awäddäsä
አወዳደረ	awwädaddärä
አወዳዳሪ	awwädadari
አወጋ	awägga
አወጣ	awäṭṭa
አወጣጣ	awwäṭaṭṭa
አወፈረ	awäffärä
አዋለደ	awwallädä
አዋላጅ	awwalaj
አዋልደጌሻ	awaledägéšša
አዋሐደ	awwaḥadä
አዋረደ	awwarrädä
አዋራ	awwara
አዋሰነ	awwassänä
አዋሰደ	awwassädä
አዋሳኝ	awwasañ
አዋሸከ	awwaššäkä
አዋቀጠ	awwaqqäṭä
አዋቃ	awwaqqa
አዋኪ	awwaki
አዋዋለ	awwawalä
አዋዋይ	awwaway
አዋዛ	awwazza
አዋየ	awwayä
አዋደደ	awwaddädä
አዋጊ	awwagi
አዋጋ	awwagga
አዋጠረ	awwaṭṭärä
አዋጣ	awwaṭṭa
አዋጪ	awwač̣i
አውለበለበ	aweläbälläbä
አውላላ	awelalla
አውራጃ	awerraja
አውሬነት	awerénnät
አውሮፓ	aweroppa
አውሮፕላን	aweroppelan
አውተረተረ	awetärättärä
አውተፈተፈ	awetäfättäfä
አውታታ	awetatta
አውደለደለ	awedäläddälä
አውድማ	awedemma
አውጫጭኝ	aweč̣ač̣č̣eññ
አዘለ	azzälä
አዘለለ	azzälälä
አዘለቀ	azälläqä
አዘለፈ	azzälläfä
አዘመመ	azämmämä
አዘመረ	azämmärä
አዘመተ	azämmätä
አዘረዘረ	azzäräzzärä
አዘረገፈ	azzäräggäfä
አዘረጋ	azzäräga
አዘረጋጋ	azzärägagga
አዘረጠ	azärräṭä
አዘረጠጠ	azzäräṭäṭä
አዘረፈ	azzärräfä
አዘራ	azzära
አዘቀዘቀ	azäqäzzäqä
አዘቀጠ	azäqqäṭä
አዘበራረቀ	azzäbärarräqä
አዘባረቀ	azzäbarräqä
አዘባነነ	azzäbannänä
አዘነ	azzänä
አዘነበ	azännäbä
አዘነበለ	azänäbbälä
አዘነጋ	azänägga
አዘነጠለ	azzänäṭṭälä
አዘናከተ	azzänakkätä
አዘናጋ	azzänagga
አዘንተኛ	azänetäñña
አዘከረ	azäkkärä
አዘከዘከ	azzäkäzzäkä
አዘወረ	azzäwwärä
አዘወተረ	azäwättärä
አዘዘ	azzäzä
አዘገመ	azäggämä
አዘገነ	azzäggänä
አዘገየ	azägäyyä
አዘገጀ	azzägäjjä
አዘጋ	azzägga
አዘጋጀ	azzägajjä
አዘጋገመ	azägaggämä
አዘጠዘጠ	azäṭäzzäṭä
አዘፈቀ	azäffäqä
አዘፈነ	azzäffänä
አዛለቀ	azzalläqä
አዛመተ	azzammätä
አዛመደ	azzammädä
አዛማች	azzamač
አዛማጅ	azzamaj
አዛቀ	azzaqä
አዛባ	azzabba
አዛነፈ	azzannäfä
አዛወረ	azzawwärä
አዛዘነ	azazzänä
አዛዥ	azzaž
አዛጋ	azzagga
አዛፈነ	azzaffänä
አዝለገለገ	azelägällägä
አዝማሚያ	azemammiya
አዝረበረበ	azeräbbärräbä
አዝረከረከ	azeräkärräkä
አዝረጠረጠ	azeräṭärräṭä
አዝረፈረፈ	azeräfärräfä
አዝናና	azenanna
አዝጎረጎረ	azegorägorrä
አዞ	azzo
አዠ	ažžä
አዠለጠ	ažžälläṭä
አዥጎረጎረ	ažegoräggorä
አዥጎደጎደ	ažegodäggodä
አዥጐረጐረ	ažegʷäräggʷärä
አየ	ayyä
አየለ	ayyälä
አየር	ayyär
አየው	ayyäw
አያ	ayya
አያሌ	ayyalé
አያያ	ayyayya
አያያዘ	ayyayazä
አያያዝ	ayyayaz
አይልም	ayelemm
አይቀርም	ayeqäremm
አይደለም	ayedälläm
አይገባኝም	ayegäbaññem
አይጥማ	ayeṭemma
አደለ	addälä
አደለበ	adälläbä
አደላ	adälla
አደላደለ	addäladdälä
አደላዳይ	addäladay
አደመ	addämä
አደመቀ	adämmäqä
አደመጠ	adämmäṭä
አደማ	adämma
አደረ	addärä
አደረሰ	adärräsä
አደረገ	addärrägä
አደረገው	adärrägäw
አደራ	adärra
አደራረግ	addäraräg
አደራደረ	addäraddärä
አደራጀ	adärajjä
አደራጅ	addäraj
አደር	addär
አደርክ	addärek
አደሰ	addäsä
አደሸደሸ	adäšäddäšä
አደቀቀ	adäqqäqä
አደበ	addäbä
አደበነ	adäbbänä
አደበዘዘ	adäbäzzäzä
አደባ	addäba
አደባለቀ	adäballäqä
አደባባይ	addäbabay
አደባየ	adäbayyä
አደብ	addäb
አደነ	addänä
አደነቀ	adännäqä
አደነቆረ	adänäqqorä
አደነዘ	adännäzä
አደነዘዘ	adänäzzäzä
አደነጋገረ	addänägaggärä
አደናቀፈ	addänaqqäfä
አደናበረ	addänabbärä
አደናባሪ	addänabari
አደናገረ	addänaggärä
አደናገጠ	addänaggäṭä
አደናጋሪ	addänagari
አደን	addän
አደንጓሬ	adänegʷarré
አደከመ	adäkkämä
አደኸየ	adäxäyyä
አደዘደዘ	adäzäddäzä
አደደበ	adäddäbä
አደገ	addägä
አደገኛ	adägäñña
አደገደ	adäggädä
አደግ	addäg
አደፈ	addäfä
አደፈረሰ	addäfäräsä
አደፈጠ	adäffäṭä
አደፋፈረ	addäfaffärä
አዱኛ	adduñña
አዲስ	addis
አዳለጠ	adalläṭä
አዳላ	addalla
አዳመረ	addammärä
አዳመቀ	addammäqä
አዳመጠ	addammäṭä
አዳሚ	addami
አዳማቂ	addammaqi
አዳም	addam
አዳምና	addamenna
አዳረሰ	addarräsä
አዳራሽ	addaraš
አዳሽ	addaš
አዳቀለ	addaqqälä
አዳቀቀ	addaqqäqä
አዳበለ	addabbälä
አዳበረ	adabbärä
አዳባይ	addabay
አዳነቀ	adannäqä
አዳኝ	addañ
አዳከመ	addakkämä
አዳወረ	adawwärä
አዳይ	adday
አዳደለ	adaddälä
አዳደሰ	adaddäsä
አዳገተ	adaggätä
አዳፈነ	adaffänä
አዳፋ	addaffa
አዳፍኔ	addafené
አድሎኛ	adeloñña
አድመኛ	ademäñña
አድረገ	aderrägä
አድራሻ	aderašša
አድበለበለ	adebäläbbälä
አድበሰበሰ	adebäsäbbäsä
አድቦለቦለ	adeboläbbolä
አድፈነፈነ	adefänäffänä
አድፋፋ	adefaffa
አዶ	addo
አዶለዶመ	adoläddomä
አጀለ	ajjälä
አጀበ	ajjäbä
አጃ	ajja
አጃቢ	ajjabi
አጃጃለ	ajjajalä
አጃገነ	ajjagänä
አጅሬ	ajjeré
አገለለ	agällälä
አገለሞተ	agälämmotä
አገለደመ	agäläddämä
አገለገለ	agällägälä
አገላበጠ	aggälabbäṭä
አገመ	aggämä
አገማ	agämma
አገሣ	agäśśa
አገረሸ	agäräššä
አገረሸበት	agäräššäbbät
አገሸሸ	agäššäšä
አገባ	agäbba
አገባብ	aggäbab
አገባት	agäbbat
አገባደደ	aggäbaddädä
አገተ	aggätä
አገነፋ	agänäffa
አገናኘ	agänaññä
አገናኝ	aggänaññ
አገናዘበ	aggänazäbä
አገናዛቢ	aggänazabi
አገኘ	agäññä
አገዘ	aggäzä
አገዝ	aggäz
አገደ	aggädä
አገደመ	agäddämä
አገደፈ	agäddäfä
አገድ	aggäd
አገገመ	agäggämä
አገጋሚ	agäggami
አገጫጨ	aggäč̣ač̣č̣ä
አጋለጠ	aggalläṭä
አጋመሰ	aggammäsä
አጋሚ	aggami
አጋማሽ	aggamaš
አጋሪ	aggari
አጋራ	aggara
አጋር	aggar
አጋሰሰ	agassäsä
አጋሰስ	agassäs
አጋበሰ	agabbäsä
አጋባ	aggabba
አጋተረ	aggattärä
አጋነነ	aggannänä
አጋኖ	agganno
አጋዛ	aggazza
አጋዥ	aggaž
አጋየ	agayyä
አጋደለ	agaddälä
አጋደመ	aggaddämä
አጋደደ	aggaddädä
አጋጅ	aggaj
አጋጋለ	aggagalä
አጋጋመ	aggagamä
አጋጠመ	aggaṭṭämä
አጋጣሚ	aggaṭami
አጋጨ	aggač̣ä
አጋፈረ	aggafärä
አጋፈጠ	aggaffäṭä
አጋፋሪ	aggafari
አግበሰበሰ	agebäsäbbäsä
አግተለተለ	agetälättälä
አግዶኝ	ageddoññ
አግጣጫ	ageṭač̣č̣a
አግፈለፈለ	agefäläffälä
አጎላመሰ	agolammäsä
አጎላማሽ	aggolamaš
አጎመዘዘ	agomäzzäzä
አጎረሰ	agorräsä
አጎራበተ	aggorabbätä
አጎት	aggot
አጎናጠፈ	aggonaṭṭäfä
አጎደለ	agoddälä
አጎፈረ	agoffärä
አጐላ	agʷälla
አጐረ	aggʷärä
አጐረና	agʷäränna
አጐራ	agʷärra
አጐሳቈለ	agʷäsaqqʷälä
አጐበደደ	agʷäbäddädä
አጐበጐበ	agʷäbäggʷäbä
አጐበጠ	agʷäbbäṭä
አጐተነ	agʷättänä
አጐነቈለ	agʷänäqqʷälä
አጐነበሰ	agʷänäbbäsä
አጐደጐደ	agʷädäggʷädä
አጓመጠ	agʷammäṭä
አጓራ	agʷarra
አጓት	aggʷat
አጓደደ	aggʷaddädä
አጓጐለ	agʷaggʷälä
አጓጓዘ	aggʷagʷazä
አጕመተመተ	agʷǝmätämmätä
አጕረመረመ	agʷǝrämärrämä
አጕረጠረጠ	agʷǝräṭärräṭä
አጕተመተመ	agʷǝtämättämä
አጠለለ	aṭällälä
አጠለቀ	aṭälläqä
አጠለቀው	aṭälläqäw
አጠመቀ	aṭämmäqä
አጠማ	aṭämma
አጠረሰ	aṭärräsä
አጠረኝ	aṭṭäräññ
አጠራ	aṭärra
አጠራቀመ	aṭṭäraqqämä
አጠቀሰ	aṭäqqäsä
አጠቃ	aṭäqqa
አጠቃለለ	aṭṭäqallälä
አጠቆረ	aṭäqqorä
አጠበቀ	aṭäbbäqä
አጠበበ	aṭäbbäbä
አጠባ	aṭäbba
አጠነባ	aṭänäbba
አጠነነ	aṭännänä
አጠነከረ	aṭänäkkärä
አጠነፈፈ	aṭänäffäfä
አጠና	aṭänna
አጠናቀረ	aṭṭänaqqärä
አጠናቀቀ	aṭṭänaqqäqä
አጠናከረ	aṭṭänakkärä
አጠናጋ	aṭänagga
አጠየቀ	aṭäyyäqä
አጠያየፈ	aṭṭäyayyäfä
አጠገበ	aṭäggäbä
አጠጋጋ	aṭṭägagga
አጠፈፈ	aṭäffäfä
አጠፋ	aṭäffa
አጣላ	aṭṭala
አጣመመ	aṭammämä
አጣመረ	aṭammärä
አጣመደ	aṭammädä
አጣራ	aṭṭara
አጣቀሰ	aṭṭaqqäsä
አጣበቀ	aṭṭabbäqä
አጣበበ	aṭṭabbäbä
አጣብቂኝ	aṭṭabeqiññ
አጣየቀ	aṭṭayyäqä
አጣደፈ	aṭṭaddäfä
አጣገበ	aṭṭaggäbä
አጣፈረ	aṭṭaffärä
አጣፈጠ	aṭaffäṭä
አጣፋ	aṭṭaffa
አጥለቀለቀ	aṭeläqälläqä
አጥላላ	aṭelalla
አጥመለመለ	aṭemälämmälä
አጥመዘመዘ	aṭemäzämmäzä
አጥበረበረ	aṭebäräbbärä
አጥናና	aṭenanna
አጥወለወለ	aṭewäläwwälä
አጥፊና	aṭefinna
አጨለመ	ač̣ällämä
አጨለገ	ač̣ällägä
አጨማለቀ	ač̣č̣ämalläqä
አጨማተረ	ač̣č̣ämattärä
አጨማደደ	ač̣č̣ämaddädä
አጨራመመ	ač̣č̣ärammämä
አጨራመደ	ač̣č̣ärammädä
አጨቀየ	ač̣äqäyyä
አጨባበጠ	ač̣č̣äbabbäṭä
አጨነቆረ	ač̣änäqqorä
አጨነጎለ	ač̣č̣änäggolä
አጨናገፈ	ač̣č̣änaggäfä
አጫረሰ	ač̣č̣arräsä
አጫረተ	ač̣č̣arrätä
አጫወተ	ač̣č̣awwätä
አጭበረበረ	ač̣ebäräbbärä
አጸለየ	aṣṣälläyä
አጸና	aṣänna
አጸየፈ	aṣṣäyyäfä
አጸያፊ	aṣṣäyyafi
አጸደቀ	aṣäddäqä
አጸዳ	aṣädda
አጽናና	aṣenanna
አፈለሰ	afälläsä
አፈለቀ	afälläqä
አፈላ	afälla
አፈረ	affärä
አፈረጠ	afärräṭä
አፈረጠው	afärräṭäw
አፈራ	afärra
አፈራረሰ	afärarräsä
አፈሰ	affäsä
አፈሰሰ	affässäsä
አፈቀረ	affäqqärä
አፈተለከ	afätälläkä
አፈታበት	afättabbät
አፈታተነ	affätattänä
አፈነ	affänä
አፈነደደ	afänäddädä
አፈነዳ	afänädda
አፈነገጠ	afänäggäṭä
አፈነፈነ	afänäffänä
አፈናቀለ	affänaqqälä
አፈናጠረ	affänaṭṭärä
አፈናጠጠ	affänaṭṭäṭä
አፈኛ	afäñña
አፈከፈ	afäkkäfä
አፈካ	afäkka
አፈዘዘ	afäzzäzä
አፈገ	affägä
አፈገመ	afäggämä
አፈገፈገ	afägäffägä
አፈፈ	affäfä
አፈፍ	afäff
አፋለመ	affallämä
አፋለሰ	affalläsä
አፋለገ	affallägä
አፋረደ	affarädä
አፋራም	affaram
አፋር	affar
አፋሰሰ	affassäsä
አፋሸገ	afaššägä
አፋቀረ	affaqqärä
አፋተለ	affattälä
አፋተገ	affattägä
አፋታ	affata
አፋኝ	affañ
አፋዘዘ	affazzäzä
አፋደሰ	afaddäsä
አፋጀ	affajjä
አፋጠነ	affaṭṭänä
አፋጠጠ	affaṭṭäṭä
አፋጣኝ	affaṭañ
አፋጨ	affač̣č̣ä
አፋፋመ	affafamä
አፍለቀለቀ	afeläqälläqä
አፍለኛ	afeläñña
አፍታታ	afetatta
አፍንጫማ	afeneč̣amma
አፍኖ	affeno
አፎካከረ	affokakkärä
አፓርትማ	apparetema
ኢትዮጲያ	iteyop̣p̣iya
ኢትዮጲያዊ	iteyop̣p̣iyawi
ኢትዮጵያዊት	iteyop̣p̣eyawit
ኢየሩሳሌም	iyyärusalém
ኢየሱሳዊ	iyyäsusawi
ኢየሱስ	iyyäsus
ኢዮቤልዩ	iyyobéleyu
ኢጣልያኛ	iṭaleyañña
ኤክዌተር	ékkewétär
እላቂ	ellaqi
እልም	ellem
እልቂት	eleqitt
እልቅ	eleqq
እልቅት	elleqet
እልቅና	eleqenna
እልባት	ellebat
እልከኛ	ellekäñña
እልክ	ellek
እልፊት	elefitt
እልፍኝ	elefeññ
እመ	emmä
እመምተኛ	emämetäñña
እመር	emmär
እመቤታችን	emmäbétaččen
እመቤት	emmäbét
እመት	emmät
እመጫት	emmäč̣at
እማሆይ	emmahoy
እሜቴ	emmété
እምር	emmer
እምስ	emmes
እምቢልተኛ	emebiletäñña
እምቢተኛ	emebitäñña
እምብዛም	emebezamm
እምቦሳ	emebossa
እምዬ	emmeyé
እሥረኛ	eśeräñña
እሥራት	eśśerat
እሥር	eśśer
እረኛ	erräñña
እረኝነት	erräññennät
እራሪ	errari
እራሽ	erraš
እርማት	erremat
እርምጃ	eremejja
እርይ	errey
እርጅና	erejenna
እርግዝና	eregezenna
እርግጠኛ	eregeṭäñña
እርግፍ	eregeff
እሮምታ	errometa
እሰይ	essäy
እሳ	essa
እሳት	essat
እሳትና	esatenna
እሳቸው	essaččäw
እስልምና	eselemenna
እስከነ	esekännä
እስከናካቴው	esekännakkatéw
እስከዚህ	esekäzzih
እስከዚያ	esekäzziya
እስፓንኛ	esepaneñña
እሸትነት	ešätennät
እሹሩሩ	eššururu
እሺ	ešši
እሽ	ešš
እሽም	eššem
እሽሩሩ	eššeruru
እሽቅድድም	ešeqededdem
እሽግ	eššeg
እቀጭታ	eqqäč̣č̣eta
እቅፍ	eqqef
እበት	ebbät
እቡይ	ebbuy
እባካችሁ	ebakkaččehu
እባክህ	ebakkeh
እባክሽ	ebakkeš
እባክዎን	ebakkewon
እባጭ	ebbač̣
እብሪተኛ	eberitäñña
እብስ	ebbess
እቴዋ	etéwwa
እትማማች	etemmamač
እትማማችነት	etemmamačennät
እትም	ettem
እትዬ	eteyyé
እትፍ	ettef
እትፍታ	ettefeta
እችግር	ečegger
እነ	ennä
እነሆ	ennäho
እነማን	ennämann
እነኋት	ennäḫʷat
እነኛ	ennäñña
እነዚያ	ennäzziya
እና	enna
እናት	ennat
እናትነት	ennatennät
እናትና	ennatenna
እንስሳነት	enesesannät
እንስትነት	enesetennät
እንቃቅላ	eneqaqella
እንቅስቃሴ	eneqesseqqasé
እንቅጥቃጤ	eneqeṭeqqaṭé
እንቆቅልሽ	eneqoqelleš
እንቆቆ	eneqoqqo
እንብርክ	eneberekk
እንትና	enetenna
እንትፍ	eneteff
እንቺ	enečči
እንክርት	enekerret
እንክብል	enekebell
እንክብካቤ	enekebekkabé
እንኮኮ	enekokko
እንደልብ	enedälebb
እንደገና	enedäggäna
እንዲሁም	enedihumm
እንጃለት	enejallät
እንጃልህ	enejalleh
እንጃልሽ	enejalleš
እንጃልኝ	enejalleññ
እንጃባቱ	enejabbatu
እንጆሪ	enejorri
እንግሊዘኛ	enegelizäñña
እንግልት	enegelett
እንግዲማ	enegedimma
እንግዲያስ	enegediyass
እንጐቻ	enegʷäčča
እንጕርጕሮ	enegʷǝreggʷǝro
እንፍሌ	enefellé
እኛ	eñña
እኝኝ	eññeññ
እኩለ	ekkulä
እኩሌታ	ekkuléta
እኩል	ekkul
እኩያ	ekkuyya
እክላም	ekkelam
እክል	ekkel
እኮ	ekko
እውልኛ	ewelleñña
እውነተኛ	ewenätäñña
እውነተኛነት	ewenätäññannät
እውነትም	ewenätemm
እዚህ	ezzih
እዚያ	ezziya
እየመጣ	eyyämäṭṭa
እየቅሉ	eyyäqelu
እየተጠና	eyätäṭänna
እያንዳንዱ	eyyanedanedu
እያደር	eyyaddär
እደሳ	eddäsa
እዳሪ	eddari
እድለ	eddelä
እድል	eddel
እድመኛ	edemäñña
እድር	edder
እድርተኛ	edderetäñña
እጀ	ejjä
እጀታ	ejjäta
እጁን	ejjun
እጄ	ejjé
እጅ	ejj
እጅብ	ejjeb
እጅና	ejjena
እጅጉን	ejjegun
እጅጌ	ejjegé
እጅግ	ejegg
እገዛ	eggäza
እገዳ	eggäda
እግረኛ	egeräñña
እግድ	egged
እጥቤ	eṭṭebbé
እጭድ	eč̣č̣ed
እፉኝት	efuññet
እፊያ	effiya
እፋሽ	effaš
እፋፊ	effafi
እፍ	eff
እፍኝ	effeñ
እፍግ	effeg
እፍግፍግ	efegefegg
እፎይ	effoy
እፎይታ	effoyeta
ከሁሉ	kähullu
ከለለ	källälä
ከለላ	källäla
ከለሰ	källäsä
ከለበ	källäbä
ከለበሰ	källäbbäsä
ከለቻ	källäčča
ከለከለ	käläkkälä
ከለፈ	källäfä
ከለፍላፋ	käläfelaffa
ከላሽ	källaš
ከላባ	källaba
ከል	käll
ከመረ	kämmärä
ከመቼ	kämäččé
ከመቼውም	kämäččéwemm
ከመከመ	kämäkkämä
ከማሪ	kämmari
ከሞላ	kämolla
ከሠተ	käśśätä
ከሠተለት	käśśätällät
ከሠተበት	käśśätäbbät
ከረመ	kärrämä
ከረረ	kärrärä
ከረበተ	käräbbätä
ከረተፈ	kärättäfä
ከረከመ	käräkkämä
ከረከረ	käräkkärä
ከረደደ	käräddädä
ከረፋ	käräffa
ከርታታ	käretatta
ከርከሮ	kärekärro
ከርዳዳ	käredadda
ከርፋፋ	käreffafa
ከሰለ	kässälä
ከሰልማ	käsälemma
ከሰመ	kässämä
ከሰረ	kässärä
ከሰሰ	kässäsä
ከሰበ	kässäbä
ከሰከሰ	käsäkkäsä
ከሲታ	kässitta
ከሳ	kässa
ከሳራ	kässara
ከሳይ	kässay
ከሸነ	käššänä
ከሸፈ	käššäfä
ከበረ	käbbärä
ከበርቴ	käbbäreté
ከበሰ	käbbäsä
ከበበ	käbbäbä
ከበተ	käbbätä
ከበደ	käbbädä
ከባዳ	käbbada
ከባድ	käbbad
ከተለበ	kätälläbä
ከተል	kättäll
ከተመ	kättämä
ከተረ	kättärä
ከተበ	kättäbä
ከተተ	kättätä
ከተከተ	kätäkkätä
ከተፈ	kättäfä
ከት	kätt
ከትቢያ	kätebbiya
ከቶ	kätto
ከቶውንም	kättowenemm
ከቸረ	käččärä
ከቸቸ	käččäčä
ከቻራ	käčarra
ከች	käčč
ከነበለ	känäbbälä
ከነቤተሰቡ	kännäbétäsäbu
ከነተረ	känättärä
ከነነ	kännänä
ከነአካቴው	kännäʾakkatéw
ከነከነ	känäkkänä
ከነዳ	känädda
ከነፈ	kännäfä
ከንቱነት	känetunnät
ከካ	käkka
ከውታታ	käwetatta
ከውካዋ	käwekawwa
ከዚህ	käzzih
ከዚህም	käzzihem
ከዚያ	käzziya
ከደነ	käddänä
ከዳ	kädda
ከዳተኛ	kädatäñña
ከጀለ	käjjälä
ከፈለ	käffälä
ከፈተ	käffätä
ከፈነ	käffänä
ከፈከፈ	käfäkkäfä
ከፈፈ	käffäfä
ከፋ	käffa
ከፋኝ	käffañ
ከፋፈለ	käfaffälä
ከፋፈተ	käfaffätä
ከፍ	käff
ከፍራራ	käferrara
ከፍተኛ	käffetäñña
ከፍታ	käffeta
ኩሊነት	kulinnät
ኩልሽት	kuleššet
ኩምትርትር	kumetereterr
ኩረጃ	kurräja
ኩራተኛ	kuratäñña
ኩራዝ	kurraz
ኩርምት	kuremett
ኩርምትምት	kuremetemett
ኩርትም	kuretemm
ኩርትምትም	kuretemetemm
ኩባያ	kubbayya
ኩብ	kubb
ኩብኩባ	kubekubba
ኩይሳ	kuyyesa
ኩፍ	kuff
ኩፍኝ	kuffeññ
ኪራየተኛ	kirayätäñña
ካባ	kabba
ካቤላ	kabélla
ካቦ	kabbo
ካቻምና	kaččamena
ካች	kačč
ካንዴላ	kanedélla
ካካ	kakka
ካውያ	kaweyya
ካደመ	kaddämä
ካዳሚ	kaddami
ካፊያ	kaffiya
ካፍያ	kaffeya
ካፒታሊዝም	kappitalizem
ካፖርት	kapporet
ኬላ	kélla
ክለሳ	kelläsa
ክልል	kellel
ክልስ	kelles
ክልብሽ	kelebešš
ክልብሽታ	kellebešeta
ክመራ	kemmära
ክምር	kemmer
ክምቹ	kemečču
ክምችት	kemeččet
ክር	kerr
ክርስትና	keresetenna
ክርክም	kerekkem
ክርክር	kerekker
ክርድ	keredd
ክርፍፍ	kerefeff
ክስ	kess
ክብ	kebb
ክብልል	kebelell
ክብርና	keberenna
ክብብ	kebebb
ክብነት	kebbennät
ክት	kett
ክትር	ketter
ክትባት	kettebat
ክትትል	ketettel
ክትካች	ketekkač
ክችች	keččeč
ክንውን	kenewwen
ክካም	kekkam
ክክ	kekk
ክው	keww
ክውትት	kewetett
ክጀላ	kejjäla
ክፉኛ	kefuñña
ክፋተኛ	kefatäñña
ክፋይ	keffay
ክፍ	keff
ክፍት	keffet
ክፍያ	kefeyya
ኮምፓስ	komepass
ኮረሸመ	koräššämä
ኮረብታማ	koräbetamma
ኮረጀ	korräjä
ኮረጠ	korräṭä
ኮራ	korra
ኮርማታ	korematta
ኮርቻ	korečča
ኮሰመነ	kosämmänä
ኮስማና	kosemanna
ኮስታራ	kosetarra
ኮሸሽ	košäšš
ኮበለለ	kobällälä
ኮተኮተ	kotäkkotä
ኮቴ	kotté
ኮትቻ	kotečča
ኮዳ	kodda
ኮፈኮፈ	kofäkkofä
ኰለለ	kʷällälä
ኰለል	kʷälläl
ኰላ	kʷälla
ኰልታፋ	kʷäletaffa
ኰልኰሎ	kʷälekʷällo
ኰመኰመ	kʷämäkkʷämä
ኰረተመ	kʷärättämä
ኰረታተመ	kʷärätattämä
ኰረኰመ	kʷäräkkʷämä
ኰረኰረ	kʷäräkkʷärä
ኰረዳ	kʷärädda
ኰረፈ	kʷärräfä
ኰረፌ	kʷärräfé
ኰሰሰ	kʷässäsä
ኰሰተረ	kʷäsättärä
ኰሰኰሰ	kʷäsäkkʷäsä
ኰሳሳ	kʷässasa
ኰሳሳነት	kʷäsasannät
ኰስታራ	kʷäsetarra
ኰስኳሳ	kʷäsekʷassa
ኰነነ	kʷännänä
ኰናኝ	kʷännañ
ኵርፈኛ	kʷǝrefäñña
ኵርፍተኛ	kʷǝrrefetäñña
ወለል	wäläll
ወለም	wälämm
ወለቀ	wälläqä
ወለወለ	wäläwwälä
ወለደ	wällädä
ወለድ	wälläd
ወለገደ	wäläggädä
ወለጋ	wälläga
ወላለቀ	wälalläqä
ወላለደ	wälallädä
ወላወለ	wälawwälä
ወላይታ	wälayetta
ወላይትኛ	wälayeteñña
ወላድ	wällad
ወልማማ	wälemmama
ወልካፋ	wälekkafa
ወልጋዳ	wälegadda
ወሎ	wällo
ወመቴ	wämmäté
ወረረ	wärrärä
ወረርሽኝ	wärärešeññ
ወረሰ	wärräsä
ወረቦ	wäräbbo
ወረተኛ	wärätäñña
ወረክራካ	wäräkerakka
ወረወረ	wäräwwärä
ወረዛ	wäräzza
ወረደ	wärrädä
ወረገኑ	wärrägänu
ወረፈ	wärräfä
ወራረደ	wärarrädä
ወራዳ	wärradda
ወራዳነት	wärraddannät
ወራፊ	wärrafi
ወሬኛ	wäréñña
ወርቃማ	wäreqamma
ወርድና	wäredenna
ወሮበላ	wärrobälla
ወሰለተ	wäsällätä
ወሰራ	wäsärra
ወሰነ	wässänä
ወሰን	wässän
ወሰንተኛ	wäsänetäñña
ወሰወሰ	wäsäwwäsä
ወሰደ	wässädä
ወሰደው	wässädäw
ወሰድ	wäsädd
ወሳኝ	wässañ
ወሳፍቻ	wässafečča
ወስላታ	wäselatta
ወስዋሳ	wäsewassa
ወሸለ	wäššälä
ወሸመ	wäššämä
ወሸቀ	wäššäqä
ወሸከተ	wäšäkkätä
ወሻቃ	wäššaqqa
ወሽመላ	wäšemälla
ወሽካታ	wäšekatta
ወቀረ	wäqqärä
ወቀሰ	wäqqäsä
ወቀሳ	wäqässa
ወቀጠ	wäqqäṭä
ወቃ	wäqqa
ወበራ	wäbärra
ወበቀ	wäbbäqä
ወባማ	wäbamma
ወቦ	wäbbo
ወተወተ	wätäwwätä
ወተፈ	wättäfä
ወተፍታፋ	wätäfetaffa
ወታደራዊ	wättaddärawi
ወታደር	wätaddär
ወታደርነት	wätaddärennät
ወታፋ	wättaffa
ወትዋታ	wätewwata
ወነበደ	wänäbbädä
ወነከረ	wänäkkärä
ወነወነ	wänäwwänä
ወነጀለ	wänäjjälä
ወንድማማችነት	wänedemmamačennät
ወንድም	wänedemm
ወንድነት	wänedennät
ወንጀለኛ	wänejäläñña
ወከለ	wäkkälä
ወከፍ	wäkkäf
ወኪል	wäkkil
ወካይ	wäkkay
ወዘተ	wäzzätä
ወዘተ\.	wäzzätä\.
ወዘወዘ	wäzäwwäzä
ወዘፈ	wäzzäfä
ወዛ	wäzza
ወዛም	wäzzam
ወዛደር	wäzaddär
ወየበ	wäyyäbä
ወየው	wäyyäw
ወያላ	wäyyala
ወይም	wäyemm
ወይስ	wäyess
ወይንማ	wäyenemma
ወዮ	wäyyo
ወዮታ	wäyyota
ወደለ	wäddälä
ወደላ	wädälla
ወደመ	wäddämä
ወደረ	wäddärä
ወደረኛ	wädäräñña
ወደቀ	wäddäqä
ወደዚህ	wädäzzih
ወደዚያ	wädäzziya
ወደደ	wäddädä
ወደድ	wäddäd
ወደጎን	wädägonn
ወዲያልኝ	wädiyalleññ
ወዳድ	wäddad
ወዳጅነት	wädajennät
ወዶ	wäddo
ወገረ	wäggärä
ወገኛ	wägäñña
ወገግ	wägägg
ወገግታ	wäggägeta
ወጋ	wägga
ወጋጋ	wägagga
ወጌሻ	wägéšša
ወጣ	wäṭṭa
ወጣራ	wäṭṭarra
ወጣትነት	wäṭṭatennät
ወጣች	wäṭačč
ወጥ	wäṭṭ
ወጭማዳ	wäč̣emadda
ወፈረ	wäffärä
ወፈር	wäfärr
ወፈፈ	wäffäfä
ወፈፌ	wäfäffé
ወፈፍተኛ	wäfäfetäñña
ወፋፈረ	wäfaffärä
ዋለለ	wallälä
ዋስትና	wasetenna
ዋሸ	waššä
ዋሻ	wašša
ዋተተ	wattätä
ዋነተኛ	wanätäñña
ዋነኛ	wannäñña
ዋና	wanna
ዋኘ	waññä
ዋዠ	wažžä
ዋጀ	wajjä
ውሀማ	wehamma
ውለኛ	weläñña
ውላቂ	wellaqi
ውላጅ	wellaj
ውል	well
ውልቃት	welleqat
ውልቅ	welleq
ውልብ	welleb
ውልታ	welleta
ውልክፍክፍ	welekefekeff
ውራ	werra
ውራጅ	werraj
ውር	werr
ውርር	werrer
ውርርድ	wererred
ውርንጭላ	wereneč̣ella
ውርጅብኝ	werejebbeññ
ውሳኔ	wessané
ውስልትና	weseletenna
ውሻ	wešša
ውሻነት	weššannät
ውሽማ	wešemma
ውቂያ	weqqiya
ውቃጭ	weqqač̣
ውቅራት	weqqerat
ውትፍ	wettef
ውነተኛ	wenätäñña
ውንብድና	wenebedenna
ውንድቢ	wenedebbi
ውከላ	wekkäla
ውክልና	wekkelenna
ውዝዋዜ	wezewwazé
ውዝፍ	wezzef
ውይባት	weyyebat
ውደሳ	weddäsa
ውዳሴ	weddasé
ውዳቂ	weddaqi
ውዴላ	weddélla
ውድ	wedd
ውድነት	weddennät
ውድድር	wededder
ውጊያ	weggiya
ውፋሬ	weffaré
ዐልቅት	ʿaleqqet
ዐመቀ	ʿammäqä
ዐመጠ	ʿammäṭä
ዐመጠኛ	ʿamäṭäñña
ዐመፀ	ʿammäẓä
ዐመፀኛ	ʿamäẓäñña
ዐሥረኛ	ʿaśeräñña
ዐሥር	ʿaśśer
ዐረቀ	ʿarräqä
ዐረበ	ʿarräbä
ዐረብኛ	ʿaräbeñña
ዐረገ	ʿarrägä
ዐረፈ	ʿarräfä
ዐራቢ	ʿarrabi
ዐቀደ	ʿaqqädä
ዐቃቢት	ʿaqqabit
ዐቃቤ	ʿaqqabé
ዐበደ	ʿabbädä
ዐበድ	ʿabbäd
ዐወቀ	ʿawwäqä
ዐወደ	ʿawwädä
ዐወደኝ	ʿawwädäññ
ዐውድማ	ʿawedemma
ዐየ	ʿayyä
ዐይናማ	ʿayenamma
ዓለመኛ	ʿalämäñña
ዓለማዊነት	ʿalämawinnät
ዕልል	ʿelell
ዕምቅ	ʿemmeq
ዕሴት	ʿessét
ዕቀዳ	ʿeqqäda
ዕቁብ	ʿeqqub
ዕቃ	ʿeqqa
ዕቅድ	ʿeqqed
ዕውር	ʿewwer
ዕውቀተኛ	ʿeweqätäñña
ዕጮኛ	ʿeč̣oñña
ዘለለ	zällälä
ዘለል	zäläll
ዘለም	zälämm
ዘለሰ	zälläsä
ዘለሰኛ	zäläsäñña
ዘለቀ	zälläqä
ዘለዘለ	zäläzzälä
ዘለግ	zälägg
ዘለግላጋ	zälägellaga
ዘለፈ	zälläfä
ዘላበደ	zälabbädä
ዘላን	zällan
ዘልዛላ	zälezzala
ዘልዛልነት	zälezallennät
ዘመመ	zämmämä
ዘመረ	zämmärä
ዘመተ	zämmätä
ዘመዘመ	zämäzzämä
ዘመዳሞች	zämädamočč
ዘማ	zämma
ዘማዊ	zämmawi
ዘረረ	zärrärä
ዘረነቀ	zärännäqä
ዘረኛ	zäräñña
ዘረከተ	zäräkkätä
ዘረክራካ	zäräkerakka
ዘረዘረ	zäräzzärä
ዘረገፈ	zäräggäfä
ዘረጋ	zärägga
ዘረፈ	zärräfä
ዘረፍራፋ	zäräferaffa
ዘራ	zärra
ዘራሽ	zärraš
ዘራፍ	zärraf
ዘርካታ	zärekatta
ዘርዛራ	zärezarra
ዘርፋፋ	zärefaffa
ዘርፍና	zärefenna
ዘቀዘቀ	zäqäzzäqä
ዘቀጠ	zäqqäṭä
ዘቅዛቃ	zäqezaqqa
ዘበለለ	zäbällälä
ዘበራረቀ	zäbärarräqä
ዘበተ	zäbbätä
ዘበነ	zäbbänä
ዘበናይነት	zäbänayennät
ዘበኛ	zäbäñña
ዘበዘበ	zäbäzzäbä
ዘበጠ	zäbbäṭä
ዘባ	zäbba
ዘባረቀ	zäbarräqä
ዘብዛባ	zäbezabba
ዘብጥያ	zäbeṭeyya
ዘነመ	zännämä
ዘነቀ	zännäqä
ዘነቆለ	zänäqqolä
ዘነበ	zännäbä
ዘነተረ	zänättärä
ዘነነ	zännänä
ዘነን	zänänn
ዘነጋ	zänägga
ዘነፈ	zännäfä
ዘና	zänna
ዘናጭ	zännač̣
ዘንባላ	zäneballa
ዘንካታ	zänekatta
ዘንፋላ	zänefalla
ዘከረ	zäkkärä
ዘከዘከ	zäkäzzäkä
ዘኬ	zäkké
ዘክዛካ	zäkezakka
ዘወረ	zäwwärä
ዘወርዋራ	zäwärewarra
ዘዋራ	zäwwarra
ዘው	zäww
ዘየረ	zäyyärä
ዘየነ	zäyyänä
ዘየደ	zäyyädä
ዘያጅ	zäyyaj
ዘዴኛ	zädéñña
ዘገምተኛ	zägämetäñña
ዘገረረ	zägärrärä
ዘገበ	zäggäbä
ዘገነ	zäggänä
ዘገነነ	zägännänä
ዘገየ	zägäyyä
ዘጋ	zägga
ዘግየት	zägeyätt
ዘጎርጓራ	zägoregʷarra
ዘጎነ	zäggonä
ዘጠነኛ	zäṭänäñña
ዘጠኝ	zäṭäññ
ዘፈቀ	zäffäqä
ዘፈነ	zäffänä
ዘፈዘፈ	zäfäzzäfä
ዘፍ	zäff
ዙጥ	zuṭṭ
ዚቀኛ	ziqäñña
ዛተለ	zattälä
ዛቻ	začča
ዛኒጋባ	zanigabba
ዛዘነ	zazzänä
ዛጎልማ	zagolemma
ዜመኛ	zémäñña
ዜንጠኛ	zéneṭäñña
ዝሊያ	zelliya
ዝላይ	zellay
ዝልል	zellel
ዝልስ	zelles
ዝመራ	zemmära
ዝሙተኛ	zemmutäñña
ዝሙት	zemmut
ዝማሬ	zemmaré
ዝም	zemm
ዝምታ	zemmeta
ዝራጭ	zerrač̣
ዝር	zerr
ዝርክርክ	zerekerekk
ዝርክት	zerekkett
ዝርዛሪ	zerezzari
ዝርዝር	zerezzer
ዝርያ	zerreya
ዝርግነት	zeregennät
ዝርግፍ	zeregeff
ዝቀታ	zeqqäta
ዝቃጭ	zeqqač̣
ዝቅ	zeqq
ዝቅተኛ	zeqqetäñña
ዝብዝብ	zebezzeb
ዝተታም	zettätam
ዝተት	zettät
ዝነኛ	zennäñña
ዝነጣ	zennäṭa
ዝና	zenna
ዝናር	zennar
ዝናቢስ	zennabis
ዝንባሌ	zenebbalé
ዝንጅብል	zenejebell
ዝንፋት	zennefat
ዝክዝክ	zekezekk
ዝውውር	zewewwer
ዝየራ	zeyyära
ዝየና	zeyyäna
ዝየዳ	zeyyäda
ዝይ	zeyy
ዝግ	zegg
ዝግተኛ	zeggetäñña
ዝግታ	zeggeta
ዝግጁ	zegejju
ዝግጅት	zegejjet
ዠለጠ	žälläṭä
ዠረር	žärärr
ዠረገገ	žäräggägä
ዠርጋዳ	žäregadda
ዠርጋጋ	žäregagga
ዠቀዠቀ	žäqäžžäqä
ዠበደ	žäbbädä
ዠበድ	žäbbäd
ዠብረር	žäberärr
ዠብራራ	žäberarra
ዥማት	žemmat
ዥዋዥዌ	žewwažewwé
ዥው	žeww
ዦፌ	žoffé
የለለው	yälälläw
የለም	yälläm
የለሽ	yälläš
የለኝም	yälläññem
የለውም	yälläwem
የሌለ	yäléllä
የሌለው	yällélläw
የሐሰት	yäḥassät
የሕግ	yäḥegg
የመረረ	yämärrärä
የመሸኛ	yämäšäñña
የሚመጣው	yämmimäṭaw
የሚበቃ	yämmibäqa
የሚዘለቅ	yämizzälläq
የሚያህል	yämmiyahel
የሚያመሰኳ	yämmiyamäsäkkʷa
የሚያሰለች	yämmiyasäläčč
የሚያስቅ	yämmiyasseq
የሚያስተኛ	yämmiyasetäñña
የሚያከራክር	yämmiyakkärakker
የሚጠልዝ	yämmiṭällez
የማን	yämann
የማዘጋጃ	yämazzägaja
የማያከራክር	yämmayakkärakker
የማያዛልቅ	yämmayazzalleq
የማይሆን	yämmayehon
የማይለወጥ	yämmayelläwwäṭ
የማይለው	yämmayeläw
የማይል	yämmayel
የማይረባ	yämmayeräba
የማይሻር	yämmayeššar
የማይቀር	yämmayeqär
የማይበቃ	yämmayebäqa
የማይበገር	yämmayebbäggär
የማይታጠፍ	yämmayetaṭṭäf
የማይጠዳው	yämmayeṭädaw
የምሩን	yämerrun
የምር	yämerr
የምስራች	yämesseračč
የረሳው	yärässaw
የረፋድ	yäräffad
የሩጫ	yäruč̣č̣a
የርሱ	yäressu
የርሳቸው	yäresaččäw
የሰራ	yässära
የሱ	yässu
የሳቸው	yässaččäw
የሸማኔ	yäšämmané
የቀረ	yäqärrä
የቀረች	yäqärräč
የቀረው	yäqärräw
የቆየ	yäqoyyä
የቈላ	yäqʷälla
የበለጠ	yäbälläṭä
የበላይነት	yäbälayennät
የበቃ	yäbäqqa
የባሰበት	yäbasäbbät
የተለቀቀ	yätäläqqäqä
የተለያየ	yätäläyayyä
የተሟላ	yätämʷalla
የተሟጠጠ	yätämʷaṭṭäṭä
የተቀደሰ	yätäqäddäsä
የተንጠለጠለ	yätäneṭäläṭṭälä
የተወለደ	yätäwwälädä
የተወሰነ	yätäwässänä
የተዛባ	yätäzabba
የተጠላ	yätäṭälla
የተጣላ	yätäṭalla
የተጣራ	yätäṭarra
የተጸውዖ	yätäṣäwweʿo
የታማ	yätamma
የትም	yätemm
የትና	yätenna
የትኛው	yäteññaw
የትየለሌ	yäteyyälälé
የነቃ	yänäqqa
የነጋዴዎች	yänäggadéwočč
የናት	yännat
የንስሐ	yänesseḥa
የአህያ	yäʾaheyya
የአየር	yäʾayyär
የአጋጣሚ	yäʾagaṭṭami
የእጅ	yäʾejj
የከበረ	yäkäbbärä
የካቲት	yäkkatit
የክት	yäkett
የኮቴ	yäkotté
የወረገኑ	yäwärrägänu
የወንድም	yäwänedemm
የዋህ	yäwwah
የዋህነት	yäwwahennät
የዝናር	yäzennar
የይ	yäyy
የደምበኛ	yädämebäñña
የደራ	yädärra
የደስደስ	yädäsedäss
የድመት	yädemmät
የገዛ	yägäzza
የጉበት	yägubbät
የጋማ	yägamma
የግሥ	yägeśś
የጎልማሶች	yägolemasočč
የጎደለበት	yägoddäläbbät
የጠለቀ	yäṭälläqä
የጠረጴዛ	yäṭäräp̣p̣éza
የጥሪ	yäṭerri
የጥቅል	yäṭeqqel
የጥያቄ	yäṭeyyaqé
የጫማ	yäč̣amma
የጭቅና	yäč̣eqqenna
የፈሰሰ	yäfässäsä
የፊታችን	yäfitaččen
የፊጥኝ	yäfiṭṭeññ
ያለ	yallä
ያለውድ	yaläwedd
ያለግምት	yalägemmet
ያልተሟላ	yaletämʷalla
ያልተወሰነ	yaletäwässänä
ያልተገራ	yaletägärra
ያልታሰበ	yaletassäbä
ያመዋል	yammäwal
ያም	yamm
ያሳማ	yassama
ያቻትና	yaččatenna
ያች	yačč
ያኔ	yanné
ያን	yann
ያንማ	yannemma
ያንን	yannen
ያኛው	yaññaw
ያውና	yawenna
ያውኮ	yawekko
ያዝ	yazz
ያደረ	yaddärä
ያገለገለ	yagäläggälä
ያጎት	yaggot
ይህም	yehemm
ይህን	yehenn
ይህኛው	yeheññaw
ይሉኝ	yeluññ
ይሉኝታ	yeluññeta
ይልቁንም	yelequnemm
ይልቁንስ	yelequness
ይልቅስ	yeleqess
ይስጠን	yeseṭänn
ይስጣኝ	yeseṭaññ
ይስጥልኝ	yeseṭeleññ
ይሻላል	yeššalal
ይብላኝ	yebelaññ
ይውልህ	yewelleh
ይግባኝ	yegebaññ
ደለለ	dällälä
ደለቀ	dälläqä
ደለበ	dälläbä
ደለኸ	dälläxä
ደለዘ	dälläzä
ደለደለ	däläddälä
ደለፈሰ	däläffäsä
ደላ	dälla
ደላላ	dällala
ደላይ	dällay
ደልቃቃ	däleqaqqa
ደልዳላ	däleddala
ደመመ	dämmämä
ደመረ	dämmärä
ደመሰሰ	dämässäsä
ደመቀ	dämmäqä
ደመና	dämmäna
ደመኛ	dämäñña
ደመወዝተኛ	dämäwäzetäñña
ደመደመ	dämäddämä
ደማ	dämma
ደማቃ	dämmaqa
ደማቅ	dämmaq
ደም	dämm
ደምበኛ	dämebäñña
ደሞ	dämmo
ደረሰ	därräsä
ደረሰለት	därräsällät
ደረሰመ	därässämä
ደረሰበት	därräsäbät
ደረሰኝ	därräsäññ
ደረቀ	därräqä
ደረበ	därräbä
ደረተ	därrätä
ደረደረ	däräddärä
ደረጀ	däräjjä
ደረገመ	däräggämä
ደራ	därra
ደራሲነት	därasinnät
ደርሽ	därrešš
ደርበብ	därebäbb
ደርባባ	därebabba
ደርካካ	därekakka
ደሰመ	dässämä
ደሰሰ	dässäsä
ደስ	däss
ደስተኛ	dässetäñña
ደስታ	dässeta
ደቀ	däqqä
ደቀለ	däqqälä
ደቀመዝሙር	däqqämäzemur
ደቀቀ	däqqäqä
ደቀነ	däqqänä
ደቀደቀ	däqäddäqä
ደቃ	däqqa
ደቃቃ	däqqaqa
ደቃቅ	däqqaq
ደቅደቂት	däqedäqqit
ደቆሰ	däqqosä
ደቆስቋሳ	däqoseqʷassa
ደቋቆሰ	däqʷaqqosä
ደበለለ	däbällälä
ደበለቀ	däbälläqä
ደበላለቀ	däbälalläqä
ደበልባላ	däbäleballa
ደበሰሰ	däbässäsä
ደበስባሳ	däbäsebassa
ደበቀ	däbbäqä
ደበበ	däbbäbä
ደበተ	däbbätä
ደበነ	däbbänä
ደበዘዘ	däbäzzäzä
ደበደበ	däbäddäbä
ደባል	däbbal
ደባቃ	däbbaqa
ደባበሰ	däbabbäsä
ደባች	däbbač
ደብሳሳ	däbesassa
ደብዛዛ	däbezazza
ደብዳቤ	däbedabbé
ደቦለቦለ	däboläbbolä
ደቦል	däbbol
ደቦልቧላ	däbolebʷalla
ደኅንነት	däḫenennät
ደነሰ	dännäsä
ደነቀ	dännäqä
ደነቀረ	dänäqqärä
ደነቀፈ	dänäqqäfä
ደነቆለ	dänäqqolä
ደነቆረ	dänäqqorä
ደነበረ	dänäbbärä
ደነበዘ	dänäbbäzä
ደነባ	dänäbba
ደነነ	dännänä
ደነዘ	dännäzä
ደነዘዘ	dänäzzäzä
ደነደነ	dänädännä
ደነገዘ	dänäggäzä
ደነገገ	dänäggägä
ደነገጠ	dänäggäṭä
ደነጎረ	dänäggorä
ደነፋ	dänäffa
ደነፋፋ	dänäffafa
ደናማ	dännamma
ደናሽ	dännaš
ደን	dänn
ደንቃፋ	däneqaffa
ደንበኛ	dänebäñña
ደንባራ	dänebarra
ደንባዛ	dänebazza
ደንደሮ	dänedärro
ደንደሳም	däneddässam
ደንደስ	dänedäss
ደንዳና	dänedanna
ደንዳኔ	dänedanné
ደንገሎ	dänegällo
ደንጉላ	dänegulla
ደንጋራ	dänegarra
ደንጋዛ	dänegazza
ደከመ	däkkämä
ደካማ	däkamma
ደኸየ	däxäyyä
ደወለ	däwwälä
ደዋይ	däwway
ደደረ	däddärä
ደደቀ	däddäqä
ደደበ	däddäbä
ደደብ	däddäb
ደጀ	däjjä
ደጃች	däjjač
ደጃፍ	däjjaf
ደጅ	däjj
ደገመ	däggämä
ደገሰ	däggäsä
ደገነ	däggänä
ደገኛ	dägäñña
ደገደገ	dägäddägä
ደገፈ	däggäfä
ደጉሰ	däggusä
ደጋደግ	däggadägg
ደጋፊ	däggafi
ደግ	dägg
ደግነቱ	däggennätu
ደግነት	däggennät
ደግዳጋ	dägedagga
ደግፍ	däggef
ደጎመ	däggomä
ደጎባ	däggoba
ደፈረ	däffärä
ደፈረሰ	däfärräsä
ደፈቀ	däffäqä
ደፈነ	däffänä
ደፈንፋና	däfänefanna
ደፈደፈ	däfäddäfä
ደፋ	däffa
ደፋር	däffar
ደፍ	däff
ዱለቻ	dulläčča
ዱለኛ	dulläñña
ዱላ	dulla
ዱርዬ	dureyyé
ዱባ	dubba
ዱቤ	dubbé
ዱብ	dubb
ዲካ	dikka
ዳለቻ	daläčča
ዳለጠ	dalläṭä
ዳሌ	dallé
ዳመነ	dammänä
ዳመና	dammäna
ዳመናማ	damännamma
ዳመናም	dammänam
ዳመጠ	dammäṭä
ዳረገ	darrägä
ዳርቻ	darečča
ዳርና	darenna
ዳሰሰ	dassäsä
ዳሸቀ	daššäqä
ዳበረ	dabbärä
ዳበሰ	dabbäsä
ዳበሳ	dabbäsa
ዳባ	dabba
ዳቦ	dabbo
ዳተኛ	datäñña
ዳንሰኛ	danesäñña
ዳንግሌ	danegellé
ዳኘ	daññä
ዳኛ	dañña
ዳኝነት	daññennät
ዳከረ	dakkärä
ዳክዬ	dakkeyyé
ዳዋ	dawwa
ዳውላ	dawella
ዳግመኛ	dagemäñña
ድህነት	dehennät
ድለላ	delläla
ድል	dell
ድልህ	delleh
ድልል	dellel
ድልኸ	dellexä
ድልኽ	dellex
ድልዝ	dellez
ድልድል	deleddel
ድሎትኛ	deloteñña
ድመራ	demmära
ድመት	demmät
ድማሪ	demmari
ድምር	demmer
ድምበረተኛ	demebärätäñña
ድምቡሼ	demebuššé
ድሪያ	derriya
ድራሹ	derrašu
ድርቅ	derreq
ድርቅና	dereqenna
ድርብ	derreb
ድርት	derret
ድርና	derenna
ድርድር	deredder
ድርጁ	derejju
ድርጅት	derejjet
ድርጊት	dereggit
ድርግም	deregemm
ድቁስ	deqqus
ድቅን	deqqenn
ድበቃ	debbäqa
ድበብ	debäbb
ድቡሽት	debbušet
ድባኖ	debbano
ድብ	debb
ድብልቅ	debelleq
ድብቅ	debbeq
ድብብቆሽ	debebbeqoš
ድብት	debbet
ድብን	debbenn
ድብኝት	debeññet
ድኅነት	deḫennät
ድንቁርና	denequrenna
ድንቄም	deneqémm
ድንቅ	denneq
ድንበረተኛ	denebärätäñña
ድንበርተኛ	denebäretäñña
ድንቡሎ	denebullo
ድንች	dennečč
ድንክዬ	denekeyyé
ድንገተኛ	denegätäñña
ድንጋጌ	deneggagé
ድንጋጤ	deneggaṭé
ድንግልና	denegellena
ድንግዝግዝ	denegezegezz
ድኝ	deññ
ድኩላ	dekkula
ድኽነት	dexennät
ድወላ	dewwäla
ድው	deww
ድውር	dewwer
ድውይ	dewwey
ድዳም	deddam
ድድ	dedd
ድድር	dedder
ድድቅ	deddeq
ድገና	deggäna
ድጋሚ	deggami
ድግስ	degges
ድግን	deggen
ድጎማ	deggoma
ድጕሳት	deggʷǝsat
ዶለተ	dollätä
ዶለዶመ	doläddomä
ዶልዷላ	doledʷalla
ዶልዷሌ	doledʷallé
ዶልዷማ	doledʷamma
ዶመኛ	domäñña
ዶኬ	dokké
ዶዮ	doyyo
ዶፈዶፈ	dofäddofä
ዶፍዷፋ	dofedʷaffa
ጀመረ	jämmärä
ጀምሮ	jämmero
ጀረገገ	järäggägä
ጀሶ	jässo
ጀበበ	jäbbäbä
ጀበደ	jäbbädä
ጀብደኛ	jäbedäñña
ጀቦነ	jäbbonä
ጀገነ	jäggänä
ጀግንነት	jägenennät
ጂጌ	jiggé
ጃኬት	jakkét
ጃዊ	jawwi
ጃውሳ	jawwesa
ጃጀ	jajjä
ጃፓናዊ	jappanawi
ጃፓን	jappan
ጅላንጅል	jelanejjel
ጅልነት	jelennät
ጅማታም	jemmatam
ጅማት	jemmat
ጅምር	jemmer
ጅብ	jebb
ጅንን	jennen
ጅዋጅዌ	jewwajewwé
ጅው	jeww
ጆንያ	joneyya
ጆፌ	joffé
ጆፍጆፌ	jofejoffé
ገሀነመ	gähannämä
ገሀነም	gähannäm
ገለል	gäläll
ገለልተኛ	gäläletäñña
ገለልተኛነት	gäläletäññanät
ገለማ	gälämma
ገለሞተ	gälämmotä
ገለበ	gälläbä
ገለበጠ	gäläbbäṭä
ገለጀጀ	gäläjjäjä
ገለጠ	gälläṭä
ገለጸ	gälläṣä
ገለፈጠ	gäläffäṭä
ገለፈፈ	gäläffäfä
ገላለጠ	gälalläṭä
ገላመጠ	gälammäṭä
ገላገለ	gälaggälä
ገልዋዳ	gälewadda
ገመለ	gämmälä
ገመምተኛ	gämämetäñña
ገመሰ	gämmäsä
ገመተ	gämmätä
ገመደ	gämmädä
ገመደለ	gämäddälä
ገመገመ	gämäggämä
ገመጠ	gämmäṭä
ገማ	gämma
ገማች	gämmač
ገምባሌ	gämeballé
ገሠሠ	gäśśäśä
ገሠጠ	gäśśäṭä
ገሠጸ	gäśśäṣä
ገረመ	gärrämä
ገረመመ	gärämmämä
ገረረ	gärrärä
ገረዘ	gärräzä
ገረደፈ	gäräddäfä
ገረጀፈ	gäräjjäfä
ገረገረ	gäräggärä
ገረገደ	gärrägädä
ገረፈ	gärräfä
ገራ	gärra
ገራም	gärram
ገርበብ	gärebäbb
ገርባባ	gärebabba
ገርጃፋ	gärejaffa
ገርጋራ	gäregarra
ገሰረ	gässärä
ገሰሰ	gässäsä
ገሰገሰ	gäsäggäsä
ገሸለጠ	gäšälläṭä
ገሸረ	gäššärä
ገሸሽ	gäšäšš
ገበረ	gäbbärä
ገበየ	gäbäyyä
ገበያተኛ	gäbäyatäñña
ገቢና	gäbinna
ገባ	gäbba
ገባር	gäbbar
ገባች	gäbačč
ገባው	gäbbaw
ገብ	gäbb
ገብጋባ	gäbeggaba
ገተረ	gättärä
ገተት	gättät
ገታ	gätta
ገታራ	gättara
ገትጋታ	gätegatta
ገቻ	gäčča
ገነባ	gänäbba
ገነተረ	gänättärä
ገነት	gännät
ገነነ	gännänä
ገነን	gännän
ገነዘ	gännäzä
ገነደሰ	gänäddäsä
ገነገነ	gänäggänä
ገነፈለ	gänäffälä
ገና	gänna
ገንባሌ	gäneballé
ገንታራ	gänetarra
ገዘተ	gäzzätä
ገዘገዘ	gäzäggäzä
ገዘፈ	gäzzäfä
ገዛ	gäzza
ገዝጋዛ	gäzegazza
ገደ	gäddä
ገደለ	gäddälä
ገደለው	gäddäläw
ገደላማ	gädälamma
ገደርዳራ	gädäredarra
ገደበ	gäddäbä
ገደገደ	gädäggädä
ገደፈ	gäddäfä
ገዳማ	gäddamma
ገዳም	gäddam
ገዳዳ	gäddada
ገዴ	gäddé
ገድ	gädd
ገድለኛ	gädeläñña
ገድጋዳ	gädegadda
ገዶኝ	gäddoññ
ገገምተኛ	gägämetäñña
ገገረ	gäggärä
ገጠገጠ	gäṭäggäṭä
ገጠጠ	gäṭṭäṭä
ገጨኸኝ	gäč̣č̣äxäññ
ገፈተረ	gäfättärä
ገፈገፈ	gäfäggäfä
ገፈፈ	gäffäfä
ገፈፋ	gäfäffa
ገፋ	gäffa
ገፋፋ	gäfaffa
ጉልላት	gullelat
ጉልማ	gulemma
ጉልበተኛ	gulebätäñña
ጉልተኛ	guletäñña
ጉልቻ	gulleča
ጉማጅ	gummaj
ጉም	gumm
ጉረሮ	gurärro
ጉረኖ	guränno
ጉረኛ	guräñña
ጉራ	gurra
ጉራሽ	gurraš
ጉራቻ	gurračča
ጉራች	gurračč
ጉራጅ	gurraj
ጉሬዛማ	gurézamma
ጉርምስና	guremessenna
ጉርብርብ	gureberebb
ጉርብትና	gurebetenna
ጉሮሮ	gurorro
ጉበት	gubbät
ጉበኛ	gubäñña
ጉብ	gubb
ጉብታ	gubbeta
ጉብዝና	gubezenna
ጉቦ	gubbo
ጉቦኛ	gubboñña
ጉተታ	guttäta
ጉትቻ	gutečča
ጉትያ	guteyya
ጉቶ	gutto
ጉያ	guyya
ጉደኛ	gudäñña
ጉዳተኛ	gudatäñña
ጉዳዩ	guddayu
ጉዳዬ	guddayé
ጉዳይ	gudday
ጉድ	gudd
ጉድለት	guddelät
ጉዶ	guddo
ጉጉት	guggut
ጋለበ	galläbä
ጋማ	gamma
ጋሜ	gammé
ጋረደ	garrädä
ጋረጠ	garräṭä
ጋራማ	garamma
ጋሬ	garré
ጋሸበ	gaššäbä
ጋሻ	gašša
ጋሼ	gaššé
ጋሽዬ	gaššeyé
ጋበዘ	gabbäzä
ጋብቻ	gabečča
ጋንድያ	ganedeyya
ጋየ	gayyä
ጋገረ	gaggärä
ጋጋ	gagga
ጋጠኝ	gaṭäññ
ጌትነት	gétennät
ጌቶች	gétočč
ጌጅ	géjj
ጌጠኛ	géṭäñña
ግለሂስ	gellähis
ግለኛ	gelläñña
ግላዊ	gellawi
ግላጭ	gellač̣
ግል	gell
ግልሙትና	gelemutenna
ግልባጭ	gellebbač̣
ግልብነት	gelebennät
ግልግል	geleggel
ግልፋፊ	geleffafi
ግልፍ	gelleff
ግልፍተኛ	gelefetäñña
ግልፍታም	gellefetam
ግማሽ	gemmaš
ግማደ	gemmadä
ግማጭ	gemmač̣
ግም	gemm
ግምል	gemmel
ግምበኛ	gemebäñña
ግምት	gemmet
ግሣዊ	geśśawi
ግሣጼ	geśśaṣé
ግሥ	geśś
ግሦች	geśśoč
ግረዛ	gerräza
ግራኝ	geraññ
ግራዋ	gerawwa
ግር	gerr
ግርዛት	gerrezat
ግርድና	geredenna
ግርድፍ	gereddef
ግርግር	gerregerr
ግርፋት	gerrefat
ግሳንግስ	gessaneges
ግስላ	gessela
ግስጋሴ	geseggasé
ግሽር	geššer
ግቢ	gebbi
ግብርና	geberenna
ግብዝ	gebbez
ግብዝና	gebezenna
ግብዣ	gebežža
ግትር	getter
ግትርትር	getereterr
ግትቻ	getečča
ግንበኛ	genebäñña
ግንኙነት	geneññunnät
ግንዛቤ	genezzabé
ግንዲላ	genedilla
ግኝት	geññet
ግዝት	gezzet
ግዞተኛ	gezotäñña
ግዥ	gežž
ግዳይ	gedday
ግዳጅ	geddaj
ግዴ	geddé
ግዴታ	geddéta
ግድ	gedd
ግድብ	geddeb
ግድያ	gedeyya
ግድግዳ	gedegedda
ግግ	gegg
ግግር	gegger
ግጥም	geṭṭemm
ግፈኛ	gefäñña
ግፊት	geffit
ግፊያ	geffiya
ጎለመሰ	golämmäsä
ጎልማሳ	golemassa
ጎመን	gommän
ጎመዘዘ	gomäzzäzä
ጎመደ	gommädä
ጎመጀ	gomäjjä
ጎሚስታ	gommiseta
ጎማ	gomma
ጎማህ	gommah
ጎማሬ	gommaré
ጎምላላ	gomelalla
ጎምዛዛ	gomezzaza
ጎረመሰ	gorämmäsä
ጎረሰ	gorräsä
ጎረበ	gorräbä
ጎረደ	gorrädä
ጎረደመ	goräddämä
ጎራረደ	gorarrädä
ጎርደድ	goredädd
ጎሸመ	goššämä
ጎሽ	gošš
ጎበበ	gobbäbä
ጎበዘ	gobbäzä
ጎታች	gottač
ጎን	gonn
ጎንደርኛ	gonedäreñña
ጎዘጎዘ	gozzäggozä
ጎዦ	gožžo
ጎደለ	goddälä
ጎደል	goddäl
ጎዳ	godda
ጎዳኒሳ	godanissa
ጎጆ	gojjo
ጎጆና	gojjona
ጎፈረ	goffärä
ጎፈር	goffär
ጎፈነነ	gofännänä
ጐለተ	gʷällätä
ጐለጐለ	gʷäläggʷälä
ጐላ	gʷälla
ጐልማማ	gʷälemamma
ጐልዳፋ	gʷäledaffa
ጐመራ	gʷämärra
ጐረበጠ	gʷäräbbäṭä
ጐረበጠኝ	gʷäräbbäṭäññ
ጐረና	gʷäränna
ጐረጐረ	gʷäräggʷärä
ጐረፈ	gʷärräfä
ጐርናና	gʷärenanna
ጐርደድ	gʷäredädd
ጐርዳዳ	gʷäredadda
ጐሰመ	gʷässämä
ጐሰረ	gʷässärä
ጐሰቈለ	gʷäsäqqʷälä
ጐሰጐሰ	gʷäsäggʷäsä
ጐስቋላ	gʷäseqʷalla
ጐበኘ	gʷäbäññä
ጐበጠ	gʷäbbäṭä
ጐባን	gʷäbban
ጐተተ	gʷättätä
ጐተጐተ	gʷätäggʷätä
ጐነቈለ	gʷänäqqʷälä
ጐነጐነ	gʷänäggʷänä
ጐነጠ	gʷännäṭä
ጐነፈ	gʷännäfä
ጐንበስ	gʷänebäss
ጐንዛላ	gʷänezalla
ጐደሪ	gʷädärri
ጐደጐደ	gʷädäggʷädä
ጐድጓዳ	gʷädegʷadda
ጐጃሜ	gʷäjjamé
ጐጃም	gʷäjjam
ጐፈየ	gʷäfäyyä
ጓሮኛ	gʷaroñña
ጓያ	gʷayya
ጓደኛ	gʷadäñña
ጓደኛሞች	gʷadäññamoč
ጓደኝነት	gʷaddäññennät
ጓድ	gʷadd
ጓጐለ	gʷaggʷälä
ጓጐረ	gʷaggʷärä
ጓጐጠ	gʷaggʷäṭä
ጓጓ	gʷaggʷa
ጓጓላ	gʷaggʷala
ጕላይ	gʷǝllay
ጕልት	gʷǝllet
ጕልቻ	gʷǝlečča
ጕሰማ	gʷǝssäma
ጕስቈላ	gʷǝseqʷälla
ጕብኝት	gʷǝbeññet
ጕተታ	gʷǝttäta
ጕትት	gʷǝttet
ጕትቻ	gʷǝtečča
ጕነጣ	gʷǝnnäṭa
ጕዞኛ	gʷǝzoñña
ጕጕ	gʷǝggʷǝ
ጕፋያ	gʷǝfayya
ጠለለ	ṭällälä
ጠለቀ	ṭälläqä
ጠለዘ	ṭälläzä
ጠለፈ	ṭälläfä
ጠላ	ṭälla
ጠል	ṭäll
ጠመመ	ṭämmämä
ጠመረረ	ṭämärrärä
ጠመሰሰ	ṭämässäsä
ጠመቀ	ṭämmäqä
ጠመዘዘ	ṭämäzzäzä
ጠመዝማዛ	ṭämäzemazza
ጠመደ	ṭämmädä
ጠምባራ	ṭämebarra
ጠምዛዛ	ṭämezazza
ጠምጣማ	ṭämeṭamma
ጠረመሰ	ṭärämmäsä
ጠረረ	ṭärrärä
ጠረሰ	ṭärräsä
ጠረቀመ	ṭäräqqämä
ጠረበ	ṭärräbä
ጠረነቀ	ṭärännäqä
ጠረዘ	ṭärräzä
ጠረገ	ṭärrägä
ጠረጴዛ	ṭäräp̣p̣éza
ጠራ	ṭärra
ጠርባባ	ṭärebabba
ጠርዛዛ	ṭärezazza
ጠሰቀ	ṭässäqä
ጠስቆ	ṭässeqo
ጠቀለለ	ṭäqällälä
ጠቀመ	ṭäqqämä
ጠቀሰ	ṭäqqäsä
ጠቀስ	ṭäqqäs
ጠቅላላ	ṭäqellala
ጠቅላላውን	ṭäqelallawen
ጠቆረ	ṭäqqorä
ጠበልተኛ	ṭäbäletäñña
ጠበሰ	ṭäbbäsä
ጠበሰቀ	ṭäbässäqä
ጠበቀ	ṭäbbäqä
ጠበበ	ṭäbbäbä
ጠበኛ	ṭäbäñña
ጠበደለ	ṭäbäddälä
ጠባ	ṭäbba
ጠባቂ	ṭäbbaqi
ጠባብ	ṭäbbab
ጠብ	ṭäbb
ጠብታ	ṭäbbeta
ጠቦት	ṭäbbot
ጠነሰሰ	ṭänässäsä
ጠነቀቀ	ṭänäqqäqä
ጠነቆለ	ṭänäqqolä
ጠነበዘ	ṭänäbbäzä
ጠነባ	ṭänäbba
ጠነነ	ṭännänä
ጠነነኝ	ṭännänäññ
ጠነዛ	ṭänäzza
ጠነፈፈ	ṭänäffäfä
ጠና	ṭänna
ጠኔ	ṭänné
ጠኔያም	ṭännéyam
ጠንቀኛ	ṭäneqäñña
ጠንቃቃ	ṭäneqaqqa
ጠንባራ	ṭänebarra
ጠንባሳ	ṭänebassa
ጠንባዛ	ṭänebazza
ጠንካራ	ṭänekkara
ጠወለገ	ṭäwällägä
ጠውላጋ	ṭäwelagga
ጠየመ	ṭäyyämä
ጠየቀ	ṭäyyäqä
ጠያር	ṭäyyar
ጠያቂ	ṭäyyaqi
ጠያፍ	ṭäyyaf
ጠይም	ṭäyyem
ጠደቀ	ṭäddäqä
ጠዳ	ṭädda
ጠጅ	ṭäjj
ጠገበ	ṭäggäbä
ጠገነ	ṭäggänä
ጠገገ	ṭäggägä
ጠጋ	ṭägga
ጠጋቢስ	ṭäggabis
ጠጋኝ	ṭäggañ
ጠጠተ	ṭäṭṭätä
ጠጠተኝ	ṭäṭṭätäññ
ጠጣ	ṭäṭṭa
ጠፈረ	ṭäffärä
ጠፈረተኛ	ṭäfärätäñña
ጠፈጠፈው	ṭäfäṭṭäfäw
ጠፈፈ	ṭäffäfä
ጠፋ	ṭäffa
ጠፍ	ṭäff
ጠፍጣፋ	ṭäfeṭaffa
ጡሌ	ṭullé
ጡል	ṭull
ጡረኛ	ṭuräñña
ጡርነት	ṭurennät
ጡብ	ṭubb
ጡንቸኛ	ṭunečäñña
ጡንቻማ	ṭunečamma
ጡጥ	ṭuṭṭ
ጢም	ṭimm
ጢሰኛ	ṭisäñña
ጢቅ	ṭiqq
ጢቅታ	ṭiqqeta
ጢን	ṭinn
ጣሰሰ	ṭassäsä
ጣጠኛ	ṭaṭäñña
ጣፈጠ	ṭaffäṭä
ጣፊያ	ṭaffiya
ጤነኛ	ṭénäñña
ጤናማ	ṭénamma
ጤናዳም	ṭénaddam
ጥለኛ	ṭeläñña
ጥላማ	ṭelamma
ጥላቻ	ṭelačča
ጥልቅ	ṭelleqq
ጥልቆ	ṭelleqo
ጥማድ	ṭemmad
ጥምልምል	ṭemelemell
ጥምር	ṭemmer
ጥምዝ	ṭemezz
ጥምጥም	ṭemeṭemm
ጥሞና	ṭemmona
ጥሩምበኛ	ṭerumebäñña
ጥሪ	ṭerri
ጥራቢ	ṭerrabi
ጥራጊ	ṭerragi
ጥር	ṭerr
ጥርቃሚ	ṭereqqami
ጥርቃሞ	ṭereqqamo
ጥርቅም	ṭereqqem
ጥርቅምአድርጎ	ṭereqemmeʾaderego
ጥርኝ	ṭereññ
ጥስቅ	ṭesseq
ጥቁም	ṭeqqum
ጥቃቅን	ṭeqaqqen
ጥቅል	ṭeqqel
ጥበቃ	ṭebbäqa
ጥበበኛ	ṭebäbäñña
ጥበት	ṭebbät
ጥቢ	ṭebbi
ጥብቅ	ṭebbeq
ጥብቅና	ṭebeqenna
ጥብቆ	ṭebbeqo
ጥብኛ	ṭebbeñña
ጥቦት	ṭebbot
ጥንቃቄ	ṭeneqqaqé
ጥንካሬ	ṭenekkaré
ጥንዚዛ	ṭenezizza
ጥየቃ	ṭeyyäqa
ጥዩፍ	ṭeyyuf
ጥያቄ	ṭeyyaqé
ጥይት	ṭeyyet
ጥይፍተኛ	ṭeyyefetäñña
ጥጃ	ṭejja
ጥገት	ṭeggät
ጥገና	ṭeggäna
ጥገኛ	ṭeggäñña
ጥገኛነት	ṭeggäññannät
ጥጋበኛ	ṭegabäñña
ጥግ	ṭegg
ጥግን	ṭeggen
ጥፊ	ṭeffi
ጥፋተኛ	ṭefatäñña
ጦልጣሏ	ṭoleṭallʷa
ጦልጧላ	ṭoleṭʷalla
ጦመኛ	ṭomäñña
ጦረኛ	ṭoräñña
ጦርነት	ṭorennät
ጦሰኛ	ṭosäñña
ጦስኝ	ṭoseññ
ጦሽ	ṭošš
ጦቢያ	ṭobbiya
ጨለመ	č̣ällämä
ጨለማ	č̣älläma
ጨለጠ	č̣älläṭä
ጨለፈ	č̣älläfä
ጨላጭ	č̣ällač̣
ጨሌ	č̣ällé
ጨመለቅ	č̣ämälläq
ጨመረ	č̣ämmärä
ጨመቀ	č̣ämmäqä
ጨመተ	č̣ämmätä
ጨመደደ	č̣ämäddädä
ጨምላቃ	č̣ämelaqqa
ጨምባሳ	č̣ämebassa
ጨምታራ	č̣ämetarra
ጨምዳዳ	č̣ämedadda
ጨረሰ	č̣ärräsä
ጨረታ	č̣ärräta
ጨረገደ	č̣äräggädä
ጨረፈ	č̣ärräfä
ጨርማማ	č̣äremamma
ጨርማታ	č̣ärematta
ጨርማዳ	č̣äremadda
ጨርሶ	č̣ärreso
ጨርጫሳ	č̣äreč̣assa
ጨቀየ	č̣äqäyyä
ጨቅላነት	č̣äqelannät
ጨቅጫቃ	č̣äqeč̣aqqa
ጨቆነ	č̣äqqonä
ጨቋኝ	č̣äqqʷañ
ጨበጠ	č̣äbbäṭä
ጨቦደ	č̣äbbodä
ጨነቀ	č̣ännäqä
ጨነገፈ	č̣änäggäfä
ጨንቋራ	č̣äneqʷarra
ጨንባሳ	č̣änebassa
ጨከነ	č̣äkkänä
ጨካኝ	č̣äkkañ
ጨዋነት	č̣äwannät
ጨውናና	č̣äwenanna
ጨገገ	č̣äggägä
ጨጓራ	č̣äggʷarra
ጨፈለቀ	č̣äfälläqä
ጨፈረ	č̣äffärä
ጨፈነ	č̣äffänä
ጨፈገገ	č̣äfäggägä
ጨፋሪ	č̣äffari
ጨፋና	č̣äffana
ጨፌ	č̣äffé
ጨፍራራ	č̣äferarra
ጨፍጋጋ	č̣äfegagga
ጩርር	č̣urerr
ጫማ	č̣amma
ጫር	č̣arr
ጫና	č̣anna
ጫን	č̣ann
ጫካ	č̣akka
ጫካማ	č̣akamma
ጫጩት	č̣ač̣utt
ጫፍና	č̣afenna
ጭለማ	č̣elläma
ጭላጭ	č̣ellač̣
ጭልጥ	č̣elleṭṭ
ጭልፊት	č̣elefitt
ጭማሪ	č̣emmari
ጭማቂ	č̣emmaqi
ጭምር	č̣emmer
ጭምት	č̣emmet
ጭራሹ	č̣errašu
ጭራሽ	č̣erraš
ጭር	č̣err
ጭርታ	č̣erreta
ጭቁን	č̣eqqun
ጭቃማ	č̣eqamma
ጭቅቅታም	č̣eqeqqetam
ጭቅቅት	č̣eqeqqet
ጭቅና	č̣eqenna
ጭቆና	č̣eqqona
ጭባጭ	č̣ebbač̣
ጭብጥ	č̣ebbeṭ
ጭብጦ	č̣ebbeṭo
ጭቦ	č̣ebbo
ጭቦኛ	č̣ebboñña
ጭንቅላታም	č̣eneqellatam
ጭንቅላት	č̣eneqqelat
ጭከና	č̣ekkäna
ጭካኔ	č̣ekkané
ጭኮ	č̣ekko
ጭው	č̣eww
ጭውውት	č̣ewwewet
ጭፈራ	č̣effära
ጭፍን	č̣effen
ጮሌ	č̣ollé
ጮረረ	č̣orrärä
ጮራ	č̣orra
ጮቤ	č̣obbé
ጳጳሳት	p̣ap̣p̣asat
ጳጳስ	p̣ap̣p̣as
ጸለየ	ṣälläyä
ጸሎተኛ	ṣälotäñña
ጸበረቀ	ṣäbärräqä
ጸነነ	ṣännänä
ጸና	ṣänna
ጸያፍ	ṣäyyaf
ጸደቀ	ṣäddäqä
ጸዳ	ṣädda
ጸጋ	ṣägga
ጸጥ	ṣäṭṭ
ጸጥተኛ	ṣäṭṭetäñña
ጸጸተ	ṣäṣṣätä
ጸጸተኛ	ṣäṣätäñña
ጽላተ	ṣellatä
ጽላት	ṣellat
ጽኑነት	ṣenunnät
ጽዋ	ṣewwa
ጽጌረዳ	ṣeggéräda
ጾመኛ	ṣomäñña
ፀሐያማ	ẓäḥayamma
ፈለሰ	fälläsä
ፈለሰመ	fälässämä
ፈለሰፈ	fälässäfä
ፈለቀ	fälläqä
ፈለቀቀ	fäläqqäqä
ፈለገ	fällägä
ፈለጠ	fälläṭä
ፈለፈለ	fäläffälä
ፈሊጠኛ	fäliṭäñña
ፈላ	fälla
ፈላሻ	fällaša
ፈላጊ	fällagi
ፈልሳሳ	fälessasa
ፈረመ	färrämä
ፈረሰ	färräsä
ፈረሰኛ	färäsäñña
ፈረሱላ	färäsulla
ፈረንሳይኛ	färänesayeñña
ፈረክራካ	färäkerakka
ፈረደ	färrädä
ፈረደለት	färrädälät
ፈረደበት	färrädäbbät
ፈረጠ	färräṭä
ፈረፈረ	färäffärä
ፈሪነት	färinnät
ፈራ	färra
ፈራሚ	färrami
ፈራረሰ	färarräsä
ፈርጣማ	färeṭamma
ፈሰሰ	fässäsä
ፈሰከ	fässäkä
ፈሰፈሰ	fäsäffäsä
ፈሳ	fässa
ፈቀቅ	fäqäqq
ፈቀደ	fäqqädä
ፈቀደው	fäqqädäw
ፈቀፈቀ	fäqäffäqä
ፈቃደኛ	fäqadäñña
ፈቃደኛነት	fäqadäññannät
ፈተለ	fättälä
ፈተሸ	fättäšä
ፈተነ	fättänä
ፈተገ	fättägä
ፈተፈተ	fätäffätä
ፈታ	fätta
ፈታሽ	fättaš
ፈታታ	fätatta
ፈታኝ	fättañ
ፈት	fätt
ፈትለክ	fäteläkk
ፈነቀለ	fänäqqälä
ፈነከተ	fänäkkätä
ፈነደቀ	fänäddäqä
ፈነዳ	fänädda
ፈነገለ	fänäggälä
ፈንዳዳ	fänedadda
ፈንጋላ	fänegalla
ፈንጠዝያ	fäneṭäzeyya
ፈንጣራ	fäneṭarra
ፈካ	fäkka
ፈወሰ	fäwwäsä
ፈዋሽ	fäwwaš
ፈዘዘ	fäzzäzä
ፈዛዛ	fäzazza
ፈየለ	fäyyälä
ፈየደ	fäyyädä
ፈጀ	fäjjä
ፈጅ	fäjj
ፈገመ	fäggämä
ፈገገ	fäggägä
ፈገፈገ	fägäffägä
ፈግጠው	fäggeṭäw
ፈጠመ	fäṭṭämä
ፈጠፈጠ	fäṭäffäṭä
ፈጸመ	fäṣṣämä
ፈጻሚ	fäṣṣami
ፉት	futt
ፉከራ	fukkära
ፉክክር	fukekker
ፉጉሎ	fugullo
ፊር	firr
ፊተኛው	fitäññaw
ፊትና	fitenna
ፊን	finn
ፊኛ	fiñña
ፊጥኝ	fiṭṭeññ
ፋነነ	fannänä
ፋንድያ	faneddeya
ፋኖ	fanno
ፋፋ	faffa
ፌዘኛ	fézzäñña
ፍለጋ	felläga
ፍላጎት	fellagot
ፍልስፍና	felesefenna
ፍልቃቂ	felleqqaqi
ፍሥሐ	feśśeḥa
ፍራሽ	ferraš
ፍራቻ	feračča
ፍሬያማ	feréyamma
ፍርምባ	feremebba
ፍርስ	ferres
ፍርጥ	ferreṭ
ፍርፋሪ	fereffari
ፍሳሽ	fessaš
ፍስስ	fesses
ፍስክ	fessek
ፍቅረኛ	feqeräñña
ፍቅፋቂ	feqeffaqi
ፍተሻ	fettäša
ፍተጋ	fettäga
ፍትወተኛ	fetewätäñña
ፍትግ	fetteg
ፍች	fečč
ፍንካች	fenekkač
ፍንክች	fenekečč
ፍንድቅ	feneddeqq
ፍየል	feyyäl
ፍዳ	fedda
ፍዳውን	feddawen
ፍጅት	fejjet
ፍግም	feggemm
ፍግፋጊ	fegeffagi
ፍጥጥ	feṭeṭṭ
ፍጹምነት	feṣṣumennät
ፎሌ	follé
ፎልፏላ	folefʷalla
ፎረሸ	forräšä
ፎቀቅ	foqqäq
ፎነነ	fonnänä
ፎከረ	fokkärä
ፎከተ	fokkätä
ፎከት	fokätt
ፓኮ	pakko
ፓፓዬ	pappayé
ፕሮፓጋንዳ	peropaganedda
ፖሊቲከኛ	politikäñña
ፖስተኛ	posetäñña
