ሀብታምነት	habǝtamǝnnät
ሀቻምና	haččamǝna
ሀች	hačč
ሁለ	hullä
ሁለመና	hullämäna
ሁለተ	hulättä
ሁለቴ	hulätte
ሁለት	hulätt
ሁሉ	hullu
ሁሉም	hullum
ሁሌ	hulle
ሁል	hull
ሁልጊዜ	hullǝgize
ሁነኛ	hunäñña
ሁከተኛ	hukätäñña
ሂስና	hisǝnna
ሃያኛ	hayañña
ሃይማኖተኛ	hayǝmanotäñña
ህላዌ	hǝllawe
ህልውና	hǝllǝwǝna
ህክምና	hǝkkǝmǝnna
ሆሳዕና	hossaʿǝna
ሆነለት	honällät
ሆነበት	honäbbät
ሆኖም	honomm
ሆጃ	hoǧǧa
ለመለመ	lämällämä
ለመሰሰ	lämässäsä
ለመነ	lämmänä
ለመዘገ	lämäzzägä
ለመደ	lämmädä
ለመጠ	lämmäṭä
ለመጥ	lämmäṭṭ
ለማ	lämma
ለማመደ	lämammädä
ለማኝ	lämmañ
ለማኝነት	lämmañǝnnät
ለማዳ	lämmada
ለማዳነት	lämmadannät
ለማጣ	lämmaṭa
ለምነት	lämǝnnät
ለሰለሰ	läsälläsä
ለሰሰ	lässäsä
ለሰነ	lässänä
ለሱ	lässu
ለሳኝ	lässañ
ለስ	läss
ለስላሳ	läsǝlassa
ለስላሳነት	läsǝlassannät
ለሸለሸ	läšälläšä
ለቀለቀ	läqälläqä
ለቀመ	läqqämä
ለቀም	läqämm
ለቀስተኛ	läqqäsǝtäñña
ለቀቀ	läqqäqä
ለቀቅ	läqqäq
ለቃቀመ	läqaqqämä
ለቅለቅ	läqǝläqq
ለቅላቂ	läqǝllaqi
ለበለበ	läbälläbä
ለበሰ	läbässä
ለበቀ	läbbäqä
ለበበ	läbbäbä
ለበደ	läbbädä
ለበጠ	läbbäṭä
ለባቃ	läbbaqqa
ለባበሰ	läbabbäsä
ለብ	läbb
ለብታ	läbbǝta
ለብቻ	läbbǝčča
ለተመ	lättämä
ለካ	läkka
ለኮሰ	läkkosä
ለኮፈ	läkkofä
ለወሰ	läwässä
ለወጠ	läwwäṭä
ለዋሳ	läwwassa
ለዘበ	läzzäbä
ለዘብተኛ	läzzäbǝtäñña
ለዛ	läzza
ለዛው	läzzaw
ለየ	läyyä
ለየብቻ	läyyäbǝčča
ለያየ	läyayyä
ለይስሙላ	läyǝsǝmulla
ለጅ	läǧǧ
ለገመ	läggämä
ለገሰ	läggäsä
ለጋ	lägga
ለጋስ	läggas
ለጋስነት	läggasǝnnät
ለግላጋ	lägǝlagga
ለጎን	lägonn
ለጎደ	läggodä
ለጐመ	läggʷämä
ለጠለጠ	läṭälläṭä
ለጫካ	läč̣akka
ለፈለፈ	läfälläfä
ለፈፈ	läffäfä
ለፋ	läffa
ሊቅነት	liqǝnnät
ላላ	lalla
ላምባ	lamǝbba
ላሸ	laššä
ላሸቀ	laššäqä
ላቂያ	laqqiya
ላቅ	laqq
ላቆጠ	laqqoṭä
ላከከ	lakkäkä
ላይኛ	layǝñña
ላጲስ	lap̣p̣is
ሌብነት	lebǝnnät
ሌጣነት	leṭannät
ልመና	lǝmmäna
ልማደኛ	lǝmadäñña
ልምምድ	lǝmǝmmǝd
ልምጥ	lǝmmǝṭṭ
ልምጭ	lǝmmǝč̣
ልሳነ	lǝssanä
ልሳን	lǝssan
ልስላሴ	lǝsǝllasse
ልስን	lǝssǝn
ልቃሚ	lǝqqami
ልቃቂ	lǝqqaqi
ልቃቂት	lǝqqaqit
ልቅ	lǝqq
ልቅም	lǝqqǝm
ልቅቅ	lǝqǝqq
ልቅነት	lǝqqǝnnät
ልበ	lǝbbä
ልቡ	lǝbbu
ልቡና	lǝbbuna
ልባም	lǝbbam
ልባሽ	lǝbbaš
ልባዊ	lǝbbawi
ልብ	lǝbb
ልብስ	lǝbbǝs
ልብቅ	lǝbbǝq
ልብዳት	lǝbbǝdat
ልብድ	lǝbbǝd
ልብጥ	lǝbbǝṭ
ልኩን	lǝkkun
ልክ	lǝkk
ልዋጭ	lǝwwač̣
ልውውጥ	lǝwǝwwǝṭ
ልዕልና	lǝʿǝlǝnna
ልዝብ	lǝzzǝb
ልዩ	lǝyyu
ልዩነት	lǝyyunnät
ልጃገረድነት	lǝǧagärädǝnnät
ልጅነት	lǝǧǝnnät
ልጉም	lǝggum
ልግመኛ	lǝgǝmäñña
ልግስና	lǝggǝsǝnna
ልጥፋት	llǝṭṭǝfat
ልጨኛ	lǝč̣č̣äñña
ልፈፋ	lǝffäfa
ልፊያ	lǝffiya
ልፋጫም	lǝffač̣am
ልፋጭ	lǝffač̣
ሎሌነት	lolennät
ሎቲ	lotti
ሐማል	ḥammal
ሐማልነት	ḥammalǝnnät
ሐሜተኛ	ḥametäñña
ሐሜት	ḥammet
ሐሰተኛ	ḥassätäñña
ሐሰት	ḥassät
ሐሳብ	ḥassab
ሐሳዌ	ḥassawe
ሐቀኛ	ḥaqqäñña
ሐቀኛነት	ḥaqqäññannät
ሐቅ	ḥaqq
ሐተተኛ	ḥatätäñña
ሐች	ḥačč
ሐካይ	ḥakkay
ሐኬተኛ	ḥaketäñña
ሐኬተኝነት	ḥaketäññǝnnät
ሐዋላ	ḥawwala
ሐዋርያነት	ḥawarǝyannät
ሐዘንተኛ	ḥazänǝtäñña
ሐዲስ	ḥaddis
ሑር	ḥurr
ሑርነት	ḥurrǝnnät
ሕመምተኛ	ḥǝmämǝttäña
ሕቅ	ḥǝqq
ሕቅታ	ḥǝqqǝta
ሕክምና	ḥǝkkǝmǝnna
ሕያውነት	ḥǝyawǝnnät
ሕገ	ḥǝggä
ሕጋዊ	ḥǝggawi
ሕጋዊነት	ḥǝggawinnät
ሕግ	ḥǝgg
ሕጓ	ḥǝggʷa
ሕፃንነት	ḥǝṣ́annǝnnät
መሀንዲስነት	mähanǝdisǝnnät
መሀከለኛ	mähakkäläñña
መሀከል	mähakkäl
መሃይም	mähayyǝm
መሃይምነት	mähayyǝmǝnnät
መለለ	mällälä
መለማመጃ	mällämamäǧa
መለሰ	mälläsä
መለቃለቂያ	mälläqaläqiya
መለኮትነት	mäläkotǝnnät
መለወጫ	mälläwäč̣č̣a
መለዮ	mälläyyo
መለጠ	mälläṭä
መላ	mälla
መላሽ	mällaš
መላክተኛ	mälakǝtäñña
መላጣነት	mälaṭannät
መልመጃ	mällǝmäǧa
መልሶ	mällǝso
መልቲነት	mälǝtinnät
መልእክተኛ	mälǝʾǝkǝtäñña
መልከኛ	mälǝkäñña
መሐለቅ	mäḥalläq
መሐላ	mäḥalla
መመሪያ	mämmäriya
መመነኛ	mämännäña
መመዘኛ	mämäzzäña
መመዝገቢያ	mämmäzǝgäbiya
መመጻደቅ	mämmäṣadäq
መማለጃ	mämmaläǧa
መምህርነት	mämǝhǝrǝnnät
መሠሪ	mäśärri
መሠሪነት	mäśärrinnät
መሠዊያ	mäśäwwiya
መሠውር	mäśäwwǝr
መሣሪያ	mäśśariya
መሥዋዕትነት	mäśǝwaʿǝtǝnnät
መረመረ	märämmärä
መረማመጃ	märrämamäǧa
መረረ	märrärä
መረረው	märräräw
መረቀ	märräqä
መረቀዘ	märäqqäzä
መረባ	märäbba
መረተ	märrätä
መረነ	märränä
መረዋ	märäwwa
መረዘ	märräzä
መረጃ	märräǧa
መረገ	märrägä
መረገጫ	märrägäč̣a
መረጋገጫ	märrägagäč̣a
መረጠ	märräṭä
መሪነት	märinnät
መራ	märra
መራራነት	märraranät
መራር	märrar
መራርነት	märrarǝnnät
መራቂ	märraqi
መራቢያ	märrabiya
መራዥ	märraž
መራገጫ	märragäč̣a
መራጭነት	märač̣ǝnnät
መር	märr
መርከበኛ	märǝkäbäñña
መርዘኛ	märǝzäñña
መሰለ	mässälä
መሰብሰቢያ	mässäbǝsäbiya
መሰነ	mässänä
መሰናዘሪያ	mässänazäriya
መሰናዶ	mässänado
መሰከረ	mäsäkkärrä
መሰከነ	mäsäkkänä
መሰኪያ	mäsäkkiya
መሰደጃ	mässädäǧa
መሰገ	mässägä
መሰጠ	mässäṭä
መሳ	mässa
መሳለሚያ	mässalämiya
መሳለቂያ	mässaläqiya
መሳጭ	mässač̣
መሳፍቻ	mässafǝčča
መስቀልኛ	mäsǝqälǝñña
መስቀልያ	mäsǝqälǝyya
መስተአምር	mäsǝtäʾammǝr
መስካሪነት	mäsǝkarinnät
መስኮብኛ	mäsǝkobǝñña
መስፈሪያ	mässǝfäriya
መሸ	mäššä
መሸለቻ	mäšälläča
መሸሸጊያ	mäššäšägiya
መሸቀጫ	mäšäqqäč̣a
መሸበቢያ	mäšäbbäbiya
መሸተ	mäššätä
መሸተኛ	mäšätäñña
መሸኛ	mäšäñña
መሸገ	mäššägä
መሸጋሸጊያ	mäššägašägiya
መሸፈቻ	mäšäffäča
መሸፈኛ	mäšäffäña
መሻገሪያ	mäššagäriya
መቀለጃ	mäqälläǧa
መቀመጫ	mäqqämäč̣a
መቀቀያ	mäqäqqäya
መቀነት	mäqännät
መቀነቻ	mäqännäča
መቀየሻ	mäqäyyäša
መቀጣጫ	mäqqäṭač̣a
መቀጫ	mäqqäč̣a
መቀጮ	mäqqäč̣o
መቃጠሪያ	mäqqaṭäriya
መቆያ	mäqoyya
መቆጣጠሪያ	mäqqoṭaṭäriya
መቆፈሪያ	mäqoffäriya
መቋቋሚያ	mäqqʷaqʷamiya
መቍጠሪያ	mäqqʷiṭäriya
መበለት	mäbällät
መበላት	mäbbälat
መበየጃ	mäbäyyäǧa
መበያ	mäbbäya
መበደሪያ	mäbbädäriya
መተላለፊያ	mättälaläfiya
መተማመኛ	mättämamäña
መተረ	mättärä
መተረቻ	mätärräča
መተረክያ	mätärräkǝya
መተተኛ	mätätäñña
መተኛ	mätäñña
መተከዣ	mätäkkäža
መተከያ	mättäkäya
መተዳደሪያ	mättädadäriya
መታ	mmäta
መታመኛ	mättamäña
መታሠሪያ	mättaśäriya
መታረቂያ	mättaräqiya
መታሰቢያ	mättasäbiya
መታሻ	mättaša
መታተረ	mätattärä
መታታ	mätatta
መታወቂያ	mättawäqiya
መታጠቂያ	mättaṭäqiya
መታጠቢያ	mättaṭäbiya
መታጠፊያ	mättaṭäfiya
መታጫ	mättač̣a
መትረየስ	mätǝräyyäs
መቶኛ	mätoñña
መቼም	mäččem
መቼውንም	mäččewǝnǝm
መነመነ	mänämmänä
መነሣት	männäśat
መነሻ	männäša
መነሾ	männäšo
መነቀረ	mänäqqärä
መነቃቀረ	mänäqaqqärä
መነተፈ	mänättäfä
መነቸከ	mänäččäkä
መነነ	männänä
መነኰሰ	mänäkkʷäsä
መነዘረ	mänäzzärä
መነዛዘረ	mänäzazzärä
መነገገ	mänäggägä
መነጥር	mänäṭṭǝr
መነጽር	mänäṣṣǝr
መና	männa
መናኛ	mänañña
መናኝ	männañ
መናገሻ	männagäša
መናፈሻ	männafäša
መንማና	mänǝmanna
መንቃራ	mänǝqarra
መንቻካ	mänǝčakka
መንደረኛ	mänǝdäräñña
መንደርተኛ	mänǝdärǝtäñña
መንገደኛ	mänǝgädäñña
መንጠቆ	mänǝṭäqqo
መንጫራ	mänǝč̣arra
መንጫቃ	mänǝč̣č̣aqqa
መንፈሳዊነት	mänǝfäsawinnät
መኖ	männo
መኝታ	mäññǝta
መከለሻ	mäkälläša
መከላከያ	mäkkälakäya
መከማቻ	mäkkämača
መከረ	mäkkärä
መከረኛ	mäkärräña
መከተ	mäkkätä
መከነ	mäkkänä
መከናነቢያ	mäkkänanäbiya
መከዳ	mäkkädda
መከፈኛ	mäkäffäña
መካች	mäkkač
መካን	mäkkan
መካንነት	mäkkanǝnnät
መካከለኛ	mäkakkäläñña
መካከል	mäkakkäl
መካከረ	mäkakkärä
መኰንን	mäkʷännǝn
መወሰኛ	mäwässäñña
መዋጮ	mäwwač̣o
መዐተኛ	mäʿatäñña
መዘመዘ	mäzämmäzä
መዘምራን	mäzämmǝran
መዘምር	mäzämmǝr
መዘበረ	mäzäbbärä
መዘባበቻ	mäzzäbabäča
መዘነ	mäzzänä
መዘክር	mäzäkkǝr
መዘውር	mäzäwwǝr
መዘዘኛ	mäzäzäñña
መዘገበ	mäzäggäbä
መዛኝ	mäzzaññ
መደለዣ	mädälläža
መደለያ	mäddäläya
መደመደ	mädämmädä
መደረቢያ	mädärräbiya
መደቆሻ	mädäqqoša
መደበ	mäddäbä
መደበኛ	mädäbäñña
መደብ	mäddäb
መደብር	mädäbbǝr
መደደ	mädäddä
መደገፊያ	mäddägäfiya
መድሃኒተኛ	mädǝhanitäñña
መድጎሚያ	mädǝggomiya
መድፈኛ	mädǝfäñña
መጀመሪያ	mäǧämmäriya
መገለ	mäggälä
መገመገ	mägämmägä
መገበ	mäggäbä
መገነዣ	mägännäža
መገጣጠሚያ	mäggäṭaṭämiya
መጋረጃ	mäggaräǧa
መጋቢ	mäggabi
መጋቢት	mäggabit
መጋዞ	mäggazo
መጋዣ	mägažža
መጎናጠፊያ	mäggonaṭäfiya
መጎናጸፊ	mäggonaṣäfi
መጓጓዣ	mäggʷagʷaža
መጠመጠ	mäṭämmäṭä
መጠነኛ	mäṭänäñña
መጠወተ	mäṭäwwätä
መጠይቅ	mäṭäyyǝq
መጥቼ	mäṭǝčče
መጨመጨ	mäč̣ämmäč̣ä
መጫኛ	mäč̣añña
መጸወተ	mäṣäwwätä
መፈተኛ	mäfättäña
መፈናፈኛ	mäffänafäña
መፈክር	mäfäkkǝr
ሙሀቻ	muhačča
ሙላጭ	mullač̣
ሙልል	mulǝll
ሙረዳ	murräda
ሙሽሪት	mušǝrrit
ሙሽራ	muššǝra
ሙትቻ	mutǝčča
ሙከራ	mukkära
ሙክት	mukkǝt
ሙክክ	mukǝkk
ሙዋለጠ	muwalläṭä
ሙዋሙዋ	muwammuwa
ሙዋርተኛ	muwarǝtäñña
ሙዋሸሸ	muwaššäšä
ሙዋጠጠ	muwaṭṭäṭä
ሙዚቀኛ	muziqäñña
ሙዝዝ	muzǝzz
ሙያሌ	muyyale
ሙያተኛ	muyatäñña
ሙዳ	mudda
ሙጃ	muǧǧa
ሙጃማ	muǧǧamma
ሙጅር	muǧǧǝr
ሙግት	muggǝt
ሙግግ	mugǝgg
ሙጥኝ	muṭṭǝññ
ሚሊዮን	milliyon
ሚዳቋ	midaqqʷa
ማለለ	mallälä
ማለቢያ	maläbbiya
ማለደ	mallädä
ማለገ	mallägä
ማላ	malla
ማላጋነት	malagannät
ማሕሌተኛ	maḥǝletäñña
ማመላለሻ	mammälaläša
ማመሻ	mammäša
ማሚቴ	mammite
ማሚቶ	mammito
ማማሰያ	mammasäya
ማምረቻና	mamǝräčanna
ማሞ	mammo
ማሞኛ	mamoñña
ማሟያ	mammʷaya
ማረረ	marrärä
ማረከ	marräkä
ማረገኛ	marägäñña
ማራቢያ	marrabiya
ማራገቢያ	marragäbiya
ማሰሻ	massäša
ማሰፊያ	massäfiya
ማሳመኛ	masammäña
ማሳተሚያ	masattämiya
ማስረጃ	masǝräǧǧa
ማስቀመጫ	masǝqämmäč̣a
ማስወረድ	masǝwärräd
ማስጠሎ	masǝṭällo
ማሸጊያ	maššägiya
ማሻሻያ	maššašaya
ማሽላ	mašǝlla
ማሾለቂያ	mašolläqiya
ማቀቀ	maqqäqä
ማቋረጫ	maqqʷaräč̣a
ማተሚያ	mattämiya
ማኅበረተኛ	maḫǝbärätäñña
ማኅበርተኛ	maḫǝbärǝtäñña
ማኅበርተኝነት	maḫǝbärǝtäññǝnnät
ማነቃቂያ	mannäqaqiya
ማናበቢያ	mannabäbiya
ማን	mann
ማንም	manǝmm
ማንኛውም	mannǝññawǝm
ማእድ	maʾǝdd
ማከፋፈያ	makkäfafäya
ማካፈል	makkafäl
ማክሰኞ	makǝsäñño
ማዋሐጃ	mawwaḥaǧa
ማዕረገኛ	maʿǝrägäñña
ማዕድ	maʿǝdd
ማዕድን	maʿǝddǝn
ማይክሮስኮፕ	mayǝkǝrosǝkopp
ማደያ	maddäya
ማዳመጫ	maddamäč̣a
ማድጋ	madǝgga
ማገረ	maggärä
ማገደ	maggädä
ማገጃ	maggäǧa
ማገጠ	maggäṭä
ማጋጣነት	magaṭannät
ማጋጭነት	magač̣ǝnnät
ማግሰኞ	magǝsäñño
ማፈኛ	maffäña
ሜዳማ	medamma
ምላሰኛ	mǝlasäñña
ምላሰኝነት	mǝlasäññǝnnät
ምላሽ	mǝllaš
ምልስ	mǝllǝs
ምልክት	mǝlǝkkǝt
ምረቃ	mǝrräqa
ምረት	mǝrrät
ምሩቅ	mǝrruq
ምሪት	mǝrrit
ምራጭ	mǝrrač̣
ምሬት	mǝrret
ምር	mǝrr
ምርምር	mǝrǝmmǝr
ምርር	mǝrǝrr
ምርቃት	mǝrrǝqat
ምርኮኛ	mǝrǝkoñña
ምርጊት	mǝrǝgitt
ምሰሶ	mǝsässo
ምሳሌ	mǝssale
ምሳር	mǝssar
ምስ	mǝss
ምስሪት	mǝssǝrit
ምስራች	mǝsǝračč
ምስኪንነት	mǝsǝkinǝnnät
ምስክር	mǝsǝkkǝr
ምስግ	mǝssǝg
ምስጢረኛ	mǝsǝṭiräñña
ምስፍና	mǝsǝfǝnna
ምሽት	mǝššǝt
ምሽግ	mǝššǝg
ምቀኛ	mǝqqäñña
ምቀኝነት	mǝqqäññǝnnät
ምትክ	mǝtǝkk
ምቹ	mǝčču
ምቹነት	mǝččunnät
ምች	mǝčč
ምቾት	mǝččot
ምነና	mǝnnäna
ምናኔ	mǝnnane
ምንም	mǝnǝmm
ምንኛ	mǝnǝñña
ምንኩስና	mǝnǝkusǝnna
ምንደኛ	mǝnǝdäñña
ምንጅላት	mǝnǝǧǝllat
ምንጠራ	mǝnǝṭṭära
ምኞት	mǝññot
ምክትል	mǝkǝttǝl
ምደባ	mǝddäba
ምድጃ	mǝdǝǧǧa
ምጥዋተኛ	mǝṭǝwatäñña
ሞለለ	mollälä
ሞለሞለ	molämmolä
ሞለጨ	molläč̣ä
ሞለፈጠ	moläffäṭä
ሞላ	molla
ሞላላ	molalla
ሞላላነት	molallannät
ሞላጫ	mollač̣č̣a
ሞልሟላ	molǝmmʷalla
ሞልቃቃ	molǝqaqqa
ሞረሞረ	morämmorä
ሞረደ	morrädä
ሞረድ	morräd
ሞሸለቀ	mošälläqä
ሞሸረ	moššärä
ሞሽላቃ	mošǝlaqqa
ሞቀሞቀ	moqämmoqä
ሞቀኝ	moqäññ
ሞቃት	moqqat
ሞቅሟቃ	moqǝmʷaqqa
ሞነተፈ	monättäfä
ሞከረ	mokkärä
ሞከተ	mokkätä
ሞከከ	mokkäkä
ሞካሪ	mokkari
ሞካች	mokkač
ሞዘዘ	mozzäzä
ሞዛዛነት	mozazannät
ሞያተኛ	moyatäñña
ሞጀረ	moǧǧärä
ሞገተ	moggätä
ሞገደኛ	mogäddäñña
ሞገገ	moggägä
ሞጋች	moggač
ሞጨለፈ	moč̣älläfä
ሞጨሞጨ	moč̣ämmoč̣ä
ሟለጠ	mʷalläṭä
ሟሟ	mʷammʷa
ሟሸሸ	mʷaššäšä
ሟከከ	mʷakkäkä
ሟጠጠ	mʷaṭṭäṭä
ሠለሰ	śälläsä
ሠለጠ	śälläṭä
ሠላጤ	śällaṭe
ሠመረ	śämmärä
ሠረሠረ	śäräśśärä
ሠረገ	śärrägä
ሠራ	śärra
ሠራተኛ	śärratäñña
ሠራው	śärraw
ሠራጊ	śärragi
ሠቀሠቀ	śäqäśśäqä
ሠቀቀ	śäqqäqä
ሠናይ	śännay
ሠወረ	śäwwärä
ሠወርዋራ	śäwärǝwarra
ሠዊ	śäwwi
ሠዋ	śäwwa
ሠዋራ	śäwwarra
ሠዓሊነት	śäʿalinnät
ሠየመ	śäyyämä
ሠያሚ	śäyyami
ሠገረ	śäggärä
ሠጋ	śägga
ሠጋር	śäggar
ሣሣ	śaśśa
ሣርማ	śarǝmma
ሥሉስ	śǝllus
ሥሉጥ	śǝlluṭ
ሥላሴ	śǝllase
ሥልጣኔ	śǝllǝṭṭane
ሥሡ	śǝśśu
ሥሥት	śǝśśǝt
ሥሥነት	śǝśǝnnät
ሥርቻ	śǝrǝčča
ሥቅቅ	śǝqǝqq
ሥያሜ	śǝyyame
ሦስተኛ	śosǝtäñña
ረመጠ	rämmäṭä
ረሰረሰ	räsärräsä
ረሳ	rässa
ረቀቀ	räqqäqä
ረቂቅነት	räqiqǝnnät
ረበረበ	räbärräbä
ረበሸ	räbbäšä
ረበበ	räbbäbä
ረባ	räbba
ረባዳ	räbbadda
ረብሸኛ	räbǝšäñña
ረታ	rätta
ረኅብተኛ	räḫǝbǝtäñña
ረከሰ	räkkäsä
ረካ	räkka
ረኸጥነት	räẖäṭǝnnät
ረዘመ	räzzämä
ረዘረዘ	räzärräzä
ረዘቀ	räzzäqä
ረዥም	räžžǝm
ረዳ	rädda
ረዳት	räddat
ረጅም	räǧǧǝm
ረገመ	räggämä
ረገበ	räggäbä
ረገብ	rägäbb
ረገጠ	räggäṭä
ረገፈ	räggäfä
ረጋ	rägga
ረጋገጠ	rägaggäṭä
ረፈረፈ	räfärräfä
ረፈደ	räffädä
ረፋድ	räffad
ሩሩ	rurru
ሩስኛ	rusǝñña
ራራ	rarra
ራብተኛ	rabǝtäñña
ርሚጦ	rǝmmiṭo
ርቀት	rǝqqät
ርችት	rǝččǝt
ርካሽ	rǝkkaš
ርክክብ	rǝkǝkkǝb
ርዝራዥ	rǝzǝrraž
ርጋጭ	rǝggač̣
ርጋፊ	rǝggafi
ሮሮ	rorro
ሰለለ	sällälä
ሰለመ	sällämä
ሰለሰለ	sälässälä
ሰለቀ	sälläqä
ሰለቀጠ	säläqqäṭä
ሰለበ	sälläbä
ሰለተ	sällätä
ሰለቸ	säläččä
ሰላ	sälla
ሰላላ	sällala
ሰላማዊነት	sälamawinnät
ሰላች	sällač
ሰላይ	sällay
ሰልካካ	sälǝkakka
ሰልፈኛ	sälǝfäñña
ሰመመ	sämmämä
ሰመጠ	sämmäṭä
ሰማ	sämma
ሰማዕትነት	sämaʿǝtǝnnät
ሰምና	sämǝnna
ሰሞንኛ	sämonǝñña
ሰረረ	särrärä
ሰረሰረ	särässärä
ሰረቀ	särräqä
ሰረዘ	särräzä
ሰረገላ	särägälla
ሰረጎደ	säräggodä
ሰራረዘ	särarräzä
ሰሰነ	sässänä
ሰቀለ	säqqälä
ሰቀቀ	säqqäqä
ሰቀቀኝ	säqqäqäññ
ሰቀዘ	säqqäzä
ሰቅ	säqq
ሰበረ	säbbärä
ሰበሰበ	säbässäbä
ሰበቀ	säbbäqä
ሰበበኛ	säbäbäñña
ሰበከ	säbbäkä
ሰባ	säbba
ሰባሰበ	säbassäbä
ሰባበረ	säbabbärä
ሰባተኛ	säbattäñña
ሰባት	säbatt
ሰባኛ	säbañña
ሰብሳባ	säbǝsabba
ሰተረ	sättärä
ሰተት	sätätt
ሰታራ	sättara
ሰነቀ	sännäqä
ሰነቀረ	sänäqqärä
ሰነበተ	sänäbbätä
ሰነበጠ	sänäbbäṭä
ሰነኘ	sänäññä
ሰነከለ	sänäkkälä
ሰነዘረ	sänäzzärä
ሰነገ	sännägä
ሰነፈ	sännäfä
ሰነፈጠ	sänäffäṭä
ሰኔና	sänenna
ሰንከሎ	sänǝkällo
ሰንካላ	sänǝkalla
ሰኞ	säñño
ሰከረ	säkkärä
ሰከሰከ	säkässäkä
ሰከነ	säkkänä
ሰካ	säkka
ሰካራም	säkkaram
ሰውነቱ	säwǝnnätu
ሰውነቱን	säwǝnnätun
ሰውነት	säwǝnnät
ሰውየው	säwǝyyäw
ሰውየውን	säwǝyyäwǝn
ሰውዬ	säwǝyye
ሰየመ	säyyämä
ሰየፈ	säyyäfä
ሰያፊ	säyyafi
ሰያፍ	säyyaf
ሰይፈኛ	säyǝfäñña
ሰደበ	säddäbä
ሰደደ	säddädä
ሰገሰገ	sägässägä
ሰገነት	sägännät
ሰገደ	säggädä
ሰገገ	säggägä
ሰጉዳት	sägguddat
ሰጐደ	säggʷädä
ሰጓዳ	sägʷadda
ሰጠ	säṭṭä
ሰጠመ	säṭṭämä
ሰፈረ	säffärä
ሰፈረተኛ	säfärätäñña
ሰፈርተኛ	säfärǝtäñña
ሰፈነ	säffänä
ሰፈፈ	säffäfä
ሰፊ	ssäfi
ሰፊው	säffiw
ሰፋ	säffa
ሰፍሳፋ	säfǝsaffa
ሱረት	surrät
ሱሪ	surri
ሱሰኛ	susäñña
ሱካር	sukkar
ሱፋጭ	suffač̣
ሲል	sill
ሲቀድ	siqädd
ሳሌ	salle
ሳሎን	sallon
ሳማ	samma
ሳምንታዊ	sammǝnǝtawi
ሳምንት	sammǝnǝt
ሳቂታ	saqqitta
ሳቅ	saqq
ሳቢያ	sabbiya
ሳንባማ	sanǝbamma
ሳይንሰኛ	sayǝnǝsäñña
ሳዱላ	sadulla
ሴረኛ	seräñña
ሴሰነ	sessänä
ሴሰኛ	sesäñña
ሴሰኛነት	sesäññannät
ሴሰኝነት	sesäññǝnnät
ሴተኛ	setäñña
ሴትነት	setǝnnät
ስለላ	sǝlläla
ስለሱ	sǝlässu
ስለዚህ	sǝläzzih
ስለዚያ	sǝläzziya
ስሌት	sǝllet
ስልም	sǝllǝm
ስልምልም	sǝlǝmǝlǝmm
ስልሳኛ	sǝlǝsañña
ስልቅ	sǝllǝq
ስልቻ	sǝllǝčča
ስልከኛ	sǝlǝkäñña
ስመኛ	sǝmäñña
ስሜት	sǝmmet
ስምም	sǝmǝmm
ስምምነት	sǝmǝmǝnnät
ስምንተኛ	sǝmǝnǝtäñña
ስምንት	sǝmmǝnǝt
ስሞተኛ	sǝmotäñña
ስረዛ	sǝrräza
ስሪያ	sǝrriya
ስርቅ	sǝrrǝq
ስርቅታ	sǝrrǝqǝta
ስርዝ	sǝrrǝz
ስቅላት	sǝqqǝlat
ስቅቅ	sǝqqǝq
ስባሪ	sǝbbari
ስብራት	sǝbbǝrat
ስብስብ	sǝbǝsǝbb
ስተተኛ	sǝtätäñña
ስትር	sǝttǝr
ስንባጭ	sǝnǝbbač̣
ስንተኛ	sǝnǝtäñña
ስንኝ	sǝnǝññ
ስንግ	sǝnnǝg
ስንጣሪ	sǝnnǝṭṭari
ስንፍና	sǝnǝfǝnna
ስኳር	sǝkkʷar
ስውር	sǝwwǝr
ስያሜ	sǝyyame
ስደተኛ	sǝddätäñña
ስደት	sǝddät
ስድ	sǝdd
ስድሳኛ	sǝdǝsañña
ስድስተኛ	sǝddǝsǝtäñña
ስድስት	sǝddǝsǝt
ስጋጃ	sǝgaǧǧa
ስግስግ	sǝgǝsǝgg
ስፋፊ	sǝffafi
ስፍስፍ	sǝfǝsǝff
ስፖርተኛ	sǝporǝtäñña
ሶመሶመ	somässommä
ሶምሶማ	somǝssoma
ሸለለ	šällälä
ሸለመ	šällämä
ሸለሸለ	šäläššälä
ሸለቀቀ	šäläqqäqä
ሸለብ	šälläbb
ሸለተ	šällätä
ሸለገ	šällägä
ሸላለመ	šälallämä
ሸላሚ	šällami
ሸላች	šällač
ሸላይ	šällay
ሸመቀ	šämmäqä
ሸመቀቀ	šämäqqäqä
ሸመተ	šämmätä
ሸመታ	šämmäta
ሸመደደ	šämäddädä
ሸመድማዳ	šämädǝmadda
ሸመገለ	šämäggälä
ሸማቂ	šämmaqi
ሸማች	šämmač
ሸማኔ	šämmane
ሸሜኔ	šämmene
ሸምቀቆ	šämǝqäqqo
ሸምቃቃ	šämǝqaqqa
ሸምበቆ	šämǝbäqqo
ሸረሞጠ	šärämmoṭä
ሸረሸረ	šäräššärä
ሸረኛ	šärräña
ሸረኝነት	šäräññǝnnät
ሸረከተ	šäräkkätä
ሸረካከተ	šäräkakkätä
ሸረደደ	šäräddädä
ሸረፈ	šärräfä
ሸራረፈ	šärarräfä
ሸር	šärr
ሸሻጊ	šäššagi
ሸቀለ	šäqqälä
ሸቀሸቀ	šäqäššäqä
ሸቀበ	šäqqäbä
ሸቀጠ	šäqqäṭä
ሸቃቢ	šäqqabi
ሸቃይ	šäqqay
ሸቃጭ	šäqqač̣
ሸበለለ	šäbällälä
ሸበሸበ	šäbäššäbä
ሸበበ	šäbbäbä
ሸበተ	šäbbätä
ሸበቶ	šäbbäto
ሸብ	šäbb
ሸብራቃ	šäbǝraqqa
ሸተተ	šättätä
ሸተተው	šättätäw
ሸተት	šätätt
ሸተትያ	šätätǝyya
ሸነሸነ	šänäššänä
ሸነቀረ	šännäqqärä
ሸነቀጠ	šänäqqäṭä
ሸነቆረ	šänäqqorä
ሸነቆጠ	šänäqqoṭä
ሸነተረ	šänättärä
ሸነታተረ	šänätattärä
ሸነከፈ	šänäkkäfä
ሸነደረ	šänäddärä
ሸነገለ	šänäggälä
ሸነጠ	šännäṭä
ሸና	šänna
ሸንበቆ	šänǝbäqqo
ሸንተረርማ	šänǝtärärǝmma
ሸንከሎ	šänǝkällo
ሸንካፋ	šänǝkkafa
ሸንዳራ	šänǝdarra
ሸኘ	šäññä
ሸኚ	šäññi
ሸከሸከ	šäkäššäkä
ሸከፈ	šäkkäfä
ሸካፋ	šäkkafa
ሸኮተ	šäkkotä
ሸውራራ	šäwǝrrara
ሸውሻዋ	šäwǝšawwa
ሸየኛ	šäyäñña
ሸጐረ	šäggʷärä
ሸጐጠ	šäggʷäṭä
ሸጠኝ	šäṭäññ
ሸፈተ	šäffätä
ሸፈነ	šäffänä
ሸፈጠ	šäffäṭä
ሸፈፈ	šäffäfä
ሸፋጭ	šäffač̣
ሸፋፈነ	šäfaffänä
ሸፍጠኛ	šäfǝṭäñña
ሹሩባ	šurrubba
ሹራብ	šurrab
ሹርቤ	šurǝbbe
ሹካ	šukka
ሹክ	šukk
ሹክክ	šukǝkk
ሺህኛ	šihǝñña
ሻምበል	šamǝbäll
ሻቀለ	šaqqälä
ሻንቅላ	šanǝqǝlla
ሻኛ	šañña
ሻከረ	šakkärä
ሻከር	šakärr
ሻገተ	šaggätä
ሻግያ	šagǝyya
ሻፈደ	šaffädä
ሽለላ	šǝlläla
ሽልማት	šǝllǝmat
ሽልም	šǝllǝm
ሽልት	šǝllǝt
ሽልግ	šǝllǝg
ሽልጦ	šǝllǝṭo
ሽመቃ	šǝmmäqa
ሽሚያ	šǝmmiya
ሽማግሌ	šǝmagǝlle
ሽምብራ	šǝmǝbǝrra
ሽምግልና	šǝmǝgǝllǝna
ሽር	šǝrr
ሽርሙጥና	šǝrǝmuṭǝnna
ሽርሽር	šǝrrǝšǝrr
ሽርክና	šǝrǝkǝnna
ሽርጥ	šǝrrǝṭ
ሽርፋት	šǝrrǝfat
ሽሽት	šǝššǝt
ሽሽግ	šǝššǝg
ሽቀላ	šǝqqäla
ሽቀባ	šǝqqäba
ሽቅብ	šǝqqǝb
ሽብልቅ	šǝbǝllǝq
ሽብር	šǝbbǝr
ሽቱ	šǝttu
ሽታ	šǝtta
ሽታው	šǝttaw
ሽቶ	šǝtto
ሽንፍላ	šǝnǝfǝlla
ሽክ	šǝkk
ሽክና	šǝkkǝna
ሽክፍ	šǝkkǝf
ሽኮኮ	šǝkokko
ሽው	šǝww
ሽውታ	šǝwwǝta
ሽያጭ	šǝyyač̣
ሽጉር	šǝggur
ሽጉጥ	šǝgguṭṭ
ሽፋች	šǝffač
ሽፍ	šǝff
ሽፍታ	šǝffǝta
ሽፍትነት	šǝfǝtǝnnät
ሽፍን	šǝffǝn
ሾለከ	šolläkkä
ሾላካ	šollaka
ሾከከ	šokkäkä
ሾጥ	šoṭṭ
ቀለለ	qällälä
ቀለል	qäläll
ቀለመ	qällämä
ቀለሰ	qälläsä
ቀለበ	qälläbä
ቀለበሰ	qäläbbäsä
ቀለብ	qälläb
ቀለብላባ	qäläbǝllaba
ቀለብተኛ	qälläbǝtäñña
ቀለደ	qällädä
ቀለጠ	qälläṭä
ቀላ	qälla
ቀላለሰ	qälalläsä
ቀላለደ	qälallädä
ቀላል	qällal
ቀላመደ	qälammädä
ቀላማጅነት	qälamaǧǧǝnnät
ቀላቢ	qällabi
ቀላወጠ	qälawwäṭä
ቀላጅ	qällaǧ
ቀልማዳ	qälǝmadda
ቀልቃላ	qälǝqalla
ቀልደኛ	qälǝdäñña
ቀልጠፍ	qälǝṭäff
ቀልጣፋ	qälǝṭaffa
ቀመለ	qämmälä
ቀመመ	qämmämä
ቀመሰ	qämmäsä
ቀመስ	qämmäs
ቀመቀመ	qämäqqämä
ቀማ	qämma
ቀማመሰ	qämammäsä
ቀማሚ	qämmami
ቀማኛ	qämmañña
ቀሠረ	qäśśärä
ቀሠፈ	qäśśäfä
ቀረ	qärrä
ቀረረ	qärrärä
ቀረሽ	qärräš
ቀረቀረ	qäräqqärä
ቀረቀበ	qäräqqäbä
ቀረበ	qärräbä
ቀረና	qäränna
ቀረደደ	qäräddädä
ቀረጠ	qärräṭä
ቀረጸ	qärräṣä
ቀረፈ	qärräfä
ቀራረመ	qärarrämä
ቀራረፈ	qärarräfä
ቀር	qärr
ቀርፋፋ	qärǝfaffa
ቀሰመ	qässämä
ቀሰረ	qässärä
ቀሰሰ	qässäsä
ቀሰስተኛ	qäsäsǝtäñña
ቀሰስተኛነት	qäsäsǝtäññannät
ቀሰቀሰ	qäsäqqäsä
ቀሰተ	qässätä
ቀሳሰመ	qäsassämä
ቀሳፈተ	qäsaffätä
ቀስ	qäss
ቀስተኛ	qäsǝtäñña
ቀስታ	qässǝta
ቀቀለ	qäqqälä
ቀቃይ	qäqqay
ቀበሌኛ	qäbäleñña
ቀበቀበ	qäbäqqäbä
ቀበተተ	qäbättätä
ቀበቶ	qäbätto
ቀበኛ	qäbäñña
ቀበዝባዛ	qäbäzǝbazza
ቀበጠ	qäbbäṭä
ቀባ	qäbba
ቀባባ	qäbabba
ቀባጀረ	qäbaǧǧärä
ቀብራራ	qäbǝrarra
ቀብቃባ	qäbǝqabba
ቀተረ	qättärä
ቀነሰ	qännäsä
ቀነቀነ	qänäqqänä
ቀነበረ	qänäbbärä
ቀነተ	qännätä
ቀነዘረ	qänäzzärä
ቀነደበ	qänäddäbä
ቀነፈ	qännäfä
ቀና	qänna
ቀናተኛ	qännatäñña
ቀናነሰ	qänannäsä
ቀን	qänn
ቀንደኛ	qänǝdäñña
ቀኖና	qännona
ቀኛዝማች	qäññazǝmač
ቀኝ	qäññ
ቀውላላ	qäwǝlalla
ቀዘቀዘ	qäzäqqäzä
ቀዘቀዘው	qäzäqqäzäw
ቀዘነ	qäzzänä
ቀዘዘ	qäzzäzä
ቀዘፈ	qäzzäfä
ቀዝቃዛ	qäzǝqazza
ቀዥቃዣ	qäžǝqažža
ቀየሠ	qäyyäśä
ቀየረ	qäyyärä
ቀየደ	qäyyädä
ቀየጠ	qäyyäṭä
ቀያሽ	qäyyaš
ቀያቴ	qäyyate
ቀያየረ	qäyayyärä
ቀያየጠ	qäyayyäṭä
ቀይ	qäyy
ቀደመ	qäddämä
ቀደምትነት	qäddämǝtǝnnät
ቀደሰ	qäddäsä
ቀደደ	qäddädä
ቀዳሚነት	qädaminnät
ቀዳሽ	qäddaš
ቀዶ	qäddo
ቀጠቀጠ	qäṭäqqäṭä
ቀጣፊነት	qäṭafinnät
ቀጨቀጨ	qäč̣äqqäč̣ä
ቀፈረረ	qäfärrärä
ቀፈቀፈ	qäfäqqäfä
ቀፈደደ	qäfäddädä
ቀፈፈ	qäffäfä
ቀፍራራ	qäfǝrrara
ቁለላ	qulläla
ቁሌት	qullet
ቁልም	qulǝmm
ቁልፍ	qullǝff
ቁማርተኛ	qumarǝtäñña
ቁማጭ	qummač̣
ቁምጥ	qummǝṭṭ
ቁምጥና	qumǝṭǝnna
ቁራሽ	qurraš
ቁራኛ	qurañña
ቁራጭ	qurrač̣
ቁር	qurr
ቁርጥምጥም	qurǝṭǝmǝṭǝmm
ቁስለኛ	qusǝläñña
ቁቅ	quqq
ቁና	qunna
ቁንን	qunnǝn
ቁንጅና	qunǝǧǝnna
ቁጥር	quṭṭǝr
ቁፈራ	quffära
ቁፋሪ	quffari
ቁፋሮ	quffaro
ቁፍር	quffǝr
ቂመኛ	qimäñña
ቂጥኝ	qiṭǝññ
ቃልቻ	qallǝčča
ቃረመ	qarrämä
ቃሬ	qarre
ቃበዘ	qabbäzä
ቃተተ	qattätä
ቃኘ	qaññä
ቃዠ	qažžä
ቄንጠኛ	qenǝṭäñña
ቅሌተኛ	qǝlletäñña
ቅሌታም	qǝlletam
ቅሌት	qǝllet
ቅልሽስሽ	qǝlǝšǝsǝšš
ቅልቅል	qǝlǝqqǝl
ቅልብ	qǝllǝb
ቅልጥ	qǝllǝṭṭ
ቅልጥፍና	qǝlǝṭǝfǝnna
ቅልጥፍጥፍ	qǝlǝṭǝffǝṭǝf
ቅመማ	qǝmmäma
ቅሚያ	qǝmmiya
ቅምምጦሽ	qǝmǝmmǝṭoš
ቅምብቻ	qǝmǝbǝčča
ቅምጥ	qǝmmǝṭ
ቅሥር	qǝśśǝr
ቅሪላ	qǝrilla
ቅሪት	qǝrrit
ቅራሪ	qǝrrari
ቅራፊ	qǝrrafi
ቅሬታ	qǝrreta
ቅር	qǝrr
ቅርጥፍ	qǝrǝṭǝff
ቅርፊት	qǝrǝfitt
ቅርፍፍ	qǝrǝfǝff
ቅስት	qǝssǝt
ቅስና	qǝssǝnna
ቅቅል	qǝqqǝl
ቅበላ	qǝbbäla
ቅባቅዱስ	qǝbaqǝddus
ቅብብል	qǝbǝbbǝl
ቅብብሎሽ	qǝbǝbbǝloš
ቅነሳ	qǝnnäsa
ቅናሽ	qǝnnaš
ቅንብር	qǝnǝbbǝr
ቅንነት	qǝnǝnnät
ቅንዝረኛ	qǝnǝzǝräñña
ቅንዲላ	qǝnǝdilla
ቅንፍ	qǝnnǝf
ቅኝ	qǝññ
ቅኝት	qǝññǝt
ቅዝቃዜ	qǝzǝqqaze
ቅዝዝ	qǝzzǝz
ቅዥቅዥ	qǝžǝqǝžž
ቅየሣ	qǝyyäśa
ቅያሜ	qǝyyame
ቅያሪ	qǝyyari
ቅይድ	qǝyyǝd
ቅይጥ	qǝyyǝṭ
ቅዱሳን	qǝddusan
ቅዱስ	qǝddus
ቅዱስነት	qǝddusǝnnät
ቅዳሴ	qǝddase
ቅዳጅ	qǝddaǧ
ቅድ	qǝdd
ቅድም	qǝddǝm
ቅድሳት	qǝddǝsat
ቅድስተ	qǝddǝsǝtä
ቅድስት	qǝddǝsǝt
ቅድስና	qǝddǝsǝna
ቅጅ	qǝǧǧ
ቅጠልያ	qǝṭälǝyya
ቅጥረኛ	qǝṭǝräñña
ቅጥቃጤ	qǝṭǝqqaṭe
ቅፍር	qǝfǝrr
ቅፍርር	qǝfǝrǝrr
ቆለለ	qollälä
ቆለመመ	qolämmämä
ቆለኛ	qolläñña
ቆላ	qolla
ቆሌ	qolle
ቆልማማ	qolǝmamma
ቆልቋላ	qolǝqʷalla
ቆመጠ	qommäṭä
ቆም	qomm
ቆራረሰ	qorarräsä
ቆራጥ	qorraṭ
ቆርቆሮ	qorǝqorro
ቆርጦኝ	qorǝṭoññ
ቆሸሸ	qoššäšä
ቆሽማዳ	qošǝmadda
ቆነጀ	qonäǧǧä
ቆነጣጠረ	qonäṭṭaṭṭärä
ቆየ	qoyyä
ቆይታ	qoyyǝta
ቆጠቆጠ	qoṭäqqoṭä
ቆጶስ	qop̣p̣os
ቆፈረ	qoffärä
ቆፈነነ	qofännänä
ቆፋሪ	qoffari
ቆፋፈረ	qofaffärä
ቈለመመ	qʷälämmämä
ቈለቈለ	qʷäläqqʷälä
ቈለፈ	qʷälläfä
ቈላለፈ	qʷälalläfä
ቈላፋ	qʷällaffa
ቈላፍ	qʷällaf
ቈረመደ	qʷärämmädä
ቈረሰ	qʷärräsä
ቈረቈረ	qʷäräqqʷärä
ቈረቈሰ	qʷäräqqʷäsä
ቈረበ	qʷärräbä
ቈረጠ	qʷärräṭä
ቈረፈደ	qʷäräffädä
ቈራ	qʷärra
ቈራረጠ	qʷärarräṭä
ቈራጥ	qʷärraṭ
ቈርማዳ	qʷärǝmadda
ቈርቈዘ	qʷärǝqqʷäzä
ቈርቋዛ	qʷärǝqqʷaza
ቈርፋዳ	qʷärǝfadda
ቈሰለ	qʷässälä
ቈሰቈሰ	qʷäsäqqʷäsä
ቈነሰ	qʷännäsä
ቈነነ	qʷännänä
ቈነደደ	qʷänäddädä
ቈነጐለ	qʷänäggʷälä
ቈንቋና	qʷänǝqʷanna
ቋመጠ	qʷammäṭä
ቋቅ	qʷaqq
ቋቅታ	qʷaqqǝtta
ቋቍቻ	qʷaqqʷičča
ቋያ	qʷayya
ቋጥኝ	qʷaṭṭǝññ
ቍልጭ	qʷillǝč̣č̣
ቍራጭ	qʷirrač̣
ቍርጥ	qʷirrǝṭ
ቍስለ	qʷisǝllä
በለቀጠ	bäläqqäṭä
በለተ	bällätä
በለኝ	bäläññ
በለዘ	bälläzä
በለገ	bällägä
በለጠ	bälläṭä
በሉጥ	bälluṭ
በሊታ	bällita
በላ	bälla
በሌለበት	bälelläbät
በል	bäll
በመጀመሪያው	bämäǧämmäriyaw
በሞላ	bämolla
በረሃማ	bärähamma
በረረ	bärrärä
በረቀ	bärräqä
በረቀሰ	bäräqqäsä
በረቃቀሰ	bäräqaqqäsä
በረበረ	bäräbbärä
በረታ	bärätta
በረኛ	bärräñña
በረከተ	bäräkkätä
በረኸኛ	bäräẖäñña
በረዘ	bärräzä
በረደ	bärrädä
በረደኝ	bärrädäññ
በረገደ	bäräggädä
በረገገ	bäräggägä
በረጋገደ	bärägaggädä
በራ	bärra
በራረዘ	bärarräzä
በራዥ	bärraž
በራድ	bärrad
በራፍ	bärraf
በር	bärr
በርበሬ	bärǝbärre
በርካታ	bärǝkatta
በርዳማ	bärǝdamma
በርጩማ	bärǝč̣umma
በሰለ	bässälä
በሰበሰ	bäsäbbäsä
በሰፊው	bäsäffiw
በሳ	bässa
በሳል	bässal
በስባሳ	bäsǝbassa
በሶ	bässo
በሸቀ	bäššäqä
በሸቀጠ	bäšäqqäṭä
በሽተኛ	bäššǝtäñña
በሽታ	bäššǝta
በቀለ	bäqqälä
በቀለኛ	bäqäläñña
በቀል	bäqqäl
በቀስ	bäqäss
በቀስታ	bäqässǝta
በቀተ	bäqqätä
በቀደም	bäqäddäm
በቃ	bäqqa
በቃኝ	bäqqañ
በቅበቃ	bäqǝbäqqa
በቆሎ	bäqqollo
በቈልት	bäqqʷälǝt
በቡጢ	bäbuṭṭi
በተለይ	bätäläyy
በተረፈ	bätärräfä
በተነ	bättänä
በተጨማሪ	bätäč̣ämmari
በታተነ	bätattänä
በትር	bättǝr
በነነ	bännänä
በአጋጣሚ	bäʾagaṭṭami
በከለ	bäkkälä
በከተ	bäkkätä
በኩል	bäkkul
በካይ	bäkkay
በወዘ	bäwwäzä
በዘበዘ	bäzäbbäzä
በዚህ	bäzzih
በዚህም	bäzihǝmm
በዚያ	bäzziya
በዛ	bäzza
በየሰዓቱ	bäyyäsäʿatu
በየቀኑ	bäyyäqänu
በየተራ	bäyyätära
በየነ	bäyyänä
በየወቅቱ	bäyyäwäqǝtu
በየዓመቱ	bäyyäʿamätu
በየደ	bäyyädä
በየጊዜው	bäyyägizew
በየግል	bäyyägǝll
በየፊናው	bäyyäfinaw
በያለበት	bäyyalläbbät
በያኝ	bäyyaññ
በያጅ	bäyyaǧ
በደለ	bäddälä
በደለኛ	bädäläñña
በደል	bäddäl
በደዊ	bädäwwi
በዱላ	bädulla
በዳ	bädda
በዳይ	bädday
በድጋሚ	bädǝggami
በጀ	bäǧǧä
በጅምር	bäǧǝmmǝr
በገነ	bäggänä
በገዛ	bägäzza
በግላጭ	bägǝllač̣
በግል	bägǝll
በግምት	bägǝmmǝt
በግድ	bägǝdd
በጐ	bäggʷä
በጐነት	bäggʷännät
በጠቅላላ	bäṭäqǝlalla
በጠቅላላው	bäṭäqǝlallaw
በጠበጠ	bäṭäbbäṭä
በጡጫ	bäṭuč̣č̣a
በጥሞና	bäṭǝmmona
በጥያቄ	bäṭǝyyaqe
በጥፊ	bäṭǝffi
በጭራሽ	bäč̣ǝrraš
በጭካኔ	bäč̣ǝkkane
በጭፍን	bäč̣ǝffǝn
ቡላ	bulla
ቡልቅ	bullǝqq
ቡልቅታ	bullǝqǝta
ቡረቃ	burräqa
ቡራቡሬ	burraburre
ቡራኬ	burrake
ቡሬ	burre
ቡሬማ	burremma
ቡቃያ	buqayya
ቡቡ	bubbu
ቡትርፍ	butǝrǝff
ቡችላ	buččǝlla
ቡና	bunna
ቡናማ	bunnamma
ቡናኝ	bunnañ
ቡን	bunn
ቡንኝ	bunnǝññ
ቡዳነት	budannät
ቡድስ	buddǝs
ቡድነት	budǝnnät
ቡግ	bugg
ቡፍ	buff
ቢሆንም	bihonǝmm
ቢላዋ	billawa
ቢላዎ	billawo
ቢል	bill
ቢልቢላ	bilǝbilla
ቢራቢሮ	birrabirro
ቢዘገይም	bizägäyyǝm
ባለሥልጣኖች	baläśǝlǝṭanočč
ባለሳምንት	baläsammǝnǝt
ባለስድስት	baläsǝddǝsǝt
ባለብር	baläbǝrr
ባለእጅ	baläʾǝǧǧ
ባለጅ	baläǧǧ
ባለገ	ballägä
ባለጉዳይ	balägudday
ባለጌነት	balägennät
ባለጠጋ	baläṭägga
ባለጥግ	baläṭǝgg
ባለፀጋ	baläṣ́ägga
ባላ	balla
ባላባት	balabbat
ባላባትነት	balabbatǝnnät
ባላንጣነት	balanǝṭannät
ባልትና	balǝtǝnna
ባልና	balǝnna
ባልንጀርነት	balǝnǝǧärǝnnät
ባልጩት	balǝč̣utt
ባረቀ	barräqä
ባረከ	barräkä
ባርማሽላ	barǝmašǝlla
ባርነት	barǝnnät
ባሻ	bašša
ባባ	babba
ባነነ	bannänä
ባንድነት	banǝdǝnnät
ባኞ	bañño
ባከነ	bakkänä
ባዘቀ	bazzäqä
ባዘተ	bazzätä
ቤተኛ	betäñña
ቤዛ	bezza
ብላታ	bǝlatta
ብላቴና	bǝlattena
ብላቴን	bǝlatten
ብላጊ	bǝllagi
ብልሃተኛ	bǝlǝhatäñña
ብልሹ	bǝlǝššu
ብልት	bǝllǝt
ብልኮ	bǝllǝkko
ብልዝ	bǝllǝzz
ብልግ	bǝllǝgg
ብልግና	bǝlǝgǝnna
ብልጥግና	bǝlǝṭǝggǝnna
ብልጫ	bǝllǝč̣a
ብልጭ	bǝllǝč̣
ብልጭታ	bǝllǝč̣ǝta
ብልፅግና	bǝlǝṣ́ǝggǝnna
ብሎት	bǝllot
ብሔረተኛ	bǝḥerätäñña
ብሕትውና	bǝḥǝtǝwǝnna
ብረድስት	bǝräddǝsǝt
ብራ	bǝrra
ብራቢሮ	bǝrabirro
ብራና	bǝranna
ብራኳ	bǝrakkʷa
ብር	bǝrr
ብርሌ	bǝrǝlle
ብርቅስቅስ	bǝrǝqǝsǝqqǝs
ብርኩማ	bǝrǝkumma
ብርካቴ	bǝrǝkkate
ብርግድ	bǝrǝgǝdd
ብርጭቆ	bǝrǝč̣ǝqqo
ብስባሽ	bǝsǝbbaš
ብስጭትጭት	bǝsǝč̣ǝtǝč̣č̣ǝt
ብቁነት	bǝqqunnät
ብቅ	bǝqq
ብቡ	bǝbbu
ብብት	bǝbbǝt
ብትቶ	bǝtǝtto
ብትቷም	bǝtǝttʷam
ብትን	bǝttǝn
ብቸኛ	bǝččäñña
ብቸኝነት	bǝččäññǝnnät
ብቻ	bǝčča
ብናኝ	bǝnnaññ
ብኩርና	bǝkurǝnna
ብኩንነት	bǝkunǝnnät
ብካች	bǝkkač
ብክል	bǝkkǝl
ብክት	bǝkkǝt
ብው	bǝww
ብየዳ	bǝyyädda
ብያኔ	bǝyyane
ብዬ	bǝyye
ብይ	bǝyy
ብይን	bǝyyǝn
ብይድ	bǝyyǝd
ብድር	bǝddǝr
ብድግ	bǝdǝgg
ብጥብጥ	bǝṭǝbbǝṭ
ቦሎቄ	bolloqe
ቦረቀ	borräqä
ቦረቦረ	boräbborä
ቦራቂ	borraqi
ቦርቃቃ	borǝqaqqa
ቦቃማ	boqamma
ቦተረፈ	botärräfä
ቦታ	botta
ቦነነ	bonnänä
ቦከቦከ	bokäbbokä
ቦካ	bokka
ቦዘነ	bozzänä
ቦዘንተኛ	bozänǝtäñña
ቦደሰ	boddäsä
ቦግ	bogg
ቦግታ	boggǝta
ቦጨቅ	boč̣č̣äq
ቦጫጨረ	boč̣č̣ač̣ärä
ቦጭ	boč̣č̣
ቧገተ	bʷaggätä
ተለመ	tällämä
ተለመለመ	tälämällämä
ተለመሰሰ	tälämässäsä
ተለመነ	tälämmänä
ተለመዘገ	tälämäzzägä
ተለመደ	tälämmädä
ተለመጠ	tälämmäṭä
ተለማመነ	tälämammänä
ተለማመደ	tälämammädä
ተለማመጠ	tälämammäṭä
ተለማኝ	tälämmañ
ተለማጅ	tälämmaǧ
ተለማጭ	tälämmač̣
ተለሰነ	tälässänä
ተለሳለሰ	täläsalläsä
ተለቀ	tälläqä
ተለቀለቀ	täläqälläqä
ተለቀመ	täläqqämä
ተለቀቀ	tälläqqäqä
ተለቃለቀ	täläqalläqä
ተለበለበ	täläbälläbä
ተለበቀ	täläbbäqä
ተለበበ	täläbbäbä
ተለበደ	täläbbädä
ተለበጠ	täläbbäṭä
ተለባቂ	täläbbaqi
ተለባበሰ	täläbabbäsä
ተለተለ	tälättälä
ተለተመ	tälättämä
ተለወጠ	täläwwäṭä
ተለዋወጠ	täläwawwäṭä
ተለዋጭ	täläwwač̣
ተለየ	täläyyä
ተለያየ	täläyayyä
ተለጠለጠ	täläṭälläṭä
ተለፈፈ	täläffäfä
ተለፋለፈ	täläfalläfä
ተለፋላፊ	täläfallafi
ተላ	tälla
ተላለቀ	tälalläqä
ተላለፈ	tälalläfä
ተላላኪነት	tälalakinnät
ተላላፊ	tälallafi
ተላመደ	tälammädä
ተላመጠ	tälammäṭä
ተላቀሰ	tälaqqäsä
ተላቀቀ	tälaqqäqä
ተላከከ	tälakkäkä
ተላወሰ	tälawässä
ተላፋ	tälaffa
ተልከስከሰ	tälǝkäsǝkkäsä
ተልከፈከፈ	tälǝkäfäkkäfä
ተልካሳ	tälǝkassa
ተልፈሰፈሰ	tälǝfäsäffäsä
ተመለሰ	tämälläsä
ተመለከ	tämälläkä
ተመለከተ	tämäläkkätä
ተመለጠ	tämälläṭä
ተመላለሰ	tämälalläsä
ተመላለጠ	tämälalläṭä
ተመላሽ	tämällaš
ተመላኪ	tämällaki
ተመመ	tämmämä
ተመሠረተ	tämäśśärätä
ተመሠጠ	tämmäśśäṭä
ተመሥጦ	tämäśśǝṭo
ተመረመረ	tämärämmärä
ተመረረ	tämärrärä
ተመረቀ	tämärräqä
ተመረኰዘ	tämäräkkʷäzä
ተመረዘ	tämärräzä
ተመረገ	tämärrägä
ተመረጠ	tämärräṭä
ተመራ	tämärra
ተመራመረ	tämärammärä
ተመራቂ	tämärraqi
ተመራጭ	tämärrač̣
ተመራጭነት	tämärrač̣ǝnnät
ተመሰለ	tämässälä
ተመሰቃቀለ	tämäsäqaqqälä
ተመሰከረ	tämäsäkkärä
ተመሰገነ	tämäsäggänä
ተመሰጠ	tämässäṭä
ተመሳቀለ	tämäsaqqälä
ተመሳከረ	tämäsakkärä
ተመተመ	tämättämä
ተመተረ	tämättärä
ተመታ	tämätta
ተመቸ	tämäččä
ተመቻቸ	tämäčaččä
ተመነ	tämmänä
ተመነቃቀረ	tämänäqaqqärä
ተመነተፈ	tämänättäfä
ተመነዘረ	tämänäzzärä
ተመናቀረ	tämänaqqärä
ተመኘ	tämäññä
ተመከረ	tämäkkärä
ተመከተ	tämäkkätä
ተመካ	tämäkka
ተመካከረ	tämäkakkärä
ተመዘመዘ	tämäzämmäzä
ተመዘበረ	tämäzäbbärä
ተመዘነ	tämäzzänä
ተመዘዘ	tämäzzäzä
ተመዘገበ	tämäzäggäbä
ተመዛዘነ	tämäzazzänä
ተመደበ	tämäddäbä
ተመገበ	tämäggäbä
ተመጋቢ	tämäggabbi
ተመጠወተ	tämäṭäwwätä
ተመጻደቀ	tämäṣaddäqä
ተማለደ	tämallädä
ተማመነ	tämammänä
ተማማ	tämamma
ተማረረ	tämarrärä
ተማረከ	tämarräkä
ተማረዘ	tämarräzä
ተማራ	tämarra
ተማሰለ	tämassälä
ተማታ	tämatta
ተማከረ	tämakkärä
ተማዘዘ	tämazzäzä
ተማገረ	tämaggärä
ተማገደ	tämaggädä
ተምቦጫቦጨ	tämǝboč̣abboč̣ä
ተምታታ	tämǝtatta
ተምነሸነሸ	tämǝnäšännäšä
ተምዘአዘገ	tämǝzäʾazzägä
ተምዘገዘገ	tämǝzägäzzägä
ተሞለጨ	tämolläč̣ä
ተሞላ	tämolla
ተሞላቀቀ	tämolaqqäqä
ተሞላፈጠ	tämolaffäṭä
ተሞረደ	tämorrädä
ተሞሸለቀ	tämošälläqä
ተሞሸረ	tämoššärä
ተሞከረ	tämokkärä
ተሞከተ	tämokkätä
ተሞካከረ	tämokakkärä
ተሞክሮ	tämokkǝro
ተሞጀረ	tämoǧǧärä
ተሞገሰ	tämoggäsä
ተሞጋሽ	tämoggaš
ተሞጋገሰ	tämogaggäsä
ተሞጨለፈ	tämoč̣älläfä
ተሟላ	tämʷalla
ተሟሸ	tämʷaššä
ተሟከረ	tämʷakkärä
ተሟገተ	tämʷaggätä
ተሟጋች	tämʷaggač
ተሠረሠረ	täśäräśśärä
ተሠረገ	täśärrägä
ተሠቀሠቀ	täśäqäśśäqä
ተሠወረ	täśäwwärä
ተሠዋሪ	täśäwwari
ተሠየመ	täśäyyämä
ተሣሠረ	täśaśśärä
ተረማመደ	tärämammädä
ተረሳ	tärässa
ተረሳሳ	täräsassa
ተረበ	tärräbä
ተረበረበ	täräbärräbä
ተረበኛ	täräbäñña
ተረባረበ	täräbarräbä
ተረተ	tärrätä
ተረተረ	tärättärä
ተረታ	tärätta
ተረኛ	täräñña
ተረከበ	täräkkäbä
ተረከከ	täräkkäkä
ተረካቢ	täräkkabi
ተረካከበ	täräkakkäbä
ተረኰሰ	täräkkʷäsä
ተረዳ	tärädda
ተረዳዳ	tärädadda
ተረገመ	täräggämä
ተረገረገ	tärägärrägä
ተረገዘ	täräggäzä
ተረገጠ	täräggäṭä
ተረጋጋ	tärägagga
ተረጐመ	täräggʷämä
ተረፈ	tärräfä
ተራመደ	tärammädä
ተራረመ	tärarrämä
ተራረደ	tärarrädä
ተራራማ	täraramma
ተራቀቀ	täraqqäqä
ተራቢ	tärrabi
ተራባ	tärabba
ተራች	tärrač
ተራኪ	tärraki
ተራኰተ	tärakkʷätä
ተራገመ	täraggämä
ተራገጠ	täraggäṭä
ተራገፈ	täraggäfä
ተርመሰመሰ	tärǝmäsämmäsä
ተርመጠመጠ	tärǝmäṭämmäṭä
ተርበተበተ	tärǝbätäbbätä
ተርበደበደ	tärǝbädäbbädä
ተርከፈከፈ	tärǝkäfäkkäfä
ተርካካ	tärǝkakka
ተርገበገበ	tärǝgäbäggäbä
ተሰለለ	täsällälä
ተሰለቀ	täsälläqä
ተሰለበ	täsälläbä
ተሰለቸ	täsäläččä
ተሰለቻቸ	täsäläčaččä
ተሰለፈ	täsälläfä
ተሰላቸ	täsälaččä
ተሰላፊ	täsällafi
ተሰሚነት	täsäminnät
ተሰማ	täsämma
ተሰማማ	täsämamma
ተሰረረ	täsärrärä
ተሰረሰረ	täsärässärä
ተሰረቀ	täsärräqä
ተሰረነቀ	täsärännäqä
ተሰረዘ	täsärräzä
ተሰረጐደ	täsäräggʷäddä
ተሰራረቀ	täsärarräqä
ተሰቀለ	täsäqqälä
ተሰቀቀ	täsäqqäqä
ተሰቃየ	täsäqayyä
ተሰቃይ	täsäqqay
ተሰበረ	täsäbbärä
ተሰበሰበ	täsäbässäbä
ተሰበከ	täsäbbäkä
ተሰባሪ	täsäbbari
ተሰባበረ	täsäbabbärä
ተሰተረ	täsättärä
ተሰነቀ	täsännäqä
ተሰነቀረ	täsänäqqärä
ተሰነቀረብኝ	täsänäqqäräbǝññ
ተሰነባበተ	täsänäbabbätä
ተሰነከለ	täsänäkkälä
ተሰነዳዳ	täsänädadda
ተሰነገ	täsännägä
ተሰናበተ	täsänabbätä
ተሰናከለ	täsänakkälä
ተሰናዘረ	täsänazzärä
ተሰናዳ	täsänadda
ተሰኘ	täsäññä
ተሰካ	täsäkka
ተሰወጠ	täsäwwäṭä
ተሰየፈ	täsäyyäfä
ተሰደበ	täsäddäbä
ተሰደደ	täsäddädä
ተሰዳደበ	täsädaddäbä
ተሰገሰገ	täsägässägä
ተሳለመ	täsallämä
ተሳለቀ	täsalläqä
ተሳረረ	tässarrärä
ተሳረቀ	täsarräqä
ተሳሰበ	täsassäbä
ተሳቀቀ	täsaqqäqä
ተሳበበ	täsabbäbä
ተሳተፈ	täsattäfä
ተሳከረ	täsakkärä
ተሳካ	täsakka
ተሳደበ	täsaddäbä
ተሳደደ	täsaddädä
ተስለመለመ	täsǝlämällämä
ተስለከለከ	täsǝläkälläkä
ተስማማ	täsǝmamma
ተስገበገበ	täsǝgäbäggäbä
ተስፋፋ	täsǝfaffa
ተሸለመ	täšällämä
ተሸለቀቀ	täšäläqqäqä
ተሸለተ	täšällätä
ተሸላለመ	täšälallämä
ተሸላሚ	täšällami
ተሸመቀቀ	täšämäqqäqä
ተሸመተ	täšämmätä
ተሸማቀቀ	täšämaqqäqä
ተሸረሸረ	täšäräššärä
ተሸረከተ	täšäräkkätä
ተሸረካከተ	täšäräkakkätä
ተሸረፈ	täšärräfä
ተሸራረፈ	täšärarräfä
ተሸራፊ	täšärrafi
ተሸሸገ	täšäššägä
ተሸቀበ	täšäqqäbä
ተሸበረ	täšäbbärä
ተሸበበ	täšäbbäbä
ተሸነሸነ	täšänäššänä
ተሸነተረ	täšänättärä
ተሸናነፈ	täšänannäfä
ተሸናፊ	täšännafi
ተሸኘ	täšäññä
ተሸከመ	täšäkkämä
ተሸከሸከ	täšäkäššäkä
ተሸካሚ	täšäkkami
ተሸካከመ	täšäkakkämä
ተሸጋሸገ	täššägaššägä
ተሸጋገረ	täšägaggärä
ተሸጐረ	täšäggʷärä
ተሸጐጠ	täšäggʷäṭä
ተሸፈነ	täšäffänä
ተሸፋፈነ	täšäfaffänä
ተሹለከለከ	täšuläkälläkä
ተሻማ	täšamma
ተሻረከ	täšarräkä
ተሻሸ	täšaššä
ተሻኰተ	täšakkʷätä
ተሻገረ	täšaggärä
ተሽመደመደ	täšǝmädämmädä
ተሽቀዳደመ	täšǝqädaddämä
ተሽቆጠቆጠ	täšǝqoṭäqqoṭä
ተሽበለበለ	täšǝbäläbbälä
ተሽከረከረ	täšǝkäräkkärä
ተሽኮረመመ	täšǝkorämmämä
ተቀለሰ	täqälläsä
ተቀለበ	täqälläbä
ተቀለበሰ	täqäläbbäsä
ተቀላ	täqälla
ተቀላለደ	täqälallädä
ተቀላቀለ	täqälaqqälä
ተቀላቢ	täqällabi
ተቀመለ	täqämmälä
ተቀመመ	täqämmämä
ተቀመሰ	täqämmäsä
ተቀመጠ	täqämmäṭä
ተቀማ	täqämma
ተቀማጭ	täqämmač̣
ተቀረቀረ	täqäräqqärä
ተቀረቀበ	täqäräqqäbä
ተቀረደደ	täqäräddädä
ተቀረጠ	täqärräṭä
ተቀረጸ	täqärräṣä
ተቀረፈ	täqärräfä
ተቀራረፈ	täqärarräfä
ተቀሰመ	täqässämä
ተቀሰረ	täqässärä
ተቀሰቀሰ	täqäsäqqäsä
ተቀሰተ	täqässätä
ተቀቀለ	täqäqqälä
ተቀበለ	täqäbbälä
ተቀበረ	täqäbbärä
ተቀበቀበ	täqäbäqqäbä
ተቀበተተ	täqäbättätä
ተቀባ	täqäbba
ተቀባበለ	täqäbabbälä
ተቀባይ	täqäbbay
ተቀተረ	täqättärä
ተቀነሰ	täqännäsä
ተቀነባበረ	täqqänäbabbärä
ተቀነፈ	täqännäfä
ተቀናሽ	täqännaš
ተቀናቀነ	täqänaqqänä
ተቀናቃኝ	täqänaqaññ
ተቀናበረ	täqänabbärä
ተቀናነሰ	täqänannäsä
ተቀናና	täqännana
ተቀኘ	täqäññä
ተቀዘፈ	täqäzzäfä
ተቀዛቀዘ	täqäzaqqäzä
ተቀየመ	täqäyyämä
ተቀየሠ	täqäyyäśä
ተቀየረ	täqäyyärä
ተቀየደ	täqäyyädä
ተቀየጠ	täqäyyäṭä
ተቀደመ	täqäddämä
ተቀደሰ	täqäddäsä
ተቀደደ	täqäddädä
ተቀዳ	täqädda
ተቀዳሚ	täqäddami
ተቀዳደመ	täqädaddämä
ተቀዳደደ	täqädaddädä
ተቀዳጀ	täqädaǧǧä
ተቀጠቀጠ	täqäṭäqqäṭä
ተቀፈረረ	täqäfärrärä
ተቀፈቀፈ	täqäfäqqäfä
ተቀፈደደ	täqäfäddädä
ተቀፈፈ	täqäffäfä
ተቁለጨለጨ	täquläč̣älläč̣č̣ä
ተቁነጠነጠ	täqunäṭännäṭä
ተቃለለ	täqallälä
ተቃለደ	täqallädä
ተቃመሰ	täqammäsä
ተቃማ	täqamma
ተቃረመ	täqarrämä
ተቃረበ	täqarräbä
ተቃረነ	täqarränä
ተቃቀፈ	täqaqqäfä
ተቃባ	täqabba
ተቃና	täqanna
ተቃኘ	täqaññä
ተቃወመ	täqawwämä
ተቃወሰ	täqawwäsä
ተቅለሰለሰ	täqǝläsälläsä
ተቅለበለበ	täqǝläbälläbä
ተቅለጠለጠ	täqǝläṭälläṭä
ተቅበዘበዘ	täqǝbäzäbbäzä
ተቅነዘነዘ	täqǝnäzännäzä
ተቆለለ	täqollälä
ተቆላ	täqolla
ተቆረሰ	täqorräsä
ተቆረቆረ	täqoräqqorä
ተቆረጠ	täqorräṭä
ተቆራረሰ	täqorarräsä
ተቆራኘ	täqoraññä
ተቆፈረ	täqoffärä
ተቈለመመ	täqʷälämmämä
ተቈለፈ	täqʷälläfä
ተቈረቈረ	täqʷäräqqʷärä
ተቈረጠ	täqʷärräṭä
ተቈራ	täqʷärra
ተቈራመደ	täqʷärammädä
ተቈራረጠ	täqʷärarräṭä
ተቈራቈሰ	täqʷäraqqʷäsä
ተቈራጭ	täqʷärrač̣
ተቈሰቈሰ	täqʷäsäqqʷäsä
ተቈነነ	täqʷännänä
ተቈነደደ	täqʷänäddädä
ተቈናኝ	täqʷännaññ
ተቋለፈ	täqʷalläfä
ተቋላ	täqʷalla
ተቋረጠ	täqʷarräṭä
ተቋራጭ	täqʷarrač̣
ተበለቀጠ	täbäläqqäṭä
ተበለጠ	täbälläṭä
ተበላ	täbälla
ተበላለጠ	täbälalläṭä
ተበላሸ	täbälaššä
ተበላቀጠ	täbälaqqäṭä
ተበረቀሰ	täbäräqqäsä
ተበረቃቀሰ	täbäräqaqqäsä
ተበረበረ	täbäräbbärä
ተበረዘ	täbärräzä
ተበረጋገደ	täbärägaggädä
ተበራከተ	täbärakkätä
ተበሳ	täbässa
ተበሳሳ	täbäsassa
ተበሳበሰ	täbäsabbäsä
ተበሻቀጠ	täbäšaqqäṭä
ተበቀለ	täbäqqälä
ተበቃይ	täbäqqay
ተበተበ	täbättäbä
ተበታተነ	täbätattänä
ተበከለ	täbäkkälä
ተበካከለ	täbäkakkälä
ተበዘበዘ	täbäzäbbäzä
ተበየነ	täbäyyänä
ተበየደ	täbäyyädä
ተበያጅ	täbäyyaǧ
ተበደለ	täbäddälä
ተበደረ	täbäddärä
ተበዳ	täbädda
ተበዳሪ	täbäddari
ተበዳይ	täbädday
ተበዳደረ	täbädaddärä
ተበጀ	täbäǧǧä
ተበጃጀ	täbäǧaǧǧä
ተበገረ	täbäggärä
ተበጠበጠ	täbäṭäbbäṭä
ተበጣበጠ	täbäṭabbäṭä
ተባ	täbba
ተባላ	täballa
ተባረረ	täbarrärä
ተባረከ	täbarräkä
ተባረደ	täbarrädä
ተባሸቀ	täbaššäqä
ተባቃ	täbaqqa
ተባበረ	täbabbärä
ተባዛ	täbazza
ተብለጠለጠ	täbǝläṭälläṭä
ተብለጨለጨ	täbǝläč̣älläč̣ä
ተብላላ	täbǝlalla
ተብረቀረቀ	täbǝräqärräqä
ተብረከረከ	täbǝräkärräkä
ተብራራ	täbǝrarra
ተብሰለሰለ	täbǝsälässälä
ተብታባ	täbǝtabba
ተብከነከነ	täbǝkänäkkänä
ተቦረቦረ	täboräbborä
ተቦተረፈ	täbotärräfä
ተቦካ	täbokka
ተቦደሰ	täboddäsä
ተቧደነ	täbʷaddänä
ተተለተለ	tätälättälä
ተተመተመ	tätämättämä
ተተመነ	tätämmänä
ተተረማመሰ	tätärämammäsä
ተተረተረ	tätärättärä
ተተረከ	tätärräkä
ተተረከከ	tätäräkkäkä
ተተረኰሰ	tätäräkkʷäsä
ተተረጐመ	tätäräggʷämä
ተተራመሰ	tätärammäsä
ተተበተበ	tätäbättäbä
ተተቸ	tätäččä
ተተነተነ	tätänättänä
ተተናኮለ	tätänakkolä
ተተከለ	tätäkkälä
ተተካ	tätäkka
ተተካይ	tätäkkay
ተተኰሰ	tätäkkʷäsä
ተታለለ	tätallälä
ተታኰሰ	tätakkʷäsä
ተታፋ	tätaffa
ተትረፈረፈ	tätǝräfärräfä
ተቸ	täččä
ተቸለሰ	täčälläsä
ተቸበቸበ	täčäbäččäbä
ተቸነከረ	täčänäkkärä
ተቸከለ	täčäkkälä
ተቸገረ	täčäggärä
ተቸፈቸፈ	täčäfäččäfä
ተቸፈገ	täčäffägä
ተቺ	täčči
ተቻኰለ	täčakkʷälä
ተነሣ	tänäśśa
ተነሣሣ	tänäśśaśśa
ተነሰነሰ	tänäsännäsä
ተነሳ	tännäsa
ተነቀለ	tänäqqälä
ተነቀሰ	tänäqqäsä
ተነቀነቀ	tänäqännäqä
ተነቀፈ	tänäqqäfä
ተነቃቀፈ	tänäqaqqäfä
ተነቃቃ	tänäqaqqa
ተነቃነቀ	tänäqannäqä
ተነበበ	tänäbbäbä
ተነበየ	tänäbbäyä
ተነባበረ	tänäbabbärä
ተነባቢ	tänäbbabi
ተነተነ	tänättänä
ተነተገ	tänättägä
ተነታረከ	tänätarräkä
ተነነ	tännänä
ተነከረ	tänäkkärä
ተነከሰ	tänäkkäsä
ተነካ	tänäkka
ተነካከሰ	tänäkakkäsä
ተነካካ	tänäkakka
ተነኰሰ	tänäkkʷäsä
ተነኰተ	tänäkkʷätä
ተነዘነዘ	tänäzännäzä
ተነዛ	tänäzza
ተነዛነዘ	tänäzannäzä
ተነደፈ	tänäddäfä
ተነዳ	tänädda
ተነዳደፈ	tänädaddäfä
ተነገተ	tänäggätä
ተነጋገረ	tänägaggärä
ተነጋገደ	tänägaggädä
ተነጐረ	tänäggʷärä
ተነጫነጨ	tänäč̣annäč̣ä
ተነፈሰ	tänäffäsä
ተነፈገ	tänäffägä
ተነፋ	tänäffa
ተነፋረቀ	tänäfarräqä
ተነፋነፈ	tänäfannäfä
ተነፋፈሰ	tänäfaffäsä
ተነፋፈቀ	tänäfaffäqä
ተነፋፈገ	tänäfaffägä
ተነፋፋ	tänäfaffa
ተናበበ	tänabbäbä
ተናባቢ	tänabbabi
ተናነቀ	tänannäqä
ተናነቀው	tänannäqäw
ተናኘ	tänaññä
ተናከሰ	tänakkäsä
ተናዘዘ	tänazzäzä
ተናደደ	tänaddädä
ተናገሠ	tänaggäśä
ተናገረ	tänaggärä
ተናጋ	tänagga
ተናፈሰ	tänaffäsä
ተናፈቀ	tänaffäqä
ተናፈጠ	tänaffäṭä
ተናፋ	tänaffa
ተን	tänn
ተንሠቀሠቀ	tänǝśäqäśśäqä
ተንሰቀሰቀ	tänǝsäqässäqä
ተንሰፈሰፈ	tänǝsäfässäfä
ተንሳፈፈ	tänǝsaffäfä
ተንሶለሶለ	tänǝsolässolä
ተንሸረሸረ	tänǝšäräššärä
ተንሸራተተ	tänǝšärattätä
ተንሸዋረረ	tänǝšäwarrärä
ተንሻተተ	tänǝšattätä
ተንቀለቀለ	tänǝqäläqqälä
ተንቀረበበ	tänǝqäräbbäbä
ተንቀረፈፈ	tänǝqäräffäffä
ተንቀሳቀሰ	tänǝqäsaqqäsä
ተንቀበቀበ	tänǝqäbäqqäbä
ተንቀበደደ	tänǝqäbäddädä
ተንቀባረረ	tänǝqäbarrärä
ተንቀባደደ	tänǝqäbaddädä
ተንቀዋለለ	tänǝqäwallälä
ተንቀዠቀዠ	tänǝqäžäqqäžä
ተንቀጠቀጠ	tänǝqäṭäqqäṭä
ተንቀፈደደ	tänǝqäfäddädä
ተንበለበለ	tänǝbäläbbälä
ተንበረከከ	tänǝbäräkkäkä
ተንበሸበሸ	tänǝbäššäbbäšä
ተንቦለቦለ	tänǝboläbbolä
ተንቦረቀቀ	tänǝboräqqäqä
ተንቦራቀቀ	tänǝboraqqäqä
ተንቦገቦገ	tänǝbogäbbogä
ተንቦጨቦጨ	tänǝboč̣äbboč̣ä
ተንቦጫበጨ	tänǝboč̣abbäč̣ä
ተንቦጫቦጨ	tänǝboč̣abboč̣ä
ተንተረከከ	tänǝtäräkkäkä
ተንተባተበ	tänǝtäbattäbä
ተንተከተከ	tänǝtäkättäkä
ተንቶሰቶሰ	tänǝtosättosä
ተንቻቻ	tänǝčačča
ተንከላወሰ	tänǝkälawwäsä
ተንከረፈፈ	tänǝkäräffäfä
ተንከራተተ	tänǝkärattätä
ተንከባለለ	tänǝkäballälä
ተንከባከበ	tänǝkäbakkäbä
ተንከተከተ	tänǝkätäkkätä
ተንከታከተ	tänǝkätakkätä
ተንከዋተተ	tänǝkäwattätä
ተንከፈረረ	tänǝkäfärrärä
ተንኮለኛ	tänǝkoläñña
ተንኳኳ	tänǝkʷakkʷa
ተንኳፈፈ	tänǝkʷaffäfä
ተንዘረፈጠ	tänǝzäräffäṭä
ተንዘረፈፈ	tänǝzäräffäfä
ተንዘራፈጠ	tänǝzäraffäṭä
ተንዘፈዘፈ	tänǝzäffäzäfä
ተንዛዛ	tänǝzazza
ተንዠረገገ	tänǝžäräggägä
ተንዠቀዠቀ	tänǝžäqäžžäqä
ተንዠባረረ	tänǝžäbarrärä
ተንዣበበ	tänǝžabbäbä
ተንደላቀቀ	tänǝdälaqqäqä
ተንደረበበ	tänǝdäräbbäbä
ተንደረከከ	tänǝdäräkkäkä
ተንደረደረ	tänǝdäräddärä
ተንደቀደቀ	tänǝdäqäddäqä
ተንደበደበ	tänǝdäbäddäbä
ተንደባለለ	tänǝdäballälä
ተንደባደበ	tänǝdäbaddäbä
ተንደከደ	tänǝdäkkädä
ተንደፋደፈ	tänǝdäfaddäfä
ተንዶለዶለ	tänǝdoläddolä
ተንጀላጀለ	tänǝǧälaǧǧälä
ተንጀረገገ	tänǝǧäräggägä
ተንገላታ	tänǝgälatta
ተንገላወደ	tänǝgälawwädä
ተንገላጀጀ	tänǝgälaǧǧäǧä
ተንገረገበ	tänǝgäräggäbä
ተንገሸገሸ	tänǝgäšäggäšä
ተንገበገበ	tänǝgäbäggäbä
ተንገዋለለ	tänǝgäwallälä
ተንገደገደ	tänǝgädäggädä
ተንገዳገደ	tänǝgädaggädä
ተንገጫገጨ	tänǝgäč̣aggäč̣ä
ተንገፈገፈ	tänǝgäfäggäfä
ተንጋለለ	tänǝgallälä
ተንጋደደ	tänǝgaddädä
ተንጋጋ	tänǝgagga
ተንጎራደደ	tänǝgoraddädä
ተንጐራደደ	tänǝgʷäraddädä
ተንጓለለ	tänǝgʷallälä
ተንጓደደ	tänǝgʷaddädä
ተንጠረበበ	tänǝṭäräbbäbä
ተንጠረዘዘ	tänǝṭäräzzäzä
ተንጠራራ	tänǝṭärrara
ተንጠራወዘ	tänǝṭärawwäzä
ተንጣለለ	tänǝṭallälä
ተንጸባረቀ	tänǝṣäbarräqä
ተንፈላሰሰ	tänǝfälassäsä
ተንፈራገጠ	tänǝfäraggäṭä
ተንፈራፈረ	tänǝfäraffärä
ተንፈስ	tänǝfäss
ተንፈቀፈቀ	tänǝfäqäffäqä
ተንፋነፈ	tänǝfannäfä
ተንፏቀቀ	tänǝfʷaqqäqä
ተንፏፏ	tänǝfʷaffʷa
ተኛ	täñña
ተኛት	täññat
ተኝቶ	täññǝto
ተኝቷል	täññǝtʷal
ተአምረኛ	täʾammǝräñña
ተአምራታዊ	täʾammǝratawi
ተአምር	täʾammǝr
ተከለ	täkkälä
ተከለለ	täkällälä
ተከለሰ	täkälläsä
ተከለበሰ	täkäläbbäsä
ተከለከለ	täkäläkkälä
ተከላከለ	täkälakkälä
ተከመቻቸ	täkämäčaččä
ተከመከመ	täkämäkkämä
ተከማቸ	täkämmačä
ተከሠተ	täkäśśätä
ተከረበተ	täkäräbbätä
ተከረተፈ	täkärättäfä
ተከረከመ	täkäräkkämä
ተከራከረ	täkärakkärä
ተከራየ	täkärayyä
ተከሰሰ	täkässäsä
ተከሰከሰ	täkäsäkkäsä
ተከሳሽ	täkässaš
ተከሳከሰ	täkäsakkäsä
ተከበረ	täkäbbärä
ተከበበ	täkäbbäbä
ተከባበረ	täkäbabbärä
ተከተለ	täkättälä
ተከተለበ	täkätälläbä
ተከተል	täkättäl
ተከተረ	täkättärä
ተከተበ	täkättäbä
ተከተተ	täkättätä
ተከተከ	täkättäkä
ተከተከተ	täkätäkkätä
ተከተፈ	täkättäfä
ተከታተለ	täkätattälä
ተከታከተ	täkätakkätä
ተከታይ	täkättay
ተከነ	täkkänä
ተከናነበ	täkänannäbä
ተከናወነ	täkänawwänä
ተከካ	täkäkka
ተከዘ	täkkäzä
ተከደነ	täkäddänä
ተከፈለ	täkäffälä
ተከፈተ	täkäffätä
ተከፈነ	täkäffänä
ተከፈከፈ	täkäfäkkäfä
ተከፈፈ	täkäffäfä
ተከፋ	täkäffa
ተከፋች	täkäffač
ተከፋይ	täkäffay
ተከፋፈለ	täkäfaffälä
ተከፋፈተ	täkäfaffätä
ተኩረፈረፈ	täkuräfärräfä
ተኩራራ	täkurarra
ተኩስ	täkkus
ተኩነሰነሰ	täkunäsännäsä
ተካ	täkka
ተካለለ	täkallälä
ተካለሰ	täkalläsä
ተካረረ	täkarrärä
ተካሰሰ	täkassäsä
ተካበደ	täkabbädä
ተካከለ	täkkakkälä
ተካዥ	täkkaž
ተካፈለ	täkaffälä
ተካፈተ	täkaffätä
ተክለፈለፈ	täkǝläfälläfä
ተክበሰበሰ	täkǝbäsäbbäsä
ተኮላሸ	täkolaššä
ተኮማተረ	täkomattärä
ተኮረተመ	täkorättämä
ተኮረጀ	täkorräǧä
ተኮረፈ	täkorräfä
ተኮራመተ	täkorammätä
ተኮራፊ	täkorrafi
ተኮሳተረ	täkosattärä
ተኮተኮተ	täkotäkkotä
ተኮፈሰ	täkoffäsä
ተኮፋሽ	täkoffaš
ተኰላተፈ	täkʷälattäfä
ተኰረተመ	täkʷärättämä
ተኰረታተመ	täkʷärätattämä
ተኰሰ	täkkʷäsä
ተኰሳተረ	täkʷäsattärä
ተኰነነ	täkʷännänä
ተኳረፈ	täkʷarräfä
ተኳሽ	täkkʷaš
ተኳሽነት	täkʷašǝnnät
ተኳኰሰ	täkʷakkʷäsä
ተወለደ	täwällädä
ተወለጋገደ	täwälägaggädä
ተወላመመ	täwälammämä
ተወላከፈ	täwälakkäfä
ተወላጅ	täwällaǧ
ተወላገደ	täwälaggädä
ተወረረ	täwärrärä
ተወረሰ	täwärräsä
ተወረወረ	täwäräwwärä
ተወረደ	täwärrädä
ተወራ	täwärra
ተወራረሰ	täwärarräsä
ተወራረደ	täwärarrädä
ተወራሽ	täwärraš
ተወራወረ	täwärawwärä
ተወራጅ	täwärraǧ
ተወሰነ	täwässänä
ተወሰወሰ	täwäsäwwäsä
ተወሰደ	täwässädä
ተወሳ	täwässa
ተወቀሰ	täwäqqäsä
ተወቀጠ	täwäqqäṭä
ተወቃ	täwäqqa
ተወቃቀሰ	täwäqaqqäsä
ተወተፈ	täwättäfä
ተወነባበደ	täwänäbabbädä
ተወነጃጀለ	täwänäǧaǧǧälä
ተወናበደ	täwänabbädä
ተወናፈለ	täwänaffälä
ተወንጀለ	täwänǝǧǧälä
ተወከለ	täwäkkälä
ተወካይ	täwäkkay
ተወዘፈ	täwäzzäfä
ተወዛወዘ	täwäzawwäzä
ተወደደ	täwäddädä
ተወዳደረ	täwädaddärä
ተወዳጀ	täwädaǧǧä
ተወዳጅ	täwäddaǧ
ተወገረ	täwäggärä
ተወገደ	täwäggädä
ተወጋ	täwägga
ተወጫመደ	täwäč̣ammädä
ተዋለደ	täwallädä
ተዋልቀ	täwallǝqä
ተዋረደ	täwarrädä
ተዋሰነ	täwassänä
ተዋቀረ	täwaqqärä
ተዋቀሰ	täwaqqäsä
ተዋከበ	täwakkäbä
ተዋወቀ	täwawwäqä
ተዋደቀ	täwaddäqä
ተዋደደ	täwaddädä
ተዋጋ	täwagga
ተውለበለበ	täwǝläbälläbä
ተውረገረገ	täwǝrägärrägä
ተውተረተረ	täwǝtärättärä
ተውተበተበ	täwǝtäbättäbä
ተውተፈተፈ	täwǝtäfättäfä
ተዘለለ	täzällälä
ተዘለቀ	täzälläqä
ተዘመዘመ	täzämäzzämä
ተዘረረ	täzärrärä
ተዘረነቀ	täzärränäqä
ተዘረከተ	täzäräkkätä
ተዘረካከተ	täzäräkakkätä
ተዘረዘረ	täzäräzzärä
ተዘረገፈ	täzäräggäfä
ተዘረጋ	täzärägga
ተዘረፈ	täzärräfä
ተዘረፈጠ	täzäräffäṭä
ተዘራ	täzärra
ተዘራረፈ	täzärarräfä
ተዘቀዘቀ	täzäqäzzäqä
ተዘበራረቀ	täzäbärarräqä
ተዘባረቀ	täzäbarräqä
ተዘባበተ	täzäbabbätä
ተዘባነነ	täzäbannänä
ተዘነቀ	täzännäqä
ተዘነተረ	täzänättärä
ተዘነጋ	täzänägga
ተዘነጋጋ	täzänägagga
ተዘናከተ	täzänakkätä
ተዘናጋ	täzänagga
ተዘናፈለ	täzänaffälä
ተዘከረ	täzäkkärä
ተዘከዘከ	täzäkäzzäkä
ተዘካሪ	täzäkkari
ተዘወተረ	täzäwättärä
ተዘዋወረ	täzäwawwärä
ተዘያየረ	täzäyayyärä
ተዘገረረ	täzägärrärä
ተዘገጃጀ	täzägäǧaǧǧä
ተዘጋ	täzzägga
ተዘጋጀ	täzägaǧǧä
ተዘፈቀ	täzäffäqä
ተዘፈዘፈ	täzäfäzzäfä
ተዛለለ	täzallälä
ተዛለፈ	täzalläfä
ተዛመተ	täzammätä
ተዛመደ	täzammädä
ተዛባ	täzzabba
ተዛነቀ	täzannäqä
ተዛነፈ	täzannäfä
ተዛና	täzanna
ተዛናና	täzananna
ተዛወረ	täzawwärä
ተዛዘበ	täzazzäbä
ተዛዘነ	täzazzänä
ተዛፈቀ	täzaffäqä
ተዝለገለገ	täzǝlägällägä
ተዝለፈለፈ	täzǝläfälläfä
ተዝረበረበ	täzǝräbärräbä
ተዝረከረከ	täzǝräkärräkä
ተዝረጠረጠ	täzǝräṭärräṭä
ተዝረፈረፈ	täzǝräfärräfä
ተዝናና	täzǝnanna
ተዝጎረጎረ	täzǝgoräggorä
ተዝጐረጐረ	täzǝgʷäräggʷärä
ተዠለጠ	täžälläṭä
ተዥጎረገረ	täžǝgoräggärä
ተዥጎደጎደ	täžǝgodäggodä
ተያየ	täyayyä
ተደለለ	tädällälä
ተደለቀ	täddälläqä
ተደለደለ	tädäläddälä
ተደላደለ	tädäladdälä
ተደመመ	tädämmämä
ተደመረ	tädämmärä
ተደመሰሰ	tädämässäsä
ተደመደመ	tädämäddämä
ተደመጠ	tädämmäṭä
ተደማመጠ	tädämammäṭä
ተደማሪ	tädämmari
ተደማጭ	tädämmač̣
ተደረሰ	tädärräsä
ተደረሰመ	tädärässämä
ተደረበ	tädärräbä
ተደረተ	tädärrätä
ተደረደረ	tädäräddärä
ተደረገ	tädärrägä
ተደረገመ	tädäräggämä
ተደራረበ	tädärarräbä
ተደራረገ	tädärarrägä
ተደራቢ	tädärrabi
ተደራደረ	tädäraddärä
ተደራጀ	tädäraǧǧä
ተደራጊ	tädärragi
ተደሰተ	tädässätä
ተደሳች	tädässač
ተደቀነ	tädäqqänä
ተደቆሰ	tädäqqosä
ተደበለለ	tädäbällälä
ተደበለቀ	tädäbälläqä
ተደበላለቀ	tädäbälalläqä
ተደበቀ	tädäbbäqä
ተደበደበ	tädäbäddäbä
ተደባለቀ	tädäballäqä
ተደባበቀ	tädäbabbäqä
ተደባደበ	tädäbaddäbä
ተደነቀ	tädännäqä
ተደነቀረ	tädänäqqärä
ተደነቀረብኝ	tädänäqqäräbǝññ
ተደናቀፈ	tädänaqqäfä
ተደናቂ	tädännaqi
ተደናበረ	tädänabbärä
ተደናበዘ	tädänabbäzä
ተደናገረ	tädännaggärä
ተደናገጠ	tädänaggäṭä
ተደከመ	tädäkkämä
ተደወለ	tädäwwälä
ተደገመ	tädäggämä
ተደገሰ	tädäggäsä
ተደገነ	tädäggänä
ተደገፈ	tädäggäfä
ተደጋገመ	tädägaggämä
ተደጋገፈ	tädägaggäfä
ተደጎመ	tädäggomä
ተደፈረ	tädäffärä
ተደፈቀ	tädäffäqä
ተደፈነ	tädäffänä
ተደፋ	tädäffa
ተደፋፈረ	tädäfaffärä
ተዳመረ	tädammärä
ተዳመጠ	tädammäṭä
ተዳረሰ	tädarräsä
ተዳረቀ	tädarräqä
ተዳረገ	tädarrägä
ተዳራ	tädarra
ተዳቀለ	tädaqqälä
ተዳቀቀ	tädaqqäqä
ተዳበለ	tädabbälä
ተዳነቀ	tädannäqä
ተዳኘ	tädaññä
ተዳከመ	tädakkämä
ተዳደረ	tädaddärä
ተዳፈረ	tädaffärä
ተዳፈቀ	tädaffäqä
ተዳፈነ	tädaffänä
ተዳፋ	tädaffa
ተድረቀረቀ	tädǝräqärräqä
ተድበለበለ	tädǝbäläbbälä
ተድበሰበሰ	tädǝbäsäbbäsä
ተድቦለቦለ	tädǝboläbbolä
ተድፈነፈነ	tädǝfänäffänä
ተጀመረ	täǧämmärä
ተጀነነ	täǧännänä
ተገለለ	tägällälä
ተገለማመጠ	tägälämammäṭä
ተገለበጠ	tägäläbbäṭä
ተገለባበጠ	tägäläbabbäṭä
ተገለጠ	tägälläṭä
ተገለፈፈ	tägäläffäfä
ተገላመጠ	tägälammäṭä
ተገላበጠ	tägälabbäṭä
ተገላገለ	tägälaggälä
ተገመሰ	tägämmäsä
ተገመተ	tägämmätä
ተገመደለ	tägämäddälä
ተገመገመ	tägämäggämä
ተገረመ	tägärrämä
ተገረዘ	tägärräzä
ተገረፈ	tägärräfä
ተገራ	tägärra
ተገሰሰ	tägässäsä
ተገሸለጠ	tägäšälläṭä
ተገሸረ	tägäššärä
ተገበያየ	tägäbäyayyä
ተገቢ	tägäbbi
ተገባደደ	tägäbaddädä
ተገታ	tägätta
ተገታተረ	tägätattärä
ተገነዘበ	tägänäzzäbä
ተገነጣጠለ	tägänäṭaṭṭälä
ተገናኘ	tägänaññä
ተገናዘበ	tägänazzäbä
ተገኘ	tägäññä
ተገዘተ	tägäzzätä
ተገዛ	tägäzza
ተገዛዛ	tägäzzazza
ተገደለ	tägäddälä
ተገደደ	tägäddädä
ተገፈፈ	tägäffäfä
ተገፋ	tägäffa
ተገፋተረ	tägäfattärä
ተገፋፋ	tägäfaffa
ተጉመጠመጠ	tägumäṭämmäṭä
ተጉረበረበ	täguräbärräbä
ተጋ	tägga
ተጋለጠ	tägalläṭä
ተጋመሰ	tägammäsä
ተጋማ	tägamma
ተጋረደ	tägarrädä
ተጋረጠ	tägarräṭä
ተጋራ	tägarra
ተጋበዘ	tägabbäzä
ተጋባ	tägabba
ተጋተረ	tägattärä
ተጋነነ	tägannänä
ተጋዘ	tägazzä
ተጋዛ	tägazza
ተጋደለ	tägaddälä
ተጋገረ	tägaggärä
ተጋገዘ	tägaggäzä
ተጋፈጠ	tägaffäṭä
ተጋፋ	tägaffa
ተግ	tägg
ተግማማ	tägǝmamma
ተግባባ	tägǝbabba
ተግተለተለ	tägǝtälättälä
ተግተረተረ	tägǝtärättärä
ተግደረደረ	tägǝdäräddärä
ተግፈለፈለ	tägǝfäläffälä
ተጎማለለ	tägomallälä
ተጎማዘዘ	tägomazzäzä
ተጎራበተ	tägorabbätä
ተጎዳ	tägodda
ተጎዳኘ	tägodaññä
ተጐለተ	tägʷällätä
ተጐላመመ	tägʷälammämä
ተጐላደፈ	tägʷäladdäfä
ተጐሳቈለ	tägʷäsaqqʷälä
ተጐተተ	tägʷättätä
ተጐታች	tägʷättač
ተጐነጐነ	tägʷänäggʷänä
ተጐናዘለ	tägʷänazzälä
ተጓተተ	tägʷattätä
ተጓደለ	tägʷaddälä
ተጓደደ	tägʷaddädä
ተጕመጠመጠ	tägʷǝmäṭämmäṭä
ተጠለለ	täṭällälä
ተጠለፈ	täṭälläfä
ተጠላ	täṭälla
ተጠላላፊ	täṭälallafi
ተጠመቀ	täṭämmäqä
ተጠመዘዘ	täṭämäzzäzä
ተጠመደ	täṭämmädä
ተጠማ	täṭämma
ተጠማዘዘ	täṭämazzäzä
ተጠረመሰ	täṭärämmäsä
ተጠረቃቀመ	täṭäräqaqqämä
ተጠራ	täṭärra
ተጠራቀመ	täṭäraqqämä
ተጠቀመ	täṭäqqämä
ተጠቃ	täṭäqqa
ተጠቃለለ	täṭäqallälä
ተጠቃሚ	täṭäqqami
ተጠቃሽ	täṭäqqaš
ተጠቃቀሰ	täṭäqaqqäsä
ተጠቆመ	täṭäqqomä
ተጠበቀ	täṭäbbäqä
ተጠበበ	täṭäbbäbä
ተጠባበቀ	täṭäbabbäqä
ተጠነቀቀ	täṭänäqqäqä
ተጠና	täṭänna
ተጠናቀቀ	täṭänaqqäqä
ተጠናቆለ	täṭänaqqolä
ተጠናበሰ	täṭänabbäsä
ተጠናከረ	täṭänakkärä
ተጠናወተ	täṭänawwätä
ተጠየቀ	täṭäyyäqä
ተጠየቅ	täṭäyyäq
ተጠየፈ	täṭäyyäfä
ተጠያቂ	täṭäyyaqi
ተጠያየቀ	täṭäyayyäqä
ተጠያፊ	täṭäyyafi
ተጠጋ	täṭägga
ተጠጋገነ	täṭägaggänä
ተጠጋጋ	täṭägagga
ተጠፋፋ	täṭäfaffa
ተጣላ	täṭṭala
ተጣመመ	täṭammämä
ተጣመረ	täṭammärä
ተጣመደ	täṭammädä
ተጣረረ	täṭarrärä
ተጣራ	täṭarra
ተጣበቀ	täṭabbäqä
ተጣበበ	täṭabbäbä
ተጣባ	täṭabba
ተጣደፈ	täṭaddäfä
ተጣዳ	täṭadda
ተጣፋ	täṭaffa
ተጥለቀለቀ	täṭǝläqälläqä
ተጥመለመለ	täṭǝmälämmälä
ተጥመሰመሰ	täṭǝmäsämmäsä
ተጥመዘመዘ	täṭǝmäzämmäzä
ተጥናና	täṭǝnanna
ተጧጧፈ	täṭʷaṭṭʷafä
ተጨለጠ	täč̣älläṭä
ተጨመላለቀ	täč̣ämälalläqä
ተጨመረ	täč̣č̣ämmärä
ተጨመቀ	täč̣ämmäqä
ተጨመታተረ	täč̣ämätattärä
ተጨማለቀ	täč̣ämalläqä
ተጨማሪ	täč̣ämmari
ተጨማተረ	täč̣ämattärä
ተጨማደደ	täč̣ämaddädä
ተጨረሰ	täč̣č̣ärräsä
ተጨራመመ	täč̣ärammämä
ተጨራመተ	täč̣ärammätä
ተጨራመደ	täč̣ärammädä
ተጨቆነ	täč̣äqqonä
ተጨቋኝ	täč̣äqqʷañ
ተጨበተ	täč̣äbbätä
ተጨበጨበለት	täč̣äbäč̣č̣äbällät
ተጨባበጠ	täč̣äbabbäṭä
ተጨባበጡ	täč̣äbabbäṭu
ተጨባጭ	täč̣äbbač̣
ተጨነቀ	täč̣ännäqä
ተጨናነቀ	täč̣änannäqä
ተጨናገፈ	täč̣änaggäfä
ተጨናጎለ	täč̣änaggolä
ተጨካከነ	täč̣äkakkänä
ተጨዋወተ	täč̣äwawwätä
ተጨፈለቀ	täč̣äfälläqä
ተጨፋጨፈ	täč̣äfač̣č̣äffä
ተጨፋፈቀ	täč̣äfaffäqä
ተጫማ	täč̣amma
ተጫረሰ	täč̣č̣arräsä
ተጫወተ	täč̣awwätä
ተጫወተበት	täč̣awwätäbbät
ተጫፈረ	täč̣affärä
ተጭበረበረ	täč̣ǝbäräbbärä
ተጸለየ	täṣälläyä
ተጸናወተ	täṣänawwätä
ተጸየፈ	täṣäyyäfä
ተጸዳዳ	täṣädadda
ተጻረረ	täṣarrärä
ተጽናና	täṣǝnanna
ተፀነሰ	täṣ́ännäsä
ተፈለቀቀ	täfäläqqäqä
ተፈለገ	täfällägä
ተፈለጠ	täfälläṭä
ተፈለፈለ	täfäläffälä
ተፈላ	täfälla
ተፈላለገ	täfälallägä
ተፈላሰፈ	täfälassäfä
ተፈላጊ	täfällagi
ተፈላጭ	täfällač̣
ተፈረመ	täfärrämä
ተፈረከሰ	täfäräkkäsä
ተፈረደ	täfärrädä
ተፈረፈረ	täfäräffärä
ተፈራ	täfärra
ተፈራረመ	täfärarrämä
ተፈራራ	täfärarra
ተፈቃቀረ	täfäqaqqärä
ተፈቃቀደ	täfäqaqqädä
ተፈተለ	täfättälä
ተፈተለከ	täfätälläkä
ተፈተሸ	täfättäšä
ተፈተነ	täfättänä
ተፈተገ	täfättägä
ተፈታ	täfätta
ተፈታተሸ	täfätattäšä
ተፈታተነ	täfättatänä
ተፈታኝ	täfättañ
ተፈነቀለ	täfänäqqälä
ተፈነቸረ	täfänäččärä
ተፈነከተ	täfänäkkätä
ተፈነገለ	täfänäggälä
ተፈናቀለ	täfänaqqälä
ተፈናከተ	täfänakkätä
ተፈናፈነ	täfänaffänä
ተፈወሰ	täfäwwäsä
ተፈጀ	täfäǧǧä
ተፈገፈገ	täfägäffägä
ተፈጋፈገ	täfägaffägä
ተፋ	täffa
ተፋለመ	täfallämä
ተፋለሰ	täfalläsä
ተፋረሰ	täfarräsä
ተፋረደ	täfarrädä
ተፋሰሰ	täfassäsä
ተፋቀረ	täfaqqärä
ተፋተገ	täfattägä
ተፋታ	täfatta
ተፋዘዘ	täfazzäzä
ተፋጀ	täfaǧǧä
ተፋፈነ	täfaffänä
ተፋፈገ	täfaffägä
ተፌ	täffe
ተፍ	täff
ተፍለቀለቀ	täfǝläqälläqä
ተፍለከለከ	täfǝläkälläkä
ተፍረቀረቀ	täfǝräqärräqä
ተፍረከረከ	täfǝräkärräkä
ተፍረጠረጠ	täfǝräṭärräṭä
ተፍታታ	täfǝtatta
ተፎካከረ	täfokakkärä
ቱር	turr
ቱስ	tuss
ቱሽ	tušš
ቱባ	tubba
ቱቦ	tubbo
ቱታ	tutta
ቱግ	tugg
ቱፋሕ	tuffaḥ
ታለበ	talläbä
ታለፈ	talläfä
ታላቅ	tallaq
ታመመ	tammämä
ታመሰ	tammäsä
ታመቀ	tammäqä
ታመነ	tammänä
ታማ	tamma
ታማኝ	tammañ
ታምረኛ	tammǝräñña
ታምራታዊ	tammǝratawi
ታምር	tammǝr
ታሠሠ	taśśäśä
ታሠረ	taśśärä
ታረመ	tarrämä
ታረሰ	tarräsä
ታረቀ	tarräqä
ታረዘ	tarräzä
ታረደ	tarrädä
ታሪከኛ	tarikäñña
ታሰበ	tassäbä
ታስቦ	tassǝbo
ታሸ	taššä
ታሸመ	taššämä
ታሸገ	taššägä
ታቀደ	taqqädä
ታቀፈ	taqqäfä
ታበለ	tabbälä
ታበየ	tabbäyä
ታተመ	tattämä
ታተረ	tattärä
ታተተ	tattätä
ታታ	tatta
ታነቀ	tannäqä
ታነጠ	tannäṭä
ታናሽ	tannaš
ታንከኛ	tanǝkäñña
ታኘከ	taññäkä
ታከለ	takkälä
ታከመ	takkämä
ታከተ	takkätä
ታከከ	takkäkä
ታካሚ	takkami
ታወረ	tawwärä
ታወሰው	tawwäsäw
ታወቀ	tawwäqä
ታወከ	tawwäkä
ታዘለ	tazzälä
ታዘበ	tazzäbä
ታዘዘ	tazzäzä
ታዛቢ	tazzabi
ታዛዥ	tazzaž
ታየ	tayyä
ታደለ	taddälä
ታደመ	taddämä
ታደገ	taddägä
ታዲያሳ	tadiyassa
ታዲያስ	tadiyass
ታዳጊ	taddagi
ታጀለ	taǧǧälä
ታጀበ	taǧǧäbä
ታገለ	taggälä
ታገሠ	taggäśä
ታገደ	taggädä
ታጋሽ	taggaš
ታጐረ	taggʷärä
ታፈረ	taffärä
ታፈነ	taffänä
ታፈገ	taffägä
ታፋሪ	taffari
ቴሌስኮፕ	telesǝkopp
ቴፕ	tepp
ትሉግሉግ	tǝlugǝlugg
ትላንትና	tǝlanǝtǝnna
ትልቅ	tǝllǝq
ትልቅነት	tǝllǝqǝnnät
ትሕትና	tǝḥǝtǝnna
ትምቡሽ	tǝmǝbušš
ትምትም	tǝmǝtǝmm
ትምክህተኛ	tǝmǝkǝhǝtäñña
ትራፊ	tǝrrafi
ትር	tǝrr
ትርምስ	tǝrǝmmǝs
ትርታ	tǝrrǝta
ትርክክ	tǝrǝkǝkk
ትርኳሽ	tǝrǝkkʷaš
ትሻለህ	tǝšalläh
ትቢተኛ	tǝbitäñña
ትቢያ	tǝbbiya
ትብብር	tǝbǝbbǝr
ትብትብ	tǝbǝtǝbb
ትችት	tǝččǝt
ትናንትና	tǝnanǝtǝnna
ትናጋ	tǝnnaga
ትንሽ	tǝnnǝš
ትንቢተኛ	tǝnǝbitäñña
ትንኝ	tǝnǝññ
ትንፋሽ	tǝnǝffaš
ትእቢተኛ	tǝʾǝbitäñña
ትእግሥተኛ	tǝʾǝgǝśǝtäñña
ትከሻ	tǝkäšša
ትከሻማ	tǝkäššamma
ትከሻም	tǝkäššam
ትኩሳት	tǝkkusat
ትኩስ	tǝkkus
ትካዜ	tǝkkaze
ትክ	tǝkk
ትክለኛ	tǝkǝläñña
ትክል	tǝkkǝl
ትክት	tǝkkǝt
ትክዝ	tǝkkǝzz
ትውልድ	tǝwǝlǝdd
ትዕይንት	tǝʿǝyyǝnǝt
ትዝ	tǝzz
ትዝብት	tǝzzǝbǝt
ትዝታ	tǝzzǝta
ትይዩ	tǝyǝyyu
ትግሥተኛ	tǝgǝśǝtäñña
ትግርኛ	tǝgǝrǝñña
ትግያ	tǝgǝyya
ትጥቅና	tǝṭǝqǝnna
ቶስቷሳ	tosǝtʷassa
ቸለል	čäläll
ቸለሰ	čälläsä
ቸል	čäll
ቸልተኛ	čällǝtäñña
ቸልታ	čällǝta
ቸረቸመ	čäräččämä
ቸረቸረ	čäräččärä
ቸርቻማ	čärǝčamma
ቸርነት	čärǝnnät
ቸሰሰ	čässäsä
ቸበቸበ	čäbäččäbä
ቸብቸቦ	čäbǝčäbbo
ቸነከረ	čänäkkärä
ቸከለ	čäkkälä
ቸኰለ	čäkkʷälä
ቸኳይ	čäkkʷay
ቸገረ	čäggärä
ቸፈቸፈ	čäfäččäfä
ቸፈገ	čäffägä
ቸፍግ	čäffǝgg
ችላ	čǝlla
ችስ	čǝss
ችቦ	čǝbbo
ችኩል	čǝkkul
ችክ	čǝkk
ችክል	čǝkkǝll
ችኮ	čǝkko
ችኰላ	čǝkkʷäla
ችግረኛ	čǝggǝräñña
ችግር	čǝggǝr
ችግኝ	čǝggǝñ
ችፍ	čǝff
ችፍርግ	čǝfǝrǝgg
ችፍቻፊ	čǝfǝččafi
ችፍግ	čǝffǝg
ኅሊና	ḫǝllina
ኅብረተሰብአዊነት	ḫǝbǝrätäsäbǝʾawinnät
ኅያል	ḫǝyyal
ኅይለኛ	ḫǝyǝläñña
ኅይለኝነት	ḫǝyǝläññǝnnät
ኅዳግ	ḫǝddag
ኅጢአተኛ	ḫǝṭiʾatäñña
ኅጢአተኝነት	ḫǝṭiʾatäññǝnnät
ኋለኛ	ḫʷaläñña
ነሣ	näśśa
ነረተ	närrätä
ነሰረ	nässärä
ነሰነሰ	näsännäsä
ነሳነሰ	näsannäsä
ነሸጠ	näššäṭä
ነቀለ	näqqälä
ነቀሰ	näqqäsä
ነቀዘ	näqqäzä
ነቃ	näqqa
ነቃቀለ	näqaqqälä
ነቃቀዘ	näqaqqäzä
ነቃቀፈ	näqaqqäfä
ነቃቃ	näqaqqa
ነቈጠ	näqqʷäṭä
ነበረ	näbbärä
ነበር	näbbär
ነበበ	näbbäbä
ነበዘ	näbbäzä
ነቢይ	näbiyy
ነባር	näbbar
ነብርማ	näbǝrǝmma
ነቦጨ	näbboč̣č̣ä
ነተረከ	nätärräkä
ነተበ	nättäbä
ነኁላላ	näḫulalla
ነኈለለ	näḫʷällälä
ነኝ	näññ
ነከረ	näkkärä
ነከሰ	näkkäsä
ነከስ	näkäss
ነከተ	näkkätä
ነካ	näkka
ነካከሰ	näkakkäsä
ነካካ	näkakka
ነክ	näkk
ነኰተ	näkkʷätä
ነውረኛ	näwǝräñña
ነዘረ	näzzärä
ነዘነዘ	näzännäzä
ነዛ	näzza
ነዝናዛ	näzǝnazza
ነደለ	näddälä
ነደደ	näddädä
ነደፈ	näddäfä
ነዳ	nädda
ነዳደለ	nädaddälä
ነዳደፈ	nädaddäfä
ነገሠ	näggäśä
ነገረ	näggärä
ነገረኛ	nägäräñña
ነገረኝ	näggäräññ
ነገረው	näggäräw
ነገደ	näggädä
ነጋ	nägga
ነጋዴ	näggade
ነጋድራስ	näggadǝras
ነጋገረ	nägaggärä
ነጋገደ	nägaggädä
ነጋጋ	nägagga
ነጐረ	näggʷärä
ነጻነት	näṣannät
ነፈለለ	näfällälä
ነፈረ	näffärä
ነፈረቀ	näfärräqä
ነፈሰ	näffäsä
ነፈሰበት	näffäsäbbät
ነፈነፈ	näfännäfä
ነፈገ	näffägä
ነፊ	näffi
ነፋ	näffa
ነፋሻ	näffašša
ነፋፈሰ	näfaffäsä
ነፋፋ	näfaffa
ነፍላላ	näfǝlalla
ነፍራቃ	näfǝraqqa
ነፍናፋ	näfǝnaffa
ነፍጠኛ	näfǝṭäñña
ናሙና	nammuna
ናቸው	naččäw
ናችሁ	naččǝhu
ናኘ	naññä
ናወዘ	nawwäzä
ናዋዥ	nawwaž
ናፈቀ	naffäqä
ንስሐ	nǝssǝḥa
ንቃሽ	nǝqqaš
ንቃይ	nǝqqay
ንቅል	nǝqqǝl
ንቅሳታም	nǝqqǝsatam
ንቅሳት	nǝqqǝsat
ንቅናቄ	nǝqǝnnaqe
ንብብር	nǝbǝbbǝr
ንብዝ	nǝbbǝz
ንብዝብዝ	nǝbǝzǝbǝzz
ንትርክ	nǝtǝrrǝk
ንክሳት	nǝkkǝsat
ንክስ	nǝkkǝs
ንክኪት	nǝkǝkkit
ንክክ	nǝkǝkk
ንኳቸ	nǝkkʷačä
ንዝራት	nǝzzǝrat
ንዴተኛ	nǝdetäñña
ንዴታም	nǝddetam
ንዴት	nǝddet
ንገዳ	nǝggäda
ንግር	nǝggǝr
ንግርተኛ	nǝggǝrǝtäñña
ንግርት	nǝggǝrǝt
ንግግር	nǝgǝggǝr
ንጹሕነት	nǝṣuḥǝnnät
ንጽሕና	nǝṣǝḥǝnna
ንፊት	nǝffit
ንፋሽ	nǝffaš
አሁኑኑ	ahunnunu
አሁንም	ahunǝmm
አሁንስ	ahunǝss
አህያ	ahǝyya
አለ	allä
አለሁ	allähu
አለለ	allälä
አለል	aläll
አለሎ	alällo
አለመ	allämä
አለመለመ	alämällämä
አለመደ	alämmädä
አለመጠ	alämmäṭä
አለማ	alämma
አለማለም	allämalläm
አለማመነ	allämammänä
አለማመደ	allämammädä
አለሳለስ	alläsaläs
አለቀ	alläqä
አለቀለቀ	aläqälläqä
አለቀመ	aläqqämä
አለቀሰ	aläqqäsä
አለቃለቀ	alläqalläqä
አለቃቀሰ	aläqaqqäsä
አለቅነት	aläqǝnnät
አለበ	alläbä
አለበለዚያ	aläbälläzziya
አለበሰ	alläbbäsä
አለበት	alläbät
አለባበሰ	aläbabbäsä
አለብኝ	alläbbǝññ
አለኝታ	alläññǝta
አለከለከ	aläkälläkä
አለው	alläw
አለዘበ	aläzzäbä
አለያየ	alläyyayä
አለጎመ	aläggomä
አለጐመ	aläggʷämä
አለጠ	alläṭä
አለጠለጠ	aläṭälläṭä
አለፈ	alläfä
አለፈበት	alläfäbbät
አለፋ	aläffa
አለፋጨቀ	alläfač̣č̣äqä
አላላ	alalla
አላላም	allalam
አላላከ	allalakä
አላመነ	allammänä
አላመደ	allamädä
አላመጠ	allammäṭä
አላሚ	allami
አላማኝ	allamañ
አላሰነ	allassänä
አላሸ	alaššä
አላሸቀ	alaššäqä
አላቀመ	allaqqämä
አላቀሰ	allaqqäsä
አላቀቀ	allaqqäqä
አላቃሽ	allaqaš
አላቆጠ	alaqqoṭä
አላጋ	allagga
አላጋጭ	allagač̣
አላፊነት	alafinnät
አልቃሻ	alǝqašša
አልባሌ	alǝbbale
አልባነት	alǝbannät
አልከሰከሰ	alǝkäsäkkäsä
አልኮሰኮሰ	alǝkosäkkosä
አልገባኝም	alǝgäbbaññǝm
አልጐመጐመ	alǝgʷämäggʷämä
አልጨረሰም	alǝč̣ärräsäm
አልጫ	allǝč̣č̣a
አልፈሰፈሰ	alǝfäsäffäsä
አሎሎ	alollo
አመለመለ	amälämmälä
አመለኛ	amäläñña
አመለከ	amälläkä
አመለከተ	amäläkkätä
አመለጠ	amälläṭä
አመለጠው	amälläṭäw
አመላለስ	ammälalläs
አመላላሽ	ammälallaš
አመመ	ammämä
አመሠራረት	ammäśärarät
አመረረ	amärrärä
አመረቀዘ	amäräqqäzä
አመረተ	amärrätä
አመራ	amärra
አመራመረ	ammärammärä
አመራመር	ammäramär
አመራማሪ	ammäramari
አመራር	ammärar
አመሰ	ammäsä
አመሰቃቀለ	ammäsäqaqqälä
አመሰቃቃይ	ammäsäqaqay
አመሰኳ	amäsäkkʷa
አመሰገነ	amäsäggänä
አመሰጋገነ	amäsägaggänä
አመሳሰል	ammäsasäl
አመሳቀለ	ammäsaqqälä
አመሳከረ	ammäsakkärä
አመሳካሪ	ammäsakari
አመሸ	ammäššä
አመሸህ	amäššäh
አመቀ	ammäqä
አመቸ	amäččä
አመቺ	amäčči
አመቻቸ	ammäčaččä
አመነ	ammänä
አመነመነ	amänämmänä
አመነቃቀረ	ammänäqaqqärä
አመነታ	amänätta
አመነታታ	amänätatta
አመነቸከ	amänäččäkä
አመነኰሰ	amänäkkʷäsä
አመነዘረ	amänäzzärä
አመነጫጨቀ	ammänäč̣ač̣č̣äqqä
አመናቀረ	ammänaqqärä
አመናጨቀ	ammänač̣č̣äqä
አመከነ	amäkkänä
አመካኘ	ammäkañä
አመዘነ	amäzzänä
አመዛዘነ	ammäzazzänä
አመዛዛኝ	ammäzazañ
አመገ	ammägä
አመገለ	ammäggälä
አመጋገብ	ammägagäb
አመጣጠነ	ammäṭaṭṭänä
አመጻደቀ	ammäṣaddäqä
አማ	amma
አማለደ	ammalädä
አማላጅ	ammalaǧ
አማላጅነት	ammalaǧǝnnät
አማመመ	amammämä
አማረረ	ammarrärä
አማረዘ	ammarräzä
አማረገ	ammarrägä
አማረጠ	ammarräṭä
አማሪኛው	amariññaw
አማራሪ	ammarari
አማራጭ	ammarač̣
አማርኛ	amarǝñña
አማሰለ	ammassälä
አማሸ	ammaššä
አማሺ	ammaši
አማሽ	ammaš
አማተበ	ammattäbä
አማታ	ammata
አማች	ammač
አማከረ	amakkärä
አማካሪ	ammakari
አማካኝ	ammakañ
አማገረ	ammaggärä
አማገጠ	amaggäṭä
አማጣ	ammaṭa
አማጭ	ammač̣
አሜተኛ	ametäñña
አምሳኛ	amǝsañña
አምሳያ	amǝsayya
አምስተኛ	ammǝsǝtäñña
አምስት	ammǝsǝt
አምበል	amǝbäll
አምቡላ	amǝbulla
አምባረቀ	amǝbarräqä
አምባሻ	amǝbašša
አምባጋሮኛ	amǝbagaroñña
አምቦልክ	amǝbolǝkk
አምቦረቀቀ	amǝboräqqäqä
አምቦጨቦጨ	amǝboč̣äbboč̣ä
አምቧቧ	amǝbʷabbʷa
አምታታ	amǝtatta
አምነሸነሸ	amǝnäšännäšä
አምዘገዘገ	amǝzägäzzägä
አሞለጨ	amolläč̣ä
አሞላ	amolla
አሞላላ	ammolalla
አሞላቀቀ	amolaqqäqä
አሞቀሞቀ	amoqämmoqä
አሞኘ	amoññä
አሞካከረ	ammokakkärä
አሞገሰ	amoggäsä
አሞጋሽ	amoggaš
አሞጋገሰ	amogaggäsä
አሞጠሞጠ	amoṭämmoṭä
አሟላ	ammʷalla
አሟሟቀ	ammʷamʷaqä
አሟሟቂ	ammʷamʷaqi
አሟረተ	amʷarrätä
አሟሸ	amʷaššä
አሟከረ	ammʷakkärä
አሟገተ	ammʷaggätä
አሟጋች	ammʷagač
አሠለሰ	aśälläsä
አሠልጣኝ	aśälǝṭaññ
አሠመረ	aśämmärä
አሠማመረ	aśämammärä
አሠሠ	aśśäśä
አሠረ	aśśärä
አሠዋ	aśśäwwa
አሠየመ	aśäyyämä
አሠገረ	aśäggärä
አሠጋ	aśägga
አሠጋገር	aśśägagär
አሣሣ	aśaśśa
አሣረኛ	aśaräñña
አረመ	arrämä
አረመኔነት	arämänennät
አረሰ	arräsä
አረሳሳ	aräsassa
አረቀ	arräqä
አረቀቀ	aräqqäqä
አረበደ	arräbbädä
አረባ	aräbba
አረባጅ	aräbbaǧ
አረከሰ	aräkkäsä
አረካ	aräkka
አረካከበ	arräkakkäbä
አረካካቢ	arräkakabi
አረዘመ	aräzzämä
አረደ	arrädä
አረዳ	arädda
አረጀ	aräǧǧä
አረገረገ	arägärrägä
አረገበ	aräggäbä
አረገዘ	aräggäzä
አረገደ	aräggädä
አረገፈ	aräggäfä
አረጋ	arägga
አረጋገጠ	arrägaggäṭä
አረጋገፈ	arrägaggäfä
አረጋጋ	arrägagga
አረጠ	arräṭä
አረጠረጠ	aräṭärräṭä
አረፈደ	aräffädä
አረፋፈደ	aräffafädä
አራ	arra
አራመደ	arrammädä
አራሙቻ	arramučča
አራሚ	arrami
አራረሰ	ararräsä
አራራ	ararra
አራራቀ	arraraqä
አራቈተ	arraqʷätä
አራባ	arraba
አራተኛ	arattäñña
አራት	aratt
አራገበ	arraggäbä
አራገፈ	arraggäfä
አራጋፊ	arraggafi
አርመጠመጠ	arǝmäṭämmäṭä
አርበተበተ	arǝbätäbbätä
አርበኛ	arǝbäñña
አርበኛነት	arǝbäññanät
አርበኝነት	arǝbäññǝnnät
አርበደበደ	arǝbädäbbädä
አርባኛ	arǝbañña
አርነት	arǝnnät
አርአያነት	arǝʾayannät
አርከፈከፈ	arǝkäfäkkäfä
አርገበገበ	arǝgäbäggäbä
አርጩሜ	arǝč̣umme
አሯሯጠ	arrʷarʷaṭä
አሰለለ	assällälä
አሰለመ	asällämä
አሰለሰለ	asälässälä
አሰለበ	assäläbä
አሰለቸ	asäläččä
አሰለፈ	asälläfä
አሰላ	asälla
አሰላሰለ	assälassälä
አሰላይ	assällay
አሰላፊ	assällafi
አሰማ	assämma
አሰረ	assärä
አሰረቀ	assäräqä
አሰረዘ	assärräzä
አሰራጨ	assärač̣ä
አሰሰ	assäsä
አሰሳ	assäsa
አሰቀለ	assäqqälä
አሰቀቀ	assäqqäqä
አሰቃቂ	assäqqaqi
አሰቃየ	assäqayyä
አሰበ	assäbä
አሰበረ	assäbbärä
አሰበከ	asäbbäkä
አሰበጣጠረ	assäbäṭaṭṭärä
አሰባ	asäbba
አሰባሰበ	assäbassäbä
አሰባጠረ	assäbaṭṭärä
አሰት	assät
አሰነቀ	assännäqä
አሰነበተ	asänäbbätä
አሰነካከለ	assänäkakkälä
አሰነዳዳ	assänädadda
አሰነጠቀ	assänäṭṭäqä
አሰነፈ	asännäfä
አሰናበተ	assänabbätä
አሰናከለ	assänakkälä
አሰናካይ	assänakay
አሰናዳ	assänadda
አሰናጅ	assänaǧ
አሰኘ	assäññä
አሰኘው	assäññäw
አሰከረ	asäkkärä
አሰከነ	asäkkänä
አሰካ	assäkka
አሰየፈ	assäyyäfä
አሰደበ	assäddäbä
አሰዳቢ	asäddabi
አሰገደ	assägäddä
አሰገገ	asäggägä
አሰጠ	assäṭṭä
አሰፈረ	assäffärä
አሰፈሰፈ	asäfässäfä
አሰፈፈ	asäffäfä
አሰፋ	assäffa
አሳለ	assalä
አሳለበ	asalläbä
አሳለፈ	asalläfä
አሳመ	assamä
አሳመመ	asammämä
አሳመሰ	asammäsä
አሳመቀ	asammäqä
አሳመነ	asammänä
አሳማኝ	asammañ
አሳሠረ	asaśśärä
አሳረመ	asarrämä
አሳረረ	assarrärä
አሳረሰ	asarräsä
አሳረደ	asarrädä
አሳረፈ	asarräfä
አሳራ	asarra
አሳራሪ	assarari
አሳራሽ	asarraš
አሳሰበ	asassäbä
አሳሳመ	assasamä
አሳሳቀ	assasaqä
አሳሳበ	assasabä
አሳሳቢ	asassabi
አሳሳተ	assasatä
አሳሳች	assasač
አሳሸ	asaššä
አሳሸገ	asaššägä
አሳቀ	assaqä
አሳቀለ	assaqqälä
አሳቀቀ	assaqqäqä
አሳቀደ	asaqqädä
አሳቀፈ	asaqqäfä
አሳበ	assabä
አሳበረ	assabbärä
አሳበቀ	assabbäqä
አሳበበ	assabbäbä
አሳበደ	asabbädä
አሳበጠ	asabbäṭä
አሳቢ	assabi
አሳባሪ	assabari
አሳባቂ	assabaqi
አሳብ	assab
አሳተ	assatä
አሳተመ	asattämä
አሳተፈ	assattäfä
አሳታሚ	asattami
አሳቻ	assačča
አሳች	assač
አሳነሰ	asannäsä
አሳነቀ	asannäqä
አሳነጠ	asannäṭä
አሳነፈ	assannäfä
አሳከለ	asakkälä
አሳከመ	asakkämä
አሳከረ	assakkärä
አሳከተ	asakkätä
አሳከከ	asakkäkä
አሳካ	assakka
አሳካሚ	asakkami
አሳወቀ	asawwäqä
አሳዘነ	asazzänä
አሳዘዘ	asazzäzä
አሳዛኝ	asazzaññ
አሳየ	asayyä
አሳደለ	asaddälä
አሳደደ	assaddädä
አሳደገ	asaddägä
አሳደፈ	asaddäfä
አሳዳጅ	assadaǧ
አሳዳጊ	asaddagi
አሳጀለ	asaǧǧälä
አሳጀበ	asaǧǧäbä
አሳገደ	asaggädä
አሳጣ	assaṭṭa
አሳጪ	assač̣i
አሳፈረ	assaffärä
አሳፈሰ	asaffäsä
አሳፈነ	asaffänä
አሳፋሪ	assafari
አስለመነ	asǝlämmänä
አስለመደ	asǝlämmädä
አስለማ	asǝlämma
አስለማጅ	asǝlämmaǧ
አስለሰነ	asǝlässänä
አስለቀለቀ	asǝläqälläqä
አስለቀመ	asǝläqqämä
አስለቀሰ	asǝläqqäsä
አስለቀቀ	asǝläqqäqä
አስለቃሽ	asǝläqqaš
አስለበለበ	asǝläbälläbä
አስለበሰ	asǝläbbäsä
አስለበበ	asǝläbbäbä
አስለበደ	asǝläbbädä
አስለበጠ	asǝläbbäṭä
አስለጎመ	asǝläggomä
አስለፈለፈ	asǝläfälläfä
አስለፈፈ	asǝläffäfä
አስለፋ	asǝläffa
አስመለሰ	asǝmälläsä
አስመለከተ	asǝmäläkkätä
አስመለጠ	asǝmälläṭä
አስመሠረተ	asǝmäśśärätä
አስመረመረ	asǝmärämmärä
አስመረረ	asǝmärrärä
አስመረቀ	asǝmärräqä
አስመረዘ	asǝmärräzä
አስመረገ	asǝmärrägä
አስመረጠ	asǝmärräṭä
አስመራ	asǝmärra
አስመሰለ	asǝmässälä
አስመሰከረ	asǝmäsäkkärä
አስመሰገነ	asǝmäsäggänä
አስመሳይ	asǝmässay
አስመሸ	asǝmäššä
አስመሸገ	asǝmäššägä
አስመተረ	asǝmättärä
አስመታ	asǝmätta
አስመነታ	asǝmänätta
አስመነነ	asǝmännänä
አስመነኰሰ	asǝmänäkkʷäsä
አስመነዘረ	asǝmänäzzärä
አስመኘ	asǝmäññä
አስመከረ	asǝmäkkärä
አስመዘነ	asǝmäzzänä
አስመዘዘ	asǝmäzzäzä
አስመዘገበ	asǝmäzäggäbä
አስመደበ	asǝmäddäbä
አስመገበ	asǝmäggäbä
አስመጠወተ	asǝmäṭäwwätä
አስማማ	asǝmamma
አስማተኛ	asǝmatäñña
አስማገረ	asǝmaggärä
አስሞላ	asǝmolla
አስሞረደ	asǝmorrädä
አስሞከተ	asǝmokkätä
አስሞገተ	asǝmoggätä
አስሞጨለፈ	asǝmoč̣älläfä
አስረረ	assǝrrärä
አስረሳ	asǝrässa
አስረቀቀ	asǝräqqäqä
አስረበረበ	asǝräbärräbä
አስረከበ	asǝräkkäbä
አስረካቢ	asǝräkkabi
አስረዳ	asǝrädda
አስረጀ	asǝräǧǧä
አስረገመ	asǝräggämä
አስረገዘ	asǝräggäzä
አስረገጠ	asǝräggäṭä
አስረገፈ	asǝräggäfä
አስረፈደ	asǝräffädä
አስቀለሰ	asǝqälläsä
አስቀለበሰ	asǝqäläbbäsä
አስቀለጠ	asǝqälläṭä
አስቀመለ	asǝqämmälä
አስቀመመ	asǝqämmämä
አስቀመሰ	asǝqämmäsä
አስቀመቀመ	asǝqämäqqämä
አስቀመጠ	asǝqämmäṭä
አስቀማ	asǝqämma
አስቀሠፈ	asǝqäśśäfä
አስቀረ	asǝqärrä
አስቀረደደ	asǝqäräddädä
አስቀረጠ	asǝqärräṭä
አስቀረጸ	asǝqärräṣä
አስቀረፈ	asǝqärräfä
አስቀሰተ	asǝqässätä
አስቀሳፈተ	asǝqäsaffätä
አስቀቀለ	asǝqäqqälä
አስቀበለ	asǝqäbbälä
አስቀበረ	asǝqäbbärä
አስቀበቀበ	asǝqäbäqqäbä
አስቀባ	asǝqäbba
አስቀነሰ	asǝqännäsä
አስቀና	asǝqänna
አስቀዘነ	asǝqäzzänä
አስቀዘፈ	asǝqäzzäfä
አስቀየመ	asǝqäyyämä
አስቀየሠ	asǝqäyyäśä
አስቀየደ	asǝqäyyädä
አስቀየጠ	asǝqäyyäṭä
አስቀያሚ	asǝqäyyami
አስቀደመ	asǝqäddämä
አስቀደሰ	asǝqäddäsä
አስቀደደ	asǝqäddädä
አስቀዳ	asǝqädda
አስቀዳሽ	asǝqäddaš
አስቀድሞ	asǝqäddǝmo
አስቀጠቀጠ	asǝqäṭäqqäṭä
አስቀፈቀፈ	asǝqäfäqqäfä
አስቀፈደደ	asǝqäfäddädä
አስቂኝ	assǝqiññ
አስቃረመ	asǝqarrämä
አስቆለለ	asǝqollälä
አስቆለፈ	asǝqolläfä
አስቆላ	asǝqolla
አስቆረሰ	asǝqorräsä
አስቆየ	asǝqoyyä
አስቆፈረ	asǝqoffärä
አስቈለመመ	asǝqʷälämmämä
አስቈረቈረ	asǝqʷäräqqʷärä
አስቈረበ	asǝqʷärräbä
አስቈረጠ	asǝqʷärräṭä
አስቈራ	asǝqʷärra
አስበላ	asǝbälla
አስበረቀሰ	asǝbäräqqäsä
አስበረበረ	asǝbäräbbärä
አስበረዘ	asǝbärräzä
አስበረደ	asǝbärrädä
አስበረገገ	asǝbäräggägä
አስበራ	asǝbärra
አስበሰለ	asǝbässälä
አስበተነ	asǝbättänä
አስበከለ	asǝbäkkälä
አስበዘበዘ	asǝbäzäbbäzä
አስበየነ	asǝbäyyänä
አስበየደ	asǝbäyyädä
አስበደለ	asǝbäddälä
አስበዳ	asǝbädda
አስበጂ	asǝbäǧǧi
አስበጠበጠ	asǝbäṭäbbäṭä
አስባረከ	asǝbarräkä
አስተለተለ	asǝtälättälä
አስተላለቀ	asǝtälalläqä
አስተላለፈ	asǝtälalläfä
አስተመተመ	asǝtämättämä
አስተማመነ	asǝtämammänä
አስተማረ	asǝtämmarä
አስተሣሠረ	asǝtäśaśśärä
አስተረተረ	asǝtärättärä
አስተረጐመ	asǝtäräggʷämä
አስተራረሰ	asǝtärarräsä
አስተሳሰበ	asǝtäsassäbä
አስተሻሸ	asǝtäšaššä
አስተባበለ	asǝtäbabbälä
አስተባበረ	asǝtäbabbärä
አስተቸ	asǝtäččä
አስተነተነ	asǝtänättänä
አስተነፈሰ	asǝtänäffäsä
አስተናበረ	asǝtänabbärä
አስተናገደ	asǝtänaggädä
አስተኛ	asǝttäña
አስተከዘ	asǝtäkkäzä
አስተካከለ	asǝtäkakkälä
አስተኰሰ	asǝtäkkʷäsä
አስተዋወቀ	asǝtäwawwäqä
አስተዛዘበ	asǝtäzazzäbä
አስተያየ	asǝtäyayyä
አስተዳደረ	asǝtädaddärä
አስተጋባ	asǝtägabba
አስተፋ	asǝtäffa
አስታረቀ	asǝtarräqä
አስታቀፈ	asǝtaqqäfä
አስታከከ	asǝtakkäkä
አስታወሰ	asǝtawwäsä
አስታወቀ	asǝtawwäqä
አስታገሠ	asǝtaggäśä
አስታጐለ	asǝtaggʷälä
አስቸረቸረ	asǝččäräččärä
አስቸነከረ	asǝčänäkkärä
አስቸከለ	asǝčäkkälä
አስቸኰለ	asǝčäkkʷälä
አስቸኳይ	asǝčäkkʷay
አስቸገረ	asǝčäggärä
አስቸጋሪ	asǝčäggari
አስነሣ	asǝnnäśa
አስነረተ	asǝnärrätä
አስነሰነሰ	asǝnäsännäsä
አስነሺ	asǝnäšši
አስነቀለ	asǝnäqqälä
አስነቀሰ	asǝnäqqäsä
አስነቀፈ	asǝnäqqäfä
አስነቃፊ	asǝnäqqafi
አስነበበ	asǝnäbbäbä
አስነከረ	asǝnäkkärä
አስነከሰ	asǝnäkkäsä
አስነካ	asǝnäkka
አስነወረ	asǝnäwwärä
አስነዋሪ	asǝnäwwari
አስነደለ	asǝnäddälä
አስነደፈ	asǝnäddäfä
አስነዳ	asǝnädda
አስነገረ	asǝnäggärä
አስነገተ	asǝnäggätä
አስነገደ	asǝnäggädä
አስነጋ	asǝnägga
አስነጐረ	asǝnäggʷärä
አስነፈሰ	asǝnäffäsä
አስነፋ	asǝnäffa
አስከለለ	asǝkällälä
አስከለበሰ	asǝkäläbbäsä
አስከለከለ	asǝkäläkkälä
አስከመረ	asǝkämmärä
አስከረተፈ	asǝkärättäfä
አስከረከመ	asǝkäräkkämä
አስከሰለ	asǝkässälä
አስከሰሰ	asǝkässäsä
አስከሰከሰ	asǝkäsäkkäsä
አስከበረ	asǝkäbbärä
አስከበበ	asǝkäbbäbä
አስከባሪ	asǝkäbbari
አስከተለ	asǝkättälä
አስከተረ	asǝkättärä
አስከተበ	asǝkättäbä
አስከተተ	asǝkättätä
አስከተከተ	asǝkätäkkätä
አስከነዳ	asǝkännäda
አስከደነ	asǝkäddänä
አስከዳ	asǝkädda
አስከፈለ	asǝkäffälä
አስከፈነ	asǝkäffänä
አስከፈከፈ	asǝkäfäkkäfä
አስከፈፈ	asǝkäffäfä
አስከፊ	asǝkäffi
አስከፋ	asǝkäffa
አስካካ	asǝkakka
አስኮላሸ	asǝkolaššä
አስኮረጀ	asǝkorräǧä
አስኮረፈ	asǝkorräfä
አስኮበለለ	asǝkobällälä
አስኮተኮተ	asǝkotäkkotä
አስኰነነ	asǝkʷännänä
አስኰናኝ	asǝkʷännañ
አስወለቀ	asǝwälläqä
አስወለደ	asǝwällädä
አስወረረ	asǝwärrärä
አስወረወረ	asǝwäräwwärä
አስወረደ	asǝwärrädä
አስወራ	asǝwärra
አስወሰነ	asǝwässänä
አስወሰደ	asǝwässädä
አስወቀረ	asǝwäqqärä
አስወቀጠ	asǝwäqqäṭä
አስወቃ	asǝwäqqa
አስወተፈ	asǝwättäfä
አስወነጀለ	asǝwänäǧǧälä
አስወደደ	asǝwäddädä
አስወገረ	asǝwäggärä
አስወገደ	asǝwäggädä
አስወጋ	asǝwägga
አስዋኘ	asǝwaññä
አስደለደለ	asǝdäläddälä
አስደመረ	asǝdämmärä
አስደመሰሰ	asǝdämässäsä
አስደረተ	asǝdärrätä
አስደረደረ	asǝdäräddärä
አስደረገ	asǝdärrägä
አስደራጊ	asǝdärragi
አስደሰተ	asǝdässätä
አስደሳች	asǝdässač
አስደቀቀ	asǝdäqqäqä
አስደበለቀ	asǝdäbälläqä
አስደበቀ	asǝdäbbäqä
አስደባለቀ	asǝdäballäqä
አስደነሰ	asǝdännäsä
አስደነቀ	asǝdännäqä
አስደነበረ	asǝdänäbbärä
አስደነገጠ	asǝdänäggäṭä
አስደናቂ	asǝdännaqi
አስደወለ	asǝdäwwälä
አስደገመ	asǝdäggämä
አስደገሰ	asǝdäggäsä
አስደገደገ	asǝdägäddägä
አስደፈረ	asǝdäffärä
አስደፈቀ	asǝdäffäqä
አስደፈነ	asǝdäffänä
አስደፈጠ	asǝdäffäṭä
አስጀመረ	asǝǧämmärä
አስገለበጠ	asǝgäläbbäṭä
አስገመሰ	asǝgämmäsä
አስገመተ	asǝgämmätä
አስገመገመ	asǝgämäggämä
አስገረመ	asǝgärrämä
አስገረዘ	asǝgärräzä
አስገራ	asǝgärra
አስገራሚ	asǝgärrami
አስገባ	asǝgäbba
አስገነዘበ	asǝgänäzzäbä
አስገኘ	asǝgäññä
አስገዘተ	asǝgäzzätä
አስገደለ	asǝgäddälä
አስገደደ	asǝgäddädä
አስገደፈ	asǝgäddäfä
አስጎመጀ	asǝgomäǧǧä
አስጐበኘ	asǝgʷäbäññä
አስጐነበሰ	asǝgʷänäbbäsä
አስጠለለ	asǝṭällälä
አስጠላ	asǝṭälla
አስጠመደ	asǝṭämmädä
አስጠማ	asǝṭämma
አስጠራ	asǝṭärra
አስጠቃ	asǝṭäqqa
አስጠነቀቀ	asǝṭänäqqäqä
አስጠና	asǝṭänna
አስጠኚ	asǝṭäññi
አስጠየፈ	asǝṭäyyäfä
አስጠያፊ	asǝṭäyyafi
አስጠይ	asǝṭäyy
አስጠገነ	asǝṭäggänä
አስጠጋ	asǝṭägga
አስጨመረ	asǝč̣ämmärä
አስጨመቀ	asǝč̣ämmäqä
አስጨበጨበ	asǝč̣äbäč̣č̣äbä
አስጨነቀ	asǝč̣ännäqä
አስጨናቂ	asǝč̣ännaqi
አስጨፈለቀ	asǝč̣äfälläqä
አስጨፈረ	asǝč̣äffärä
አስጸየፈ	asǝṣṣäyyäfä
አስጸያፊ	asǝṣṣäyyafi
አስፈለገ	asǝfällägä
አስፈለገኝ	asǝfällägäññ
አስፈለፈለ	asǝfäläffälä
አስፈላ	asǝfälla
አስፈረመ	asǝfärrämä
አስፈረደ	asǝffärädä
አስፈሪ	asǝfärri
አስፈራ	asǝfärra
አስፈራራ	asǝfärarra
አስፈሳ	asǝfässa
አስፈሳው	asǝfässaw
አስፈቀደ	asǝfäqqädä
አስፈተሸ	asǝfättäšä
አስፈተነ	asǝfättänä
አስፈተገ	asǝfättägä
አስፈታ	asǝfätta
አስፈጀ	asǝfäǧǧä
አስፋፋ	asǝfaffa
አሶመሰመ	asomässämä
አሸ	aššä
አሸለለ	aššällälä
አሸለመ	ašällämä
አሸለቀቀ	aššäläqqäqä
አሸለበ	ašälläbä
አሸለተ	aššällätä
አሸመ	aššämä
አሸመተ	ašämmätä
አሸመገለ	ašämäggälä
አሸመጠጠ	aššämäṭṭäṭä
አሸረሞጠ	ašärämmoṭä
አሸረጠ	ašärräṭä
አሸረፈ	ašärräfä
አሸሸ	aššäšä
አሸሸገ	aššäššägä
አሸቀለ	aššäqqälä
አሸቀበ	ašäqqäbä
አሸበረ	aššäbbärä
አሸበረቀ	ašäbärräqä
አሸበሸበ	ašäbäššäbä
አሸበበ	aššäbbäbä
አሸበተ	ašäbbätä
አሸባሪ	aššäbbari
አሸተተ	ašättätä
አሸነሸነ	aššänäššänä
አሸነፈ	aššännäfä
አሸና	aššänna
አሸናፊ	aššännafi
አሸኘ	aššäññä
አሸኛኘት	aššäñañät
አሸከመ	aššäkkämä
አሸካሸከ	aššäkaššäkä
አሸዋማ	ašäwamma
አሸዋነት	ašäwannät
አሸገ	aššägä
አሸጋሸገ	aššägaššägä
አሸጋገረ	aššägaggärä
አሸጠ	aššäṭä
አሸፈተ	ašäffätä
አሸፈነ	aššäffänä
አሻለ	aššalä
አሻማ	aššamma
አሻረ	aššarä
አሻረከ	aššarräkä
አሻሸ	ašaššä
አሻሻለ	aššašalä
አሻሻጠ	aššašaṭä
አሻሻጭ	aššašač̣
አሻቀበ	ašaqqäbä
አሻንጉሊት	ašanǝgullit
አሻከረ	ašakkärä
አሻገረ	ašaggärä
አሻገተ	ašaggätä
አሻፈረኝ	ašaffäräñ
አሻፈደ	ašaffädä
አሽሙረኛ	ašǝmuräñña
አሽሟጣጭነት	ašǝmʷaṭač̣ǝnnät
አሽቀዳደመ	ašǝqädaddämä
አሽቆጠቆጠ	ašǝqoṭäqqoṭä
አሽበለበለ	ašǝbäläbbälä
አሽታ	aššǝta
አሽከረከረ	ašǝkäräkkärä
አሽከርነት	ašǝkärǝnnät
አሽካካ	ašǝkkaka
አሽኮረመመ	ašǝkorämmämä
አሾለቀ	ašolläqä
አሾለከ	ašolläkä
አሾላቂ	ašollaqi
አሾመ	aššomä
አሾከሾከ	ašokäššokä
አቀለለ	aqällälä
አቀለመ	aqällämä
አቀለጠ	aqälläṭä
አቀላ	aqälla
አቀላል	aqqälal
አቀላቀለ	aqqälaqqälä
አቀላጠፈ	aqqälaṭṭäfä
አቀመሰ	aqämmäsä
አቀማመጥ	aqqämamäṭ
አቀማጠለ	aqqämaṭṭälä
አቀረረ	aqärrärä
አቀረቀረ	aqäräqqärä
አቀረበ	aqärräbä
አቀረና	aqäränna
አቀረጣጠፈ	aqqäräṭaṭṭäfä
አቀራረበ	aqqärarräbä
አቀሰሰ	aqässäsä
አቀበለ	aqäbbälä
አቀበጠ	aqäbbäṭä
አቀባበለ	aqqäbabbälä
አቀባበረ	aqqäbabbärä
አቀባባይ	aqqäbabay
አቀባይ	aqäbbay
አቀነቀነ	aqänäqqänä
አቀነበጠ	aqänäbbäṭä
አቀነባበረ	aqqänäbabbärä
አቀነባባሪ	aqqänäbabbari
አቀና	aqänna
አቀናበረ	aqqänabbärä
አቀናበር	aqqänabbär
አቀናባሪ	aqqänabari
አቀናነሰ	aqqänannäsä
አቀዘቀዘ	aqäzäqqäzä
አቀዛቀዘ	aqqäzaqäzä
አቀያየረ	aqqäyayyärä
አቀያየደ	aqäyayyädä
አቀያየጠ	aqqäyayyäṭä
አቀዳጀ	aqädaǧǧä
አቀጣጠረ	aqqäṭaṭärä
አቀጣጠነ	aqqäṭaṭänä
አቀፈ	aqqäfä
አቀፍ	aqqäf
አቁለጨለጨ	aquläč̣älläč̣ä
አቁላላ	aqulalla
አቁነጠነጠ	aqunäṭännäṭä
አቃለለ	aqqallälä
አቃመሰ	aqammäsä
አቃረበ	aqqaräbä
አቃራመ	aqqarramä
አቃሰተ	aqassätä
አቃበረ	aqqabbärä
አቃባ	aqqabba
አቃነሰ	aqqannäsä
አቃና	aqqanna
አቃወሰ	aqawwäsä
አቃዋሽ	aqqawaš
አቃዠ	aqažžä
አቃጠለ	aqqaṭṭälä
አቃጠረ	aqqaṭärä
አቃጠፈ	aqqaṭṭäfä
አቃጣሪ	aqqaṭari
አቅለሸለሸ	aqǝläšälläšä
አቅለበለበ	aqǝläbälläbä
አቅማማ	aqǝmamma
አቅራቢያ	aqǝrabbiya
አቅበዘበዘ	aqǝbäzäbbäzä
አቅነዘነዘ	aqǝnäzännäzä
አቅጣጫ	aqǝṭač̣č̣a
አቆለቆለ	aqoläqqolä
አቆላለፈ	aqqolalläfä
አቆላመጠ	aqqolammäṭä
አቆራኘ	aqqoraññä
አቆሸሸ	aqoššäšä
አቆነጀ	aqonäǧǧä
አቆየ	aqoyyä
አቆጠቆጠ	aqoṭäqqoṭä
አቈለቈለ	aqʷäläqqʷälä
አቈላለፈ	aqʷälalläfä
አቈረቈዘ	aqʷäräqqʷäzä
አቈረበ	aqʷärräbä
አቈረፈደ	aqʷäräffädä
አቈራመደ	aqqʷärammädä
አቈራረጠ	aqqʷärarräṭä
አቈሰለ	aqʷässälä
አቈሳሰለ	aqʷäsassälä
አቈነሰ	aqʷännäsä
አቈጣጠረ	aqqʷäṭaṭṭärä
አቋለፈ	aqqʷalläfä
አቋመጠ	aqʷammäṭä
አቋረጠ	aqqʷarräṭä
አቋራጭ	aqqʷarač̣
አቋቋመ	aqqʷaqʷamä
አቋቋሚ	aqqʷaqʷami
አቋቋም	aqqʷaqʷam
አቋፈረ	aqqʷaffärä
አበለ	abbälä
አበለዘ	abälläzä
አበለጠ	abälläṭä
አበላ	abälla
አበላለጠ	abälalläṭä
አበላሸ	abälaššä
አበል	abäll
አበረ	abbärä
አበረረ	abärrärä
አበረታ	abärätta
አበረከተ	abäräkkätä
አበረደ	abärrädä
አበረገገ	abäräggägä
አበራ	abärra
አበራከተ	abbärakkätä
አበራየ	abärayyä
አበር	abbär
አበሰ	abbäsä
አበሰለ	abässälä
አበሰረ	abässärä
አበሰበሰ	abäsäbbäsä
አበሳጨ	abbäsač̣č̣ä
አበሸቀ	abäššäqä
አበሸቀጠ	abbäšäqqäṭä
አበሻቀጠ	abbäšaqqäṭä
አበቀለ	abäqqälä
አበቃ	abäqqa
አበቃቃ	abbäqaqqa
አበበ	abbäbä
አበባማ	abäbamma
አበታተነ	abbätattänä
አበከተ	abäkkätä
አበካከነ	abäkakkänä
አበዛ	abäzza
አበደረ	abäddärä
አበዳሪ	abäddari
አበጀ	abäǧǧä
አበጃጀ	abäǧaǧǧä
አበገነ	abäggänä
አበጠ	abbäṭä
አበጣበጠ	abbäṭabbäṭä
አበጣባጭ	abbäṭabač̣
አባ	abba
አባለገ	aballägä
አባለጠ	aballäṭä
አባላ	aballa
አባልነት	abalǝnnät
አባረረ	abbarrärä
አባረቀ	abarräqä
አባራ	abarra
አባራሪ	abbarari
አባቃ	abaqqa
አባበለ	ababbälä
አባበጠ	ababbäṭä
አባባ	abbabba
አባባለ	abbabalä
አባባል	abbabal
አባባሰ	abbabasä
አባቴ	abbate
አባት	abbat
አባነነ	abannänä
አባከነ	abakkänä
አባካኝ	abakaññ
አባወራ	abbawärra
አባዛ	abazza
አባዥ	abbaž
አባዬ	abbaye
አባይ	abbay
አባይነት	abayǝnnät
አባዳ	abbada
አባጨጓሬ	abbač̣äggʷarre
አብላላ	abǝllala
አብረቀረቀ	abǝräqärräqä
አብረከረከ	abǝräkärräkä
አብራራ	abǝrarra
አብሰለሰለ	abǝsälässälä
አብቃቃ	abǝqaqqa
አብነት	abǝnnät
አብዛኛው	abǝzaññaw
አብዛኛውን	abǝzaññawǝn
አቦ	abbo
አቦነነ	abonnänä
አቦካ	abokka
አቦዘነ	abozzänä
አቧለተ	abʷallätä
አቧራማ	abʷarrama
አቧደነ	abbʷaddänä
አተላ	atälla
አተመ	attämä
አተመተመ	atämättämä
አተረማመሰ	attärämammäsä
አተረፈ	atärräfä
አተራመሰ	attärammäsä
አተራማሽ	attäramaš
አተራረፈ	atärarräfä
አተራተረ	attärattärä
አተበ	attäbä
አተተ	attätä
አተኛኘት	attäñañät
አተኛኝ	attäñañ
አተከነ	atäkkänä
አተኮረ	atäkkorä
አተኰሰ	atäkkʷäsä
አታለለ	attalälä
አታላይ	attalay
አታሚ	attami
አታቢ	attabi
አታች	attač
አታከለ	attakkälä
አታከተ	atakkätä
አታገለ	attaggälä
አታጋይ	attagay
አትራ	attǝra
አትክልተኛ	atǝkǝlǝttäña
አትጠራጠር	attǝṭṭäraṭär
አቶሰቶሰ	atosättosä
አቶፈቶፈ	atofättofä
አቸነፈ	aččännäfä
አቻ	ačča
አቻምና	aččamǝna
አቻቻለ	aččačalä
አቻኳይ	aččakʷay
አነሣ	anäśśa
አነሣሣ	annäśaśśa
አነሣሽ	annäśaš
አነሰ	annäsä
አነሰረ	anässärä
አነስተኛ	anäsǝtäñña
አነቀ	annäqä
አነቀዘ	anäqqäzä
አነቀፈ	anäqqäfä
አነቃ	anäqqa
አነቃቂ	annäqaqi
አነቃቃ	annäqaqqa
አነቃነቀ	annäqannäqä
አነቃናቂ	annäqanaqi
አነቈረ	anäqqʷärä
አነበበ	anäbbäbä
አነበነበ	anäbännäbä
አነበዘ	anäbbäzä
አነባ	anäbba
አነባበረ	annäbabbärä
አነባበሮ	annäbabäro
አነባበበ	anäbabbäbä
አነታረከ	annätarräkä
አነኈለለ	anäḫʷällälä
አነከሰ	anäkkäsä
አነከተ	anäkkätä
አነካከሰ	anäkakkäsä
አነካኪ	annäkaki
አነካካ	annäkakka
አነኰረ	anäkkʷärä
አነኰተ	anäkkʷätä
አነኳኰተ	anäkʷakkʷätä
አነወረ	anäwwärä
አነዘረ	anäzzärä
አነደደ	anäddädä
አነዳድ	annädad
አነገሠ	anäggäśä
አነገበ	anäggäbä
አነገተ	anäggätä
አነጋ	anägga
አነጋገር	annägagär
አነጋጋ	anägagga
አነጋጋሪ	annägagari
አነጐረ	anäggʷärä
አነጐተ	anäggʷätä
አነጐድ	anäggʷäd
አነጠ	annäṭä
አነጠነጠ	anäṭännäṭä
አነጣጠለ	annäṭaṭṭälä
አነጣጠረ	annäṭaṭṭärä
አነጣጣሪ	annäṭaṭari
አነጫነጨ	anäč̣annäč̣ä
አነጻጸረ	annäṣaṣṣärä
አነፈረ	anäffärä
አነፈረቀ	anäfärräqä
አነፈሰ	anäffäsä
አነፈነ	annäfänä
አነፈነፈ	anäfännäfä
አነፋረቀ	annäfarräqä
አነፋፈሰ	anäfaffäsä
አናረ	annarä
አናቀለ	annaqqälä
አናበበ	annabbäbä
አናባቢ	annababi
አናከሰ	annakkäsä
አናኪ	annaki
አናካ	annakka
አናዘዘ	annazzäzä
አናዛዥ	annazaž
አናደደ	annaddädä
አናደፈ	annaddäfä
አናዳ	annadda
አናዳጅ	annadaǧ
አናገሠ	annaggäśä
አናገረ	annaggärä
አናጊ	annagi
አናጋ	annagga
አናጋሪ	annagari
አናጋሽ	annagaš
አናጠቀ	annaṭṭäqä
አናጠበ	annaṭṭäbä
አናጠፈ	annaṭäfä
አናጢነት	anaṭinnät
አናፈሰ	annaffäsä
አናፋ	anaffa
አንሰፈሰፈ	anǝsäfässäfä
አንሸረሸረ	anǝšäräššärä
አንሸዋረረ	anǝšäwarrärä
አንሻተተ	anǝšattätä
አንሻፈፈ	anǝšaffäfä
አንሾካሾከ	anǝšokašokkä
አንሿከከ	anǝšʷakkäkä
አንሿካኪ	anǝšʷakkaki
አንቀለቀለ	anǝqäläqqälä
አንቀላፋ	anǝqälaffa
አንቀረበበ	anǝqäräbbäbä
አንቀረፈፈ	anǝqäräffäfä
አንቀሰቀሰ	anǝqäsäqqäsä
አንቀሳቀሰ	anǝqäsaqqäsä
አንቀባረረ	anǝqäbarrärä
አንቀዋለለ	anǝqäwallälä
አንቀጠቀጠ	anǝqäṭäqqäṭä
አንቃረረ	anǝqarrärä
አንቆረቆረ	anǝqoräqqorä
አንቋሸሸ	anǝqʷaššäšä
አንበለበለ	anǝbäläbbälä
አንበረከከ	anǝbäräkkäkä
አንበሳ	anǝbässa
አንበሸበሸ	anǝbäšäbbäšä
አንቦራቀቀ	anǝboraqqäqä
አንቦገቦገ	anǝbogäbbogä
አንቦጨቦጨ	anǝboč̣č̣äbboč̣ä
አንቦጫቦጨ	anǝboč̣č̣abboč̣ä
አንተላከሰ	anǝtälakkäsä
አንተረከከ	anǝtäräkkäkä
አንተከተከ	anǝtäkättäkä
አንተገተገ	anǝtägättägä
አንቺዬ	anǝčiyye
አንከረፈፈ	anǝkäräffäfä
አንከራተተ	anǝkärattätä
አንከበከበ	anǝkäbäkkäbä
አንከባለለ	anǝkäballälä
አንከባከበ	anǝkäbakkäbä
አንከተከተ	anǝkätäkkätä
አንከታከተ	anǝkätakkätä
አንከፈረረ	anǝkäfärrärä
አንካላ	anǝkalla
አንካሳ	anǝkassa
አንካሴ	anǝkasse
አንኳሰሰ	anǝkʷassäsä
አንኳኳ	anǝkʷakkʷa
አንዘላዘለ	anǝzälazzälä
አንዘረፈጠ	anǝzäräffäṭä
አንዘረፈፈ	anǝzäräffäfä
አንዘፈዘፈ	anǝzäfäzzäfä
አንዛረጠ	anǝzarräṭä
አንዛዛ	anǝzazza
አንዠቀዘቀ	anǝžäqäzzäqä
አንዠቀዠቀ	anǝžäqäžžäqä
አንዣበበ	anǝžabbäbä
አንዣባቢ	anǝžabbabi
አንደላቀቀ	anǝdälaqqäqä
አንደረበበ	anǝdäräbbäbä
አንደቀደቀ	anǝdäqäddäqä
አንደበደበ	anǝdäbäddäbä
አንደባለለ	anǝdäballälä
አንደኛ	anǝdäñña
አንደፋደፈ	anǝdäfaddäfä
አንዳች	anǝdačč
አንድም	anǝdǝmm
አንድነት	anǝdǝnnät
አንጀረገገ	anǝǧäräggägä
አንጀተ	anǝǧǧätä
አንገላታ	anǝgälatta
አንገረገበ	anǝgäräggäbä
አንገራገረ	anǝgäraggärä
አንገሸገሸ	anǝgäšäggäšä
አንገበገበ	anǝgäbäggäbä
አንገዋለለ	anǝgäwallälä
አንገደገደ	anǝgädäggädä
አንገዳገደ	anǝgädaggädä
አንገጫገጨ	anǝgäč̣aggäč̣ä
አንገፈገፈ	anǝgäfäggäfä
አንጋለለ	anǝgallälä
አንጋሬ	anǝgarre
አንጋደደ	anǝgaddädä
አንጋጋ	anǝgagga
አንጋፋ	anǝgaffa
አንግዋለለ	anǝgǝwallälä
አንጐራደደ	anǝgʷäraddädä
አንጐራጐረ	anǝgʷäraggʷärä
አንጐደጐደ	anǝgʷädäggʷädä
አንጓለለ	anǝgʷallälä
አንጕራጐረ	anǝgʷǝraggʷärä
አንጠራራ	anǝṭärrara
አንጠራራኝ	anǝṭäraraññ
አንጠራወዘ	anǝṭärawwäzä
አንጥረኛ	anǝṭǝräñña
አንጨረፈፈ	anǝč̣äräffäfä
አንጸባረቀ	anǝṣäbarräqä
አንፈራገጠ	anǝfäraggäṭä
አንፈራፈረ	anǝfäraffärä
አንፈቀፈቀ	anǝfäqäffäqä
አንፏቀቀ	anǝfʷaqqäqä
አንፏቃቂ	anǝfʷaqqaqi
አኘከ	aññäkä
አኢሉባቦር	aʾilubbabor
አከለ	akkälä
አከላከለ	akkälakkälä
አከል	akkäl
አከመ	akkämä
አከመቻቸ	akämäčaččä
አከማቸ	akkämaččä
አከረመ	akärrämä
አከረረ	akärrärä
አከረፋ	akäräffa
አከራካሪ	akkärakari
አከራየ	akkärayyä
አከሰለ	akässälä
አከሰመ	akässämä
አከሰረ	akässärä
አከሰከሰ	akäsäkkäsä
አከሳ	akässa
አከበረ	akäbbärä
አከበደ	akäbbädä
አከባበረ	akäbabbärä
አከባበር	akkäbabär
አከተ	akkätä
አከተመ	akättämä
አከታተለ	akkätattälä
አከነነ	akännänä
አከነፈ	akännäfä
አከናነበ	akkänannäbä
አከናወ	akkännawä
አከናወነ	akkänawwänä
አከከ	akkäkä
አከድዬ	akkädǝyye
አከፈለ	akäffälä
አከፋ	akäffa
አከፋፈለ	akkäfaffälä
አከፋፋይ	akkäfafay
አካለለ	akkalälä
አካለሰ	akkalläsä
አካመረ	akkammärä
አካሚ	akkami
አካሰሰ	akkassäsä
አካበበ	akkabbäbä
አካበተ	akabbätä
አካባቢ	akkababi
አካተተ	akkattätä
አካቴ	akkate
አካከከ	akakkäkä
አካካሰ	akkakasä
አካደነ	akkaddänä
አካፈለ	akkaffälä
አካፋ	akaffa
አካፋይ	akkafay
አክ	akk
አክለፈለፈ	akǝläfälläfä
አክታ	akkǝta
አኮላሸ	akkolaššä
አኮመታተረ	akkomätattärä
አኮማተረ	akkomattärä
አኮረፈ	akorräfä
አኮራ	akorra
አኮራመተ	akkorammätä
አኮሰመነ	akosämmänä
አኮበለለ	akobällälä
አኰረተ	akʷärrätä
አኰሰሰ	akʷässäsä
አኰበኰበ	akʷäbäkkʷäbä
አኰቴት	akkʷätet
አኳሁዋን	akkʷahuwan
አኳሰሰ	akʷassäsä
አወለቀ	awälläqä
አወለወለ	awäläwwälä
አወለጋገደ	awwälägaggädä
አወላለቀ	awälalläqä
አወላመመ	awwälammämä
አወላከፈ	awwälakkäfä
አወላካፊ	awwälakafi
አወላወለ	awwälawwälä
አወላገደ	awwälaggädä
አወረሰ	awärräsä
አወረዛ	awäräzza
አወረደ	awärrädä
አወራ	awärra
አወራረሰ	awärarräsä
አወራረደ	awärarrädä
አወራጨ	awwärač̣ä
አወሰለተ	awäsällätä
አወሳ	awässa
አወበቀ	awäbbäqä
አወናበደ	awwänabbädä
አወናባጅ	awwänabbaǧ
አወናከረ	awwänakkärä
አወናፈለ	awwänaffälä
አወከ	awwäkä
አወካ	awäkka
አወዛወዘ	awwäzawwäzä
አወደለ	awäddälä
አወደመ	awäddämä
አወደሰ	awäddäsä
አወዳደረ	awwädaddärä
አወዳዳሪ	awwädadari
አወጋ	awägga
አወጣ	awäṭṭa
አወጣጣ	awwäṭaṭṭa
አወፈረ	awäffärä
አዋለደ	awwallädä
አዋላጅ	awwalaǧ
አዋልደጌሻ	awalǝdägešša
አዋሐደ	awwaḥadä
አዋረደ	awwarrädä
አዋራ	awwara
አዋሰነ	awwassänä
አዋሰደ	awwassädä
አዋሳኝ	awwasañ
አዋሸከ	awwaššäkä
አዋቀጠ	awwaqqäṭä
አዋቃ	awwaqqa
አዋኪ	awwaki
አዋዋለ	awwawalä
አዋዋይ	awwaway
አዋዛ	awwazza
አዋየ	awwayä
አዋደደ	awwaddädä
አዋጊ	awwagi
አዋጋ	awwagga
አዋጠረ	awwaṭṭärä
አዋጣ	awwaṭṭa
አዋጪ	awwač̣i
አውለበለበ	awǝläbälläbä
አውላላ	awǝlalla
አውራጃ	awǝrraǧa
አውሬነት	awǝrennät
አውሮፓ	awǝroppa
አውሮፕላን	awǝroppǝlan
አውተረተረ	awǝtärättärä
አውተፈተፈ	awǝtäfättäfä
አውታታ	awǝtatta
አውደለደለ	awǝdäläddälä
አውድማ	awǝdǝmma
አውጫጭኝ	awǝč̣ač̣č̣ǝññ
አዘለ	azzälä
አዘለለ	azzälälä
አዘለቀ	azälläqä
አዘለፈ	azzälläfä
አዘመመ	azämmämä
አዘመረ	azämmärä
አዘመተ	azämmätä
አዘረዘረ	azzäräzzärä
አዘረገፈ	azzäräggäfä
አዘረጋ	azzäräga
አዘረጋጋ	azzärägagga
አዘረጠ	azärräṭä
አዘረጠጠ	azzäräṭäṭä
አዘረፈ	azzärräfä
አዘራ	azzära
አዘቀዘቀ	azäqäzzäqä
አዘቀጠ	azäqqäṭä
አዘበራረቀ	azzäbärarräqä
አዘባረቀ	azzäbarräqä
አዘባነነ	azzäbannänä
አዘነ	azzänä
አዘነበ	azännäbä
አዘነበለ	azänäbbälä
አዘነጋ	azänägga
አዘነጠለ	azzänäṭṭälä
አዘናከተ	azzänakkätä
አዘናጋ	azzänagga
አዘንተኛ	azänǝtäñña
አዘከረ	azäkkärä
አዘከዘከ	azzäkäzzäkä
አዘወረ	azzäwwärä
አዘወተረ	azäwättärä
አዘዘ	azzäzä
አዘገመ	azäggämä
አዘገነ	azzäggänä
አዘገየ	azägäyyä
አዘገጀ	azzägäǧǧä
አዘጋ	azzägga
አዘጋጀ	azzägaǧǧä
አዘጋገመ	azägaggämä
አዘጠዘጠ	azäṭäzzäṭä
አዘፈቀ	azäffäqä
አዘፈነ	azzäffänä
አዛለቀ	azzalläqä
አዛመተ	azzammätä
አዛመደ	azzammädä
አዛማች	azzamač
አዛማጅ	azzamaǧ
አዛቀ	azzaqä
አዛባ	azzabba
አዛነፈ	azzannäfä
አዛወረ	azzawwärä
አዛዘነ	azazzänä
አዛዥ	azzaž
አዛጋ	azzagga
አዛፈነ	azzaffänä
አዝለገለገ	azǝlägällägä
አዝማሚያ	azǝmammiya
አዝረበረበ	azǝräbbärräbä
አዝረከረከ	azǝräkärräkä
አዝረጠረጠ	azǝräṭärräṭä
አዝረፈረፈ	azǝräfärräfä
አዝናና	azǝnanna
አዝጎረጎረ	azǝgorägorrä
አዞ	azzo
አዠ	ažžä
አዠለጠ	ažžälläṭä
አዥጎረጎረ	ažǝgoräggorä
አዥጎደጎደ	ažǝgodäggodä
አዥጐረጐረ	ažǝgʷäräggʷärä
አየ	ayyä
አየለ	ayyälä
አየር	ayyär
አየው	ayyäw
አያ	ayya
አያሌ	ayyale
አያያ	ayyayya
አያያዘ	ayyayazä
አያያዝ	ayyayaz
አይልም	ayǝlǝmm
አይቀርም	ayǝqärǝmm
አይደለም	ayǝdälläm
አይገባኝም	ayǝgäbaññǝm
አይጥማ	ayǝṭǝmma
አደለ	addälä
አደለበ	adälläbä
አደላ	adälla
አደላደለ	addäladdälä
አደላዳይ	addäladay
አደመ	addämä
አደመቀ	adämmäqä
አደመጠ	adämmäṭä
አደማ	adämma
አደረ	addärä
አደረሰ	adärräsä
አደረገ	addärrägä
አደረገው	adärrägäw
አደራ	adärra
አደራረግ	addäraräg
አደራደረ	addäraddärä
አደራጀ	adäraǧǧä
አደራጅ	addäraǧ
አደር	addär
አደርክ	addärǝk
አደሰ	addäsä
አደሸደሸ	adäšäddäšä
አደቀቀ	adäqqäqä
አደበ	addäbä
አደበነ	adäbbänä
አደበዘዘ	adäbäzzäzä
አደባ	addäba
አደባለቀ	adäballäqä
አደባባይ	addäbabay
አደባየ	adäbayyä
አደብ	addäb
አደነ	addänä
አደነቀ	adännäqä
አደነቆረ	adänäqqorä
አደነዘ	adännäzä
አደነዘዘ	adänäzzäzä
አደነጋገረ	addänägaggärä
አደናቀፈ	addänaqqäfä
አደናበረ	addänabbärä
አደናባሪ	addänabari
አደናገረ	addänaggärä
አደናገጠ	addänaggäṭä
አደናጋሪ	addänagari
አደን	addän
አደንጓሬ	adänǝgʷarre
አደከመ	adäkkämä
አደኸየ	adäẖäyyä
አደዘደዘ	adäzäddäzä
አደደበ	adäddäbä
አደገ	addägä
አደገኛ	adägäñña
አደገደ	adäggädä
አደግ	addäg
አደፈ	addäfä
አደፈረሰ	addäfäräsä
አደፈጠ	adäffäṭä
አደፋፈረ	addäfaffärä
አዱኛ	adduñña
አዲስ	addis
አዳለጠ	adalläṭä
አዳላ	addalla
አዳመረ	addammärä
አዳመቀ	addammäqä
አዳመጠ	addammäṭä
አዳሚ	addami
አዳማቂ	addammaqi
አዳም	addam
አዳምና	addamǝnna
አዳረሰ	addarräsä
አዳራሽ	addaraš
አዳሽ	addaš
አዳቀለ	addaqqälä
አዳቀቀ	addaqqäqä
አዳበለ	addabbälä
አዳበረ	adabbärä
አዳባይ	addabay
አዳነቀ	adannäqä
አዳኝ	addañ
አዳከመ	addakkämä
አዳወረ	adawwärä
አዳይ	adday
አዳደለ	adaddälä
አዳደሰ	adaddäsä
አዳገተ	adaggätä
አዳፈነ	adaffänä
አዳፋ	addaffa
አዳፍኔ	addafǝne
አድሎኛ	adǝloñña
አድመኛ	adǝmäñña
አድረገ	adǝrrägä
አድራሻ	adǝrašša
አድበለበለ	adǝbäläbbälä
አድበሰበሰ	adǝbäsäbbäsä
አድቦለቦለ	adǝboläbbolä
አድፈነፈነ	adǝfänäffänä
አድፋፋ	adǝfaffa
አዶ	addo
አዶለዶመ	adoläddomä
አጀለ	aǧǧälä
አጀበ	aǧǧäbä
አጃ	aǧǧa
አጃቢ	aǧǧabi
አጃጃለ	aǧǧaǧalä
አጃገነ	aǧǧagänä
አጅሬ	aǧǧǝre
አገለለ	agällälä
አገለሞተ	agälämmotä
አገለደመ	agäläddämä
አገለገለ	agällägälä
አገላበጠ	aggälabbäṭä
አገመ	aggämä
አገማ	agämma
አገሣ	agäśśa
አገረሸ	agäräššä
አገረሸበት	agäräššäbbät
አገሸሸ	agäššäšä
አገባ	agäbba
አገባብ	aggäbab
አገባት	agäbbat
አገባደደ	aggäbaddädä
አገተ	aggätä
አገነፋ	agänäffa
አገናኘ	agänaññä
አገናኝ	aggänaññ
አገናዘበ	aggänazäbä
አገናዛቢ	aggänazabi
አገኘ	agäññä
አገዘ	aggäzä
አገዝ	aggäz
አገደ	aggädä
አገደመ	agäddämä
አገደፈ	agäddäfä
አገድ	aggäd
አገገመ	agäggämä
አገጋሚ	agäggami
አገጫጨ	aggäč̣ač̣č̣ä
አጋለጠ	aggalläṭä
አጋመሰ	aggammäsä
አጋሚ	aggami
አጋማሽ	aggamaš
አጋሪ	aggari
አጋራ	aggara
አጋር	aggar
አጋሰሰ	agassäsä
አጋሰስ	agassäs
አጋበሰ	agabbäsä
አጋባ	aggabba
አጋተረ	aggattärä
አጋነነ	aggannänä
አጋኖ	agganno
አጋዛ	aggazza
አጋዥ	aggaž
አጋየ	agayyä
አጋደለ	agaddälä
አጋደመ	aggaddämä
አጋደደ	aggaddädä
አጋጅ	aggaǧ
አጋጋለ	aggagalä
አጋጋመ	aggagamä
አጋጠመ	aggaṭṭämä
አጋጣሚ	aggaṭami
አጋጨ	aggač̣ä
አጋፈረ	aggafärä
አጋፈጠ	aggaffäṭä
አጋፋሪ	aggafari
አግበሰበሰ	agǝbäsäbbäsä
አግተለተለ	agǝtälättälä
አግዶኝ	agǝddoññ
አግጣጫ	agǝṭač̣č̣a
አግፈለፈለ	agǝfäläffälä
አጎላመሰ	agolammäsä
አጎላማሽ	aggolamaš
አጎመዘዘ	agomäzzäzä
አጎረሰ	agorräsä
አጎራበተ	aggorabbätä
አጎት	aggot
አጎናጠፈ	aggonaṭṭäfä
አጎደለ	agoddälä
አጎፈረ	agoffärä
አጐላ	agʷälla
አጐረ	aggʷärä
አጐረና	agʷäränna
አጐራ	agʷärra
አጐሳቈለ	agʷäsaqqʷälä
አጐበደደ	agʷäbäddädä
አጐበጐበ	agʷäbäggʷäbä
አጐበጠ	agʷäbbäṭä
አጐተነ	agʷättänä
አጐነቈለ	agʷänäqqʷälä
አጐነበሰ	agʷänäbbäsä
አጐደጐደ	agʷädäggʷädä
አጓመጠ	agʷammäṭä
አጓራ	agʷarra
አጓት	aggʷat
አጓደደ	aggʷaddädä
አጓጐለ	agʷaggʷälä
አጓጓዘ	aggʷagʷazä
አጕመተመተ	agʷǝmätämmätä
አጕረመረመ	agʷǝrämärrämä
አጕረጠረጠ	agʷǝräṭärräṭä
አጕተመተመ	agʷǝtämättämä
አጠለለ	aṭällälä
አጠለቀ	aṭälläqä
አጠለቀው	aṭälläqäw
አጠመቀ	aṭämmäqä
አጠማ	aṭämma
አጠረሰ	aṭärräsä
አጠረኝ	aṭṭäräññ
አጠራ	aṭärra
አጠራቀመ	aṭṭäraqqämä
አጠቀሰ	aṭäqqäsä
አጠቃ	aṭäqqa
አጠቃለለ	aṭṭäqallälä
አጠቆረ	aṭäqqorä
አጠበቀ	aṭäbbäqä
አጠበበ	aṭäbbäbä
አጠባ	aṭäbba
አጠነባ	aṭänäbba
አጠነነ	aṭännänä
አጠነከረ	aṭänäkkärä
አጠነፈፈ	aṭänäffäfä
አጠና	aṭänna
አጠናቀረ	aṭṭänaqqärä
አጠናቀቀ	aṭṭänaqqäqä
አጠናከረ	aṭṭänakkärä
አጠናጋ	aṭänagga
አጠየቀ	aṭäyyäqä
አጠያየፈ	aṭṭäyayyäfä
አጠገበ	aṭäggäbä
አጠጋጋ	aṭṭägagga
አጠፈፈ	aṭäffäfä
አጠፋ	aṭäffa
አጣላ	aṭṭala
አጣመመ	aṭammämä
አጣመረ	aṭammärä
አጣመደ	aṭammädä
አጣራ	aṭṭara
አጣቀሰ	aṭṭaqqäsä
አጣበቀ	aṭṭabbäqä
አጣበበ	aṭṭabbäbä
አጣብቂኝ	aṭṭabǝqiññ
አጣየቀ	aṭṭayyäqä
አጣደፈ	aṭṭaddäfä
አጣገበ	aṭṭaggäbä
አጣፈረ	aṭṭaffärä
አጣፈጠ	aṭaffäṭä
አጣፋ	aṭṭaffa
አጥለቀለቀ	aṭǝläqälläqä
አጥላላ	aṭǝlalla
አጥመለመለ	aṭǝmälämmälä
አጥመዘመዘ	aṭǝmäzämmäzä
አጥበረበረ	aṭǝbäräbbärä
አጥናና	aṭǝnanna
አጥወለወለ	aṭǝwäläwwälä
አጥፊና	aṭǝfinna
አጨለመ	ač̣ällämä
አጨለገ	ač̣ällägä
አጨማለቀ	ač̣č̣ämalläqä
አጨማተረ	ač̣č̣ämattärä
አጨማደደ	ač̣č̣ämaddädä
አጨራመመ	ač̣č̣ärammämä
አጨራመደ	ač̣č̣ärammädä
አጨቀየ	ač̣äqäyyä
አጨባበጠ	ač̣č̣äbabbäṭä
አጨነቆረ	ač̣änäqqorä
አጨነጎለ	ač̣č̣änäggolä
አጨናገፈ	ač̣č̣änaggäfä
አጫረሰ	ač̣č̣arräsä
አጫረተ	ač̣č̣arrätä
አጫወተ	ač̣č̣awwätä
አጭበረበረ	ač̣ǝbäräbbärä
አጸለየ	aṣṣälläyä
አጸና	aṣänna
አጸየፈ	aṣṣäyyäfä
አጸያፊ	aṣṣäyyafi
አጸደቀ	aṣäddäqä
አጸዳ	aṣädda
አጽናና	aṣǝnanna
አፈለሰ	afälläsä
አፈለቀ	afälläqä
አፈላ	afälla
አፈረ	affärä
አፈረጠ	afärräṭä
አፈረጠው	afärräṭäw
አፈራ	afärra
አፈራረሰ	afärarräsä
አፈሰ	affäsä
አፈሰሰ	affässäsä
አፈቀረ	affäqqärä
አፈተለከ	afätälläkä
አፈታበት	afättabbät
አፈታተነ	affätattänä
አፈነ	affänä
አፈነደደ	afänäddädä
አፈነዳ	afänädda
አፈነገጠ	afänäggäṭä
አፈነፈነ	afänäffänä
አፈናቀለ	affänaqqälä
አፈናጠረ	affänaṭṭärä
አፈናጠጠ	affänaṭṭäṭä
አፈኛ	afäñña
አፈከፈ	afäkkäfä
አፈካ	afäkka
አፈዘዘ	afäzzäzä
አፈገ	affägä
አፈገመ	afäggämä
አፈገፈገ	afägäffägä
አፈፈ	affäfä
አፈፍ	afäff
አፋለመ	affallämä
አፋለሰ	affalläsä
አፋለገ	affallägä
አፋረደ	affarädä
አፋራም	affaram
አፋር	affar
አፋሰሰ	affassäsä
አፋሸገ	afaššägä
አፋቀረ	affaqqärä
አፋተለ	affattälä
አፋተገ	affattägä
አፋታ	affata
አፋኝ	affañ
አፋዘዘ	affazzäzä
አፋደሰ	afaddäsä
አፋጀ	affaǧǧä
አፋጠነ	affaṭṭänä
አፋጠጠ	affaṭṭäṭä
አፋጣኝ	affaṭañ
አፋጨ	affač̣č̣ä
አፋፋመ	affafamä
አፍለቀለቀ	afǝläqälläqä
አፍለኛ	afǝläñña
አፍታታ	afǝtatta
አፍንጫማ	afǝnǝč̣amma
አፍኖ	affǝno
አፎካከረ	affokakkärä
አፓርትማ	apparǝtǝma
ኢትዮጲያ	itǝyop̣p̣iya
ኢትዮጲያዊ	itǝyop̣p̣iyawi
ኢትዮጵያዊት	itǝyop̣p̣ǝyawit
ኢየሩሳሌም	iyyärusalem
ኢየሱሳዊ	iyyäsusawi
ኢየሱስ	iyyäsus
ኢዮቤልዩ	iyyobelǝyu
ኢጣልያኛ	iṭalǝyañña
ኤክዌተር	ekkǝwetär
እላቂ	ǝllaqi
እልም	ǝllǝm
እልቂት	ǝlǝqitt
እልቅ	ǝlǝqq
እልቅት	ǝllǝqǝt
እልቅና	ǝlǝqǝnna
እልባት	ǝllǝbat
እልከኛ	ǝllǝkäñña
እልክ	ǝllǝk
እልፊት	ǝlǝfitt
እልፍኝ	ǝlǝfǝññ
እመ	ǝmmä
እመምተኛ	ǝmämǝtäñña
እመር	ǝmmär
እመቤታችን	ǝmmäbetaččǝn
እመቤት	ǝmmäbet
እመት	ǝmmät
እመጫት	ǝmmäč̣at
እማሆይ	ǝmmahoy
እሜቴ	ǝmmete
እምር	ǝmmǝr
እምስ	ǝmmǝs
እምቢልተኛ	ǝmǝbilǝtäñña
እምቢተኛ	ǝmǝbitäñña
እምብዛም	ǝmǝbǝzamm
እምቦሳ	ǝmǝbossa
እምዬ	ǝmmǝye
እሥረኛ	ǝśǝräñña
እሥራት	ǝśśǝrat
እሥር	ǝśśǝr
እረኛ	ǝrräñña
እረኝነት	ǝrräññǝnnät
እራሪ	ǝrrari
እራሽ	ǝrraš
እርማት	ǝrrǝmat
እርምጃ	ǝrǝmǝǧǧa
እርይ	ǝrrǝy
እርጅና	ǝrǝǧǝnna
እርግዝና	ǝrǝgǝzǝnna
እርግጠኛ	ǝrǝgǝṭäñña
እርግፍ	ǝrǝgǝff
እሮምታ	ǝrromǝta
እሰይ	ǝssäy
እሳ	ǝssa
እሳት	ǝssat
እሳትና	ǝsatǝnna
እሳቸው	ǝssaččäw
እስልምና	ǝsǝlǝmǝnna
እስከነ	ǝsǝkännä
እስከናካቴው	ǝsǝkännakkatew
እስከዚህ	ǝsǝkäzzih
እስከዚያ	ǝsǝkäzziya
እስፓንኛ	ǝsǝpanǝñña
እሸትነት	ǝšätǝnnät
እሹሩሩ	ǝššururu
እሺ	ǝšši
እሽ	ǝšš
እሽም	ǝššǝm
እሽሩሩ	ǝššǝruru
እሽቅድድም	ǝšǝqǝdǝddǝm
እሽግ	ǝššǝg
እቀጭታ	ǝqqäč̣č̣ǝta
እቅፍ	ǝqqǝf
እበት	ǝbbät
እቡይ	ǝbbuy
እባካችሁ	ǝbakkaččǝhu
እባክህ	ǝbakkǝh
እባክሽ	ǝbakkǝš
እባክዎን	ǝbakkǝwon
እባጭ	ǝbbač̣
እብሪተኛ	ǝbǝritäñña
እብስ	ǝbbǝss
እቴዋ	ǝtewwa
እትማማች	ǝtǝmmamač
እትማማችነት	ǝtǝmmamačǝnnät
እትም	ǝttǝm
እትዬ	ǝtǝyye
እትፍ	ǝttǝf
እትፍታ	ǝttǝfǝta
እችግር	ǝčǝggǝr
እነ	ǝnnä
እነሆ	ǝnnäho
እነማን	ǝnnämann
እነኋት	ǝnnäḫʷat
እነኛ	ǝnnäñña
እነዚያ	ǝnnäzziya
እና	ǝnna
እናት	ǝnnat
እናትነት	ǝnnatǝnnät
እናትና	ǝnnatǝnna
እንስሳነት	ǝnǝsǝsannät
እንስትነት	ǝnǝsǝtǝnnät
እንቃቅላ	ǝnǝqaqǝlla
እንቅስቃሴ	ǝnǝqǝssǝqqase
እንቅጥቃጤ	ǝnǝqǝṭǝqqaṭe
እንቆቅልሽ	ǝnǝqoqǝllǝš
እንቆቆ	ǝnǝqoqqo
እንብርክ	ǝnǝbǝrǝkk
እንትና	ǝnǝtǝnna
እንትፍ	ǝnǝtǝff
እንቺ	ǝnǝčči
እንክርት	ǝnǝkǝrrǝt
እንክብል	ǝnǝkǝbǝll
እንክብካቤ	ǝnǝkǝbǝkkabe
እንኮኮ	ǝnǝkokko
እንደልብ	ǝnǝdälǝbb
እንደገና	ǝnǝdäggäna
እንዲሁም	ǝnǝdihumm
እንጃለት	ǝnǝǧallät
እንጃልህ	ǝnǝǧallǝh
እንጃልሽ	ǝnǝǧallǝš
እንጃልኝ	ǝnǝǧallǝññ
እንጃባቱ	ǝnǝǧabbatu
እንጆሪ	ǝnǝǧorri
እንግሊዘኛ	ǝnǝgǝlizäñña
እንግልት	ǝnǝgǝlǝtt
እንግዲማ	ǝnǝgǝdimma
እንግዲያስ	ǝnǝgǝdiyass
እንጐቻ	ǝnǝgʷäčča
እንጕርጕሮ	ǝnǝgʷǝrǝggʷǝro
እንፍሌ	ǝnǝfǝlle
እኛ	ǝñña
እኝኝ	ǝññǝññ
እኩለ	ǝkkulä
እኩሌታ	ǝkkuleta
እኩል	ǝkkul
እኩያ	ǝkkuyya
እክላም	ǝkkǝlam
እክል	ǝkkǝl
እኮ	ǝkko
እውልኛ	ǝwǝllǝñña
እውነተኛ	ǝwǝnätäñña
እውነተኛነት	ǝwǝnätäññannät
እውነትም	ǝwǝnätǝmm
እዚህ	ǝzzih
እዚያ	ǝzziya
እየመጣ	ǝyyämäṭṭa
እየቅሉ	ǝyyäqǝlu
እየተጠና	ǝyätäṭänna
እያንዳንዱ	ǝyyanǝdanǝdu
እያደር	ǝyyaddär
እደሳ	ǝddäsa
እዳሪ	ǝddari
እድለ	ǝddǝlä
እድል	ǝddǝl
እድመኛ	ǝdǝmäñña
እድር	ǝddǝr
እድርተኛ	ǝddǝrǝtäñña
እጀ	ǝǧǧä
እጀታ	ǝǧǧäta
እጁን	ǝǧǧun
እጄ	ǝǧǧe
እጅ	ǝǧǧ
እጅብ	ǝǧǧǝb
እጅና	ǝǧǧǝna
እጅጉን	ǝǧǧǝgun
እጅጌ	ǝǧǧǝge
እጅግ	ǝǧǝgg
እገዛ	ǝggäza
እገዳ	ǝggäda
እግረኛ	ǝgǝräñña
እግድ	ǝggǝd
እጥቤ	ǝṭṭǝbbe
እጭድ	ǝč̣č̣ǝd
እፉኝት	ǝfuññǝt
እፊያ	ǝffiya
እፋሽ	ǝffaš
እፋፊ	ǝffafi
እፍ	ǝff
እፍኝ	ǝffǝñ
እፍግ	ǝffǝg
እፍግፍግ	ǝfǝgǝfǝgg
እፎይ	ǝffoy
እፎይታ	ǝffoyǝta
ከሁሉ	kähullu
ከለለ	källälä
ከለላ	källäla
ከለሰ	källäsä
ከለበ	källäbä
ከለበሰ	källäbbäsä
ከለቻ	källäčča
ከለከለ	käläkkälä
ከለፈ	källäfä
ከለፍላፋ	käläfǝlaffa
ከላሽ	källaš
ከላባ	källaba
ከል	käll
ከመረ	kämmärä
ከመቼ	kämäčče
ከመቼውም	kämäččewǝmm
ከመከመ	kämäkkämä
ከማሪ	kämmari
ከሞላ	kämolla
ከሠተ	käśśätä
ከሠተለት	käśśätällät
ከሠተበት	käśśätäbbät
ከረመ	kärrämä
ከረረ	kärrärä
ከረበተ	käräbbätä
ከረተፈ	kärättäfä
ከረከመ	käräkkämä
ከረከረ	käräkkärä
ከረደደ	käräddädä
ከረፋ	käräffa
ከርታታ	kärǝtatta
ከርከሮ	kärǝkärro
ከርዳዳ	kärǝdadda
ከርፋፋ	kärǝffafa
ከሰለ	kässälä
ከሰልማ	käsälǝmma
ከሰመ	kässämä
ከሰረ	kässärä
ከሰሰ	kässäsä
ከሰበ	kässäbä
ከሰከሰ	käsäkkäsä
ከሲታ	kässitta
ከሳ	kässa
ከሳራ	kässara
ከሳይ	kässay
ከሸነ	käššänä
ከሸፈ	käššäfä
ከበረ	käbbärä
ከበርቴ	käbbärǝte
ከበሰ	käbbäsä
ከበበ	käbbäbä
ከበተ	käbbätä
ከበደ	käbbädä
ከባዳ	käbbada
ከባድ	käbbad
ከተለበ	kätälläbä
ከተል	kättäll
ከተመ	kättämä
ከተረ	kättärä
ከተበ	kättäbä
ከተተ	kättätä
ከተከተ	kätäkkätä
ከተፈ	kättäfä
ከት	kätt
ከትቢያ	kätǝbbiya
ከቶ	kätto
ከቶውንም	kättowǝnǝmm
ከቸረ	käččärä
ከቸቸ	käččäčä
ከቻራ	käčarra
ከች	käčč
ከነበለ	känäbbälä
ከነቤተሰቡ	kännäbetäsäbu
ከነተረ	känättärä
ከነነ	kännänä
ከነአካቴው	kännäʾakkatew
ከነከነ	känäkkänä
ከነዳ	känädda
ከነፈ	kännäfä
ከንቱነት	känǝtunnät
ከካ	käkka
ከውታታ	käwǝtatta
ከውካዋ	käwǝkawwa
ከዚህ	käzzih
ከዚህም	käzzihǝm
ከዚያ	käzziya
ከደነ	käddänä
ከዳ	kädda
ከዳተኛ	kädatäñña
ከጀለ	käǧǧälä
ከፈለ	käffälä
ከፈተ	käffätä
ከፈነ	käffänä
ከፈከፈ	käfäkkäfä
ከፈፈ	käffäfä
ከፋ	käffa
ከፋኝ	käffañ
ከፋፈለ	käfaffälä
ከፋፈተ	käfaffätä
ከፍ	käff
ከፍራራ	käfǝrrara
ከፍተኛ	käffǝtäñña
ከፍታ	käffǝta
ኩሊነት	kulinnät
ኩልሽት	kulǝššǝt
ኩምትርትር	kumǝtǝrǝtǝrr
ኩረጃ	kurräǧa
ኩራተኛ	kuratäñña
ኩራዝ	kurraz
ኩርምት	kurǝmǝtt
ኩርምትምት	kurǝmǝtǝmǝtt
ኩርትም	kurǝtǝmm
ኩርትምትም	kurǝtǝmǝtǝmm
ኩባያ	kubbayya
ኩብ	kubb
ኩብኩባ	kubǝkubba
ኩይሳ	kuyyǝsa
ኩፍ	kuff
ኩፍኝ	kuffǝññ
ኪራየተኛ	kirayätäñña
ካባ	kabba
ካቤላ	kabella
ካቦ	kabbo
ካቻምና	kaččamǝna
ካች	kačč
ካንዴላ	kanǝdella
ካካ	kakka
ካውያ	kawǝyya
ካደመ	kaddämä
ካዳሚ	kaddami
ካፊያ	kaffiya
ካፍያ	kaffǝya
ካፒታሊዝም	kappitalizǝm
ካፖርት	kapporǝt
ኬላ	kella
ክለሳ	kǝlläsa
ክልል	kǝllǝl
ክልስ	kǝllǝs
ክልብሽ	kǝlǝbǝšš
ክልብሽታ	kǝllǝbǝšǝta
ክመራ	kǝmmära
ክምር	kǝmmǝr
ክምቹ	kǝmǝčču
ክምችት	kǝmǝččǝt
ክር	kǝrr
ክርስትና	kǝrǝsǝtǝnna
ክርክም	kǝrǝkkǝm
ክርክር	kǝrǝkkǝr
ክርድ	kǝrǝdd
ክርፍፍ	kǝrǝfǝff
ክስ	kǝss
ክብ	kǝbb
ክብልል	kǝbǝlǝll
ክብርና	kǝbǝrǝnna
ክብብ	kǝbǝbb
ክብነት	kǝbbǝnnät
ክት	kǝtt
ክትር	kǝttǝr
ክትባት	kǝttǝbat
ክትትል	kǝtǝttǝl
ክትካች	kǝtǝkkač
ክችች	kǝččǝč
ክንውን	kǝnǝwwǝn
ክካም	kǝkkam
ክክ	kǝkk
ክው	kǝww
ክውትት	kǝwǝtǝtt
ክጀላ	kǝǧǧäla
ክፉኛ	kǝfuñña
ክፋተኛ	kǝfatäñña
ክፋይ	kǝffay
ክፍ	kǝff
ክፍት	kǝffǝt
ክፍያ	kǝfǝyya
ኮምፓስ	komǝpass
ኮረሸመ	koräššämä
ኮረብታማ	koräbǝtamma
ኮረጀ	korräǧä
ኮረጠ	korräṭä
ኮራ	korra
ኮርማታ	korǝmatta
ኮርቻ	korǝčča
ኮሰመነ	kosämmänä
ኮስማና	kosǝmanna
ኮስታራ	kosǝtarra
ኮሸሽ	košäšš
ኮበለለ	kobällälä
ኮተኮተ	kotäkkotä
ኮቴ	kotte
ኮትቻ	kotǝčča
ኮዳ	kodda
ኮፈኮፈ	kofäkkofä
ኰለለ	kʷällälä
ኰለል	kʷälläl
ኰላ	kʷälla
ኰልታፋ	kʷälǝtaffa
ኰልኰሎ	kʷälǝkʷällo
ኰመኰመ	kʷämäkkʷämä
ኰረተመ	kʷärättämä
ኰረታተመ	kʷärätattämä
ኰረኰመ	kʷäräkkʷämä
ኰረኰረ	kʷäräkkʷärä
ኰረዳ	kʷärädda
ኰረፈ	kʷärräfä
ኰረፌ	kʷärräfe
ኰሰሰ	kʷässäsä
ኰሰተረ	kʷäsättärä
ኰሰኰሰ	kʷäsäkkʷäsä
ኰሳሳ	kʷässasa
ኰሳሳነት	kʷäsasannät
ኰስታራ	kʷäsǝtarra
ኰስኳሳ	kʷäsǝkʷassa
ኰነነ	kʷännänä
ኰናኝ	kʷännañ
ኵርፈኛ	kʷǝrǝfäñña
ኵርፍተኛ	kʷǝrrǝfǝtäñña
ወለል	wäläll
ወለም	wälämm
ወለቀ	wälläqä
ወለወለ	wäläwwälä
ወለደ	wällädä
ወለድ	wälläd
ወለገደ	wäläggädä
ወለጋ	wälläga
ወላለቀ	wälalläqä
ወላለደ	wälallädä
ወላወለ	wälawwälä
ወላይታ	wälayǝtta
ወላይትኛ	wälayǝtǝñña
ወላድ	wällad
ወልማማ	wälǝmmama
ወልካፋ	wälǝkkafa
ወልጋዳ	wälǝgadda
ወሎ	wällo
ወመቴ	wämmäte
ወረረ	wärrärä
ወረርሽኝ	wärärǝšǝññ
ወረሰ	wärräsä
ወረቦ	wäräbbo
ወረተኛ	wärätäñña
ወረክራካ	wäräkǝrakka
ወረወረ	wäräwwärä
ወረዛ	wäräzza
ወረደ	wärrädä
ወረገኑ	wärrägänu
ወረፈ	wärräfä
ወራረደ	wärarrädä
ወራዳ	wärradda
ወራዳነት	wärraddannät
ወራፊ	wärrafi
ወሬኛ	wäreñña
ወርቃማ	wärǝqamma
ወርድና	wärǝdǝnna
ወሮበላ	wärrobälla
ወሰለተ	wäsällätä
ወሰራ	wäsärra
ወሰነ	wässänä
ወሰን	wässän
ወሰንተኛ	wäsänǝtäñña
ወሰወሰ	wäsäwwäsä
ወሰደ	wässädä
ወሰደው	wässädäw
ወሰድ	wäsädd
ወሳኝ	wässañ
ወሳፍቻ	wässafǝčča
ወስላታ	wäsǝlatta
ወስዋሳ	wäsǝwassa
ወሸለ	wäššälä
ወሸመ	wäššämä
ወሸቀ	wäššäqä
ወሸከተ	wäšäkkätä
ወሻቃ	wäššaqqa
ወሽመላ	wäšǝmälla
ወሽካታ	wäšǝkatta
ወቀረ	wäqqärä
ወቀሰ	wäqqäsä
ወቀሳ	wäqässa
ወቀጠ	wäqqäṭä
ወቃ	wäqqa
ወበራ	wäbärra
ወበቀ	wäbbäqä
ወባማ	wäbamma
ወቦ	wäbbo
ወተወተ	wätäwwätä
ወተፈ	wättäfä
ወተፍታፋ	wätäfǝtaffa
ወታደራዊ	wättaddärawi
ወታደር	wätaddär
ወታደርነት	wätaddärǝnnät
ወታፋ	wättaffa
ወትዋታ	wätǝwwata
ወነበደ	wänäbbädä
ወነከረ	wänäkkärä
ወነወነ	wänäwwänä
ወነጀለ	wänäǧǧälä
ወንድማማችነት	wänǝdǝmmamačǝnnät
ወንድም	wänǝdǝmm
ወንድነት	wänǝdǝnnät
ወንጀለኛ	wänǝǧäläñña
ወከለ	wäkkälä
ወከፍ	wäkkäf
ወኪል	wäkkil
ወካይ	wäkkay
ወዘተ	wäzzätä
ወዘተ\.	wäzzätä\.
ወዘወዘ	wäzäwwäzä
ወዘፈ	wäzzäfä
ወዛ	wäzza
ወዛም	wäzzam
ወዛደር	wäzaddär
ወየበ	wäyyäbä
ወየው	wäyyäw
ወያላ	wäyyala
ወይም	wäyǝmm
ወይስ	wäyǝss
ወይንማ	wäyǝnǝmma
ወዮ	wäyyo
ወዮታ	wäyyota
ወደለ	wäddälä
ወደላ	wädälla
ወደመ	wäddämä
ወደረ	wäddärä
ወደረኛ	wädäräñña
ወደቀ	wäddäqä
ወደዚህ	wädäzzih
ወደዚያ	wädäzziya
ወደደ	wäddädä
ወደድ	wäddäd
ወደጎን	wädägonn
ወዲያልኝ	wädiyallǝññ
ወዳድ	wäddad
ወዳጅነት	wädaǧǝnnät
ወዶ	wäddo
ወገረ	wäggärä
ወገኛ	wägäñña
ወገግ	wägägg
ወገግታ	wäggägǝta
ወጋ	wägga
ወጋጋ	wägagga
ወጌሻ	wägešša
ወጣ	wäṭṭa
ወጣራ	wäṭṭarra
ወጣትነት	wäṭṭatǝnnät
ወጣች	wäṭačč
ወጥ	wäṭṭ
ወጭማዳ	wäč̣ǝmadda
ወፈረ	wäffärä
ወፈር	wäfärr
ወፈፈ	wäffäfä
ወፈፌ	wäfäffe
ወፈፍተኛ	wäfäfǝtäñña
ወፋፈረ	wäfaffärä
ዋለለ	wallälä
ዋስትና	wasǝtǝnna
ዋሸ	waššä
ዋሻ	wašša
ዋተተ	wattätä
ዋነተኛ	wanätäñña
ዋነኛ	wannäñña
ዋና	wanna
ዋኘ	waññä
ዋዠ	wažžä
ዋጀ	waǧǧä
ውሀማ	wǝhamma
ውለኛ	wǝläñña
ውላቂ	wǝllaqi
ውላጅ	wǝllaǧ
ውል	wǝll
ውልቃት	wǝllǝqat
ውልቅ	wǝllǝq
ውልብ	wǝllǝb
ውልታ	wǝllǝta
ውልክፍክፍ	wǝlǝkǝfǝkǝff
ውራ	wǝrra
ውራጅ	wǝrraǧ
ውር	wǝrr
ውርር	wǝrrǝr
ውርርድ	wǝrǝrrǝd
ውርንጭላ	wǝrǝnǝč̣ǝlla
ውርጅብኝ	wǝrǝǧǝbbǝññ
ውሳኔ	wǝssane
ውስልትና	wǝsǝlǝtǝnna
ውሻ	wǝšša
ውሻነት	wǝššannät
ውሽማ	wǝšǝmma
ውቂያ	wǝqqiya
ውቃጭ	wǝqqač̣
ውቅራት	wǝqqǝrat
ውትፍ	wǝttǝf
ውነተኛ	wǝnätäñña
ውንብድና	wǝnǝbǝdǝnna
ውንድቢ	wǝnǝdǝbbi
ውከላ	wǝkkäla
ውክልና	wǝkkǝlǝnna
ውዝዋዜ	wǝzǝwwaze
ውዝፍ	wǝzzǝf
ውይባት	wǝyyǝbat
ውደሳ	wǝddäsa
ውዳሴ	wǝddase
ውዳቂ	wǝddaqi
ውዴላ	wǝddella
ውድ	wǝdd
ውድነት	wǝddǝnnät
ውድድር	wǝdǝddǝr
ውጊያ	wǝggiya
ውፋሬ	wǝffare
ዐልቅት	ʿalǝqqǝt
ዐመቀ	ʿammäqä
ዐመጠ	ʿammäṭä
ዐመጠኛ	ʿamäṭäñña
ዐመፀ	ʿammäṣ́ä
ዐመፀኛ	ʿamäṣ́äñña
ዐሥረኛ	ʿaśǝräñña
ዐሥር	ʿaśśǝr
ዐረቀ	ʿarräqä
ዐረበ	ʿarräbä
ዐረብኛ	ʿaräbǝñña
ዐረገ	ʿarrägä
ዐረፈ	ʿarräfä
ዐራቢ	ʿarrabi
ዐቀደ	ʿaqqädä
ዐቃቢት	ʿaqqabit
ዐቃቤ	ʿaqqabe
ዐበደ	ʿabbädä
ዐበድ	ʿabbäd
ዐወቀ	ʿawwäqä
ዐወደ	ʿawwädä
ዐወደኝ	ʿawwädäññ
ዐውድማ	ʿawǝdǝmma
ዐየ	ʿayyä
ዐይናማ	ʿayǝnamma
ዓለመኛ	ʿalämäñña
ዓለማዊነት	ʿalämawinnät
ዕልል	ʿǝlǝll
ዕምቅ	ʿǝmmǝq
ዕሴት	ʿǝsset
ዕቀዳ	ʿǝqqäda
ዕቁብ	ʿǝqqub
ዕቃ	ʿǝqqa
ዕቅድ	ʿǝqqǝd
ዕውር	ʿǝwwǝr
ዕውቀተኛ	ʿǝwǝqätäñña
ዕጮኛ	ʿǝč̣oñña
ዘለለ	zällälä
ዘለል	zäläll
ዘለም	zälämm
ዘለሰ	zälläsä
ዘለሰኛ	zäläsäñña
ዘለቀ	zälläqä
ዘለዘለ	zäläzzälä
ዘለግ	zälägg
ዘለግላጋ	zälägǝllaga
ዘለፈ	zälläfä
ዘላበደ	zälabbädä
ዘላን	zällan
ዘልዛላ	zälǝzzala
ዘልዛልነት	zälǝzallǝnnät
ዘመመ	zämmämä
ዘመረ	zämmärä
ዘመተ	zämmätä
ዘመዘመ	zämäzzämä
ዘመዳሞች	zämädamočč
ዘማ	zämma
ዘማዊ	zämmawi
ዘረረ	zärrärä
ዘረነቀ	zärännäqä
ዘረኛ	zäräñña
ዘረከተ	zäräkkätä
ዘረክራካ	zäräkǝrakka
ዘረዘረ	zäräzzärä
ዘረገፈ	zäräggäfä
ዘረጋ	zärägga
ዘረፈ	zärräfä
ዘረፍራፋ	zäräfǝraffa
ዘራ	zärra
ዘራሽ	zärraš
ዘራፍ	zärraf
ዘርካታ	zärǝkatta
ዘርዛራ	zärǝzarra
ዘርፋፋ	zärǝfaffa
ዘርፍና	zärǝfǝnna
ዘቀዘቀ	zäqäzzäqä
ዘቀጠ	zäqqäṭä
ዘቅዛቃ	zäqǝzaqqa
ዘበለለ	zäbällälä
ዘበራረቀ	zäbärarräqä
ዘበተ	zäbbätä
ዘበነ	zäbbänä
ዘበናይነት	zäbänayǝnnät
ዘበኛ	zäbäñña
ዘበዘበ	zäbäzzäbä
ዘበጠ	zäbbäṭä
ዘባ	zäbba
ዘባረቀ	zäbarräqä
ዘብዛባ	zäbǝzabba
ዘብጥያ	zäbǝṭǝyya
ዘነመ	zännämä
ዘነቀ	zännäqä
ዘነቆለ	zänäqqolä
ዘነበ	zännäbä
ዘነተረ	zänättärä
ዘነነ	zännänä
ዘነን	zänänn
ዘነጋ	zänägga
ዘነፈ	zännäfä
ዘና	zänna
ዘናጭ	zännač̣
ዘንባላ	zänǝballa
ዘንካታ	zänǝkatta
ዘንፋላ	zänǝfalla
ዘከረ	zäkkärä
ዘከዘከ	zäkäzzäkä
ዘኬ	zäkke
ዘክዛካ	zäkǝzakka
ዘወረ	zäwwärä
ዘወርዋራ	zäwärǝwarra
ዘዋራ	zäwwarra
ዘው	zäww
ዘየረ	zäyyärä
ዘየነ	zäyyänä
ዘየደ	zäyyädä
ዘያጅ	zäyyaǧ
ዘዴኛ	zädeñña
ዘገምተኛ	zägämǝtäñña
ዘገረረ	zägärrärä
ዘገበ	zäggäbä
ዘገነ	zäggänä
ዘገነነ	zägännänä
ዘገየ	zägäyyä
ዘጋ	zägga
ዘግየት	zägǝyätt
ዘጎርጓራ	zägorǝgʷarra
ዘጎነ	zäggonä
ዘጠነኛ	zäṭänäñña
ዘጠኝ	zäṭäññ
ዘፈቀ	zäffäqä
ዘፈነ	zäffänä
ዘፈዘፈ	zäfäzzäfä
ዘፍ	zäff
ዙጥ	zuṭṭ
ዚቀኛ	ziqäñña
ዛተለ	zattälä
ዛቻ	začča
ዛኒጋባ	zanigabba
ዛዘነ	zazzänä
ዛጎልማ	zagolǝmma
ዜመኛ	zemäñña
ዜንጠኛ	zenǝṭäñña
ዝሊያ	zǝlliya
ዝላይ	zǝllay
ዝልል	zǝllǝl
ዝልስ	zǝllǝs
ዝመራ	zǝmmära
ዝሙተኛ	zǝmmutäñña
ዝሙት	zǝmmut
ዝማሬ	zǝmmare
ዝም	zǝmm
ዝምታ	zǝmmǝta
ዝራጭ	zǝrrač̣
ዝር	zǝrr
ዝርክርክ	zǝrǝkǝrǝkk
ዝርክት	zǝrǝkkǝtt
ዝርዛሪ	zǝrǝzzari
ዝርዝር	zǝrǝzzǝr
ዝርያ	zǝrrǝya
ዝርግነት	zǝrǝgǝnnät
ዝርግፍ	zǝrǝgǝff
ዝቀታ	zǝqqäta
ዝቃጭ	zǝqqač̣
ዝቅ	zǝqq
ዝቅተኛ	zǝqqǝtäñña
ዝብዝብ	zǝbǝzzǝb
ዝተታም	zǝttätam
ዝተት	zǝttät
ዝነኛ	zǝnnäñña
ዝነጣ	zǝnnäṭa
ዝና	zǝnna
ዝናር	zǝnnar
ዝናቢስ	zǝnnabis
ዝንባሌ	zǝnǝbbale
ዝንጅብል	zǝnǝǧǝbǝll
ዝንፋት	zǝnnǝfat
ዝክዝክ	zǝkǝzǝkk
ዝውውር	zǝwǝwwǝr
ዝየራ	zǝyyära
ዝየና	zǝyyäna
ዝየዳ	zǝyyäda
ዝይ	zǝyy
ዝግ	zǝgg
ዝግተኛ	zǝggǝtäñña
ዝግታ	zǝggǝta
ዝግጁ	zǝgǝǧǧu
ዝግጅት	zǝgǝǧǧǝt
ዠለጠ	žälläṭä
ዠረር	žärärr
ዠረገገ	žäräggägä
ዠርጋዳ	žärǝgadda
ዠርጋጋ	žärǝgagga
ዠቀዠቀ	žäqäžžäqä
ዠበደ	žäbbädä
ዠበድ	žäbbäd
ዠብረር	žäbǝrärr
ዠብራራ	žäbǝrarra
ዥማት	žǝmmat
ዥዋዥዌ	žǝwwažǝwwe
ዥው	žǝww
ዦፌ	žoffe
የለለው	yälälläw
የለም	yälläm
የለሽ	yälläš
የለኝም	yälläññǝm
የለውም	yälläwǝm
የሌለ	yälellä
የሌለው	yällelläw
የሐሰት	yäḥassät
የሕግ	yäḥǝgg
የመረረ	yämärrärä
የመሸኛ	yämäšäñña
የሚመጣው	yämmimäṭaw
የሚበቃ	yämmibäqa
የሚዘለቅ	yämizzälläq
የሚያህል	yämmiyahǝl
የሚያመሰኳ	yämmiyamäsäkkʷa
የሚያሰለች	yämmiyasäläčč
የሚያስቅ	yämmiyassǝq
የሚያስተኛ	yämmiyasǝtäñña
የሚያከራክር	yämmiyakkärakkǝr
የሚጠልዝ	yämmiṭällǝz
የማን	yämann
የማዘጋጃ	yämazzägaǧa
የማያከራክር	yämmayakkärakkǝr
የማያዛልቅ	yämmayazzallǝq
የማይሆን	yämmayǝhon
የማይለወጥ	yämmayǝlläwwäṭ
የማይለው	yämmayǝläw
የማይል	yämmayǝl
የማይረባ	yämmayǝräba
የማይሻር	yämmayǝššar
የማይቀር	yämmayǝqär
የማይበቃ	yämmayǝbäqa
የማይበገር	yämmayǝbbäggär
የማይታጠፍ	yämmayǝtaṭṭäf
የማይጠዳው	yämmayǝṭädaw
የምሩን	yämǝrrun
የምር	yämǝrr
የምስራች	yämǝssǝračč
የረሳው	yärässaw
የረፋድ	yäräffad
የሩጫ	yäruč̣č̣a
የርሱ	yärǝssu
የርሳቸው	yärǝsaččäw
የሰራ	yässära
የሱ	yässu
የሳቸው	yässaččäw
የሸማኔ	yäšämmane
የቀረ	yäqärrä
የቀረች	yäqärräč
የቀረው	yäqärräw
የቆየ	yäqoyyä
የቈላ	yäqʷälla
የበለጠ	yäbälläṭä
የበላይነት	yäbälayǝnnät
የበቃ	yäbäqqa
የባሰበት	yäbasäbbät
የተለቀቀ	yätäläqqäqä
የተለያየ	yätäläyayyä
የተሟላ	yätämʷalla
የተሟጠጠ	yätämʷaṭṭäṭä
የተቀደሰ	yätäqäddäsä
የተንጠለጠለ	yätänǝṭäläṭṭälä
የተወለደ	yätäwwälädä
የተወሰነ	yätäwässänä
የተዛባ	yätäzabba
የተጠላ	yätäṭälla
የተጣላ	yätäṭalla
የተጣራ	yätäṭarra
የተጸውዖ	yätäṣäwwǝʿo
የታማ	yätamma
የትም	yätǝmm
የትና	yätǝnna
የትኛው	yätǝññaw
የትየለሌ	yätǝyyäläle
የነቃ	yänäqqa
የነጋዴዎች	yänäggadewočč
የናት	yännat
የንስሐ	yänǝssǝḥa
የአህያ	yäʾahǝyya
የአየር	yäʾayyär
የአጋጣሚ	yäʾagaṭṭami
የእጅ	yäʾǝǧǧ
የከበረ	yäkäbbärä
የካቲት	yäkkatit
የክት	yäkǝtt
የኮቴ	yäkotte
የወረገኑ	yäwärrägänu
የወንድም	yäwänǝdǝmm
የዋህ	yäwwah
የዋህነት	yäwwahǝnnät
የዝናር	yäzǝnnar
የይ	yäyy
የደምበኛ	yädämǝbäñña
የደራ	yädärra
የደስደስ	yädäsǝdäss
የድመት	yädǝmmät
የገዛ	yägäzza
የጉበት	yägubbät
የጋማ	yägamma
የግሥ	yägǝśś
የጎልማሶች	yägolǝmasočč
የጎደለበት	yägoddäläbbät
የጠለቀ	yäṭälläqä
የጠረጴዛ	yäṭäräp̣p̣eza
የጥሪ	yäṭǝrri
የጥቅል	yäṭǝqqǝl
የጥያቄ	yäṭǝyyaqe
የጫማ	yäč̣amma
የጭቅና	yäč̣ǝqqǝnna
የፈሰሰ	yäfässäsä
የፊታችን	yäfitaččǝn
የፊጥኝ	yäfiṭṭǝññ
ያለ	yallä
ያለውድ	yaläwǝdd
ያለግምት	yalägǝmmǝt
ያልተሟላ	yalǝtämʷalla
ያልተወሰነ	yalǝtäwässänä
ያልተገራ	yalǝtägärra
ያልታሰበ	yalǝtassäbä
ያመዋል	yammäwal
ያም	yamm
ያሳማ	yassama
ያቻትና	yaččatǝnna
ያች	yačč
ያኔ	yanne
ያን	yann
ያንማ	yannǝmma
ያንን	yannǝn
ያኛው	yaññaw
ያውና	yawǝnna
ያውኮ	yawǝkko
ያዝ	yazz
ያደረ	yaddärä
ያገለገለ	yagäläggälä
ያጎት	yaggot
ይህም	yǝhǝmm
ይህን	yǝhǝnn
ይህኛው	yǝhǝññaw
ይሉኝ	yǝluññ
ይሉኝታ	yǝluññǝta
ይልቁንም	yǝlǝqunǝmm
ይልቁንስ	yǝlǝqunǝss
ይልቅስ	yǝlǝqǝss
ይስጠን	yǝsǝṭänn
ይስጣኝ	yǝsǝṭaññ
ይስጥልኝ	yǝsǝṭǝlǝññ
ይሻላል	yǝššalal
ይብላኝ	yǝbǝlaññ
ይውልህ	yǝwǝllǝh
ይግባኝ	yǝgǝbaññ
ደለለ	dällälä
ደለቀ	dälläqä
ደለበ	dälläbä
ደለኸ	dälläẖä
ደለዘ	dälläzä
ደለደለ	däläddälä
ደለፈሰ	däläffäsä
ደላ	dälla
ደላላ	dällala
ደላይ	dällay
ደልቃቃ	dälǝqaqqa
ደልዳላ	dälǝddala
ደመመ	dämmämä
ደመረ	dämmärä
ደመሰሰ	dämässäsä
ደመቀ	dämmäqä
ደመና	dämmäna
ደመኛ	dämäñña
ደመወዝተኛ	dämäwäzǝtäñña
ደመደመ	dämäddämä
ደማ	dämma
ደማቃ	dämmaqa
ደማቅ	dämmaq
ደም	dämm
ደምበኛ	dämǝbäñña
ደሞ	dämmo
ደረሰ	därräsä
ደረሰለት	därräsällät
ደረሰመ	därässämä
ደረሰበት	därräsäbät
ደረሰኝ	därräsäññ
ደረቀ	därräqä
ደረበ	därräbä
ደረተ	därrätä
ደረደረ	däräddärä
ደረጀ	däräǧǧä
ደረገመ	däräggämä
ደራ	därra
ደራሲነት	därasinnät
ደርሽ	därrǝšš
ደርበብ	därǝbäbb
ደርባባ	därǝbabba
ደርካካ	därǝkakka
ደሰመ	dässämä
ደሰሰ	dässäsä
ደስ	däss
ደስተኛ	dässǝtäñña
ደስታ	dässǝta
ደቀ	däqqä
ደቀለ	däqqälä
ደቀመዝሙር	däqqämäzǝmur
ደቀቀ	däqqäqä
ደቀነ	däqqänä
ደቀደቀ	däqäddäqä
ደቃ	däqqa
ደቃቃ	däqqaqa
ደቃቅ	däqqaq
ደቅደቂት	däqǝdäqqit
ደቆሰ	däqqosä
ደቆስቋሳ	däqosǝqʷassa
ደቋቆሰ	däqʷaqqosä
ደበለለ	däbällälä
ደበለቀ	däbälläqä
ደበላለቀ	däbälalläqä
ደበልባላ	däbälǝballa
ደበሰሰ	däbässäsä
ደበስባሳ	däbäsǝbassa
ደበቀ	däbbäqä
ደበበ	däbbäbä
ደበተ	däbbätä
ደበነ	däbbänä
ደበዘዘ	däbäzzäzä
ደበደበ	däbäddäbä
ደባል	däbbal
ደባቃ	däbbaqa
ደባበሰ	däbabbäsä
ደባች	däbbač
ደብሳሳ	däbǝsassa
ደብዛዛ	däbǝzazza
ደብዳቤ	däbǝdabbe
ደቦለቦለ	däboläbbolä
ደቦል	däbbol
ደቦልቧላ	däbolǝbʷalla
ደኅንነት	däḫǝnǝnnät
ደነሰ	dännäsä
ደነቀ	dännäqä
ደነቀረ	dänäqqärä
ደነቀፈ	dänäqqäfä
ደነቆለ	dänäqqolä
ደነቆረ	dänäqqorä
ደነበረ	dänäbbärä
ደነበዘ	dänäbbäzä
ደነባ	dänäbba
ደነነ	dännänä
ደነዘ	dännäzä
ደነዘዘ	dänäzzäzä
ደነደነ	dänädännä
ደነገዘ	dänäggäzä
ደነገገ	dänäggägä
ደነገጠ	dänäggäṭä
ደነጎረ	dänäggorä
ደነፋ	dänäffa
ደነፋፋ	dänäffafa
ደናማ	dännamma
ደናሽ	dännaš
ደን	dänn
ደንቃፋ	dänǝqaffa
ደንበኛ	dänǝbäñña
ደንባራ	dänǝbarra
ደንባዛ	dänǝbazza
ደንደሮ	dänǝdärro
ደንደሳም	dänǝddässam
ደንደስ	dänǝdäss
ደንዳና	dänǝdanna
ደንዳኔ	dänǝdanne
ደንገሎ	dänǝgällo
ደንጉላ	dänǝgulla
ደንጋራ	dänǝgarra
ደንጋዛ	dänǝgazza
ደከመ	däkkämä
ደካማ	däkamma
ደኸየ	däẖäyyä
ደወለ	däwwälä
ደዋይ	däwway
ደደረ	däddärä
ደደቀ	däddäqä
ደደበ	däddäbä
ደደብ	däddäb
ደጀ	däǧǧä
ደጃች	däǧǧač
ደጃፍ	däǧǧaf
ደጅ	däǧǧ
ደገመ	däggämä
ደገሰ	däggäsä
ደገነ	däggänä
ደገኛ	dägäñña
ደገደገ	dägäddägä
ደገፈ	däggäfä
ደጉሰ	däggusä
ደጋደግ	däggadägg
ደጋፊ	däggafi
ደግ	dägg
ደግነቱ	däggǝnnätu
ደግነት	däggǝnnät
ደግዳጋ	dägǝdagga
ደግፍ	däggǝf
ደጎመ	däggomä
ደጎባ	däggoba
ደፈረ	däffärä
ደፈረሰ	däfärräsä
ደፈቀ	däffäqä
ደፈነ	däffänä
ደፈንፋና	däfänǝfanna
ደፈደፈ	däfäddäfä
ደፋ	däffa
ደፋር	däffar
ደፍ	däff
ዱለቻ	dulläčča
ዱለኛ	dulläñña
ዱላ	dulla
ዱርዬ	durǝyye
ዱባ	dubba
ዱቤ	dubbe
ዱብ	dubb
ዲካ	dikka
ዳለቻ	daläčča
ዳለጠ	dalläṭä
ዳሌ	dalle
ዳመነ	dammänä
ዳመና	dammäna
ዳመናማ	damännamma
ዳመናም	dammänam
ዳመጠ	dammäṭä
ዳረገ	darrägä
ዳርቻ	darǝčča
ዳርና	darǝnna
ዳሰሰ	dassäsä
ዳሸቀ	daššäqä
ዳበረ	dabbärä
ዳበሰ	dabbäsä
ዳበሳ	dabbäsa
ዳባ	dabba
ዳቦ	dabbo
ዳተኛ	datäñña
ዳንሰኛ	danǝsäñña
ዳንግሌ	danǝgǝlle
ዳኘ	daññä
ዳኛ	dañña
ዳኝነት	daññǝnnät
ዳከረ	dakkärä
ዳክዬ	dakkǝyye
ዳዋ	dawwa
ዳውላ	dawǝlla
ዳግመኛ	dagǝmäñña
ድህነት	dǝhǝnnät
ድለላ	dǝlläla
ድል	dǝll
ድልህ	dǝllǝh
ድልል	dǝllǝl
ድልኸ	dǝllǝẖä
ድልኽ	dǝllǝẖ
ድልዝ	dǝllǝz
ድልድል	dǝlǝddǝl
ድሎትኛ	dǝlotǝñña
ድመራ	dǝmmära
ድመት	dǝmmät
ድማሪ	dǝmmari
ድምር	dǝmmǝr
ድምበረተኛ	dǝmǝbärätäñña
ድምቡሼ	dǝmǝbušše
ድሪያ	dǝrriya
ድራሹ	dǝrrašu
ድርቅ	dǝrrǝq
ድርቅና	dǝrǝqǝnna
ድርብ	dǝrrǝb
ድርት	dǝrrǝt
ድርና	dǝrǝnna
ድርድር	dǝrǝddǝr
ድርጁ	dǝrǝǧǧu
ድርጅት	dǝrǝǧǧǝt
ድርጊት	dǝrǝggit
ድርግም	dǝrǝgǝmm
ድቁስ	dǝqqus
ድቅን	dǝqqǝnn
ድበቃ	dǝbbäqa
ድበብ	dǝbäbb
ድቡሽት	dǝbbušǝt
ድባኖ	dǝbbano
ድብ	dǝbb
ድብልቅ	dǝbǝllǝq
ድብቅ	dǝbbǝq
ድብብቆሽ	dǝbǝbbǝqoš
ድብት	dǝbbǝt
ድብን	dǝbbǝnn
ድብኝት	dǝbǝññǝt
ድኅነት	dǝḫǝnnät
ድንቁርና	dǝnǝqurǝnna
ድንቄም	dǝnǝqemm
ድንቅ	dǝnnǝq
ድንበረተኛ	dǝnǝbärätäñña
ድንበርተኛ	dǝnǝbärǝtäñña
ድንቡሎ	dǝnǝbullo
ድንች	dǝnnǝčč
ድንክዬ	dǝnǝkǝyye
ድንገተኛ	dǝnǝgätäñña
ድንጋጌ	dǝnǝggage
ድንጋጤ	dǝnǝggaṭe
ድንግልና	dǝnǝgǝllǝna
ድንግዝግዝ	dǝnǝgǝzǝgǝzz
ድኝ	dǝññ
ድኩላ	dǝkkula
ድኽነት	dǝẖǝnnät
ድወላ	dǝwwäla
ድው	dǝww
ድውር	dǝwwǝr
ድውይ	dǝwwǝy
ድዳም	dǝddam
ድድ	dǝdd
ድድር	dǝddǝr
ድድቅ	dǝddǝq
ድገና	dǝggäna
ድጋሚ	dǝggami
ድግስ	dǝggǝs
ድግን	dǝggǝn
ድጎማ	dǝggoma
ድጕሳት	dǝggʷǝsat
ዶለተ	dollätä
ዶለዶመ	doläddomä
ዶልዷላ	dolǝdʷalla
ዶልዷሌ	dolǝdʷalle
ዶልዷማ	dolǝdʷamma
ዶመኛ	domäñña
ዶኬ	dokke
ዶዮ	doyyo
ዶፈዶፈ	dofäddofä
ዶፍዷፋ	dofǝdʷaffa
ጀመረ	ǧämmärä
ጀምሮ	ǧämmǝro
ጀረገገ	ǧäräggägä
ጀሶ	ǧässo
ጀበበ	ǧäbbäbä
ጀበደ	ǧäbbädä
ጀብደኛ	ǧäbǝdäñña
ጀቦነ	ǧäbbonä
ጀገነ	ǧäggänä
ጀግንነት	ǧägǝnǝnnät
ጂጌ	ǧigge
ጃኬት	ǧakket
ጃዊ	ǧawwi
ጃውሳ	ǧawwǝsa
ጃጀ	ǧaǧǧä
ጃፓናዊ	ǧappanawi
ጃፓን	ǧappan
ጅላንጅል	ǧǝlanǝǧǧǝl
ጅልነት	ǧǝlǝnnät
ጅማታም	ǧǝmmatam
ጅማት	ǧǝmmat
ጅምር	ǧǝmmǝr
ጅብ	ǧǝbb
ጅንን	ǧǝnnǝn
ጅዋጅዌ	ǧǝwwaǧǝwwe
ጅው	ǧǝww
ጆንያ	ǧonǝyya
ጆፌ	ǧoffe
ጆፍጆፌ	ǧofǝǧoffe
ገሀነመ	gähannämä
ገሀነም	gähannäm
ገለል	gäläll
ገለልተኛ	gälälǝtäñña
ገለልተኛነት	gälälǝtäññanät
ገለማ	gälämma
ገለሞተ	gälämmotä
ገለበ	gälläbä
ገለበጠ	gäläbbäṭä
ገለጀጀ	gäläǧǧäǧä
ገለጠ	gälläṭä
ገለጸ	gälläṣä
ገለፈጠ	gäläffäṭä
ገለፈፈ	gäläffäfä
ገላለጠ	gälalläṭä
ገላመጠ	gälammäṭä
ገላገለ	gälaggälä
ገልዋዳ	gälǝwadda
ገመለ	gämmälä
ገመምተኛ	gämämǝtäñña
ገመሰ	gämmäsä
ገመተ	gämmätä
ገመደ	gämmädä
ገመደለ	gämäddälä
ገመገመ	gämäggämä
ገመጠ	gämmäṭä
ገማ	gämma
ገማች	gämmač
ገምባሌ	gämǝballe
ገሠሠ	gäśśäśä
ገሠጠ	gäśśäṭä
ገሠጸ	gäśśäṣä
ገረመ	gärrämä
ገረመመ	gärämmämä
ገረረ	gärrärä
ገረዘ	gärräzä
ገረደፈ	gäräddäfä
ገረጀፈ	gäräǧǧäfä
ገረገረ	gäräggärä
ገረገደ	gärrägädä
ገረፈ	gärräfä
ገራ	gärra
ገራም	gärram
ገርበብ	gärǝbäbb
ገርባባ	gärǝbabba
ገርጃፋ	gärǝǧaffa
ገርጋራ	gärǝgarra
ገሰረ	gässärä
ገሰሰ	gässäsä
ገሰገሰ	gäsäggäsä
ገሸለጠ	gäšälläṭä
ገሸረ	gäššärä
ገሸሽ	gäšäšš
ገበረ	gäbbärä
ገበየ	gäbäyyä
ገበያተኛ	gäbäyatäñña
ገቢና	gäbinna
ገባ	gäbba
ገባር	gäbbar
ገባች	gäbačč
ገባው	gäbbaw
ገብ	gäbb
ገብጋባ	gäbǝggaba
ገተረ	gättärä
ገተት	gättät
ገታ	gätta
ገታራ	gättara
ገትጋታ	gätǝgatta
ገቻ	gäčča
ገነባ	gänäbba
ገነተረ	gänättärä
ገነት	gännät
ገነነ	gännänä
ገነን	gännän
ገነዘ	gännäzä
ገነደሰ	gänäddäsä
ገነገነ	gänäggänä
ገነፈለ	gänäffälä
ገና	gänna
ገንባሌ	gänǝballe
ገንታራ	gänǝtarra
ገዘተ	gäzzätä
ገዘገዘ	gäzäggäzä
ገዘፈ	gäzzäfä
ገዛ	gäzza
ገዝጋዛ	gäzǝgazza
ገደ	gäddä
ገደለ	gäddälä
ገደለው	gäddäläw
ገደላማ	gädälamma
ገደርዳራ	gädärǝdarra
ገደበ	gäddäbä
ገደገደ	gädäggädä
ገደፈ	gäddäfä
ገዳማ	gäddamma
ገዳም	gäddam
ገዳዳ	gäddada
ገዴ	gädde
ገድ	gädd
ገድለኛ	gädǝläñña
ገድጋዳ	gädǝgadda
ገዶኝ	gäddoññ
ገገምተኛ	gägämǝtäñña
ገገረ	gäggärä
ገጠገጠ	gäṭäggäṭä
ገጠጠ	gäṭṭäṭä
ገጨኸኝ	gäč̣č̣äẖäññ
ገፈተረ	gäfättärä
ገፈገፈ	gäfäggäfä
ገፈፈ	gäffäfä
ገፈፋ	gäfäffa
ገፋ	gäffa
ገፋፋ	gäfaffa
ጉልላት	gullǝlat
ጉልማ	gulǝmma
ጉልበተኛ	gulǝbätäñña
ጉልተኛ	gulǝtäñña
ጉልቻ	gullǝča
ጉማጅ	gummaǧ
ጉም	gumm
ጉረሮ	gurärro
ጉረኖ	guränno
ጉረኛ	guräñña
ጉራ	gurra
ጉራሽ	gurraš
ጉራቻ	gurračča
ጉራች	gurračč
ጉራጅ	gurraǧ
ጉሬዛማ	gurezamma
ጉርምስና	gurǝmǝssǝnna
ጉርብርብ	gurǝbǝrǝbb
ጉርብትና	gurǝbǝtǝnna
ጉሮሮ	gurorro
ጉበት	gubbät
ጉበኛ	gubäñña
ጉብ	gubb
ጉብታ	gubbǝta
ጉብዝና	gubǝzǝnna
ጉቦ	gubbo
ጉቦኛ	gubboñña
ጉተታ	guttäta
ጉትቻ	gutǝčča
ጉትያ	gutǝyya
ጉቶ	gutto
ጉያ	guyya
ጉደኛ	gudäñña
ጉዳተኛ	gudatäñña
ጉዳዩ	guddayu
ጉዳዬ	guddaye
ጉዳይ	gudday
ጉድ	gudd
ጉድለት	guddǝlät
ጉዶ	guddo
ጉጉት	guggut
ጋለበ	galläbä
ጋማ	gamma
ጋሜ	gamme
ጋረደ	garrädä
ጋረጠ	garräṭä
ጋራማ	garamma
ጋሬ	garre
ጋሸበ	gaššäbä
ጋሻ	gašša
ጋሼ	gašše
ጋሽዬ	gaššǝye
ጋበዘ	gabbäzä
ጋብቻ	gabǝčča
ጋንድያ	ganǝdǝyya
ጋየ	gayyä
ጋገረ	gaggärä
ጋጋ	gagga
ጋጠኝ	gaṭäññ
ጌትነት	getǝnnät
ጌቶች	getočč
ጌጅ	geǧǧ
ጌጠኛ	geṭäñña
ግለሂስ	gǝllähis
ግለኛ	gǝlläñña
ግላዊ	gǝllawi
ግላጭ	gǝllač̣
ግል	gǝll
ግልሙትና	gǝlǝmutǝnna
ግልባጭ	gǝllǝbbač̣
ግልብነት	gǝlǝbǝnnät
ግልግል	gǝlǝggǝl
ግልፋፊ	gǝlǝffafi
ግልፍ	gǝllǝff
ግልፍተኛ	gǝlǝfǝtäñña
ግልፍታም	gǝllǝfǝtam
ግማሽ	gǝmmaš
ግማደ	gǝmmadä
ግማጭ	gǝmmač̣
ግም	gǝmm
ግምል	gǝmmǝl
ግምበኛ	gǝmǝbäñña
ግምት	gǝmmǝt
ግሣዊ	gǝśśawi
ግሣጼ	gǝśśaṣe
ግሥ	gǝśś
ግሦች	gǝśśoč
ግረዛ	gǝrräza
ግራኝ	gǝraññ
ግራዋ	gǝrawwa
ግር	gǝrr
ግርዛት	gǝrrǝzat
ግርድና	gǝrǝdǝnna
ግርድፍ	gǝrǝddǝf
ግርግር	gǝrrǝgǝrr
ግርፋት	gǝrrǝfat
ግሳንግስ	gǝssanǝgǝs
ግስላ	gǝssǝla
ግስጋሴ	gǝsǝggase
ግሽር	gǝššǝr
ግቢ	gǝbbi
ግብርና	gǝbǝrǝnna
ግብዝ	gǝbbǝz
ግብዝና	gǝbǝzǝnna
ግብዣ	gǝbǝžža
ግትር	gǝttǝr
ግትርትር	gǝtǝrǝtǝrr
ግትቻ	gǝtǝčča
ግንበኛ	gǝnǝbäñña
ግንኙነት	gǝnǝññunnät
ግንዛቤ	gǝnǝzzabe
ግንዲላ	gǝnǝdilla
ግኝት	gǝññǝt
ግዝት	gǝzzǝt
ግዞተኛ	gǝzotäñña
ግዥ	gǝžž
ግዳይ	gǝdday
ግዳጅ	gǝddaǧ
ግዴ	gǝdde
ግዴታ	gǝddeta
ግድ	gǝdd
ግድብ	gǝddǝb
ግድያ	gǝdǝyya
ግድግዳ	gǝdǝgǝdda
ግግ	gǝgg
ግግር	gǝggǝr
ግጥም	gǝṭṭǝmm
ግፈኛ	gǝfäñña
ግፊት	gǝffit
ግፊያ	gǝffiya
ጎለመሰ	golämmäsä
ጎልማሳ	golǝmassa
ጎመን	gommän
ጎመዘዘ	gomäzzäzä
ጎመደ	gommädä
ጎመጀ	gomäǧǧä
ጎሚስታ	gommisǝta
ጎማ	gomma
ጎማህ	gommah
ጎማሬ	gommare
ጎምላላ	gomǝlalla
ጎምዛዛ	gomǝzzaza
ጎረመሰ	gorämmäsä
ጎረሰ	gorräsä
ጎረበ	gorräbä
ጎረደ	gorrädä
ጎረደመ	goräddämä
ጎራረደ	gorarrädä
ጎርደድ	gorǝdädd
ጎሸመ	goššämä
ጎሽ	gošš
ጎበበ	gobbäbä
ጎበዘ	gobbäzä
ጎታች	gottač
ጎን	gonn
ጎንደርኛ	gonǝdärǝñña
ጎዘጎዘ	gozzäggozä
ጎዦ	gožžo
ጎደለ	goddälä
ጎደል	goddäl
ጎዳ	godda
ጎዳኒሳ	godanissa
ጎጆ	goǧǧo
ጎጆና	goǧǧona
ጎፈረ	goffärä
ጎፈር	goffär
ጎፈነነ	gofännänä
ጐለተ	gʷällätä
ጐለጐለ	gʷäläggʷälä
ጐላ	gʷälla
ጐልማማ	gʷälǝmamma
ጐልዳፋ	gʷälǝdaffa
ጐመራ	gʷämärra
ጐረበጠ	gʷäräbbäṭä
ጐረበጠኝ	gʷäräbbäṭäññ
ጐረና	gʷäränna
ጐረጐረ	gʷäräggʷärä
ጐረፈ	gʷärräfä
ጐርናና	gʷärǝnanna
ጐርደድ	gʷärǝdädd
ጐርዳዳ	gʷärǝdadda
ጐሰመ	gʷässämä
ጐሰረ	gʷässärä
ጐሰቈለ	gʷäsäqqʷälä
ጐሰጐሰ	gʷäsäggʷäsä
ጐስቋላ	gʷäsǝqʷalla
ጐበኘ	gʷäbäññä
ጐበጠ	gʷäbbäṭä
ጐባን	gʷäbban
ጐተተ	gʷättätä
ጐተጐተ	gʷätäggʷätä
ጐነቈለ	gʷänäqqʷälä
ጐነጐነ	gʷänäggʷänä
ጐነጠ	gʷännäṭä
ጐነፈ	gʷännäfä
ጐንበስ	gʷänǝbäss
ጐንዛላ	gʷänǝzalla
ጐደሪ	gʷädärri
ጐደጐደ	gʷädäggʷädä
ጐድጓዳ	gʷädǝgʷadda
ጐጃሜ	gʷäǧǧame
ጐጃም	gʷäǧǧam
ጐፈየ	gʷäfäyyä
ጓሮኛ	gʷaroñña
ጓያ	gʷayya
ጓደኛ	gʷadäñña
ጓደኛሞች	gʷadäññamoč
ጓደኝነት	gʷaddäññǝnnät
ጓድ	gʷadd
ጓጐለ	gʷaggʷälä
ጓጐረ	gʷaggʷärä
ጓጐጠ	gʷaggʷäṭä
ጓጓ	gʷaggʷa
ጓጓላ	gʷaggʷala
ጕላይ	gʷǝllay
ጕልት	gʷǝllǝt
ጕልቻ	gʷǝlǝčča
ጕሰማ	gʷǝssäma
ጕስቈላ	gʷǝsǝqʷälla
ጕብኝት	gʷǝbǝññǝt
ጕተታ	gʷǝttäta
ጕትት	gʷǝttǝt
ጕትቻ	gʷǝtǝčča
ጕነጣ	gʷǝnnäṭa
ጕዞኛ	gʷǝzoñña
ጕጕ	gʷǝggʷǝ
ጕፋያ	gʷǝfayya
ጠለለ	ṭällälä
ጠለቀ	ṭälläqä
ጠለዘ	ṭälläzä
ጠለፈ	ṭälläfä
ጠላ	ṭälla
ጠል	ṭäll
ጠመመ	ṭämmämä
ጠመረረ	ṭämärrärä
ጠመሰሰ	ṭämässäsä
ጠመቀ	ṭämmäqä
ጠመዘዘ	ṭämäzzäzä
ጠመዝማዛ	ṭämäzǝmazza
ጠመደ	ṭämmädä
ጠምባራ	ṭämǝbarra
ጠምዛዛ	ṭämǝzazza
ጠምጣማ	ṭämǝṭamma
ጠረመሰ	ṭärämmäsä
ጠረረ	ṭärrärä
ጠረሰ	ṭärräsä
ጠረቀመ	ṭäräqqämä
ጠረበ	ṭärräbä
ጠረነቀ	ṭärännäqä
ጠረዘ	ṭärräzä
ጠረገ	ṭärrägä
ጠረጴዛ	ṭäräp̣p̣eza
ጠራ	ṭärra
ጠርባባ	ṭärǝbabba
ጠርዛዛ	ṭärǝzazza
ጠሰቀ	ṭässäqä
ጠስቆ	ṭässǝqo
ጠቀለለ	ṭäqällälä
ጠቀመ	ṭäqqämä
ጠቀሰ	ṭäqqäsä
ጠቀስ	ṭäqqäs
ጠቅላላ	ṭäqǝllala
ጠቅላላውን	ṭäqǝlallawǝn
ጠቆረ	ṭäqqorä
ጠበልተኛ	ṭäbälǝtäñña
ጠበሰ	ṭäbbäsä
ጠበሰቀ	ṭäbässäqä
ጠበቀ	ṭäbbäqä
ጠበበ	ṭäbbäbä
ጠበኛ	ṭäbäñña
ጠበደለ	ṭäbäddälä
ጠባ	ṭäbba
ጠባቂ	ṭäbbaqi
ጠባብ	ṭäbbab
ጠብ	ṭäbb
ጠብታ	ṭäbbǝta
ጠቦት	ṭäbbot
ጠነሰሰ	ṭänässäsä
ጠነቀቀ	ṭänäqqäqä
ጠነቆለ	ṭänäqqolä
ጠነበዘ	ṭänäbbäzä
ጠነባ	ṭänäbba
ጠነነ	ṭännänä
ጠነነኝ	ṭännänäññ
ጠነዛ	ṭänäzza
ጠነፈፈ	ṭänäffäfä
ጠና	ṭänna
ጠኔ	ṭänne
ጠኔያም	ṭänneyam
ጠንቀኛ	ṭänǝqäñña
ጠንቃቃ	ṭänǝqaqqa
ጠንባራ	ṭänǝbarra
ጠንባሳ	ṭänǝbassa
ጠንባዛ	ṭänǝbazza
ጠንካራ	ṭänǝkkara
ጠወለገ	ṭäwällägä
ጠውላጋ	ṭäwǝlagga
ጠየመ	ṭäyyämä
ጠየቀ	ṭäyyäqä
ጠያር	ṭäyyar
ጠያቂ	ṭäyyaqi
ጠያፍ	ṭäyyaf
ጠይም	ṭäyyǝm
ጠደቀ	ṭäddäqä
ጠዳ	ṭädda
ጠጅ	ṭäǧǧ
ጠገበ	ṭäggäbä
ጠገነ	ṭäggänä
ጠገገ	ṭäggägä
ጠጋ	ṭägga
ጠጋቢስ	ṭäggabis
ጠጋኝ	ṭäggañ
ጠጠተ	ṭäṭṭätä
ጠጠተኝ	ṭäṭṭätäññ
ጠጣ	ṭäṭṭa
ጠፈረ	ṭäffärä
ጠፈረተኛ	ṭäfärätäñña
ጠፈጠፈው	ṭäfäṭṭäfäw
ጠፈፈ	ṭäffäfä
ጠፋ	ṭäffa
ጠፍ	ṭäff
ጠፍጣፋ	ṭäfǝṭaffa
ጡሌ	ṭulle
ጡል	ṭull
ጡረኛ	ṭuräñña
ጡርነት	ṭurǝnnät
ጡብ	ṭubb
ጡንቸኛ	ṭunǝčäñña
ጡንቻማ	ṭunǝčamma
ጡጥ	ṭuṭṭ
ጢም	ṭimm
ጢሰኛ	ṭisäñña
ጢቅ	ṭiqq
ጢቅታ	ṭiqqǝta
ጢን	ṭinn
ጣሰሰ	ṭassäsä
ጣጠኛ	ṭaṭäñña
ጣፈጠ	ṭaffäṭä
ጣፊያ	ṭaffiya
ጤነኛ	ṭenäñña
ጤናማ	ṭenamma
ጤናዳም	ṭenaddam
ጥለኛ	ṭǝläñña
ጥላማ	ṭǝlamma
ጥላቻ	ṭǝlačča
ጥልቅ	ṭǝllǝqq
ጥልቆ	ṭǝllǝqo
ጥማድ	ṭǝmmad
ጥምልምል	ṭǝmǝlǝmǝll
ጥምር	ṭǝmmǝr
ጥምዝ	ṭǝmǝzz
ጥምጥም	ṭǝmǝṭǝmm
ጥሞና	ṭǝmmona
ጥሩምበኛ	ṭǝrumǝbäñña
ጥሪ	ṭǝrri
ጥራቢ	ṭǝrrabi
ጥራጊ	ṭǝrragi
ጥር	ṭǝrr
ጥርቃሚ	ṭǝrǝqqami
ጥርቃሞ	ṭǝrǝqqamo
ጥርቅም	ṭǝrǝqqǝm
ጥርቅምአድርጎ	ṭǝrǝqǝmmǝʾadǝrǝgo
ጥርኝ	ṭǝrǝññ
ጥስቅ	ṭǝssǝq
ጥቁም	ṭǝqqum
ጥቃቅን	ṭǝqaqqǝn
ጥቅል	ṭǝqqǝl
ጥበቃ	ṭǝbbäqa
ጥበበኛ	ṭǝbäbäñña
ጥበት	ṭǝbbät
ጥቢ	ṭǝbbi
ጥብቅ	ṭǝbbǝq
ጥብቅና	ṭǝbǝqǝnna
ጥብቆ	ṭǝbbǝqo
ጥብኛ	ṭǝbbǝñña
ጥቦት	ṭǝbbot
ጥንቃቄ	ṭǝnǝqqaqe
ጥንካሬ	ṭǝnǝkkare
ጥንዚዛ	ṭǝnǝzizza
ጥየቃ	ṭǝyyäqa
ጥዩፍ	ṭǝyyuf
ጥያቄ	ṭǝyyaqe
ጥይት	ṭǝyyǝt
ጥይፍተኛ	ṭǝyyǝfǝtäñña
ጥጃ	ṭǝǧǧa
ጥገት	ṭǝggät
ጥገና	ṭǝggäna
ጥገኛ	ṭǝggäñña
ጥገኛነት	ṭǝggäññannät
ጥጋበኛ	ṭǝgabäñña
ጥግ	ṭǝgg
ጥግን	ṭǝggǝn
ጥፊ	ṭǝffi
ጥፋተኛ	ṭǝfatäñña
ጦልጣሏ	ṭolǝṭallʷa
ጦልጧላ	ṭolǝṭʷalla
ጦመኛ	ṭomäñña
ጦረኛ	ṭoräñña
ጦርነት	ṭorǝnnät
ጦሰኛ	ṭosäñña
ጦስኝ	ṭosǝññ
ጦሽ	ṭošš
ጦቢያ	ṭobbiya
ጨለመ	č̣ällämä
ጨለማ	č̣älläma
ጨለጠ	č̣älläṭä
ጨለፈ	č̣älläfä
ጨላጭ	č̣ällač̣
ጨሌ	č̣älle
ጨመለቅ	č̣ämälläq
ጨመረ	č̣ämmärä
ጨመቀ	č̣ämmäqä
ጨመተ	č̣ämmätä
ጨመደደ	č̣ämäddädä
ጨምላቃ	č̣ämǝlaqqa
ጨምባሳ	č̣ämǝbassa
ጨምታራ	č̣ämǝtarra
ጨምዳዳ	č̣ämǝdadda
ጨረሰ	č̣ärräsä
ጨረታ	č̣ärräta
ጨረገደ	č̣äräggädä
ጨረፈ	č̣ärräfä
ጨርማማ	č̣ärǝmamma
ጨርማታ	č̣ärǝmatta
ጨርማዳ	č̣ärǝmadda
ጨርሶ	č̣ärrǝso
ጨርጫሳ	č̣ärǝč̣assa
ጨቀየ	č̣äqäyyä
ጨቅላነት	č̣äqǝlannät
ጨቅጫቃ	č̣äqǝč̣aqqa
ጨቆነ	č̣äqqonä
ጨቋኝ	č̣äqqʷañ
ጨበጠ	č̣äbbäṭä
ጨቦደ	č̣äbbodä
ጨነቀ	č̣ännäqä
ጨነገፈ	č̣änäggäfä
ጨንቋራ	č̣änǝqʷarra
ጨንባሳ	č̣änǝbassa
ጨከነ	č̣äkkänä
ጨካኝ	č̣äkkañ
ጨዋነት	č̣äwannät
ጨውናና	č̣äwǝnanna
ጨገገ	č̣äggägä
ጨጓራ	č̣äggʷarra
ጨፈለቀ	č̣äfälläqä
ጨፈረ	č̣äffärä
ጨፈነ	č̣äffänä
ጨፈገገ	č̣äfäggägä
ጨፋሪ	č̣äffari
ጨፋና	č̣äffana
ጨፌ	č̣äffe
ጨፍራራ	č̣äfǝrarra
ጨፍጋጋ	č̣äfǝgagga
ጩርር	č̣urǝrr
ጫማ	č̣amma
ጫር	č̣arr
ጫና	č̣anna
ጫን	č̣ann
ጫካ	č̣akka
ጫካማ	č̣akamma
ጫጩት	č̣ač̣utt
ጫፍና	č̣afǝnna
ጭለማ	č̣ǝlläma
ጭላጭ	č̣ǝllač̣
ጭልጥ	č̣ǝllǝṭṭ
ጭልፊት	č̣ǝlǝfitt
ጭማሪ	č̣ǝmmari
ጭማቂ	č̣ǝmmaqi
ጭምር	č̣ǝmmǝr
ጭምት	č̣ǝmmǝt
ጭራሹ	č̣ǝrrašu
ጭራሽ	č̣ǝrraš
ጭር	č̣ǝrr
ጭርታ	č̣ǝrrǝta
ጭቁን	č̣ǝqqun
ጭቃማ	č̣ǝqamma
ጭቅቅታም	č̣ǝqǝqqǝtam
ጭቅቅት	č̣ǝqǝqqǝt
ጭቅና	č̣ǝqǝnna
ጭቆና	č̣ǝqqona
ጭባጭ	č̣ǝbbač̣
ጭብጥ	č̣ǝbbǝṭ
ጭብጦ	č̣ǝbbǝṭo
ጭቦ	č̣ǝbbo
ጭቦኛ	č̣ǝbboñña
ጭንቅላታም	č̣ǝnǝqǝllatam
ጭንቅላት	č̣ǝnǝqqǝlat
ጭከና	č̣ǝkkäna
ጭካኔ	č̣ǝkkane
ጭኮ	č̣ǝkko
ጭው	č̣ǝww
ጭውውት	č̣ǝwwǝwǝt
ጭፈራ	č̣ǝffära
ጭፍን	č̣ǝffǝn
ጮሌ	č̣olle
ጮረረ	č̣orrärä
ጮራ	č̣orra
ጮቤ	č̣obbe
ጳጳሳት	p̣ap̣p̣asat
ጳጳስ	p̣ap̣p̣as
ጸለየ	ṣälläyä
ጸሎተኛ	ṣälotäñña
ጸበረቀ	ṣäbärräqä
ጸነነ	ṣännänä
ጸና	ṣänna
ጸያፍ	ṣäyyaf
ጸደቀ	ṣäddäqä
ጸዳ	ṣädda
ጸጋ	ṣägga
ጸጥ	ṣäṭṭ
ጸጥተኛ	ṣäṭṭǝtäñña
ጸጸተ	ṣäṣṣätä
ጸጸተኛ	ṣäṣätäñña
ጽላተ	ṣǝllatä
ጽላት	ṣǝllat
ጽኑነት	ṣǝnunnät
ጽዋ	ṣǝwwa
ጽጌረዳ	ṣǝggeräda
ጾመኛ	ṣomäñña
ፀሐያማ	ṣ́äḥayamma
ፈለሰ	fälläsä
ፈለሰመ	fälässämä
ፈለሰፈ	fälässäfä
ፈለቀ	fälläqä
ፈለቀቀ	fäläqqäqä
ፈለገ	fällägä
ፈለጠ	fälläṭä
ፈለፈለ	fäläffälä
ፈሊጠኛ	fäliṭäñña
ፈላ	fälla
ፈላሻ	fällaša
ፈላጊ	fällagi
ፈልሳሳ	fälǝssasa
ፈረመ	färrämä
ፈረሰ	färräsä
ፈረሰኛ	färäsäñña
ፈረሱላ	färäsulla
ፈረንሳይኛ	färänǝsayǝñña
ፈረክራካ	färäkǝrakka
ፈረደ	färrädä
ፈረደለት	färrädälät
ፈረደበት	färrädäbbät
ፈረጠ	färräṭä
ፈረፈረ	färäffärä
ፈሪነት	färinnät
ፈራ	färra
ፈራሚ	färrami
ፈራረሰ	färarräsä
ፈርጣማ	färǝṭamma
ፈሰሰ	fässäsä
ፈሰከ	fässäkä
ፈሰፈሰ	fäsäffäsä
ፈሳ	fässa
ፈቀቅ	fäqäqq
ፈቀደ	fäqqädä
ፈቀደው	fäqqädäw
ፈቀፈቀ	fäqäffäqä
ፈቃደኛ	fäqadäñña
ፈቃደኛነት	fäqadäññannät
ፈተለ	fättälä
ፈተሸ	fättäšä
ፈተነ	fättänä
ፈተገ	fättägä
ፈተፈተ	fätäffätä
ፈታ	fätta
ፈታሽ	fättaš
ፈታታ	fätatta
ፈታኝ	fättañ
ፈት	fätt
ፈትለክ	fätǝläkk
ፈነቀለ	fänäqqälä
ፈነከተ	fänäkkätä
ፈነደቀ	fänäddäqä
ፈነዳ	fänädda
ፈነገለ	fänäggälä
ፈንዳዳ	fänǝdadda
ፈንጋላ	fänǝgalla
ፈንጠዝያ	fänǝṭäzǝyya
ፈንጣራ	fänǝṭarra
ፈካ	fäkka
ፈወሰ	fäwwäsä
ፈዋሽ	fäwwaš
ፈዘዘ	fäzzäzä
ፈዛዛ	fäzazza
ፈየለ	fäyyälä
ፈየደ	fäyyädä
ፈጀ	fäǧǧä
ፈጅ	fäǧǧ
ፈገመ	fäggämä
ፈገገ	fäggägä
ፈገፈገ	fägäffägä
ፈግጠው	fäggǝṭäw
ፈጠመ	fäṭṭämä
ፈጠፈጠ	fäṭäffäṭä
ፈጸመ	fäṣṣämä
ፈጻሚ	fäṣṣami
ፉት	futt
ፉከራ	fukkära
ፉክክር	fukǝkkǝr
ፉጉሎ	fugullo
ፊር	firr
ፊተኛው	fitäññaw
ፊትና	fitǝnna
ፊን	finn
ፊኛ	fiñña
ፊጥኝ	fiṭṭǝññ
ፋነነ	fannänä
ፋንድያ	fanǝddǝya
ፋኖ	fanno
ፋፋ	faffa
ፌዘኛ	fezzäñña
ፍለጋ	fǝlläga
ፍላጎት	fǝllagot
ፍልስፍና	fǝlǝsǝfǝnna
ፍልቃቂ	fǝllǝqqaqi
ፍሥሐ	fǝśśǝḥa
ፍራሽ	fǝrraš
ፍራቻ	fǝračča
ፍሬያማ	fǝreyamma
ፍርምባ	fǝrǝmǝbba
ፍርስ	fǝrrǝs
ፍርጥ	fǝrrǝṭ
ፍርፋሪ	fǝrǝffari
ፍሳሽ	fǝssaš
ፍስስ	fǝssǝs
ፍስክ	fǝssǝk
ፍቅረኛ	fǝqǝräñña
ፍቅፋቂ	fǝqǝffaqi
ፍተሻ	fǝttäša
ፍተጋ	fǝttäga
ፍትወተኛ	fǝtǝwätäñña
ፍትግ	fǝttǝg
ፍች	fǝčč
ፍንካች	fǝnǝkkač
ፍንክች	fǝnǝkǝčč
ፍንድቅ	fǝnǝddǝqq
ፍየል	fǝyyäl
ፍዳ	fǝdda
ፍዳውን	fǝddawǝn
ፍጅት	fǝǧǧǝt
ፍግም	fǝggǝmm
ፍግፋጊ	fǝgǝffagi
ፍጥጥ	fǝṭǝṭṭ
ፍጹምነት	fǝṣṣumǝnnät
ፎሌ	folle
ፎልፏላ	folǝfʷalla
ፎረሸ	forräšä
ፎቀቅ	foqqäq
ፎነነ	fonnänä
ፎከረ	fokkärä
ፎከተ	fokkätä
ፎከት	fokätt
ፓኮ	pakko
ፓፓዬ	pappaye
ፕሮፓጋንዳ	pǝropaganǝdda
ፖሊቲከኛ	politikäñña
ፖስተኛ	posǝtäñña
