# Baby names
ਅਂਗਦ	അംഗദ
ਅਂਗਦ ਦੇਵ	അംഗദ ദേവ
ਅਂਗਾਰਿਕਾ	അംഗാരികാ
ਅਂਤਰਜੋਤ	അംതരജോത
ਅਂਤਰਪ੍ਰਿਤ	അംതരപ്രിത
ਅਂਤਰਾ	അംതരാ
ਅਕਲਤਟ	അകലതട
ਅਕਲਰੂਪ	അകലരൂപ
ਅਕਲਸ਼ਰਣ	അകലശരണ
ਅਕਲਸੀਮਾਰ	അകലസീമാര
ਅਕਾਲਜੋਗ	അകാലജോഗ
ਅਕਾਲਦੀਪ	അകാലദീപ
ਅਕਾਲਪ੍ਰੀਤ	അകാലപ്രീത
ਅਕਾਲਬੀਰ	അകാലബീര
ਅਗਮਜੀਤ	അഗമജീത
ਅਗਮਜੋਤ	അഗമജോത
ਅਗਮ੍ਪਾਲ	അഗമ്പാല
ਅਗਮ੍ਪ੍ਰੀਤ	അഗമ്പ്രീത
ਅਜ੍ਮੀਨ੍ਦੇਰ	അജ്മീന്ദേര
ਅਝਾਦਬੀਰ	അഝാദബീര
ਅਝੀਝ	അഝീഝ
ਅਤੀਨਦੇਰ੍ਜਿਤ	അതീനദേര്ജിത
ਅਤੀਨ੍ਦੇਰ	അതീന്ദേര
ਅਤ੍ਤਾਮਜਿਤ	അത്താമജിത
ਅਨਂਤਦੇਵ	അനംതദേവ
ਅਨਂਤਰ	അനംതര
ਅਨਂਤਵੀਰ	അനംതവീര
ਅਨਂਤ੍ਜੀਤ	അനംത്ജീത
ਅਨਾਹਤ	അനാഹത
ਅਨਿਂਦਿਤਾ	അനിംദിതാ
ਅਨਿਸ਼ਾ	അനിശാ
ਅਨੀਲਜੋਤ	അനീലജോത
ਅਨੀਸ਼੍ਕੋਉਂਰ	അനീശ്കോഉംര
ਅਨੁਂਜਪਾਲ	അനുംജപാല
ਅਨੁਂਪਜੋਤ	അനുംപജോത
ਅਨੁਰਾਧਾ	അനുരാധാ
ਅਨੁਸ਼੍ਕਾ	അനുശ്കാ
ਅਨੂਪਜੋਤ	അനൂപജോത
ਅਨੂਪਬੀਰ	അനൂപബീര
ਅਨੂਪਲੋਕ	അനൂപലോക
ਅਪੂਰ੍ਵਾ	അപൂര്വാ
ਅਪ੍ਰੀਨਦੇਰ	അപ്രീനദേര
ਅਬਨੀ	അബനീ
ਅਬਿਚਾਲ	അബിചാല
ਅਬਿਨਾਸ਼	അബിനാശ
ਅਭਿਜੀਤ	അഭിജീത
ਅਭਿਰੂਪ	അഭിരൂപ
ਅਮਨਜੀਤ	അമനജീത
ਅਮਰਜੋਤ	അമരജോത
ਅਮਰਤ	അമരത
ਅਮਰਿਂਦਰ	അമരിംദര
ਅਮਰਿਤ	അമരിത
ਅਮਲਜੋਤ	അമലജോത
ਅਮਾਨਜੀਵਨ	അമാനജീവന
ਅਮਾਨੀਨ੍ਦੇਰ	അമാനീന്ദേര
ਅਮਾਨ੍ਰੂਪ	അമാന്രൂപ
ਅਮਾਰ੍ਪਾਲ	അമാര്പാല
ਅਮਾਰ੍ਬੀਰ	അമാര്ബീര
ਅਮਿਕ	അമിക
ਅਮਿਤ	അമിത
ਅਮਿਤੋਜ	അമിതോജ
ਅਮੀਤਪਾਲ	അമീതപാല
ਅਮੀਤ੍ਬੀਰ	അമീത്ബീര
ਅਮੋਲ੍ਰਸ	അമോല്രസ
ਅਮ੍ਨੀਨ੍ਦੇਰ	അമ്നീന്ദേര
ਅਮ੍ਰੀਤਬਾਨ	അമ്രീതബാന
ਅਮ੍ਰੀਤ੍ਪ੍ਰਿਤ	അമ്രീത്പ്രിത
ਅਮ੍ਰੀਤ੍ਵਾਨੀ	അമ്രീത്വാനീ
ਅਰਮਾਨੀ	അരമാനീ
ਅਰਵਜੋਤ	അരവജോത
ਅਰੀਨਾਜੇਤ	അരീനാജേത
ਅਰੀਨ੍ਦੇਰ੍ਜੀਤ	അരീന്ദേര്ജീത
ਅਰੁਨਜੀਤ	അരുനജീത
ਅਰੁਨਜੋਤ	അരുനജോത
ਅਰ੍ਚਨਾ	അര്ചനാ
ਅਰ੍ਦਮਨ	അര്ദമന
ਅਰ੍ਨਾਲੀਨ੍ਦੇਰ	അര്നാലീന്ദേര
ਅਰ੍ਸ਼੍ਦੀਪ	അര്ശ്ദീപ
ਅਲੋਕ੍ਪਾਲ	അലോക്പാല
ਅਲ੍ਪਨਾ	അല്പനാ
ਅਵਨੀਨਦੇਰ	അവനീനദേര
ਅਵਿਰ	അവിര
ਅਵ੍ਲੀਨ	അവ്ലീന
ਅਸਂਖ	അസംഖ
ਅਸ਼ਮਿਤ	അശമിത
ਅਸ਼ਰ੍ਨਾਮ	അശര്നാമ
ਅਸ਼ਰ੍ਪ੍ਰੀਤ	അശര്പ്രീത
ਅਸ਼ਰ੍ਪ੍ਰੇਮ	അശര്പ്രേമ
ਅਸ਼ਰ੍ਵੀਰ	അശര്വീര
ਅਸ਼ਿਮਾ	അശിമാ
ਅਸੀਮ	അസീമ
ਅਸੀਸ	അസീസ
ਅਸ੍ਨੇਹ	അസ്നേഹ
ਆਖਰੀ	ആഖരീ
ਆਤ੍ਮਜਾ	ആത്മജാ
ਆਨਂਦਮਯੀ	ആനംദമയീ
ਆਨਂਦਰੂਪ	ആനംദരൂപ
ਆਯਕਾਰ	ആയകാര
ਆਯਾਤਪ੍ਰਿਤ	ആയാതപ്രിത
ਆਯੁਸ਼੍ਮਤਿ	ആയുശ്മതി
ਆਰਮਾਨ	ആരമാന
ਆਰਾਧ	ആരാധ
ਆਰਾਧਨਾ	ആരാധനാ
ਆਰ੍ਯਨ	ആര്യന
ਇਂਦਰਬੀਰ	ഇംദരബീര
ਇਂਦਿਵਰ	ഇംദിവര
ਇਕਪ੍ਰਿਤ	ഇകപ്രിത
ਇਕਬਾਲ	ഇകബാല
ਇਕਰੂਪ	ഇകരൂപ
ਇਕ੍ਪੂਜ	ഇക്പൂജ
ਇਕ੍ਮਾਨ	ഇക്മാന
ਇਚ੍ਕਜਿਤ	ഇച്കജിത
ਇਨ੍ਦਾਰਤੇਜ	ഇന്ദാരതേജ
ਇਨ੍ਦਾਰਮਿਤ	ഇന്ദാരമിത
ਇਨ੍ਦਾਰ੍ਦੀਪ	ഇന്ദാര്ദീപ
ਇਨ੍ਦਾਰ੍ਪ੍ਰਿਤ	ഇന്ദാര്പ്രിത
ਇਨ੍ਦਾਰ੍ਪ੍ਰੇਮ	ഇന്ദാര്പ്രേമ
ਇਨ੍ਦੇਰ	ഇന്ദേര
ਇਨ੍ਦੇਰਪਲ	ഇന്ദേരപല
ਇਨ੍ਦੇਰਮਾਨ	ഇന്ദേരമാന
ਇਨ੍ਦੇਰਹਾਰ੍ਜਿਤ	ഇന്ദേരഹാര്ജിത
ਇਮਰਾਤ	ഇമരാത
ਈਖ੍ਤਿਅਰ	ഈഖ്തിഅര
ਈਨ੍ਦਰ੍ਜੀਏਤ	ഈന്ദര്ജീഏത
ਈਨ੍ਦੇਰਤੇਕ	ഈന്ദേരതേക
ਈਨ੍ਦੇਰਵੀਰ	ഈന്ദേരവീര
ਈਬਾਦਤ	ഈബാദത
ਈਸ਼ਪਾਲ	ഈശപാല
ਈਸ਼ਲੀਨ	ഈശലീന
ਈਸ਼ਾਰਤੇਕ	ഈശാരതേക
ਈਸ਼ਾਰਪਾਲ	ഈശാരപാല
ਈਸ਼੍ਤ੍ਵਰ੍ਜਿਤ	ഈശ്ത്വര്ജിത
ਈਸ਼੍ਪ੍ਰਿਤ	ഈശ്പ്രിത
ਈਸ਼੍ਵਾਰ੍ਜਿਤ	ഈശ്വാര്ജിത
ਈਸ਼੍ਵੀਨਦੇਰ	ഈശ്വീനദേര
ਉਖ੍ਤਿਅਰ	ഉഖ്തിഅര
ਉਚਪਾਲ	ഉചപാല
ਉਚਪ੍ਰਿਤ	ഉചപ്രിത
ਉਚੀਤਦੀਪ	ഉചീതദീപ
ਉਚੀਤਪ੍ਰਿਤ	ഉചീതപ്രിത
ਉਚੀਤਬੀਰ	ഉചീതബീര
ਉਚੀਤਰੂਪ	ഉചീതരൂപ
ਉਚੀਤਲੋਕ	ഉചീതലോക
ਉਚੀਤਵਂਤ	ഉചീതവംത
ਉਜਗਰ੍ਜੋਤ	ഉജഗര്ജോത
ਉਜਗਰ੍ਦੀਪ	ഉജഗര്ദീപ
ਉਜਗਰ੍ਬੀਰ	ഉജഗര്ബീര
ਉਜਾਗਰ	ഉജാഗര
ਉਜਾਲਾ	ഉജാലാ
ਉਜ੍ਜਲਜੋਤ	ഉജ്ജലജോത
ਉਤ੍ਤਮ	ഉത്തമ
ਉਤ੍ਤਮਪਾਲ	ഉത്തമപാല
ਉਤ੍ਤਮਲੀਵ	ഉത്തമലീവ
ਉਤ੍ਤਾਮਕਾਰਾਮ	ഉത്താമകാരാമ
ਉਤ੍ਤਾਮਜੋਧ	ഉത്താമജോധ
ਉਤ੍ਤਾਮਤਿਰਥ	ഉത്താമതിരഥ
ਉਤ੍ਤਾਮਤੇਕ	ഉത്താമതേക
ਉਤ੍ਤਾਮਦੀਪ	ഉത്താമദീപ
ਉਤ੍ਤਾਮਪਦ	ഉത്താമപദ
ਉਤ੍ਤਾਮ੍ਰਸ	ഉത്താമ്രസ
ਉਤ੍ਤਾਮ੍ਰੂਪ	ഉത്താമ്രൂപ
ਉਤ੍ਰਕ੍ਸ਼	ഉത്രക്ശ
ਉਦੀਤਦੀਪ	ഉദീതദീപ
ਉਦੀਤਪ੍ਰਿਤ	ഉദീതപ്രിത
ਉਦੀਤਬੀਰ	ഉദീതബീര
ਉਦੈਬੀਰ	ഉദൈബീര
ਉਦੈਭਗਤ	ഉദൈഭഗത
ਉਦ੍ਦਾਮਜੀਤ	ഉദ്ദാമജീത
ਉਪਕਰਮ	ഉപകരമ
ਉਪਕਿਰਤ	ഉപകിരത
ਉਪਜਿਤ	ഉപജിത
ਉਪਨਿਤ	ഉപനിത
ਉਪੀਨਦੇਰ੍ਪ੍ਰਿਤ	ഉപീനദേര്പ്രിത
ਉਪੇਨ੍ਦੇਰ	ഉപേന്ദേര
ਉਮੀਦ	ഉമീദ
ਊਤ੍ਤਮ੍ਗਿਆਨ	ഊത്തമ്ഗിആന
ਏਕਂਕਰ	ഏകംകര
ਏਕਬੀਰ	ഏകബീര
ਏਕਮ	ഏകമ
ਏਕਮਪੂਜ	ഏകമപൂജ
ਏਕਮਬੀਰ	ഏകമബീര
ਏਕਮ੍ਜੋਤ	ഏകമ്ജോത
ਏਕਮ੍ਰੂਪ	ഏകമ്രൂപ
ਏਕਾਨਪ੍ਰੀਤ	ഏകാനപ്രീത
ਏਕ੍ਕਾਮ	ഏക്കാമ
ਏਤੀਬਾਰ	ഏതീബാര
ਏਤ੍ਤਲੀਨ	ഏത്തലീന
ਏਰਸ਼ੀਨ	ഏരശീന
ਏਵੇਨਿਤ	ഏവേനിത
ਏਸ਼ਨਾ	ഏശനാ
ਏਸ਼੍ਵਰ	ഏശ്വര
ਓਨਕਾਰ੍ਜਿਤ	ഓനകാര്ജിത
ਓਨਕਾਰ੍ਜੀਤ	ഓനകാര്ജീത
ਓਨਕਾਰ੍ਪ੍ਰਿਤ	ഓനകാര്പ്രിത
ਓਮਪ੍ਰਿਤ	ഓമപ്രിത
ਕਂਵਲ	കംവല
ਕਂਵਲਜੀਤ	കംവലജീത
ਕਨਵਾਰ੍ਜਾਗਤ	കനവാര്ജാഗത
ਕਨਵਾਰ੍ਜਿਤ	കനവാര്ജിത
ਕਨਵਾਰ੍ਪ੍ਰੇਮ	കനവാര്പ്രേമ
ਕਨਵਾਲ੍ਜੋਤ	കനവാല്ജോത
ਕਨਵਾਲ੍ਨੈਨ	കനവാല്നൈന
ਕਨਵਾਲ੍ਪਾਲ	കനവാല്പാല
ਕਨਵਾਲ੍ਪ੍ਰੇਮ	കനവാല്പ്രേമ
ਕਨਵਾਲ੍ਬੀਰ	കനവാല്ബീര
ਕਨਵਾਲ੍ਰੂਪ	കനവാല്രൂപ
ਕਨ੍ਚਨ੍ਦੀਪ	കന്ചന്ദീപ
ਕਨ੍ਚਾਨ੍ਪਾਲ	കന്ചാന്പാല
ਕਨ੍ਵਾਰਪਾਲ	കന്വാരപാല
ਕਮਾਲ੍ਲਾ	കമാല്ലാ
ਕਰਨਦੀਪ	കരനദീപ
ਕਰਨਪਾਲ	കരനപാല
ਕਰਨਪ੍ਰਿਤ	കരനപ്രിത
ਕਰਨਰੂਪ	കരനരൂപ
ਕਰਮਪਲ	കരമപല
ਕਰਮਪੁਲ	കരമപുല
ਕਰਮ੍ਜੋਤ	കരമ്ജോത
ਕਰੁਨ੍ਯਾ	കരുന്യാ
ਕਲਬੀਰ	കലബീര
ਕਲਾਜੋਤ	കലാജോത
ਕਲਾਪ੍ਰੇਮ	കലാപ്രേമ
ਕਵਨਿਤ	കവനിത
ਕਵਨੀਰ	കവനീര
ਕਵਾਲ੍ਨਾਨ	കവാല്നാന
ਕਵਿਰਾਜ	കവിരാജ
ਕਸਮ	കസമ
ਕਾਨਵਾਲੀਨ੍ਦੇਰ	കാനവാലീന്ദേര
ਕਾਮਾਂਲਜੋਤ	കാമാംലജോത
ਕਾਮਾਂਲਮਿਤ	കാമാംലമിത
ਕਾਮਾਂਲਮੋਹਨ	കാമാംലമോഹന
ਕਾਮਾਂਲ੍ਪਤਿ	കാമാംല്പതി
ਕਾਰਮਨ	കാരമന
ਕਾਵਾਲਪ੍ਰਿਤ	കാവാലപ്രിത
ਕਿਰਣਜੀਤ	കിരണജീത
ਕਿਰਨਰੂਪ	കിരനരൂപ
ਕਿਰਨਸੁਖ	കിരനസുഖ
ਕਿਸ਼ੇਨ	കിശേന
ਕੁਂਵਰਜੀਤ	കുംവരജീത
ਕੁਲ	കുല
ਕੁਲਜੋਤ	കുലജോത
ਕੁਲਮਿਤ	കുലമിത
ਕੁਲਰਾਤਨ	കുലരാതന
ਕੁਲਰੂਪ	കുലരൂപ
ਕੁਲਵਂਠ	കുലവംഠ
ਕੁਸ਼ਪ੍ਰਿਤ	കുശപ്രിത
ਕੇਵਾਲਦੀਪ	കേവാലദീപ
ਕੇਵਾਲਬੀਰ	കേവാലബീര
ਕੋਉਰ	കോഉര
ਕੋਮਾਂਲਜੀਤ	കോമാംലജീത
ਕੋਮਾਂਲਪ੍ਰੇਮ	കോമാംലപ്രേമ
ਕੋਮਾਲਦੀਪ	കോമാലദീപ
ਕੋਮਾਲਮਿਤ	കോമാലമിത
ਕੌਰ	കൌര
ਕ੍ਰਿਸ਼੍ਦੀਪ	ക്രിശ്ദീപ
ਕ੍ਸ਼ਾਗਨ	ക്ശാഗന
ਕ੍ਸ਼ਾਗਰ	ക്ശാഗര
ਕ੍ਸ਼ਿਤਿਜ	ക്ശിതിജ
ਕ੍ਸ਼੍ਹੀਮ	ക്ശ്ഹീമ
ਖਰਗ	ഖരഗ
ਖਾਲਾਕ੍ਵੀਰ	ഖാലാക്വീര
ਖੁਂਸ਼ਜੋਤ	ഖുംശജോത
ਖੁਸ	ഖുസ
ਖੁਸ਼	ഖുശ
ਖੁਸ਼ਜੀਤ	ഖുശജീത
ਖੇਮਵਂਤ	ഖേമവംത
ਗਗਨ	ഗഗന
ਗਗਨਜੀਵ	ഗഗനജീവ
ਗਗਨਜੋਤ	ഗഗനജോത
ਗਗਨਪ੍ਰਿਤ	ഗഗനപ്രിത
ਗਗਨਮਿਤ	ഗഗനമിത
ਗਤਲੀਨ	ഗതലീന
ਗਤਸ਼ਰਣ	ഗതശരണ
ਗਤਸੀਮਾਰ	ഗതസീമാര
ਗਰੀਨ੍ਦੇਰ	ഗരീന്ദേര
ਗਰ੍ਗੋਤ	ഗര്ഗോത
ਗਾਤਨੀਵਾਸ	ഗാതനീവാസ
ਗਿਅਨ	ഗിഅന
ਗੀਂਜੀਵਨ	ഗീംജീവന
ਗੀਂਰਾਤਨ	ഗീംരാതന
ਗੀਂਲੀਨ	ഗീംലീന
ਗੀਅਂਗੀਤ	ഗീഅംഗീത
ਗੀਅਂਚੇਤਨ	ഗീഅംചേതന
ਗੀਅਂਜੋਤ	ഗീഅംജോത
ਗੀਅਂਪ੍ਰਿਤ	ഗീഅംപ്രിത
ਗੀਅਂਰੂਪ	ഗീഅംരൂപ
ਗੀਅਨੀਨਦੇਰ	ഗീഅനീനദേര
ਗੀਅਨ੍ਬੀਰ	ഗീഅന്ബീര
ਗੀਆਨਪ੍ਰਿਤ	ഗീആനപ്രിത
ਗੀਆਨਲੀਨ	ഗീആനലീന
ਗੀਤ	ഗീത
ਗੀਤਲੀਨ	ഗീതലീന
ਗੀਤੀਨਦੇਰ	ഗീതീനദേര
ਗੁਣਿਤ	ഗുണിത
ਗੁਨ ਦਾਤ	ഗുന ദാത
ਗੁਨਕਿਰਤ	ഗുനകിരത
ਗੁਨਜਸ	ഗുനജസ
ਗੁਨਜਿਤ	ഗുനജിത
ਗੁਨਜੀਵਨ	ഗുനജീവന
ਗੁਨਜੁਨ	ഗുനജുന
ਗੁਨਜੋਤ	ഗുനജോത
ਗੁਨਪ੍ਰਿਤ	ഗുനപ്രിത
ਗੁਨਮਿਤ	ഗുനമിത
ਗੁਨਰਾਜ	ഗുനരാജ
ਗੁਨਸ਼ਾਂਤ	ഗുനശാംത
ਗੁਨਾਤਮ	ഗുനാതമ
ਗੁਨਿਤਪੁਲ	ഗുനിതപുല
ਗੁਨਿਤਪ੍ਰਿਤ	ഗുനിതപ്രിത
ਗੁਨ੍ਰਿਤ	ഗുന്രിത
ਗੁਰਕਮਲ਼	ഗുരകമല
ਗੁਰਗਿਯਨ	ഗുരഗിയന
ਗੁਰਜਾਸ	ഗുരജാസ
ਗੁਰਜੀਵਨ	ഗുരജീവന
ਗੁਰਜੋਗ	ഗുരജോഗ
ਗੁਰਜੋਤ	ഗുരജോത
ਗੁਰਝੀਲ	ഗുരഝീല
ਗੁਰਤਰਣ	ഗുരതരണ
ਗੁਰਤਿਰਥ	ഗുരതിരഥ
ਗੁਰਦਰ੍ਸ਼ਨ	ഗുരദര്ശന
ਗੁਰਦਿਤ	ഗുരദിത
ਗੁਰਦੀਤ੍ਤਾ	ഗുരദീത്താ
ਗੁਰਦ੍ਵੀਪ	ഗുരദ്വീപ
ਗੁਰਨਾਦ	ഗുരനാദ
ਗੁਰਨਾਮਾਸ੍ਕਾਰ	ഗുരനാമാസ്കാര
ਗੁਰਨੀਧ	ഗുരനീധ
ਗੁਰਨੀਰ੍ਮਾਲ	ഗുരനീര്മാല
ਗੁਰਨੀਸ਼ਾਨ	ഗുരനീശാന
ਗੁਰਨ੍ਯਮ	ഗുരന്യമ
ਗੁਰਪਰ੍ਵਿਨ	ഗുരപര്വിന
ਗੁਰਪੀਨਦੇਰ	ഗുരപീനദേര
ਗੁਰਪ੍ਰੀਤਮ	ഗുരപ്രീതമ
ਗੁਰਬਕ੍ਸ਼	ഗുരബക്ശ
ਗੁਰਬਲੀਹਾਰ	ഗുരബലീഹാര
ਗੁਰਬੀਨ੍ਦੇਰ	ഗുരബീന്ദേര
ਗੁਰਬੀਰ	ഗുരബീര
ਗੁਰਭਜਨ	ഗുരഭജന
ਗੁਰਭਾਗਤ	ഗുരഭാഗത
ਗੁਰਮਾਰ	ഗുരമാര
ਗੁਰਮਾਹੇਰ	ഗുരമാഹേര
ਗੁਰਮੁਖ	ഗുരമുഖ
ਗੁਰਮੇਹਾਰ	ഗുരമേഹാര
ਗੁਰਮੈਲ	ഗുരമൈല
ਗੁਰਮ੍ਰਿਤ	ഗുരമ്രിത
ਗੁਰਲੋਚਨ	ഗുരലോചന
ਗੁਰਵਿਂਦਰ	ഗുരവിംദര
ਗੁਰਵੀਨ੍ਦੇਰ	ഗുരവീന്ദേര
ਗੁਰਵੀਰ	ഗുരവീര
ਗੁਰਸਨ੍ਦੀਪ	ഗുരസന്ദീപ
ਗੁਰਸ਼ਾਨ	ഗുരശാന
ਗੁਰਸੁਖ	ഗുരസുഖ
ਗੁਰਸੇਵ	ഗുരസേവ
ਗੁਰਹਾਰ੍ਪਾਲ	ഗുരഹാര്പാല
ਗੁਰਿਂਦਰ	ഗുരിംദര
ਗੁਰੀਨਦੇਰ੍ਪਾਲ	ഗുരീനദേര്പാല
ਗੁਰੁਕਾਰ	ഗുരുകാര
ਗੁਰੁਗੁਲ੍ਝਾਰ	ഗുരുഗുല്ഝാര
ਗੁਰੁਚਰਣ	ഗുരുചരണ
ਗੁਰੁਦਰ੍ਸ਼ਨ	ഗുരുദര്ശന
ਗੁਰੁਦਾਸ	ഗുരുദാസ
ਗੁਰੁਦੀਪ	ഗുരുദീപ
ਗੁਰੁਪ੍ਰੇਮ	ഗുരുപ്രേമ
ਗੁਰੁਬੀਰ	ഗുരുബീര
ਗੁਰੁਮਾਂਨ੍ਦੀਰ	ഗുരുമാംന്ദീര
ਗੁਰੁਸੀਮ੍ਰਣ	ഗുരുസീമ്രണ
ਗੁਰ੍ਕੀਰਣ	ഗുര്കീരണ
ਗੁਰ੍ਕੀਰਪਾਲ	ഗുര്കീരപാല
ਗੁਰ੍ਚਾਰਾਨ੍ਜੋਤ	ഗുര്ചാരാന്ജോത
ਗੁਰ੍ਜਨਪਾਲ	ഗുര്ജനപാല
ਗੁਰ੍ਜੁ	ഗുര്ജു
ਗੁਰ੍ਤੇਜ	ഗുര്തേജ
ਗੁਰ੍ਨੀਵਾਝ	ഗുര്നീവാഝ
ਗੁਰ੍ਨੂਰ	ഗുര്നൂര
ਗੁਰ੍ਪ੍ਰਿਤੀ	ഗുര്പ്രിതീ
ਗੁਰ੍ਮੀਤ	ഗുര്മീത
ਗੁਰ੍ਮੀਨਦੇਰ	ഗുര്മീനദേര
ਗੁਰ੍ਮੁਖਨੀਹਲ	ഗുര്മുഖനീഹല
ਗੁਰ੍ਸ਼ਣ	ഗുര്ശണ
ਗੁਰ੍ਸ਼ਾਂਤ	ഗുര്ശാംത
ਗੁਰ੍ਸ਼ੀਲ	ഗുര്ശീല
ਗੁਰ੍ਸਾਹੇਬ	ഗുര്സാഹേബ
ਗੁਲਦੀਪ	ഗുലദീപ
ਗੁਲਵਂਤ	ഗുലവംത
ਗੁਲਸ਼ਾਨ੍ਰੂਪ	ഗുലശാന്രൂപ
ਗੁਲ੍ਵਾਨ੍ਤਪ੍ਰਿਤ	ഗുല്വാന്തപ്രിത
ਗੁਲ੍ਸ਼ਾਨਪ੍ਰਿਤ	ഗുല്ശാനപ്രിത
ਗੁਲ੍ਸ਼ਾਨਮਿਤ	ഗുല്ശാനമിത
ਗੋਪਲਪ੍ਰਿਤ	ഗോപലപ്രിത
ਗੋਬਿਂਦ	ഗോബിംദ
ਗੋਬੀਨਦੇਰ	ഗോബീനദേര
ਗੋਬੀਨਦੇਰ੍ਜਿਤ	ഗോബീനദേര്ജിത
ਗੋਬੀਨ੍ਦਰਾਈ	ഗോബീന്ദരാഈ
ਗੌਰਵ੍ਪ੍ਰਿਤ	ഗൌരവ്പ്രിത
ਘਮਾਂਨਦ੍ਜਿਤ	ഘമാംനദ്ജിത
ਘਮਾਂਨਦ੍ਪਾਲ	ഘമാംനദ്പാല
ਚਂਚਲਜਿਤ	ചംചലജിത
ਚਂਚਲ੍ਪ੍ਰੀਤ	ചംചല്പ്രീത
ਚਂਦਨ	ചംദന
ਚਂਦਨਦੀਪ	ചംദനദീപ
ਚਮਕੌਰ	ചമകൌര
ਚਮਨਜਿਤ	ചമനജിത
ਚਮਨਪ੍ਰਿਤ	ചമനപ്രിത
ਚਮਨਰੂਪ	ചമനരൂപ
ਚਰਨਕਾਨ੍ਵਾਲ	ചരനകാന്വാല
ਚਰਨਜੋਤ /ਚਰਨਜ੍ਯੋਤ	ചരനജോത /ചരനജ്യോത
ਚਰਨਪ੍ਰੇਮ	ചരനപ്രേമ
ਚਾਂਦ	ചാംദ
ਚਿਤਰਾਮਣ	ചിതരാമണ
ਚਿਤਸਰੂਪ	ചിതസരൂപ
ਚੀਤਪ੍ਰਿਤ	ചീതപ്രിത
ਚੇਤਨ੍ਦੀਪ	ചേതന്ദീപ
ਜਗਜੀਤ	ജഗജീത
ਜਗਜੀਵ	ജഗജീവ
ਜਗਜੀਵਨ	ജഗജീവന
ਜਗਤਜੀਤ	ജഗതജീത
ਜਗਤਪ੍ਰੇਮ	ജഗതപ്രേമ
ਜਗਤਰਣ	ജഗതരണ
ਜਗਤਰੂਪ	ജഗതരൂപ
ਜਗਨ	ജഗന
ਜਗਪਾਲ	ജഗപാല
ਜਗਪ੍ਰਿਤ	ജഗപ്രിത
ਜਗਪ੍ਰੇਮ	ജഗപ്രേമ
ਜਗਮਿਤ	ജഗമിത
ਜਗਮੇਹਾਰ	ജഗമേഹാര
ਜਗਮੋਹਨ	ജഗമോഹന
ਜਗਰਾਜ	ജഗരാജ
ਜਗਰੂਪ	ജഗരൂപ
ਜਗਵੀਨ੍ਦੇਰ	ജഗവീന്ദേര
ਜਗਵੀਰ	ജഗവീര
ਜਗੀਨਦੇਰ	ജഗീനദേര
ਜਗੀਨ੍ਦੇਰਪਾਲ	ജഗീന്ദേരപാല
ਜਗ੍ਵੀਰ	ജഗ്വീര
ਜਘ੍ਰ	ജഘ്ര
ਜਤੀਨਦੇਰ੍ਜਿਤ	ജതീനദേര്ജിത
ਜਤੀਨਦੇਰ੍ਬੀਰ	ജതീനദേര്ബീര
ਜਤੀਨਦੇਰ੍ਮਿਤ	ജതീനദേര്മിത
ਜਨਜਿਤ	ജനജിത
ਜਨਜੋਤ	ജനജോത
ਜਨਪ੍ਰਿਤ	ജനപ്രിത
ਜਨਰਾਜ	ജനരാജ
ਜਨਿਸ਼	ജനിശ
ਜਪਜਿਤ	ജപജിത
ਜਪਧਾਰਾਮ	ജപധാരാമ
ਜਪਧਿਰ	ജപധിര
ਜਪਨਾਮ	ജപനാമ
ਜਪਸ਼ੇਰ	ജപശേര
ਜਪੁਜੀ	ജപുജീ
ਜਬਰਜਂਗ	ജബരജംഗ
ਜਮੀਲ	ജമീല
ਜਯਂਸ਼	ജയംശ
ਜਯਪਾਲ	ജയപാല
ਜਰ੍ਨੈਲ	ജര്നൈല
ਜਲਿਨ੍ਦ੍ਰ	ജലിന്ദ്ര
ਜਲ੍ਬੀਰ	ജല്ബീര
ਜਸਂਜੋਤ	ജസംജോത
ਜਸਂਪਾਲ	ജസംപാല
ਜਸਂਮਿਤ	ജസംമിത
ਜਸਕੀਰਣ	ജസകീരണ
ਜਸਗੁਰ੍ਕੀਰ੍ਤਤ	ജസഗുര്കീര്തത
ਜਸਜੀਨ੍ਦੇਰ	ജസജീന്ദേര
ਜਸਜੀਵਨ	ജസജീവന
ਜਸਜੋਤ	ജസജോത
ਜਸਤਰਣ	ജസതരണ
ਜਸਨਾਮ	ജസനാമ
ਜਸਪਾਲ (ਪੁਲ )	ജസപാല (പുല )
ਜਸਬੀਰ	ജസബീര
ਜਸਭੂਪ	ജസഭൂപ
ਜਸਮਿਂਦਰ	ജസമിംദര
ਜਸਮੋਹਨ	ജസമോഹന
ਜਸਰੂਪ	ജസരൂപ
ਜਸ੍ਕਰਣ	ജസ്കരണ
ਜਸ੍ਕੀਰਿਤ	ജസ്കീരിത
ਜਸ੍ਕੀਰ੍ਪਲ	ജസ്കീര്പല
ਜਸ੍ਗੁਨ	ജസ്ഗുന
ਜਸ੍ਮਿਤ	ജസ്മിത
ਜਸ੍ਮੀਨਪ੍ਰਿਤ	ജസ്മീനപ്രിത
ਜਸ੍ਰਜਪ੍ਰਿਤ	ജസ്രജപ്രിത
ਜਸ੍ਸੀ	ജസ്സീ
ਜਾਗ	ജാഗ
ਜਾਗਰੀਤ	ജാഗരീത
ਜਾਤਵਂਤ	ജാതവംത
ਜਾਤਿਨਦੇਰ੍ਦੀਪ	ജാതിനദേര്ദീപ
ਜਾਨਾਕਪ੍ਰਿਤ	ജാനാകപ്രിത
ਜਾਪਮਾਨ	ജാപമാന
ਜਾਸਨਿਤ	ജാസനിത
ਜਾਸ਼ਾਨਪ੍ਰਿਤ	ജാശാനപ്രിത
ਜਾਸ੍ਮੀਲ	ജാസ്മീല
ਜੀਵਨਦੀਪ ; ਜੀਵਨਦੀਪ ; ਜੀਵਨਦੀਪ	ജീവനദീപ ; ജീവനദീപ ; ജീവനദീപ
ਜੀਵਨਪਲ	ജീവനപല
ਜੀਵਨਪ੍ਰਿਤ	ജീവനപ്രിത
ਜੀਵਾਨਬੀਰ	ജീവാനബീര
ਜੁਗਦ	ജുഗദ
ਜੁਪੀਨਦੇਰਦੀਪ	ജുപീനദേരദീപ
ਜੁਪੀਨਦੇਰ੍ਬੀਰ	ജുപീനദേര്ബീര
ਜੁਸਜਿਤ	ജുസജിത
ਜੁਸਪੁਲ	ജുസപുല
ਜੁਸਮੈਲ	ജുസമൈല
ਜੇਬਾ	ജേബാ
ਜੇਸਪਾਲ	ജേസപാല
ਜੈਕਾਰ	ജൈകാര
ਜੈਪ੍ਰਜ	ജൈപ്രജ
ਜੈਪ੍ਰਤਨ	ജൈപ്രതന
ਜੈਬੀਰ	ജൈബീര
ਜੈਸਂਗਤ	ജൈസംഗത
ਜੈਸੁਖਬੀਰ	ജൈസുഖബീര
ਜੋਗਧੀਆਨ	ജോഗധീആന
ਜੋਗਪ੍ਰਕਾਸ਼	ജോഗപ്രകാശ
ਜੋਗੀਨਦੇਰ੍ਬੀਰ	ജോഗീനദേര്ബീര
ਜੋਗੀਨਦੇਰ੍ਮਿਤ	ജോഗീനദേര്മിത
ਜੋਗੇਨਦੇਰ	ജോഗേനദേര
ਜੋਤਪ੍ਰਕਾਸ਼	ജോതപ്രകാശ
ਜੋਬਨਰੂਪ	ജോബനരൂപ
ਜੋਹਾਰ	ജോഹാര
ਜ੍ਞਾਨਜਿਤ	ജ്ഞാനജിത
ਜ੍ਞਾਨਜੋਤ	ജ്ഞാനജോത
ਜ੍ਞਾਨਪ੍ਰਿਤ	ജ്ഞാനപ്രിത
ਜ੍ਞਾਨਰੂਪ	ജ്ഞാനരൂപ
ਜ੍ਞਾਨਵੀਰ	ജ്ഞാനവീര
ਜ੍ਞਾਨੇਨ੍ਦੇਰ	ജ്ഞാനേന്ദേര
ਜ੍ਹਮਕ	ജ്ഹമക
ਜ੍ਹਾਗਰ	ജ്ഹാഗര
ਝਈਤੂਨ	ഝഈതൂന
ਝਹਾਗਨ	ഝഹാഗന
ਝਾਮੀਨਾਹ	ഝാമീനാഹ
ਝੀਤੁਨ	ഝീതുന
ਝੀਲ	ഝീല
ਝੁਲਾਖਾ	ഝുലാഖാ
ਝੁਲ੍ਫਾ	ഝുല്ഫാ
ਝੇਬਵਂਤ	ഝേബവംത
ਝੋਰਾਵਾਰ	ഝോരാവാര
ਟੇਇਜਿਨ੍ਦੇਰ	ടേഇജിന്ദേര
ਤਕਦੀਰ	തകദീര
ਤਖਤ	തഖത
ਤਤਜੋਗ	തതജോഗ
ਤਤਬੀਰ	തതബീര
ਤਤਵਿਚਾਰ	തതവിചാര
ਤਤ੍ਰਾਤਨ	തത്രാതന
ਤਦਬੀਰ	തദബീര
ਤਨਦੀਪ	തനദീപ
ਤਨਵੀਰ	തനവീര
ਤਮਨ੍ਪ੍ਰਿਤ	തമന്പ്രിത
ਤਰਣਵੀਰ	തരണവീര
ਤਰਲੋਚਨ	തരലോചന
ਤਰਸੇਮ	തരസേമ
ਤਰੁਨਜਿਤ	തരുനജിത
ਤਲਵਿਨ	തലവിന
ਤਾਜਦਾਰ	താജദാര
ਤਾਜੀਨਦੇਰ੍ਦੀਪ	താജീനദേര്ദീപ
ਤਾਜੀਨਦੇਰ੍ਪ੍ਰੇਮ	താജീനദേര്പ്രേമ
ਤਾਨੁਪ੍ਰਿਤ	താനുപ്രിത
ਤਾਪਨਪਾਲ	താപനപാല
ਤੀਰਨ /ਤਿਹ੍ਰਣ /ਤੇਯ੍ਰੁਣ	തീരന /തിഹ്രണ /തേയ്രുണ
ਤੀਰਾਥ੍ਰਾਮ	തീരാഥ്രാമ
ਤੁਵਿਜਾਤ	തുവിജാത
ਤੇਕਜੀਤ	തേകജീത
ਤੇਕਦੀਪ	തേകദീപ
ਤੇਕਪ੍ਰਿਤ	തേകപ്രിത
ਤੇਕ੍ਪਾਲ	തേക്പാല
ਤੇਘਬਹਾਦੁਰ	തേഘബഹാദുര
ਤੇਜਧਾਰਾਮ	തേജധാരാമ
ਤੇਜਨਾਮ	തേജനാമ
ਤੇਜਪ੍ਰਤਾਪ	തേജപ്രതാപ
ਤੇਜ਼	തേജ
ਤੇਜਾਸਵੀਰ	തേജാസവീര
ਤੇਜੀਨਦੇਰ੍ਜੀਤ	തേജീനദേര്ജീത
ਤੇਜੀਨਦੇਰ੍ਪਾਲ	തേജീനദേര്പാല
ਤੋਤਾਸਿਂਹ	തോതാസിംഹ
ਤ੍ਰਿਪਲ	ത്രിപല
ਤ੍ਰਿਲੋਚਨ	ത്രിലോചന
ਤ੍ਰੀਭਾਵਾਨ	ത്രീഭാവാന
ਤ੍ਰੀਸ਼ਾਨਜੋਤ	ത്രീശാനജോത
ਤ੍ਰੀਸ਼ਾਨਦੀਪ	ത്രീശാനദീപ
ਤ੍ਰੀਸ਼ਾਨਬੀਰ	ത്രീശാനബീര
ਥਾਕੁਰਨਾਮ	ഥാകുരനാമ
ਥਾਲਭੂਪ	ഥാലഭൂപ
ਥਾਲਰਾਜ	ഥാലരാജ
ਥੀਰਮਾਨ	ഥീരമാന
ਥੀਰ੍ਧੀਆਨ	ഥീര്ധീആന
ਦਮਨਜਿਤ	ദമനജിത
ਦਮਨਜੋਤ	ദമനജോത
ਦਯਾਜੋਤ	ദയാജോത
ਦਯਾਦੀਪ	ദയാദീപ
ਦਰਮੀਨ੍ਦੇਰ	ദരമീന്ദേര
ਦਰ੍ਪ੍ਰਿਤ	ദര്പ്രിത
ਦਲਜੋਧ	ദലജോധ
ਦਲਬੀਨਦੇਰ	ദലബീനദേര
ਦਲਬੀਨ੍ਦੇਰ੍ਜਿਤ	ദലബീന്ദേര്ജിത
ਦਲਰਾਜ	ദലരാജ
ਦਲੇਰ	ദലേര
ਦਵੀਨ੍ਦੇਰ	ദവീന്ദേര
ਦਿਦਾਰ	ദിദാര
ਦਿਨਤੇਕ	ദിനതേക
ਦਿਪਲੀਨ	ദിപലീന
ਦਿਲਜੋਤ	ദിലജോത
ਦਿਲਨਿਤ	ദിലനിത
ਦਿਲਪ੍ਰਿਤ	ദിലപ്രിത
ਦਿਲਮਿਤ	ദിലമിത
ਦਿਲਰਿਤ	ദിലരിത
ਦਿਲਸ਼ਾਨ	ദിലശാന
ਦਿਲਸ਼ੇਰ	ദിലശേര
ਦਿਵ੍ਯਜ੍ਯੋਤ	ദിവ്യജ്യോത
ਦੀਲਜੀਤ	ദീലജീത
ਦੀਲਬਾਘ	ദീലബാഘ
ਦੀਲ੍ਜਿਤ	ദീല്ജിത
ਦੀਵ੍ਯਜੋਤ	ദീവ്യജോത
ਦੇਵਜੀਤ	ദേവജീത
ਦੇਵਪ੍ਰਿਤ	ദേവപ്രിത
ਦੇਵਾਤ੍ਮਾ	ദേവാത്മാ
ਦੇਵੀਨ੍ਦੇਰ	ദേവീന്ദേര
ਧਰਮਜ੍ਯੋਤ	ധരമജ്യോത
ਧਰਮਪਾਲ	ധരമപാല
ਧਰਮਪ੍ਰੀਤ	ധരമപ്രീത
ਧਰਮਲੀਨ	ധരമലീന
ਧੀਅਨ੍ਜੋਗ	ധീഅന്ജോഗ
ਨਕ੍ਸ਼ਤ੍ਰਾ	നക്ശത്രാ
ਨਮ੍ਰੀਤਾਬੀਰ	നമ്രീതാബീര
ਨਯਨਦੀਪ	നയനദീപ
ਨਰਿਨ੍ਦਰ	നരിന്ദര
ਨਰੇਨ੍ਦ੍ਰ	നരേന്ദ്ര
ਨਵਜੀਤ	നവജീത
ਨਵਜੀਵਨ	നവജീവന
ਨਵਦੀਪ	നവദീപ
ਨਵਬੀਰ	നവബീര
ਨਵਮਿਤ	നവമിത
ਨਵ੍ਜੀਨ੍ਦੇਰ	നവ്ജീന്ദേര
ਨਾਗਂਦਰ	നാഗംദര
ਨਾਨਕੀ	നാനകീ
ਨਾਨਵੀਰ	നാനവീര
ਨਾਨ੍ਦਾਨਜਿਤ	നാന്ദാനജിത
ਨਾਨ੍ਦਾਨਪ੍ਰਿਤ	നാന്ദാനപ്രിത
ਨਾਮਜੀਵ	നാമജീവ
ਨਾਮਜੋਗ	നാമജോഗ
ਨਾਮਜੋਤ	നാമജോത
ਨਾਮਜੋਧ	നാമജോധ
ਨਾਮਧਾਰ	നാമധാര
ਨਾਮਧਿਯਨ	നാമധിയന
ਨਾਮਧਿਰ	നാമധിര
ਨਾਮਨੀਰ੍ਮਾਲ	നാമനീര്മാല
ਨਾਮਨੀਵਾਸ	നാമനീവാസ
ਨਾਮਪ੍ਰਿਤ	നാമപ്രിത
ਨਾਮਪ੍ਰੇਮ	നാമപ്രേമ
ਨਾਮਭਾਗਤ	നാമഭാഗത
ਨਾਮਵਿਚਾਰ	നാമവിചാര
ਨਾਮਸ਼ਰਣ	നാമശരണ
ਨਾਮਾਂਡੋਲ਼	നാമാംഡോല
ਨਾਮਾਹਾਰ	നാമാഹാര
ਨਾਮੁਤ੍ਤਮ	നാമുത്തമ
ਨਾਮ੍ਰਾਤਨ	നാമ്രാതന
ਨਾਮ੍ਰਿਤਾ	നാമ്രിതാ
ਨਾਮ੍ਰੀਤਾਜੋਤ	നാമ്രീതാജോത
ਨਾਮ੍ਰੀਤਾਦੀਪ	നാമ്രീതാദീപ
ਨਾਮ੍ਰੀਤਾਪ੍ਰਿਤ	നാമ്രീതാപ്രിത
ਨਾਰ	നാര
ਨਾਰਂਜਨ	നാരംജന
ਨਾਰੀਤਪਲ	നാരീതപല
ਨਾਰੀਨਦੇਰਦੀਪ	നാരീനദേരദീപ
ਨਾਰੈਨ	നാരൈന
ਨਾਵਿਨਜਿਤ	നാവിനജിത
ਨਾਵ੍ਕੀਰਣ	നാവ്കീരണ
ਨਾਵ੍ਕੀਰਨਜੋਤ	നാവ്കീരനജോത
ਨਾਵ੍ਪ੍ਰਿਤ	നാവ്പ്രിത
ਨਿਮਾਈ	നിമാഈ
ਨਿਰਂਜਨ	നിരംജന
ਨਿਰਂਜਨਾ	നിരംജനാ
ਨਿਰ੍ਮਲਜੀਤ	നിര്മലജീത
ਨਿਲਾਮਜੋਤ	നിലാമജോത
ਨਿਲਾਮਪੁਲ	നിലാമപുല
ਨਿਲਾਮਪ੍ਰਿਤ	നിലാമപ്രിത
ਨਿਲਾਮਬੇਰ	നിലാമബേര
ਨਿਸ਼ਾ	നിശാ
ਨਿਹ੍ਚਾਲਤੇਕ	നിഹ്ചാലതേക
ਨਿਹ੍ਚਾਲਮਿਤ	നിഹ്ചാലമിത
ਨੀਤਨਾਮ	നീതനാമ
ਨੀਨਦੇਰ੍ਬੀਰ	നീനദേര്ബീര
ਨੀਮਮਾਂਪ੍ਰਿਤ	നീമമാംപ്രിത
ਨੀਮਮਾਂਰ੍ਦੀਪ	നീമമാംര്ദീപ
ਨੀਮ੍ਮਾਂਰਤਾ	നീമ്മാംരതാ
ਨੀਮ੍ਰਤ	നീമ്രത
ਨੀਰਮਾਂਲਦੀਪ	നീരമാംലദീപ
ਨੀਰਮਾਂਲਬੀਰ	നീരമാംലബീര
ਨੀਰਮੋਲ	നീരമോല
ਨੀਰਵੈਰ	നീരവൈര
ਨੀਰ੍ਭਾਉ	നീര്ഭാഉ
ਨੀਰ੍ਮਾਂਲਕਾਰਾਮ	നീര്മാംലകാരാമ
ਨੀਰ੍ਮਾਂਲਜੀਵ	നീര്മാംലജീവ
ਨੀਰ੍ਮਾਂਲਜੋਤ	നീര്മാംലജോത
ਨੀਰ੍ਮਾਂਲਤੇਕ	നീര്മാംലതേക
ਨੀਰ੍ਮਾਂਲਧਾਰਾਮ	നീര്മാംലധാരാമ
ਨੀਰ੍ਮਾਂਲਪ੍ਰਿਤ	നീര്മാംലപ്രിത
ਨੀਸ਼ਾਨ੍ਦੀਪ	നീശാന്ദീപ
ਨੀਹ੍ਚਾਲ੍ਪ੍ਰੇਮ	നീഹ്ചാല്പ്രേമ
ਨੂਰਦੇਵ	നൂരദേവ
ਨੂਰਨਿਤ	നൂരനിത
ਨੂਰਪ੍ਰਿਤ	നൂരപ്രിത
ਨੇਕਨਾਮ	നേകനാമ
ਨੇਕੀਨਦੇਰ	നേകീനദേര
ਨੇਕ੍ਦੀਪ	നേക്ദീപ
ਨੇਕ੍ਪਾਲ	നേക്പാല
ਨੇਹ੍ਚਾਲਪ੍ਰਿਤ	നേഹ്ചാലപ്രിത
ਨੈਨਤਾਰ	നൈനതാര
ਨੈਨਦੀਪ	നൈനദീപ
ਨੈਨੀਨਦੇਰ	നൈനീനദേര
ਨੋਉਲਖ	നോഉലഖ
ਨੌਹਨੀਹਲ	നൌഹനീഹല
ਨ੍ਰੀਪਜੋਤ	ന്രീപജോത
ਪਤਵਂਤ	പതവംത
ਪਤਵੀਰ	പതവീര
ਪਦਾਮਜਿਤ	പദാമജിത
ਪਦਾਮਪ੍ਰੇਮ	പദാമപ്രേമ
ਪਦ੍ਮਸ਼੍ਰੀ	പദ്മശ്രീ
ਪਰਤਾਪ ; ਪਰਤਾਪ	പരതാപ ; പരതാപ
ਪਰਤਾਪੀ	പരതാപീ
ਪਰਦੀਪ	പരദീപ
ਪਰਬੀਨ	പരബീന
ਪਰਮਕਮਲ਼	പരമകമല
ਪਰਮਕਿਰਤ	പരമകിരത
ਪਰਮਗੁਨ	പരമഗുന
ਪਰਮਜਾਪ	പരമജാപ
ਪਰਮਜੀਤ ; ਪਰਮਜੀਤ	പരമജീത ; പരമജീത
ਪਰਮਜੁਗਤ	പരമജുഗത
ਪਰਮਜੋਗ	പരമജോഗ
ਪਰਮਜੋਧ	പരമജോധ
ਪਰਮਠਾਕਰ	പരമഠാകര
ਪਰਮਤੇਕ	പരമതേക
ਪਰਮਦੀਪ	പരമദീപ
ਪਰਮਧਾਰਾਮ	പരമധാരാമ
ਪਰਮਧਿਰ	പരമധിര
ਪਰਮਪਾਲ	പരമപാല
ਪਰਮਪ੍ਰੇਮ	പരമപ്രേമ
ਪਰਮਬੋਧ	പരമബോധ
ਪਰਮਯੋਗ	പരമയോഗ
ਪਰਮਰਂਗ	പരമരംഗ
ਪਰਮਲੀਨ	പരമലീന
ਪਰਮਸ਼ਾਂਤ	പരമശാംത
ਪਰਮਸਿਤਾਲ	പരമസിതാല
ਪਰਮਸੁਖ	പരമസുഖ
ਪਰਮਸੇਵਕ	പരമസേവക
ਪਰਮਾਧਾਰ	പരമാധാര
ਪਰਮਾਰ੍ਥ	പരമാര്ഥ
ਪਰਮਿਂਦਰ	പരമിംദര
ਪਰਮੀਤ	പരമീത
ਪਰਮ੍ਦਯਾ	പരമ്ദയാ
ਪਰਸਂਜੀਤ	പരസംജീത
ਪਰਸ਼ੋਤਮ	പരശോതമ
ਪਰਾਮਨੀਵਾਸ	പരാമനീവാസ
ਪਰੀਦਰ੍ਸ਼ਨ	പരീദര്ശന
ਪਰ੍ਗਤ	പര്ഗത
ਪਰ੍ਵੀਨ੍ਦੇਰ	പര്വീന്ദേര
ਪਲਬੀਨਦੇਰ	പലബീനദേര
ਪਲਵੀਨ੍ਦੇਰ੍ਪਾਲ	പലവീന്ദേര്പാല
ਪਵਾਨਜੋਤ	പവാനജോത
ਪਵਾਨਦੀਪ	പവാനദീപ
ਪਵਾਨਪ੍ਰਿਤ	പവാനപ്രിത
ਪਵਾਨਵੀਰ	പവാനവീര
ਪਵੀਤ	പവീത
ਪਾਰਂਗਤ	പാരംഗത
ਪੁਨੀਤ	പുനീത
ਪੁਨੀਤਪਾਲ	പുനീതപാല
ਪੁਰਾਨਪ੍ਰੇਮ	പുരാനപ്രേമ
ਪੁਰਾਨ੍ਜੀਤ	പുരാന്ജീത
ਪੁਸ਼ਪ੍ਰਿਤ	പുശപ്രിത
ਪੁਸ਼੍ਪਿਤਾ	പുശ്പിതാ
ਪੂਰਨਜੀਤ	പൂരനജീത
ਪ੍ਰਗਿਤ	പ്രഗിത
ਪ੍ਰਜਨਾ	പ്രജനാ
ਪ੍ਰਣਿਤ	പ്രണിത
ਪ੍ਰਨੀਤਾ	പ്രനീതാ
ਪ੍ਰਫੂਲਦੀਪ	പ്രഫൂലദീപ
ਪ੍ਰਭਕੀਰਤ	പ്രഭകീരത
ਪ੍ਰਭਕੀਰ੍ਪਾਲ	പ്രഭകീര്പാല
ਪ੍ਰਭਗੀਤ	പ്രഭഗീത
ਪ੍ਰਭਚਰਣ	പ്രഭചരണ
ਪ੍ਰਭਚੇਤਨ	പ്രഭചേതന
ਪ੍ਰਭਜਿਤ	പ്രഭജിത
ਪ੍ਰਭਜੀਤ	പ്രഭജീത
ਪ੍ਰਭਜੀਵਨ	പ്രഭജീവന
ਪ੍ਰਭਜੋਗ	പ്രഭജോഗ
ਪ੍ਰਭਜੋਤੇ	പ്രഭജോതേ
ਪ੍ਰਭਜੋਧ	പ്രഭജോധ
ਪ੍ਰਭਤਿਰਥ	പ്രഭതിരഥ
ਪ੍ਰਭਦਾਸ	പ്രഭദാസ
ਪ੍ਰਭਧਿਯਨ	പ്രഭധിയന
ਪ੍ਰਭਧਿਰਾਜ	പ്രഭധിരാജ
ਪ੍ਰਭਨਾਮ	പ്രഭനാമ
ਪ੍ਰਭਨੂਰ	പ്രഭനൂര
ਪ੍ਰਭਪਰ੍ਵਾਨ	പ്രഭപര്വാന
ਪ੍ਰਭਬੋਧ	പ്രഭബോധ
ਪ੍ਰਭਮਿਤ	പ്രഭമിത
ਪ੍ਰਭਮੇਹਾਰ	പ്രഭമേഹാര
ਪ੍ਰਭਲੀਨ	പ്രഭലീന
ਪ੍ਰਭਵਿਚਾਰ	പ്രഭവിചാര
ਪ੍ਰਭਸਂਗਤ	പ്രഭസംഗത
ਪ੍ਰਭਸਿਤਾਲ	പ്രഭസിതാല
ਪ੍ਰਭਾਤਕੀਰਣ	പ്രഭാതകീരണ
ਪ੍ਰਭ੍ਰਮਣ	പ്രഭ്രമണ
ਪ੍ਰਭ੍ਰਾਤਨ	പ്രഭ്രാതന
ਪ੍ਰਭ੍ਰੂਪ	പ്രഭ്രൂപ
ਪ੍ਰਸ਼ਾਰਨਬੀਰ	പ്രശാരനബീര
ਪ੍ਰਿਤਮੋਹਨ	പ്രിതമോഹന
ਪ੍ਰਿਤੀਨ੍ਦੇਰ	പ്രിതീന്ദേര
ਪ੍ਰਿਤ੍ਵੀਰ	പ്രിത്വീര
ਪ੍ਰੀਤਪਾਲ	പ്രീതപാല
ਪ੍ਰੀਤਮ੍ਹਾਰੀ	പ്രീതമ്ഹാരീ
ਪ੍ਰੀਤਾਮਜਿਤ	പ്രീതാമജിത
ਪ੍ਰੀਥਾਮ੍ਦੀਪ	പ്രീഥാമ്ദീപ
ਪ੍ਰੀਥੀਪਾਲ	പ്രീഥീപാല
ਪ੍ਰੀਥ੍ਵੀਪਾਲ	പ്രീഥ്വീപാല
ਪ੍ਰੇਮਜਿਤ	പ്രേമജിത
ਪ੍ਰੇਮਤੇਕ	പ്രേമതേക
ਪ੍ਰੇਮਪਾਲ	പ്രേമപാല
ਪ੍ਰੇਮਬਂਸ	പ്രേമബംസ
ਪ੍ਰੇਮਭਾਗਤ	പ്രേമഭാഗത
ਪ੍ਰੇਮਰਂਗ	പ്രേമരംഗ
ਪ੍ਰੇਮਰਮਣ	പ്രേമരമണ
ਪ੍ਰੇਮਰਸ	പ്രേമരസ
ਪ੍ਰੇਮਲੀਨ	പ്രേമലീന
ਪ੍ਰੇਮਵਾਂਤ	പ്രേമവാംത
ਪ੍ਰੇਮਸੀਰੀ	പ്രേമസീരീ
ਪ੍ਰੇਮਸੁਖ	പ്രേമസുഖ
ਪ੍ਰੇਮ੍ਵੀਰ	പ്രേമ്വീര
ਫਕੀਰ	ഫകീര
ਫਤੇਹਕਾਰਾਮ	ഫതേഹകാരാമ
ਫਤੇਹਪ੍ਰਿਤ	ഫതേഹപ്രിത
ਫਤੇਹਬੀਰ	ഫതേഹബീര
ਫਤੇਹ੍ਵਂਤ	ഫതേഹ്വംത
ਫਾਜਲ	ഫാജല
ਫੁਲਵਂਤ	ഫുലവംത
ਫੋਜੀਨਦੇਰ	ഫോജീനദേര
ਬਂਸਮਿਤ	ബംസമിത
ਬਕ੍ਸ਼ੀ	ബക്ശീ
ਬਚਾਨਬੀਰ	ബചാനബീര
ਬਚੀਨ੍ਤ	ബചീന്ത
ਬਨੀਤ	ബനീത
ਬਨੀਨਦੇਰ	ബനീനദേര
ਬਰਿਨ੍ਦ੍ਰ	ബരിന്ദ്ര
ਬਰੀਨ੍ਦੇਰ	ബരീന്ദേര
ਬਲਤੇਜ	ബലതേജ
ਬਲਦੀਪ	ബലദീപ
ਬਲਦੇਵ	ബലദേവ
ਬਲਮੋਹਨ	ബലമോഹന
ਬਲਰਾਜ	ബലരാജ
ਬਲਵਿਂਦਰ	ബലവിംദര
ਬਲੀਨਦੇਰ	ബലീനദേര
ਬਲੀਹਾਰ	ബലീഹാര
ਬਲ੍ਵਿਨ੍ਦ੍ਰ	ബല്വിന്ദ്ര
ਬਲ੍ਵੀਨ੍ਦੇਰ	ബല്വീന്ദേര
ਬਹਾਦਰ	ബഹാദര
ਬਾਲਮਿਤ	ബാലമിത
ਬਿਸ਼ਨਪਾਲ	ബിശനപാല
ਬਿਸ੍ਮੀਤ	ബിസ്മീത
ਬੀਨਦੇਰ	ബീനദേര
ਬੀਨਾ	ബീനാ
ਬੀਬੀਨਾਨਾਕੀ	ബീബീനാനാകീ
ਬੀਮਾਂਲਜੋਤ	ബീമാംലജോത
ਬੀਰੀਨਦਾਰ	ബീരീനദാര
ਬੀਸਮਾਧ	ബീസമാധ
ਬੀਸ਼੍ਮਿਤ	ബീശ്മിത
ਬੁਜੀ	ബുജീ
ਬੁਧ੍ਪ੍ਰਿਤ	ബുധ്പ്രിത
ਬੁਧ੍ਰੂਪ	ബുധ്രൂപ
ਬੇਂਤ	ബേംത
ਬੇਨ੍ਨੀ	ബേന്നീ
ਬੇਬੇ	ബേബേ
ਬੈਰਾਗੀ	ബൈരാഗീ
ਬ੍ਰਹਮਜੋਤ	ബ്രഹമജോത
ਬ੍ਰਹਾਮਲੀਨ	ബ്രഹാമലീന
ਬ੍ਰਹਾਮ੍ਜੀਤ	ബ്രഹാമ്ജീത
ਬ੍ਰਹ੍ਮਲੀਨ	ബ്രഹ്മലീന
ਬ੍ਰਹ੍ਮਵੀਰ	ബ്രഹ്മവീര
ਬ੍ਰਿਜੇਂਦਰ	ബ്രിജേംദര
ਬ੍ਰੀਜੋਧ	ബ്രീജോധ
ਭਗਤ	ഭഗത
ਭਗਵਾਨ	ഭഗവാന
ਭਜਨਿਕ	ഭജനിക
ਭਰਪੂਰ	ഭരപൂര
ਭਾਘਵੀਨ੍ਦੇਰ	ഭാഘവീന്ദേര
ਭਾਜ੍ਨਾਮ	ഭാജ്നാമ
ਭਾਜ੍ਨਿਤ	ഭാജ്നിത
ਭਾਵਜਿਤ	ഭാവജിത
ਭਾਵਜੀਨ੍ਦੇਰ	ഭാവജീന്ദേര
ਭਾਵਨਦੀਪ	ഭാവനദീപ
ਭਾਵਨੀਤ	ഭാവനീത
ਭਾਵਪਾਲ	ഭാവപാല
ਭਾਵਪ੍ਰੇਮ	ഭാവപ്രേമ
ਭਾਵਲੀਨ	ഭാവലീന
ਭੀਨਦੇਰ੍ਪਾਲ	ഭീനദേര്പാല
ਭੁਪੀਨ੍ਦੇਰ	ഭുപീന്ദേര
ਮਂਗਲਾ	മംഗലാ
ਮਂਤੇਕ	മംതേക
ਮਜਾਲ	മജാല
ਮਣਿਪਾਲ	മണിപാല
ਮਧੁਪ੍ਰਿਤ	മധുപ്രിത
ਮਧੁਰਬੀਨ	മധുരബീന
ਮਧੁਵਂਤ	മധുവംത
ਮਨਵਂਤ	മനവംത
ਮਰਦੁਲਾ	മരദുലാ
ਮਸ੍ਤਪ੍ਰੇਮ	മസ്തപ്രേമ
ਮਸ੍ਤਾਨ	മസ്താന
ਮਸ੍ਤੁਕ	മസ്തുക
ਮਸ੍ਤ੍ਵੀਰ	മസ്ത്വീര
ਮਹਨਬੀਰ	മഹനബീര
ਮਹਾਜਿਤ	മഹാജിത
ਮਹਾਨਗਿਯਨ	മഹാനഗിയന
ਮਹਾਨਗੀਤ	മഹാനഗീത
ਮਹਾਨਗੁਨ	മഹാനഗുന
ਮਹਾਨਜਿਤ	മഹാനജിത
ਮਹਾਨਜੀਵਨ	മഹാനജീവന
ਮਹਾਨਜੋਤ	മഹാനജോത
ਮਹਾਨਤੇਕ	മഹാനതേക
ਮਹਾਨਤ੍ਰੀਪਾਤ	മഹാനത്രീപാത
ਮਹਾਨਦੀਪ	മഹാനദീപ
ਮਹਾਨਪਾਲ	മഹാനപാല
ਮਹਾਨਪ੍ਰੇਮ	മഹാനപ്രേമ
ਮਹਾਨਭਗਤ	മഹാനഭഗത
ਮਹਿਨਦੇਰ੍ਪ੍ਰਿਤ	മഹിനദേര്പ്രിത
ਮਹੀਨਗਾ	മഹീനഗാ
ਮਹੀਨਦੇਰ੍ਪਾਲ	മഹീനദേര്പാല
ਮਹੇਕਪ੍ਰਿਤ	മഹേകപ്രിത
ਮਹੇਨਦੇਰ	മഹേനദേര
ਮਹੇਰਬਾਨੀ	മഹേരബാനീ
ਮਹੇਸ਼ੀਨਦੇਰ	മഹേശീനദേര
ਮਾਂਨਕਰਣ	മാംനകരണ
ਮਾਂਨਗਲ੍ਪ੍ਰਿਤ	മാംനഗല്പ്രിത
ਮਾਂਨਵਾਨ੍ਤ੍ਬੀਰ	മാംനവാന്ത്ബീര
ਮਾਂਨਸੀਰਤ	മാംനസീരത
ਮਾਂਨਾਵੀਨਦੇਰ	മാംനാവീനദേര
ਮਾਂਨਾਸਪ੍ਰੇਮ	മാംനാസപ്രേമ
ਮਾਂਨੀਨਦੇਰ੍ਬੀਰ	മാംനീനദേര്ബീര
ਮਾਂਨੋਹਾਰਜੋਤ	മാംനോഹാരജോത
ਮਾਂਨੋਹਾਰਦੀਪ	മാംനോഹാരദീപ
ਮਾਂਨੋਹਾਰ੍ਜੀਤ	മാംനോഹാര്ജീത
ਮਾਂਨੋਹਾਰ੍ਪਲ	മാംനോഹാര്പല
ਮਾਂਨ੍ਗਲ੍ਜੀਤ	മാംന്ഗല്ജീത
ਮਾਂਨ੍ਗਲ੍ਪ੍ਰੇਮ	മാംന്ഗല്പ്രേമ
ਮਾਂਨ੍ਸ਼ਿਤਾਲ	മാംന്ശിതാല
ਮਾਦਨਬੀਰ	മാദനബീര
ਮਾਦਾਨਕੀਰ੍ਪਾਲ	മാദാനകീര്പാല
ਮਾਦਾਨਪਾਲ	മാദാനപാല
ਮਾਨਤੇਜ	മാനതേജ
ਮਾਨਦੇਵ	മാനദേവ
ਮਾਨਪੁਲ	മാനപുല
ਮਾਨਬੀਰ	മാനബീര
ਮਾਨਰਿਤ	മാനരിത
ਮਾਨਾਸਦੀਪ	മാനാസദീപ
ਮਾਨ੍ਕੀਰਣ	മാന്കീരണ
ਮਾਨ੍ਗਲ੍ਜੋਤ	മാന്ഗല്ജോത
ਮਾਨ੍ਪ੍ਰੀਯਾ	മാന്പ്രീയാ
ਮਾਯ੍ਰਾਯ	മായ്രായ
ਮਿਤ੍ਰਾ	മിത്രാ
ਮਿਤ੍ਰਾਜ	മിത്രാജ
ਮੀਰਾ	മീരാ
ਮੁਕੁਂਦਾ	മുകുംദാ
ਮੁਕੁਨਦ੍ਪ੍ਰਿਤ	മുകുനദ്പ്രിത
ਮੁਖ੍ਤਯਾਰ	മുഖ്തയാര
ਮੁਦ੍ਰਾ	മുദ്രാ
ਮੁਨਦੀਪ	മുനദീപ
ਮੁਨਲੇਨੇ	മുനലേനേ
ਮੇਸ਼	മേശ
ਮੇਹਰ	മേഹര
ਮੇਹਾਰਤੇਕ	മേഹാരതേക
ਮੇਹਾਰਪਲ	മേഹാരപല
ਮੇਹਾਰਪ੍ਰਿਤ	മേഹാരപ്രിത
ਮੇਹਾਰਭੂਪ	മേഹാരഭൂപ
ਮੇਹਾਰਮਿਤ	മേഹാരമിത
ਮੇਹੇਰ	മേഹേര
ਮੇਹੇਰਬਾਨੀ	മേഹേരബാനീ
ਮੋਨੀਨ੍ਦੇਰ	മോനീന്ദേര
ਮੋਹਨਤੇਕ	മോഹനതേക
ਮੋਹਨਮਿਤ	മോഹനമിത
ਮੋਹਨਲੀਨ	മോഹനലീന
ਮੋਹਨਵਂਤ	മോഹനവംത
ਮੋਹਨਵੀਰ	മോഹനവീര
ਮੋਹਿਨ੍ਦੇਰਪਾਲ	മോഹിന്ദേരപാല
ਮੋਹੇਨਪਲ	മോഹേനപല
ਮੋਹੇਨਪ੍ਰਿਤ	മോഹേനപ്രിത
ਯਕਿਨ	യകിന
ਯਸ਼ਜੋਤ	യശജോത
ਯਸ਼ਨੂਰ	യശനൂര
ਯਸ਼ਪਾਲ	യശപാല
ਯਸ਼ਵਂਤ	യശവംത
ਯਸ਼੍ਦੀਪ	യശ്ദീപ
ਯਾਤੀਨਪਾਲ	യാതീനപാല
ਯਾਦਲੀਨ	യാദലീന
ਯਾਦਵੀਰ	യാദവീര
ਯਾਦ੍ਬੀਰ	യാദ്ബീര
ਯਾਸ੍ਮੀਨੇ	യാസ്മീനേ
ਯੁਵਰਾਨੀ	യുവരാനീ
ਯੋਗੇਸ਼ਪਾਲ	യോഗേശപാല
ਰਂਗ ਰਮਨ	രംഗ രമന
ਰਂਗਜੋਤ	രംഗജോത
ਰਂਗਪ੍ਰਿਤ	രംഗപ്രിത
ਰਂਗਾਤਮ	രംഗാതമ
ਰਂਗੀਵਨ	രംഗീവന
ਰਂਜੀਤ	രംജീത
ਰਘੁਜਿਤ	രഘുജിത
ਰਘੁਬਂਸ	രഘുബംസ
ਰਚਨਜਿਤ	രചനജിത
ਰਚਨਜੋਤ	രചനജോത
ਰਚ੍ਪੀਨਦੇਰ੍ਜਿਤ	രച്പീനദേര്ജിത
ਰਜੀਨਦਾਰ	രജീനദാര
ਰਣਦੀਪ	രണദീപ
ਰਣਬੀਰ	രണബീര
ਰਤਨ੍ਕਾਰਾਮ	രതന്കാരാമ
ਰਤ੍ਤਾਨਜੋਤ	രത്താനജോത
ਰਤ੍ਤਾਨਦੀਪ	രത്താനദീപ
ਰਨਗ੍ਰਤ੍ਤੀ	രനഗ്രത്തീ
ਰਨਪ੍ਰਿਤ	രനപ്രിത
ਰਪੀਨਦੇਰ	രപീനദേര
ਰਮਚੇਤਨ	രമചേതന
ਰਮਣੀਕ	രമണീക
ਰਮਨਜਿਤ	രമനജിത
ਰਮਨਦੀਪ	രമനദീപ
ਰਮਨਿਤ	രമനിത
ਰਮਨੀਵਾਸ	രമനീവാസ
ਰਮਲੀਨ	രമലീന
ਰਮਾਂਨਜੋਤ	രമാംനജോത
ਰਮਾਂਨਰੂਪ	രമാംനരൂപ
ਰਮਾਂਨਸੁਖ	രമാംനസുഖ
ਰਮਿਤ	രമിത
ਰਮਿਨਾਜੀਤ	രമിനാജീത
ਰਮੀਨਦੇਰ੍ਜਿਤ	രമീനദേര്ജിത
ਰਮੀਨਦੇਰ੍ਪਾਲ	രമീനദേര്പാല
ਰਮੀਨਦੇਰ੍ਪ੍ਰਿਤ	രമീനദേര്പ്രിത
ਰਮੀਨਦੇਰ੍ਬੀਰ	രമീനദേര്ബീര
ਰਮੇਸ਼ਪਲ	രമേശപല
ਰਮੇਸ਼ਮਿਤ	രമേശമിത
ਰਵਜੋਤ	രവജോത
ਰਵਨੀਤ	രവനീത
ਰਵਿਨ੍ਦਰ	രവിന്ദര
ਰਵਿਰਾਜ	രവിരാജ
ਰਵੀਦੀਪ	രവീദീപ
ਰਵੀਨਦੇਰ੍ਦੀਪ	രവീനദേര്ദീപ
ਰਵੀਨਦੇਰ੍ਮਿਤ	രവീനദേര്മിത
ਰਸਂਜਿਤ	രസംജിത
ਰਸਂਜੋਤ	രസംജോത
ਰਸਂਮਿਤ	രസംമിത
ਰਸਗੁਨ	രസഗുന
ਰਸਜੋਤ	രസജോത
ਰਸਧਾਰਮ	രസധാരമ
ਰਸਨਂਦ	രസനംദ
ਰਸਪ੍ਰਿਤ	രസപ്രിത
ਰਸਬੀਰ	രസബീര
ਰਸਭਾਗਤ	രസഭാഗത
ਰਸਮ	രസമ
ਰਸਮ੍ਰਿਤ	രസമ്രിത
ਰਸਲੀਨ	രസലീന
ਰਸਵਂਤ	രസവംത
ਰਸ਼ਾਨ੍ਪ੍ਰਿਤ	രശാന്പ്രിത
ਰਸੁਤ੍ਤਮ	രസുത്തമ
ਰਹੁਲਜੀਤ	രഹുലജീത
ਰਹੁਲਦੀਪ	രഹുലദീപ
ਰਾਖਨਾਂ	രാഖനാം
ਰਾਖਬੀਰ	രാഖബീര
ਰਾਜਕਿਰਣ	രാജകിരണ
ਰਾਜਦੀਪ	രാജദീപ
ਰਾਜਨਾਰੀਨ੍ਦ	രാജനാരീന്ദ
ਰਾਜਪਰਾਮ	രാജപരാമ
ਰਾਜਪਾਲ	രാജപാല
ਰਾਜਪ੍ਰਤਾਪ	രാജപ്രതാപ
ਰਾਜਮਂਦਰ	രാജമംദര
ਰਾਜਮਿਤ	രാജമിത
ਰਾਜਸ਼ਰਣ	രാജശരണ
ਰਾਜਸੁਖ	രാജസുഖ
ਰਾਜਾਨਜਿਤ	രാജാനജിത
ਰਾਜਾਨਮਿਤ	രാജാനമിത
ਰਾਜਾਨ੍ਦੀਪ	രാജാന്ദീപ
ਰਾਤਾਨਗੀਤ	രാതാനഗീത
ਰਾਤਾਨਚੇਤਨ	രാതാനചേതന
ਰਾਤਾਨਜੀਵਨ	രാതാനജീവന
ਰਾਤਾਨਪ੍ਰਿਤ	രാതാനപ്രിത
ਰਾਤਾਨਮਿਤ	രാതാനമിത
ਰਾਤਾਨਵਂਤ	രാതാനവംത
ਰਾਤਾਨਾਤਮ	രാതാനാതമ
ਰਾਮਦਾਸ	രാമദാസ
ਰਾਮਪਾਲ	രാമപാല
ਰਾਮਰਂਗ	രാമരംഗ
ਰਾਮਰਤ੍ਤਨ	രാമരത്തന
ਰਾਮਸੁਖ	രാമസുഖ
ਰਾਸਰਮਣ	രാസരമണ
ਰਾਸ਼੍ਪਲ	രാശ്പല
ਰਾਸ਼੍ਮੀਨਦੇਰ	രാശ്മീനദേര
ਰਿਧਿਮਾ	രിധിമാ
ਰੀਜਕ	രീജക
ਰੀਤੀਨਦੇਰ	രീതീനദേര
ਰੀਪਨ੍ਜੋਤ	രീപന്ജോത
ਰੀਪੁਦਮ	രീപുദമ
ਰੂਂਗ / ਰਂਗ	രൂംഗ / രംഗ
ਰੂਪਦੀਪ	രൂപദീപ
ਰੂਪਦੇਵ	രൂപദേവ
ਰੂਪਵਂਤ	രൂപവംത
ਰੇਗੇਨਦਰ	രേഗേനദര
ਰੋਸ਼ਨਦੀਪ	രോശനദീപ
ਰੌਸ਼ਾਨਪ੍ਰੇਮ	രൌശാനപ്രേമ
ਰੌਸ਼ਾਨਬੀਰ	രൌശാനബീര
ਲਕ੍ਸ਼੍ਮੀ	ലക്ശ്മീ
ਲਖਪ੍ਰਿਤ	ലഖപ്രിത
ਲਖਮਿਤ	ലഖമിത
ਲਖਰੂਪ	ലഖരൂപ
ਲਖਵੀਰ	ലഖവീര
ਲਵੇਨਿਤ	ലവേനിത
ਲਾਜਵਂਤ	ലാജവംത
ਲਾਵਪ੍ਰਿਤ	ലാവപ്രിത
ਲਾਵਿਨਦੀਪ	ലാവിനദീപ
ਲੀਵਗੀਆਨ	ലീവഗീആന
ਲੀਵਚਿਤ	ലീവചിത
ਲੀਵਚੇਤ	ലീവചേത
ਲੀਵਜੋਤ	ലീവജോത
ਲੀਵਨਾਮ	ലീവനാമ
ਲੀਵਸ਼ਰਣ	ലീവശരണ
ਲੀਵਾਵਤਰ	ലീവാവതര
ਲੋਕਪਾਲ	ലോകപാല
ਲੋਕਪ੍ਰਿਤ	ലോകപ്രിത
ਲੋਕਰੂਪ	ലോകരൂപ
ਲੋਕ੍ਪ੍ਰੇਮ	ലോക്പ്രേമ
ਲੋਵਪ੍ਰੇਮ	ലോവപ്രേമ
ਲੋਵੇਦੀਪ	ലോവേദീപ
ਵਰੀਨਦੇਰ੍ਪਾਲ	വരീനദേര്പാല
ਵਰੁਨਜਿਤ	വരുനജിത
ਵਰੁਨਦੀਪ	വരുനദീപ
ਵਸਂਤਪ੍ਰਿਤ	വസംതപ്രിത
ਵਸੁਂਧਰਾ	വസുംധരാ
ਵਾਦਭਾਗ	വാദഭാഗ
ਵਾਮਾਂਨਜੀਤ	വാമാംനജീത
ਵਾਰੀਨਦੇਰ	വാരീനദേര
ਵਾਸੀਮਬੀਰ	വാസീമബീര
ਵਾਹੀਦਪ੍ਰਿਤ	വാഹീദപ്രിത
ਵਾਹੇਗੁਰੁ	വാഹേഗുരു
ਵਿਕ੍ਰਮਜੀਤ	വിക്രമജീത
ਵਿਕ੍ਰਮਜੋਤ	വിക്രമജോത
ਵਿਚਾਰ੍ਚੇਤਨ	വിചാര്ചേതന
ਵਿਚਾਰ੍ਦੀਪ	വിചാര്ദീപ
ਵਿਚਾਰ੍ਲੀਨ	വിചാര്ലീന
ਵਿਜਯਪ੍ਰਤਾਪ	വിജയപ്രതാപ
ਵਿਜਯਪ੍ਰਿਤ	വിജയപ്രിത
ਵਿਜੇਂਦਰ	വിജേംദര
ਵਿਨਾਯਦੀਪ	വിനായദീപ
ਵਿਨਾਯਪੁਲ	വിനായപുല
ਵਿਨਾਯ੍ਬਿਰ	വിനായ്ബിര
ਵਿਮਾਂਲਜਿਤ	വിമാംലജിത
ਵਿਮਾਂਲਜੋਤ	വിമാംലജോത
ਵਿਮਾਂਲਪ੍ਰੇਮ	വിമാംലപ്രേമ
ਵਿਰੀਨਦਾਰ ; ਵਿਰੀਨਦੇਰ	വിരീനദാര ; വിരീനദേര
ਵਿਰੀਨਦੇਰ	വിരീനദേര
ਵਿਸਮਦ	വിസമദ
ਵਿਸ਼ਾਲਦੀਪ	വിശാലദീപ
ਵਿਸ਼ਾਲਪ੍ਰਿਤ	വിശാലപ്രിത
ਵਿਸ਼੍ਵਰ੍ਪ੍ਰਿਤ	വിശ്വര്പ്രിത
ਵਿਸ਼੍ਵਾਤਮ	വിശ്വാതമ
ਵਿਸਾਹ	വിസാഹ
ਵੀਜਯਮਿਤ	വീജയമിത
ਵੀਰ	വീര
ਵੀਰ /ਵੀਰ	വീര /വീര
ਵੀਰਪਾਲ	വീരപാല
ਵੀਵੇਕ੍ਬੀਰ	വീവേക്ബീര
ਵੀਸ੍ਰਮਣ	വീസ്രമണ
ਵੇਰਾਜ	വേരാജ
ਵੈਭਵ	വൈഭവ
ਸਂਗਜਾਪ	സംഗജാപ
ਸਂਗਤਪ੍ਰਿਤ	സംഗതപ്രിത
ਸਂਗਤਰੂਪ	സംഗതരൂപ
ਸਂਗਤ੍ਰਸ	സംഗത്രസ
ਸਂਗੀਤਾ	സംഗീതാ
ਸਂਗ੍ਰਾਮ	സംഗ്രാമ
ਸਂਜੀਤ	സംജീത
ਸਂਜੋਗ	സംജോഗ
ਸਂਤਕੀਰੀਨ	സംതകീരീന
ਸਂਤਪ੍ਰਕਾਸ਼	സംതപ്രകാശ
ਸਂਤਪ੍ਰੇਮ	സംതപ്രേമ
ਸਂਤਬੀਰ	സംതബീര
ਸਂਤੋਖਜੀਤ	സംതോഖജീത
ਸਂਤੋਖਜੋਤ	സംതോഖജോത
ਸਂਤੋਖਪ੍ਰਿਤ	സംതോഖപ്രിത
ਸਂਤੋਖਬੀਰ	സംതോഖബീര
ਸਂਦੀਪ	സംദീപ
ਸਗਲਜੋਤ	സഗലജോത
ਸਚਕਿਰਤ	സചകിരത
ਸਚਜੋਗ	സചജോഗ
ਸਚਪਾਲ	സചപാല
ਸਚਪ੍ਰਧਾਨ	സചപ്രധാന
ਸਚਭਾਗਤ	സചഭാഗത
ਸਚਮਾਨ	സചമാന
ਸਚਰੂਪ	സചരൂപ
ਸਚਵੀਰ	സചവീര
ਸਚਸੁਖ	സചസുഖ
ਸਚਸੇਵਕ	സചസേവക
ਸਚਾਮ੍ਰਿਤ	സചാമ്രിത
ਸਚ੍ਦੀਪ	സച്ദീപ
ਸਜੀਨਦੇਰ	സജീനദേര
ਸਤਕਿਰਤ	സതകിരത
ਸਤਕੀਰਤ	സതകീരത
ਸਤਕੀਰ੍ਤਨ	സതകീര്തന
ਸਤਗੁਨ	സതഗുന
ਸਤਗੁਰ	സതഗുര
ਸਤਜੋਤ	സതജോത
ਸਤਨਾਮ	സതനാമ
ਸਤਪਾਲ	സതപാല
ਸਤਪ੍ਰਕਾਸ਼	സതപ്രകാശ
ਸਤਪ੍ਰਿਤ	സതപ്രിത
ਸਤਪ੍ਰੇਮ	സതപ്രേമ
ਸਤਬਚਨ	സതബചന
ਸਤਮਿਤ	സതമിത
ਸਤਰਜਿਤ	സതരജിത
ਸਤਰਾਜ	സതരാജ
ਸਤਲੀਨ	സതലീന
ਸਤਵਂਤ	സതവംത
ਸਤਸਂਗਤ	സതസംഗത
ਸਤਸਂਤੋਖ	സതസംതോഖ
ਸਤਸਰਂਗ	സതസരംഗ
ਸਤਸੁਖ	സതസുഖ
ਸਤੀਨਦੇਰ੍ਜਿਤ	സതീനദേര്ജിത
ਸਤ੍ਯਜਿਤ	സത്യജിത
ਸਤ੍ਯਪ੍ਰੇਮ	സത്യപ്രേമ
ਸਥਿਨ੍ਦਰ	സഥിന്ദര
ਸਦਜੀਵਨ	സദജീവന
ਸਦਸੁਖ	സദസുഖ
ਸਨਮੁਖ	സനമുഖ
ਸਨਾਨਤਨ	സനാനതന
ਸਪਨਦੀਪ	സപനദീപ
ਸਪਾਹੀ	സപാഹീ
ਸਬੂਰੀ	സബൂരീ
ਸਭਾਜੀਤ	സഭാജീത
ਸਮਰਜੀਤ	സമരജീത
ਸਮਰਣ	സമരണ
ਸਮਰਵੀਰ	സമരവീര
ਸਮਰ੍ਥ	സമര്ഥ
ਸਮਾਂਰਬੀਰ	സമാംരബീര
ਸਮਾਂਰ੍ਜੋਤ	സമാംര്ജോത
ਸਮਾਈ	സമാഈ
ਸਮੀਨਦੀਪ	സമീനദീപ
ਸਮੀਰ	സമീര
ਸਰਦਾਰ	സരദാര
ਸਰਨਦਾਯਲ	സരനദായല
ਸਰਨਦੀਪ	സരനദീപ
ਸਰਨਾਗਤ	സരനാഗത
ਸਰਬਜੀਤ / ਸਰਬਜੀਤ	സരബജീത / സരബജീത
ਸਰਬਨੀਵਾਸ	സരബനീവാസ
ਸਰਬਪ੍ਰਿਤ	സരബപ്രിത
ਸਰਬਸੁਖ	സരബസുഖ
ਸਰਬੁਤ੍ਤਮ	സരബുത്തമ
ਸਰਬ੍ਗਿਆਨ	സരബ്ഗിആന
ਸਰਬ੍ਜਿਤ	സരബ്ജിത
ਸਰਬ੍ਦਾਯਲ	സരബ്ദായല
ਸਰਬ੍ਦੀਪ	സരബ്ദീപ
ਸਰਬ੍ਦੇਵ	സരബ്ദേവ
ਸਰਬ੍ਧਾਰਾਮ	സരബ്ധാരാമ
ਸਰਲਜਿਤ	സരലജിത
ਸਰਲਬੀਰ	സരലബീര
ਸਰਾਬ੍ਰਜ	സരാബ്രജ
ਸਰੂਪ	സരൂപ
ਸਰੂਰ	സരൂര
ਸਰ੍ਜਿਤ	സര്ജിത
ਸਰ੍ਮੀਨਦੇਰ	സര്മീനദേര
ਸਵਾਨਪ੍ਰਿਤ	സവാനപ്രിത
ਸਵਾਰਜਦੀਪ	സവാരജദീപ
ਸਵਾਰਜਬੀਰ	സവാരജബീര
ਸਵਾਰਨਜੋਤ	സവാരനജോത
ਸਵਾਰਨਪ੍ਰਿਤ	സവാരനപ്രിത
ਸਵੀਤੀਨਦੇਰ	സവീതീനദേര
ਸਵੀਤੋਜ	സവീതോജ
ਸਵੀਨਦੇਰ	സവീനദേര
ਸਹੀਲਮਿਤ	സഹീലമിത
ਸ਼ਯ੍ਮ੍ਸੁਨ੍ਦਾਰ	ശയ്മ്സുന്ദാര
ਸ਼ਰਨਪਾਲ	ശരനപാല
ਸ਼ਰਨਬੀਰ	ശരനബീര
ਸ਼ਰਨ੍ਜੀਤ੍ਕੌਰ	ശരന്ജീത്കൌര
ਸ਼ਾਂਤਚਿਤ	ശാംതചിത
ਸ਼ਾਂਤਦੀਪ	ശാംതദീപ
ਸ਼ਾਂਤਪ੍ਰਕਾਸ਼	ശാംതപ്രകാശ
ਸ਼ਾਂਤਪ੍ਰਿਤ	ശാംതപ്രിത
ਸ਼ਾਂਤਬੀਰ	ശാംതബീര
ਸ਼ਾਂਤਲੀਨ	ശാംതലീന
ਸ਼ਾਨਤ੍ਨੀਵਾਸ	ശാനത്നീവാസ
ਸ਼ਾਬਦਚੇਤ	ശാബദചേത
ਸ਼ਾਬਦਤੇਕ	ശാബദതേക
ਸ਼ਾਬਦ੍ਰਾਸ	ശാബദ്രാസ
ਸ਼ਾਬਾਦ੍ਦੀਪ	ശാബാദ്ദീപ
ਸ਼ਾਲੀਨ	ശാലീന
ਸ਼ਾਸ਼ੀਪ੍ਰਿਤ	ശാശീപ്രിത
ਸ਼ਿਵਚਰਣ	ശിവചരണ
ਸ਼ਿਵ੍ਚਾਰਨ੍ਜੀਤ	ശിവ്ചാരന്ജീത
ਸ਼ੁਕਾਰਿਯਨ	ശുകാരിയന
ਸ਼ੁਭਦੀਪ	ശുഭദീപ
ਸ਼ੂਰਵੀਰ	ശൂരവീര
ਸ਼ੇਰ	ശേര
ਸ਼ੇਰਪੁਲ	ശേരപുല
ਸ਼ੇਰਬਹਾਦੁਰ	ശേരബഹാദുര
ਸ਼ੇਹ੍ਬਾਝ	ശേഹ്ബാഝ
ਸਾਕਰਥ	സാകരഥ
ਸਾਖ	സാഖ
ਸਾਗਰ	സാഗര
ਸਾਜ	സാജ
ਸਾਤਪੁਲ	സാതപുല
ਸਾਧਨਾਹ	സാധനാഹ
ਸਾਧਿਕਾ	സാധികാ
ਸਾਬਰ	സാബര
ਸਾਰ	സാര
ਸਿਂਦਾ	സിംദാ
ਸਿਓਪਰਿਤ	സിഓപരിത
ਸਿਤਾਲਜੀਤ	സിതാലജീത
ਸਿਤਾਲਜੋਤ	സിതാലജോത
ਸਿਮਰਨ	സിമരന
ਸੀਖਲ	സീഖല
ਸੀਮਾਂਰ੍ਜਿਤ	സീമാംര്ജിത
ਸੀਮਾਂਰ੍ਨਾਮ	സീമാംര്നാമ
ਸੀਮਾਂਰ੍ਪ੍ਰਿਤ	സീമാംര്പ്രിത
ਸੀਮਾਂਰ੍ਲੀਨ	സീമാംര്ലീന
ਸੀਮ੍ਰਤ	സീമ്രത
ਸੀਮ੍ਰਨਪਾਲ	സീമ്രനപാല
ਸੀਮ੍ਰਨਪ੍ਰਿਤ	സീമ്രനപ്രിത
ਸੀਮ੍ਰਨ੍ਕੌਰ	സീമ്രന്കൌര
ਸੀਮ੍ਰਨ੍ਜੀਤ	സീമ്രന്ജീത
ਸੀਮ੍ਰੀਤਾ	സീമ്രീതാ
ਸੀਰਤ	സീരത
ਸੀਰੀਪ੍ਰੀਤਮ	സീരീപ്രീതമ
ਸੀਰੀਵੇਦ੍ਯਾ	സീരീവേദ്യാ
ਸੀਰੀਸੀਮ੍ਰਣ	സീരീസീമ്രണ
ਸੀਰੀਸੇਵਾ	സീരീസേവാ
ਸੁਖਚੈਨ	സുഖചൈന
ਸੁਖਜੀਵਨ	സുഖജീവന
ਸੁਖਜੋਤ	സുഖജോത
ਸੁਖਜੋਧ	സുഖജോധ
ਸੁਖਦਾਯਲ	സുഖദായല
ਸੁਖਦੀਪ	സുഖദീപ
ਸੁਖਦੇਵ	സുഖദേവ
ਸੁਖਬੀਰ	സുഖബീര
ਸੁਖਮਾਂ	സുഖമാം
ਸੁਖਰੂਪ	സുഖരൂപ
ਸੁਖਸਿਤਾਲ	സുഖസിതാല
ਸੁਖਸੀਮ੍ਰਣ	സുഖസീമ്രണ
ਸੁਖਾਨਂਦ	സുഖാനംദ
ਸੁਖਿਤ	സുഖിത
ਸੁਖੀਨ	സുഖീന
ਸੁਖੀਨ੍ਦੇਰ	സുഖീന്ദേര
ਸੁਖ੍ਚਾਰਨ੍ਜੀਤ	സുഖ്ചാരന്ജീത
ਸੁਖ੍ਜਿਤ	സുഖ്ജിത
ਸੁਚਦੀਪ	സുചദീപ
ਸੁਚਦੇਵ	സുചദേവ
ਸੁਚਮ	സുചമ
ਸੁਜਨਰੂਪ	സുജനരൂപ
ਸੁਜਨ੍ਬੀਰ	സുജന്ബീര
ਸੁਜ੍ਜਨ	സുജ്ജന
ਸੁਧਬੁਧ	സുധബുധ
ਸੁਧਸੁਰਤ	സുധസുരത
ਸੁਭਪ੍ਰਿਤ	സുഭപ്രിത
ਸੁਹੇਜਦੀਪ	സുഹേജദീപ
ਸੇਵਾਕਪ੍ਰਿਤ	സേവാകപ്രിത
ਸੇਵਾਕਪ੍ਰੇਮ	സേവാകപ്രേമ
ਸੇਵਾਕਰਣ	സേവാകരണ
ਸੇਵਾਪ੍ਰੀਤ	സേവാപ്രീത
ਸੇਹਜ	സേഹജ
ਸੇਹੇਜਬੀਰ	സേഹേജബീര
ਸੈਲੇਸ਼ਦੀਪ	സൈലേശദീപ
ਸੈਹਜ	സൈഹജ
ਸੈਹਾਜਨੀਵਾਸ	സൈഹാജനീവാസ
ਸੈਹਾਜਲੀਨ	സൈഹാജലീന
ਸੈਹਾਜਾਧਾਰ	സൈഹാജാധാര
ਸੋਚੀ	സോചീ
ਸੋਨਹਨ	സോനഹന
ਸੋਭਾਵਂਤ	സോഭാവംത
ਸੋਹੀਨਦੇਰ	സോഹീനദേര
ਸੋਹੁਨ	സോഹുന
ਸ੍ਵਰ੍ਨ	സ്വര്ന
ਹਕਾਮਪ੍ਰਿਤ	ഹകാമപ്രിത
ਹਨ੍ਸ੍ਪਾਲ	ഹന്സ്പാല
ਹਰਕਾਨ੍ਵਾਲ	ഹരകാന്വാല
ਹਰਕੀਰਣ	ഹരകീരണ
ਹਰਗੀਤ	ഹരഗീത
ਹਰਗੁਰ੍ਮਿਤ (ਮਿਤ )	ഹരഗുര്മിത (മിത )
ਹਰਗੋਬੀਨ੍ਦ	ഹരഗോബീന്ദ
ਹਰਚਰਣ	ഹരചരണ
ਹਰਜਪ	ഹരജപ
ਹਰਜੀ	ഹരജീ
ਹਰਜੀਤ	ഹരജീത
ਹਰਜੀਨ੍ਦੇਰ	ഹരജീന്ദേര
ਹਰਜੀਵ	ഹരജീവ
ਹਰਜੁਗਤ	ഹരജുഗത
ਹਰਜੋਗ	ഹരജോഗ
ਹਰਜੋਧ	ഹരജോധ
ਹਰਜ੍ਯੋਤ	ഹരജ്യോത
ਹਰਤਿਰਥ	ഹരതിരഥ
ਹਰਤੇਜ੍ਪਾਲ	ഹരതേജ്പാല
ਹਰਦਯਾਲ	ഹരദയാല
ਹਰਦਾਸ	ഹരദാസ
ਹਰਦਿਪਾ	ഹരദിപാ
ਹਰਦੀਪ	ഹരദീപ
ਹਰਧਨ	ഹരധന
ਹਰਨਾਮ	ഹരനാമ
ਹਰਨਾਰਾਯਣ	ഹരനാരായണ
ਹਰਨਿਤ	ഹരനിത
ਹਰਨੀਰ੍ਮਲ	ഹരനീര്മല
ਹਰਨੀਹਲ	ഹരനീഹല
ਹਰਪਰ੍ਸਨ੍ਨ	ഹരപര്സന്ന
ਹਰਪਾਲ	ഹരപാല
ਹਰਪ੍ਰੇਮ੍ਜੀਤ	ഹരപ്രേമ്ജീത
ਹਰਬਿਂਦਰ	ഹരബിംദര
ਹਰਬਿਰ	ഹരബിര
ਹਰਭਗਤ	ഹരഭഗത
ਹਰਮਨਾਦ	ഹരമനാദ
ਹਰਮਾਂਨ੍ਦੇਰ	ഹരമാംന്ദേര
ਹਰਮੀਤ	ഹരമീത
ਹਰਮੀਲਨ	ഹരമീലന
ਹਰਮੂਰਤ	ഹരമൂരത
ਹਰਰਾਈ	ഹരരാഈ
ਹਰਰੂਪ	ഹരരൂപ
ਹਰਵਂਤ	ഹരവംത
ਹਰਵਿਨ	ഹരവിന
ਹਰਸ਼ਰਣ	ഹരശരണ
ਹਰਸਿਤਾਲ	ഹരസിതാല
ਹਰਸੀਮ੍ਰਣ	ഹരസീമ്രണ
ਹਰਸੀਮ੍ਰਨ੍ਜੋਤ	ഹരസീമ്രന്ജോത
ਹਰਸੀਮ੍ਰਿਤ	ഹരസീമ്രിത
ਹਰਸੁਖ	ഹരസുഖ
ਹਰਾਨੂਪ	ഹരാനൂപ
ਹਰਾਮ੍ਰੀਤ	ഹരാമ്രീത
ਹਰਿਕੀਰ੍ਤਨ	ഹരികീര്തന
ਹਰਿਦਰ੍ਸ਼ਨ	ഹരിദര്ശന
ਹਰਿਨਾਰਾਯਣ	ഹരിനാരായണ
ਹਰਿਪ੍ਰੀਤ	ഹരിപ്രീത
ਹਰੀਅਮ੍ਰਿਤ	ഹരീഅമ്രിത
ਹਰੀਸਰੂਪ	ഹരീസരൂപ
ਹਰੀਸੀਮਾਂਰਣ	ഹരീസീമാംരണ
ਹਰ੍ਕਾਰਾਨ੍ਜੀਤ	ഹര്കാരാന്ജീത
ਹਰ੍ਕੀਰਨ੍ਜੀਤ	ഹര്കീരന്ജീത
ਹਰ੍ਕੀਰਪਾਲ	ഹര്കീരപാല
ਹਰ੍ਜਸ	ഹര്ജസ
ਹਰ੍ਤੇਇਜ	ഹര്തേഇജ
ਹਰ੍ਨੀਝ	ഹര്നീഝ
ਹਰ੍ਬਂਸ	ഹര്ബംസ
ਹਰ੍ਮਾਂਨਜਿਤ	ഹര്മാംനജിത
ਹਰ੍ਮਾਂਨਪਾਲ	ഹര്മാംനപാല
ਹਰ੍ਮੀਨ੍ਦੇਰ	ഹര്മീന്ദേര
ਹਰ੍ਮੇਂਦ੍ਰ	ഹര്മേംദ്ര
ਹਰ੍ਸ਼ਰ੍ਧਾ	ഹര്ശര്ധാ
ਹਰ੍ਸ਼ਵਰ੍ਧਨ	ഹര്ശവര്ധന
ਹਰ੍ਸ਼ਾਗੁਨ	ഹര്ശാഗുന
ਹਰ੍ਸਿਰਤ	ഹര്സിരത
ਹਸਨ	ഹസന
ਹਾਰਭਾਗ	ഹാരഭാഗ
ਹਿਤੀਨਦੇਰ	ഹിതീനദേര
ਹਿਤੇਨਦੇਰ	ഹിതേനദേര
ਹਿਮ੍ਮਤ	ഹിമ്മത
ਹਿਰੀਸ਼	ഹിരീശ
ਹੁਅਲੀਨਾ	ഹുഅലീനാ
ਹੁਕੁਮਪਰਿਤ	ഹുകുമപരിത
ਹੂਜਓਏ	ഹൂജഓഏ
ਹੇਤ	ഹേത
ਹੇਤਬੀਰ	ഹേതബീര
ਹੇਮੀਨਦੇਰ	ഹേമീനദേര
ਹੇਯ੍ਮਾਂਨ੍ਪ੍ਰਿਤ	ഹേയ്മാംന്പ്രിത
ਹੇਰਹੋ	ഹേരഹോ
#
#
# Territory names from CLDR
ਅਸੈਂਸ਼ਨ ਟਾਪੂ	അസൈംശന ടാപൂ
ਅੰਡੋਰਾ	അഡോരാ
ਸੰਯੁਕਤ ਅਰਬ ਅਮੀਰਾਤ	സയുകത അരബ അമീരാത
ਅਫ਼ਗਾਨਿਸਤਾਨ	അഫഗാനിസതാന
ਐਂਟੀਗੁਆ ਅਤੇ ਬਾਰਬੁਡਾ	ഐംടീഗുആ അതേ ബാരബുഡാ
ਅੰਗੁਇਲਾ	അഗുഇലാ
ਅਲਬਾਨੀਆ	അലബാനീആ
ਅਰਮੀਨੀਆ	അരമീനീആ
ਅੰਗੋਲਾ	അഗോലാ
ਅੰਟਾਰਕਟਿਕਾ	അടാരകടികാ
ਅਰਜਨਟੀਨਾ	അരജനടീനാ
ਅਮੈਰੀਕਨ ਸਮੋਆ	അമൈരീകന സമോആ
ਆਸਟਰੀਆ	ആസടരീആ
ਆਸਟ੍ਰੇਲੀਆ	ആസട്രേലീആ
ਅਰੂਬਾ	അരൂബാ
ਅਲੈਂਡ ਟਾਪੂ	അലൈംഡ ടാപൂ
ਅਜ਼ਰਬਾਈਜਾਨ	അജരബാഈജാന
ਬੋਸਨੀਆ ਅਤੇ ਹਰਜ਼ੇਗੋਵੀਨਾ	ബോസനീആ അതേ ഹരജേഗോവീനാ
ਬਾਰਬਾਡੋਸ	ബാരബാഡോസ
ਬੰਗਲਾਦੇਸ਼	ബഗലാദേശ
ਬੈਲਜੀਅਮ	ബൈലജീഅമ
ਬੁਰਕੀਨਾ ਫ਼ਾਸੋ	ബുരകീനാ ഫാസോ
ਬੁਲਗਾਰੀਆ	ബുലഗാരീആ
ਬਹਿਰੀਨ	ബഹിരീന
ਬੁਰੁੰਡੀ	ബുരുഡീ
ਬੇਨਿਨ	ബേനിന
ਸੇਂਟ ਬਾਰਥੇਲੇਮੀ	സേംട ബാരഥേലേമീ
ਬਰਮੂਡਾ	ബരമൂഡാ
ਬਰੂਨੇਈ	ബരൂനേഈ
ਬੋਲੀਵੀਆ	ബോലീവീആ
ਕੈਰੇਬੀਆਈ ਨੀਦਰਲੈਂਡ	കൈരേബീആഈ നീദരലൈംഡ
ਬ੍ਰਾਜ਼ੀਲ	ബ്രാജീല
ਬਹਾਮਾਸ	ബഹാമാസ
ਭੂਟਾਨ	ഭൂടാന
ਬੌਵੇਟ ਟਾਪੂ	ബൌവേട ടാപൂ
ਬੋਟਸਵਾਨਾ	ബോടസവാനാ
ਬੇਲਾਰੂਸ	ബേലാരൂസ
ਬੇਲੀਜ਼	ബേലീജ
ਕੈਨੇਡਾ	കൈനേഡാ
ਕੋਕੋਸ (ਕੀਲਿੰਗ) ਟਾਪੂ	കോകോസ (കീലിഗ) ടാപൂ
ਕਾਂਗੋ - ਕਿੰਸ਼ਾਸਾ	കാംഗോ - കിശാസാ
ਕਾਂਗੋ ਲੋਕਤੰਤਰੀ ਗਣਰਾਜ	കാംഗോ ലോകതതരീ ഗണരാജ
ਕੇਂਦਰੀ ਅਫ਼ਰੀਕੀ ਗਣਰਾਜ	കേംദരീ അഫരീകീ ഗണരാജ
ਕਾਂਗੋ - ਬ੍ਰਾਜ਼ਾਵਿਲੇ	കാംഗോ - ബ്രാജാവിലേ
ਕਾਂਗੋ ਗਣਰਾਜ	കാംഗോ ഗണരാജ
ਸਵਿਟਜ਼ਰਲੈਂਡ	സവിടജരലൈംഡ
ਕੋਟ ਡੀਵੋਆਰ	കോട ഡീവോആര
ਆਇਵਰੀ ਕੋਸਟ	ആഇവരീ കോസട
ਕੁੱਕ ਟਾਪੂ	കുക ടാപൂ
ਚਿਲੀ	ചിലീ
ਕੈਮਰੂਨ	കൈമരൂന
ਚੀਨ	ചീന
ਕੋਲੰਬੀਆ	കോലബീആ
ਕਲਿੱਪਰਟਨ ਟਾਪੂ	കലിപരടന ടാപൂ
ਕੋਸਟਾ ਰੀਕਾ	കോസടാ രീകാ
ਕਿਊਬਾ	കിഊബാ
ਕੇਪ ਵਰਡੇ	കേപ വരഡേ
ਕੁਰਾਕਾਓ	കുരാകാഓ
ਕ੍ਰਿਸਮਿਸ ਟਾਪੂ	ക്രിസമിസ ടാപൂ
ਸਾਇਪ੍ਰਸ	സാഇപ്രസ
ਚੈਕ ਗਣਰਾਜ	ചൈക ഗണരാജ
ਜਰਮਨੀ	ജരമനീ
ਡੀਇਗੋ ਗਾਰਸੀਆ	ഡീഇഗോ ഗാരസീആ
ਜ਼ੀਬੂਤੀ	ജീബൂതീ
ਡੈਨਮਾਰਕ	ഡൈനമാരക
ਡੋਮੀਨਿਕਾ	ഡോമീനികാ
ਡੋਮੀਨਿਕਾਈ ਗਣਰਾਜ	ഡോമീനികാഈ ഗണരാജ
ਅਲਜੀਰੀਆ	അലജീരീആ
ਸਿਓਟਾ ਅਤੇ ਮੇਲਿੱਲਾ	സിഓടാ അതേ മേലിലാ
ਇਕਵੇਡੋਰ	ഇകവേഡോര
ਇਸਟੋਨੀਆ	ഇസടോനീആ
ਮਿਸਰ	മിസര
ਪੱਛਮੀ ਸਹਾਰਾ	പഛമീ സഹാരാ
ਇਰੀਟ੍ਰਿਆ	ഇരീട്രിആ
ਸਪੇਨ	സപേന
ਇਥੋਪੀਆ	ഇഥോപീആ
ਯੂਰਪੀ ਯੂਨੀਅਨ	യൂരപീ യൂനീഅന
ਫਿਨਲੈਂਡ	ഫിനലൈംഡ
ਫ਼ਿਜੀ	ഫിജീ
ਫ਼ਾਕਲੈਂਡ ਟਾਪੂ	ഫാകലൈംഡ ടാപൂ
ਫ਼ਾਕਲੈਂਡ ਟਾਪੂ (ਆਈਲਾਸ ਮਾਲਵਿਨਾਸ)	ഫാകലൈംഡ ടാപൂ (ആഈലാസ മാലവിനാസ)
ਮਾਇਕ੍ਰੋਨੇਸ਼ੀਆ	മാഇക്രോനേശീആ
ਫੈਰੋ ਟਾਪੂ	ഫൈരോ ടാപൂ
ਫ਼ਰਾਂਸ	ഫരാംസ
ਗਬੋਨ	ഗബോന
ਯੂਨਾਈਟਡ ਕਿੰਗਡਮ	യൂനാഈടഡ കിഗഡമ
ਗ੍ਰੇਨਾਡਾ	ഗ്രേനാഡാ
ਜਾਰਜੀਆ	ജാരജീആ
ਫ਼ਰੈਂਚ ਗੁਆਨਾ	ഫരൈംച ഗുആനാ
ਗਰਨਜੀ	ഗരനജീ
ਘਾਨਾ	ഘാനാ
ਜਿਬਰਾਲਟਰ	ജിബരാലടര
ਗ੍ਰੀਨਲੈਂਡ	ഗ്രീനലൈംഡ
ਗੈਂਬੀਆ	ഗൈംബീആ
ਗਿਨੀ	ഗിനീ
ਗੁਆਡੇਲੋਪ	ഗുആഡേലോപ
ਭੂ-ਖੰਡੀ ਗਿਨੀ	ഭൂ-ഖഡീ ഗിനീ
ਗ੍ਰੀਸ	ഗ്രീസ
ਦੱਖਣੀ ਜਾਰਜੀਆ ਅਤੇ ਦੱਖਣੀ ਸੈਂਡਵਿਚ ਟਾਪੂ	ദഖണീ ജാരജീആ അതേ ദഖണീ സൈംഡവിച ടാപൂ
ਗੁਆਟੇਮਾਲਾ	ഗുആടേമാലാ
ਗੁਆਮ	ഗുആമ
ਗਿਨੀ-ਬਿਸਾਉ	ഗിനീ-ബിസാഉ
ਗੁਯਾਨਾ	ഗുയാനാ
ਹਾਂਗ ਕਾਂਗ ਐਸਏਆਰ ਚੀਨ	ഹാംഗ കാംഗ ഐസഏആര ചീന
ਹਾਂਗ ਕਾਂਗ	ഹാംഗ കാംഗ
ਹਰਡ ਤੇ ਮੈਕਡੋਨਾਲਡ ਟਾਪੂ	ഹരഡ തേ മൈകഡോനാലഡ ടാപൂ
ਹੋਂਡੁਰਸ	ഹോംഡുരസ
ਕਰੋਏਸ਼ੀਆ	കരോഏശീആ
ਹੈਤੀ	ഹൈതീ
ਹੰਗਰੀ	ഹഗരീ
ਕੇਨਾਰੀ ਟਾਪੂ	കേനാരീ ടാപൂ
ਇੰਡੋਨੇਸ਼ੀਆ	ഇഡോനേശീആ
ਆਇਰਲੈਂਡ	ആഇരലൈംഡ
ਇਜ਼ਰਾਈਲ	ഇജരാഈല
ਆਇਲ ਆਫ ਮੈਨ	ആഇല ആഫ മൈന
ਭਾਰਤ	ഭാരത
ਬਰਤਾਨਵੀ ਹਿੰਦ ਮਹਾਂਸਾਗਰ ਪ੍ਰਦੇਸ਼	ബരതാനവീ ഹിദ മഹാംസാഗര പ്രദേശ
ਇਰਾਕ	ഇരാക
ਈਰਾਨ	ഈരാന
ਆਈਸਲੈਂਡ	ആഈസലൈംഡ
ਇਟਲੀ	ഇടലീ
ਜਰਸੀ	ജരസീ
ਜਮਾਇਕਾ	ജമാഇകാ
ਜਾਰਡਨ	ജാരഡന
ਜਪਾਨ	ജപാന
ਕੀਨੀਆ	കീനീആ
ਕਿਰਗਿਜ਼ਸਤਾਨ	കിരഗിജസതാന
ਕੰਬੋਡੀਆ	കബോഡീആ
ਕਿਰਬਾਤੀ	കിരബാതീ
ਕੋਮੋਰੋਸ	കോമോരോസ
ਸੈਂਟ ਕਿਟਸ ਐਂਡ ਨੇਵਿਸ	സൈംട കിടസ ഐംഡ നേവിസ
ਉੱਤਰੀ ਕੋਰੀਆ	ഉതരീ കോരീആ
ਦੱਖਣੀ ਕੋਰੀਆ	ദഖണീ കോരീആ
ਕੁਵੈਤ	കുവൈത
ਕੇਮੈਨ ਟਾਪੂ	കേമൈന ടാപൂ
ਕਜ਼ਾਖਸਤਾਨ	കജാഖസതാന
ਲਾਓਸ	ലാഓസ
ਲੈਬਨਾਨ	ലൈബനാന
ਸੇਂਟ ਲੂਸੀਆ	സേംട ലൂസീആ
ਲਿਚੇਂਸਟਾਇਨ	ലിചേംസടാഇന
ਸ੍ਰੀ ਲੰਕਾ	സ്രീ ലകാ
ਲਾਈਬੀਰੀਆ	ലാഈബീരീആ
ਲੇਸੋਥੋ	ലേസോഥോ
ਲਿਥੁਆਨੀਆ	ലിഥുആനീആ
ਲਕਜ਼ਮਬਰਗ	ലകജമബരഗ
ਲਾਟਵੀਆ	ലാടവീആ
ਲੀਬੀਆ	ലീബീആ
ਮੋਰੱਕੋ	മോരകോ
ਮੋਨਾਕੋ	മോനാകോ
ਮੋਲਡੋਵਾ	മോലഡോവാ
ਮੋਂਟੇਨੇਗਰੋ	മോംടേനേഗരോ
ਸੇਂਟ ਮਾਰਟਿਨ	സേംട മാരടിന
ਮੈਡਾਗਾਸਕਰ	മൈഡാഗാസകര
ਮਾਰਸ਼ਲ ਟਾਪੂ	മാരശല ടാപൂ
ਮੈਕਡੋਨੀਆ	മൈകഡോനീആ
ਮੈਕਡੋਨੀਆ (ਪੂਰਵ ਯੂਗੋਸਲਾਵ ਮੈਕਡੋਨੀਆਈ ਗਣਰਾਜ)	മൈകഡോനീആ (പൂരവ യൂഗോസലാവ മൈകഡോനീആഈ ഗണരാജ)
ਮਾਲੀ	മാലീ
ਮਿਆਂਮਾਰ (ਬਰਮਾ)	മിആംമാര (ബരമാ)
ਮੰਗੋਲੀਆ	മഗോലീആ
ਮਕਾਉ ਐਸਏਆਰ ਚੀਨ	മകാഉ ഐസഏആര ചീന
ਮਕਾਉ	മകാഉ
ਉੱਤਰੀ ਮਾਰੀਆਨਾ ਟਾਪੂ	ഉതരീ മാരീആനാ ടാപൂ
ਮਾਰਟੀਨਿਕ	മാരടീനിക
ਮੋਰਿਟਾਨੀਆ	മോരിടാനീആ
ਮੋਂਟਸੇਰਾਤ	മോംടസേരാത
ਮਾਲਟਾ	മാലടാ
ਮੌਰਿਸ਼ਸ	മൌരിശസ
ਮਾਲਦੀਵ	മാലദീവ
ਮਲਾਵੀ	മലാവീ
ਮੈਕਸੀਕੋ	മൈകസീകോ
ਮਲੇਸ਼ੀਆ	മലേശീആ
ਮੋਜ਼ਾਮਬੀਕ	മോജാമബീക
ਨਾਮੀਬੀਆ	നാമീബീആ
ਨਿਊ ਕੈਲੇਡੋਨੀਆ	നിഊ കൈലേഡോനീആ
ਨਾਈਜਰ	നാഈജര
ਨੋਰਫੌਕ ਟਾਪੂ	നോരഫൌക ടാപൂ
ਨਾਈਜੀਰੀਆ	നാഈജീരീആ
ਨਿਕਾਰਾਗੁਆ	നികാരാഗുആ
ਨੀਦਰਲੈਂਡ	നീദരലൈംഡ
ਨਾਰਵੇ	നാരവേ
ਨੇਪਾਲ	നേപാല
ਨਾਉਰੂ	നാഉരൂ
ਨਿਯੂ	നിയൂ
ਨਿਊਜ਼ੀਲੈਂਡ	നിഊജീലൈംഡ
ਓਮਾਨ	ഓമാന
ਪਨਾਮਾ	പനാമാ
ਪੇਰੂ	പേരൂ
ਫਰੈਂਚ ਪੋਲੀਨੇਸ਼ੀਆ	ഫരൈംച പോലീനേശീആ
ਪਾਪੂਆ ਨਿਊ ਗਿਨੀ	പാപൂആ നിഊ ഗിനീ
ਫਿਲੀਪੀਂਸ	ഫിലീപീംസ
ਪਾਕਿਸਤਾਨ	പാകിസതാന
ਪੋਲੈਂਡ	പോലൈംഡ
ਸੈਂਟ ਪੀਅਰੇ ਐਂਡ ਮਿਕੇਲਨ	സൈംട പീഅരേ ഐംഡ മികേലന
ਪਿਟਕੇਰਨ ਟਾਪੂ	പിടകേരന ടാപൂ
ਪਿਊਰਟੋ ਰਿਕੋ	പിഊരടോ രികോ
ਫਿਲੀਸਤੀਨੀ ਖੇਤਰ	ഫിലീസതീനീ ഖേതര
ਫਿਲੀਸਤੀਨ	ഫിലീസതീന
ਪੁਰਤਗਾਲ	പുരതഗാല
ਪਲਾਉ	പലാഉ
ਪੈਰਾਗਵੇ	പൈരാഗവേ
ਕਤਰ	കതര
ਆਊਟਲਾਇੰਗ ਓਸ਼ੀਨੀਆ	ആഊടലാഇഗ ഓശീനീആ
ਰਿਯੂਨੀਅਨ	രിയൂനീഅന
ਰੋਮਾਨੀਆ	രോമാനീആ
ਸਰਬੀਆ	സരബീആ
ਰੂਸ	രൂസ
ਰਵਾਂਡਾ	രവാംഡാ
ਸਾਊਦੀ ਅਰਬ	സാഊദീ അരബ
ਸੋਲੋਮਨ ਟਾਪੂ	സോലോമന ടാപൂ
ਸੇਸ਼ਲਸ	സേശലസ
ਸੂਡਾਨ	സൂഡാന
ਸਵੀਡਨ	സവീഡന
ਸਿੰਗਾਪੁਰ	സിഗാപുര
ਸੇਂਟ ਹੇਲੇਨਾ	സേംട ഹേലേനാ
ਸਲੋਵੇਨੀਆ	സലോവേനീആ
ਸਵਾਲਬਰਡ ਅਤੇ ਜਾਨ ਮਾਯੇਨ	സവാലബരഡ അതേ ജാന മായേന
ਸਲੋਵਾਕੀਆ	സലോവാകീആ
ਸਿਏਰਾ ਲਿਓਨ	സിഏരാ ലിഓന
ਸੈਨ ਮਰੀਨੋ	സൈന മരീനോ
ਸੇਨੇਗਲ	സേനേഗല
ਸੋਮਾਲੀਆ	സോമാലീആ
ਸੂਰੀਨਾਮ	സൂരീനാമ
ਦੱਖਣੀ ਸੂਡਾਨ	ദഖണീ സൂഡാന
ਸਾਓ ਟੋਮ ਅਤੇ ਪ੍ਰਿੰਸੀਪੇ	സാഓ ടോമ അതേ പ്രിസീപേ
ਅਲ ਸਲਵਾਡੋਰ	അല സലവാഡോര
ਸਿੰਟ ਮਾਰਟੀਨ	സിട മാരടീന
ਸੀਰੀਆ	സീരീആ
ਸਵਾਜ਼ੀਲੈਂਡ	സവാജീലൈംഡ
ਟ੍ਰਿਸਟਾਨ ਦਾ ਕੁੰਹਾ	ട്രിസടാന ദാ കുഹാ
ਟੁਰਕਸ ਅਤੇ ਕੈਕੋਸ ਟਾਪੂ	ടുരകസ അതേ കൈകോസ ടാപൂ
ਚਾਡ	ചാഡ
ਫਰੈਂਚ ਦੱਖਣੀ ਪ੍ਰਦੇਸ਼	ഫരൈംച ദഖണീ പ്രദേശ
ਟੋਗੋ	ടോഗോ
ਥਾਈਲੈਂਡ	ഥാഈലൈംഡ
ਤਾਜਿਕਿਸਤਾਨ	താജികിസതാന
ਟੋਕੇਲਾਉ	ടോകേലാഉ
ਤਿਮੋਰ-ਲੇਸਤੇ	തിമോര-ലേസതേ
ਪੂਰਬੀ ਤਿਮੋਰ	പൂരബീ തിമോര
ਤੁਰਕਮੇਨਿਸਤਾਨ	തുരകമേനിസതാന
ਟਿਊਨੀਸ਼ੀਆ	ടിഊനീശീആ
ਟੌਂਗਾ	ടൌംഗാ
ਤੁਰਕੀ	തുരകീ
ਟ੍ਰਿਨੀਡਾਡ ਅਤੇ ਟੋਬਾਗੋ	ട്രിനീഡാഡ അതേ ടോബാഗോ
ਟੁਵਾਲੂ	ടുവാലൂ
ਤਾਇਵਾਨ	താഇവാന
ਤਨਜ਼ਾਨੀਆ	തനജാനീആ
ਯੂਕਰੇਨ	യൂകരേന
ਯੂਗਾਂਡਾ	യൂഗാംഡാ
ਸੰਯੁਕਤ ਰਾਜ	സയുകത രാജ
ਉਰੂਗਵੇ	ഉരൂഗവേ
ਉਜ਼ਬੇਕਿਸਤਾਨ	ഉജബേകിസതാന
ਵੈਟੀਕਨ ਸਿਟੀ	വൈടീകന സിടീ
ਸੇਂਟ ਵਿਨਸੈਂਟ ਐਂਡ ਗ੍ਰੇਨਾਡੀਨਸ	സേംട വിനസൈംട ഐംഡ ഗ്രേനാഡീനസ
ਵੇਨੇਜ਼ੂਏਲਾ	വേനേജൂഏലാ
ਬ੍ਰਿਟਿਸ਼ ਵਰਜਿਨ ਟਾਪੂ	ബ്രിടിശ വരജിന ടാപൂ
ਯੂ ਐਸ ਵਰਜਿਨ ਟਾਪੂ	യൂ ഐസ വരജിന ടാപൂ
ਵੀਅਤਨਾਮ	വീഅതനാമ
ਵਾਨੂਆਟੂ	വാനൂആടൂ
ਵਾਲਿਸ ਅਤੇ ਫੂਟੂਨਾ	വാലിസ അതേ ഫൂടൂനാ
ਸਾਮੋਆ	സാമോആ
ਕੋਸੋਵੋ	കോസോവോ
ਯਮਨ	യമന
ਮਾਯੋਟੀ	മായോടീ
ਦੱਖਣੀ ਅਫਰੀਕਾ	ദഖണീ അഫരീകാ
ਜ਼ਾਮਬੀਆ	ജാമബീആ
ਜ਼ਿੰਬਾਬਵੇ	ജിബാബവേ
ਅਣਪਛਾਤਾ ਖੇਤਰ	അണപഛാതാ ഖേതര
