# Baby names
ਅਂਗਦ	அஂகத
ਅਂਗਦ ਦੇਵ	அஂகத தேவ
ਅਂਗਾਰਿਕਾ	அஂகாரிகா
ਅਂਤਰਜੋਤ	அஂதரஜோத
ਅਂਤਰਪ੍ਰਿਤ	அஂதரப்ரித
ਅਂਤਰਾ	அஂதரா
ਅਕਲਤਟ	அகலதட
ਅਕਲਰੂਪ	அகலரூப
ਅਕਲਸ਼ਰਣ	அகலஶரண
ਅਕਲਸੀਮਾਰ	அகலஸீமார
ਅਕਾਲਜੋਗ	அகாலஜோக
ਅਕਾਲਦੀਪ	அகாலதீப
ਅਕਾਲਪ੍ਰੀਤ	அகாலப்ரீத
ਅਕਾਲਬੀਰ	அகாலபீர
ਅਗਮਜੀਤ	அகமஜீத
ਅਗਮਜੋਤ	அகமஜோத
ਅਗਮ੍ਪਾਲ	அகம்பால
ਅਗਮ੍ਪ੍ਰੀਤ	அகம்ப்ரீத
ਅਜ੍ਮੀਨ੍ਦੇਰ	அஜ்மீந்தேர
ਅਝਾਦਬੀਰ	அசாதபீர
ਅਝੀਝ	அசீச
ਅਤੀਨਦੇਰ੍ਜਿਤ	அதீநதேர்ஜித
ਅਤੀਨ੍ਦੇਰ	அதீந்தேர
ਅਤ੍ਤਾਮਜਿਤ	அத்தாமஜித
ਅਨਂਤਦੇਵ	அநஂததேவ
ਅਨਂਤਰ	அநஂதர
ਅਨਂਤਵੀਰ	அநஂதவீர
ਅਨਂਤ੍ਜੀਤ	அநஂத்ஜீத
ਅਨਾਹਤ	அநாஹத
ਅਨਿਂਦਿਤਾ	அநிஂதிதா
ਅਨਿਸ਼ਾ	அநிஶா
ਅਨੀਲਜੋਤ	அநீலஜோத
ਅਨੀਸ਼੍ਕੋਉਂਰ	அநீஶ்கோஉஂர
ਅਨੁਂਜਪਾਲ	அநுஂஜபால
ਅਨੁਂਪਜੋਤ	அநுஂபஜோத
ਅਨੁਰਾਧਾ	அநுராதா
ਅਨੁਸ਼੍ਕਾ	அநுஶ்கா
ਅਨੂਪਜੋਤ	அநூபஜோத
ਅਨੂਪਬੀਰ	அநூபபீர
ਅਨੂਪਲੋਕ	அநூபலோக
ਅਪੂਰ੍ਵਾ	அபூர்வா
ਅਪ੍ਰੀਨਦੇਰ	அப்ரீநதேர
ਅਬਨੀ	அபநீ
ਅਬਿਚਾਲ	அபிசால
ਅਬਿਨਾਸ਼	அபிநாஶ
ਅਭਿਜੀਤ	அபிஜீத
ਅਭਿਰੂਪ	அபிரூப
ਅਮਨਜੀਤ	அமநஜீத
ਅਮਰਜੋਤ	அமரஜோத
ਅਮਰਤ	அமரத
ਅਮਰਿਂਦਰ	அமரிஂதர
ਅਮਰਿਤ	அமரித
ਅਮਲਜੋਤ	அமலஜோத
ਅਮਾਨਜੀਵਨ	அமாநஜீவந
ਅਮਾਨੀਨ੍ਦੇਰ	அமாநீந்தேர
ਅਮਾਨ੍ਰੂਪ	அமாந்ரூப
ਅਮਾਰ੍ਪਾਲ	அமார்பால
ਅਮਾਰ੍ਬੀਰ	அமார்பீர
ਅਮਿਕ	அமிக
ਅਮਿਤ	அமித
ਅਮਿਤੋਜ	அமிதோஜ
ਅਮੀਤਪਾਲ	அமீதபால
ਅਮੀਤ੍ਬੀਰ	அமீத்பீர
ਅਮੋਲ੍ਰਸ	அமோல்ரஸ
ਅਮ੍ਨੀਨ੍ਦੇਰ	அம்நீந்தேர
ਅਮ੍ਰੀਤਬਾਨ	அம்ரீதபாந
ਅਮ੍ਰੀਤ੍ਪ੍ਰਿਤ	அம்ரீத்ப்ரித
ਅਮ੍ਰੀਤ੍ਵਾਨੀ	அம்ரீத்வாநீ
ਅਰਮਾਨੀ	அரமாநீ
ਅਰਵਜੋਤ	அரவஜோத
ਅਰੀਨਾਜੇਤ	அரீநாஜேத
ਅਰੀਨ੍ਦੇਰ੍ਜੀਤ	அரீந்தேர்ஜீத
ਅਰੁਨਜੀਤ	அருநஜீத
ਅਰੁਨਜੋਤ	அருநஜோத
ਅਰ੍ਚਨਾ	அர்சநா
ਅਰ੍ਦਮਨ	அர்தமந
ਅਰ੍ਨਾਲੀਨ੍ਦੇਰ	அர்நாலீந்தேர
ਅਰ੍ਸ਼੍ਦੀਪ	அர்ஶ்தீப
ਅਲੋਕ੍ਪਾਲ	அலோக்பால
ਅਲ੍ਪਨਾ	அல்பநா
ਅਵਨੀਨਦੇਰ	அவநீநதேர
ਅਵਿਰ	அவிர
ਅਵ੍ਲੀਨ	அவ்லீந
ਅਸਂਖ	அஸஂக
ਅਸ਼ਮਿਤ	அஶமித
ਅਸ਼ਰ੍ਨਾਮ	அஶர்நாம
ਅਸ਼ਰ੍ਪ੍ਰੀਤ	அஶர்ப்ரீத
ਅਸ਼ਰ੍ਪ੍ਰੇਮ	அஶர்ப்ரேம
ਅਸ਼ਰ੍ਵੀਰ	அஶர்வீர
ਅਸ਼ਿਮਾ	அஶிமா
ਅਸੀਮ	அஸீம
ਅਸੀਸ	அஸீஸ
ਅਸ੍ਨੇਹ	அஸ்நேஹ
ਆਖਰੀ	ஆகரீ
ਆਤ੍ਮਜਾ	ஆத்மஜா
ਆਨਂਦਮਯੀ	ஆநஂதமயீ
ਆਨਂਦਰੂਪ	ஆநஂதரூப
ਆਯਕਾਰ	ஆயகார
ਆਯਾਤਪ੍ਰਿਤ	ஆயாதப்ரித
ਆਯੁਸ਼੍ਮਤਿ	ஆயுஶ்மதி
ਆਰਮਾਨ	ஆரமாந
ਆਰਾਧ	ஆராத
ਆਰਾਧਨਾ	ஆராதநா
ਆਰ੍ਯਨ	ஆர்யந
ਇਂਦਰਬੀਰ	இஂதரபீர
ਇਂਦਿਵਰ	இஂதிவர
ਇਕਪ੍ਰਿਤ	இகப்ரித
ਇਕਬਾਲ	இகபால
ਇਕਰੂਪ	இகரூப
ਇਕ੍ਪੂਜ	இக்பூஜ
ਇਕ੍ਮਾਨ	இக்மாந
ਇਚ੍ਕਜਿਤ	இச்கஜித
ਇਨ੍ਦਾਰਤੇਜ	இந்தாரதேஜ
ਇਨ੍ਦਾਰਮਿਤ	இந்தாரமித
ਇਨ੍ਦਾਰ੍ਦੀਪ	இந்தார்தீப
ਇਨ੍ਦਾਰ੍ਪ੍ਰਿਤ	இந்தார்ப்ரித
ਇਨ੍ਦਾਰ੍ਪ੍ਰੇਮ	இந்தார்ப்ரேம
ਇਨ੍ਦੇਰ	இந்தேர
ਇਨ੍ਦੇਰਪਲ	இந்தேரபல
ਇਨ੍ਦੇਰਮਾਨ	இந்தேரமாந
ਇਨ੍ਦੇਰਹਾਰ੍ਜਿਤ	இந்தேரஹார்ஜித
ਇਮਰਾਤ	இமராத
ਈਖ੍ਤਿਅਰ	ஈக்திஅர
ਈਨ੍ਦਰ੍ਜੀਏਤ	ஈந்தர்ஜீஏத
ਈਨ੍ਦੇਰਤੇਕ	ஈந்தேரதேக
ਈਨ੍ਦੇਰਵੀਰ	ஈந்தேரவீர
ਈਬਾਦਤ	ஈபாதத
ਈਸ਼ਪਾਲ	ஈஶபால
ਈਸ਼ਲੀਨ	ஈஶலீந
ਈਸ਼ਾਰਤੇਕ	ஈஶாரதேக
ਈਸ਼ਾਰਪਾਲ	ஈஶாரபால
ਈਸ਼੍ਤ੍ਵਰ੍ਜਿਤ	ஈஶ்த்வர்ஜித
ਈਸ਼੍ਪ੍ਰਿਤ	ஈஶ்ப்ரித
ਈਸ਼੍ਵਾਰ੍ਜਿਤ	ஈஶ்வார்ஜித
ਈਸ਼੍ਵੀਨਦੇਰ	ஈஶ்வீநதேர
ਉਖ੍ਤਿਅਰ	உக்திஅர
ਉਚਪਾਲ	உசபால
ਉਚਪ੍ਰਿਤ	உசப்ரித
ਉਚੀਤਦੀਪ	உசீததீப
ਉਚੀਤਪ੍ਰਿਤ	உசீதப்ரித
ਉਚੀਤਬੀਰ	உசீதபீர
ਉਚੀਤਰੂਪ	உசீதரூப
ਉਚੀਤਲੋਕ	உசீதலோக
ਉਚੀਤਵਂਤ	உசீதவஂத
ਉਜਗਰ੍ਜੋਤ	உஜகர்ஜோத
ਉਜਗਰ੍ਦੀਪ	உஜகர்தீப
ਉਜਗਰ੍ਬੀਰ	உஜகர்பீர
ਉਜਾਗਰ	உஜாகர
ਉਜਾਲਾ	உஜாலா
ਉਜ੍ਜਲਜੋਤ	உஜ்ஜலஜோத
ਉਤ੍ਤਮ	உத்தம
ਉਤ੍ਤਮਪਾਲ	உத்தமபால
ਉਤ੍ਤਮਲੀਵ	உத்தமலீவ
ਉਤ੍ਤਾਮਕਾਰਾਮ	உத்தாமகாராம
ਉਤ੍ਤਾਮਜੋਧ	உத்தாமஜோத
ਉਤ੍ਤਾਮਤਿਰਥ	உத்தாமதிரத
ਉਤ੍ਤਾਮਤੇਕ	உத்தாமதேக
ਉਤ੍ਤਾਮਦੀਪ	உத்தாமதீப
ਉਤ੍ਤਾਮਪਦ	உத்தாமபத
ਉਤ੍ਤਾਮ੍ਰਸ	உத்தாம்ரஸ
ਉਤ੍ਤਾਮ੍ਰੂਪ	உத்தாம்ரூப
ਉਤ੍ਰਕ੍ਸ਼	உத்ரக்ஶ
ਉਦੀਤਦੀਪ	உதீததீப
ਉਦੀਤਪ੍ਰਿਤ	உதீதப்ரித
ਉਦੀਤਬੀਰ	உதீதபீர
ਉਦੈਬੀਰ	உதைபீர
ਉਦੈਭਗਤ	உதைபகத
ਉਦ੍ਦਾਮਜੀਤ	உத்தாமஜீத
ਉਪਕਰਮ	உபகரம
ਉਪਕਿਰਤ	உபகிரத
ਉਪਜਿਤ	உபஜித
ਉਪਨਿਤ	உபநித
ਉਪੀਨਦੇਰ੍ਪ੍ਰਿਤ	உபீநதேர்ப்ரித
ਉਪੇਨ੍ਦੇਰ	உபேந்தேர
ਉਮੀਦ	உமீத
ਊਤ੍ਤਮ੍ਗਿਆਨ	ஊத்தம்கிஆந
ਏਕਂਕਰ	ஏகஂகர
ਏਕਬੀਰ	ஏகபீர
ਏਕਮ	ஏகம
ਏਕਮਪੂਜ	ஏகமபூஜ
ਏਕਮਬੀਰ	ஏகமபீர
ਏਕਮ੍ਜੋਤ	ஏகம்ஜோத
ਏਕਮ੍ਰੂਪ	ஏகம்ரூப
ਏਕਾਨਪ੍ਰੀਤ	ஏகாநப்ரீத
ਏਕ੍ਕਾਮ	ஏக்காம
ਏਤੀਬਾਰ	ஏதீபார
ਏਤ੍ਤਲੀਨ	ஏத்தலீந
ਏਰਸ਼ੀਨ	ஏரஶீந
ਏਵੇਨਿਤ	ஏவேநித
ਏਸ਼ਨਾ	ஏஶநா
ਏਸ਼੍ਵਰ	ஏஶ்வர
ਓਨਕਾਰ੍ਜਿਤ	ஓநகார்ஜித
ਓਨਕਾਰ੍ਜੀਤ	ஓநகார்ஜீத
ਓਨਕਾਰ੍ਪ੍ਰਿਤ	ஓநகார்ப்ரித
ਓਮਪ੍ਰਿਤ	ஓமப்ரித
ਕਂਵਲ	கஂவல
ਕਂਵਲਜੀਤ	கஂவலஜீத
ਕਨਵਾਰ੍ਜਾਗਤ	கநவார்ஜாகத
ਕਨਵਾਰ੍ਜਿਤ	கநவார்ஜித
ਕਨਵਾਰ੍ਪ੍ਰੇਮ	கநவார்ப்ரேம
ਕਨਵਾਲ੍ਜੋਤ	கநவால்ஜோத
ਕਨਵਾਲ੍ਨੈਨ	கநவால்நைந
ਕਨਵਾਲ੍ਪਾਲ	கநவால்பால
ਕਨਵਾਲ੍ਪ੍ਰੇਮ	கநவால்ப்ரேம
ਕਨਵਾਲ੍ਬੀਰ	கநவால்பீர
ਕਨਵਾਲ੍ਰੂਪ	கநவால்ரூப
ਕਨ੍ਚਨ੍ਦੀਪ	கந்சந்தீப
ਕਨ੍ਚਾਨ੍ਪਾਲ	கந்சாந்பால
ਕਨ੍ਵਾਰਪਾਲ	கந்வாரபால
ਕਮਾਲ੍ਲਾ	கமால்லா
ਕਰਨਦੀਪ	கரநதீப
ਕਰਨਪਾਲ	கரநபால
ਕਰਨਪ੍ਰਿਤ	கரநப்ரித
ਕਰਨਰੂਪ	கரநரூப
ਕਰਮਪਲ	கரமபல
ਕਰਮਪੁਲ	கரமபுல
ਕਰਮ੍ਜੋਤ	கரம்ஜோத
ਕਰੁਨ੍ਯਾ	கருந்யா
ਕਲਬੀਰ	கலபீர
ਕਲਾਜੋਤ	கலாஜோத
ਕਲਾਪ੍ਰੇਮ	கலாப்ரேம
ਕਵਨਿਤ	கவநித
ਕਵਨੀਰ	கவநீர
ਕਵਾਲ੍ਨਾਨ	கவால்நாந
ਕਵਿਰਾਜ	கவிராஜ
ਕਸਮ	கஸம
ਕਾਨਵਾਲੀਨ੍ਦੇਰ	காநவாலீந்தேர
ਕਾਮਾਂਲਜੋਤ	காமாஂலஜோத
ਕਾਮਾਂਲਮਿਤ	காமாஂலமித
ਕਾਮਾਂਲਮੋਹਨ	காமாஂலமோஹந
ਕਾਮਾਂਲ੍ਪਤਿ	காமாஂல்பதி
ਕਾਰਮਨ	காரமந
ਕਾਵਾਲਪ੍ਰਿਤ	காவாலப்ரித
ਕਿਰਣਜੀਤ	கிரணஜீத
ਕਿਰਨਰੂਪ	கிரநரூப
ਕਿਰਨਸੁਖ	கிரநஸுக
ਕਿਸ਼ੇਨ	கிஶேந
ਕੁਂਵਰਜੀਤ	குஂவரஜீத
ਕੁਲ	குல
ਕੁਲਜੋਤ	குலஜோத
ਕੁਲਮਿਤ	குலமித
ਕੁਲਰਾਤਨ	குலராதந
ਕੁਲਰੂਪ	குலரூப
ਕੁਲਵਂਠ	குலவஂட
ਕੁਸ਼ਪ੍ਰਿਤ	குஶப்ரித
ਕੇਵਾਲਦੀਪ	கேவாலதீப
ਕੇਵਾਲਬੀਰ	கேவாலபீர
ਕੋਉਰ	கோஉர
ਕੋਮਾਂਲਜੀਤ	கோமாஂலஜீத
ਕੋਮਾਂਲਪ੍ਰੇਮ	கோமாஂலப்ரேம
ਕੋਮਾਲਦੀਪ	கோமாலதீப
ਕੋਮਾਲਮਿਤ	கோமாலமித
ਕੌਰ	கௌர
ਕ੍ਰਿਸ਼੍ਦੀਪ	க்ரிஶ்தீப
ਕ੍ਸ਼ਾਗਨ	க்ஶாகந
ਕ੍ਸ਼ਾਗਰ	க்ஶாகர
ਕ੍ਸ਼ਿਤਿਜ	க்ஶிதிஜ
ਕ੍ਸ਼੍ਹੀਮ	க்ஶ்ஹீம
ਖਰਗ	கரக
ਖਾਲਾਕ੍ਵੀਰ	காலாக்வீர
ਖੁਂਸ਼ਜੋਤ	குஂஶஜோத
ਖੁਸ	குஸ
ਖੁਸ਼	குஶ
ਖੁਸ਼ਜੀਤ	குஶஜீத
ਖੇਮਵਂਤ	கேமவஂத
ਗਗਨ	ககந
ਗਗਨਜੀਵ	ககநஜீவ
ਗਗਨਜੋਤ	ககநஜோத
ਗਗਨਪ੍ਰਿਤ	ககநப்ரித
ਗਗਨਮਿਤ	ககநமித
ਗਤਲੀਨ	கதலீந
ਗਤਸ਼ਰਣ	கதஶரண
ਗਤਸੀਮਾਰ	கதஸீமார
ਗਰੀਨ੍ਦੇਰ	கரீந்தேர
ਗਰ੍ਗੋਤ	கர்கோத
ਗਾਤਨੀਵਾਸ	காதநீவாஸ
ਗਿਅਨ	கிஅந
ਗੀਂਜੀਵਨ	கீஂஜீவந
ਗੀਂਰਾਤਨ	கீஂராதந
ਗੀਂਲੀਨ	கீஂலீந
ਗੀਅਂਗੀਤ	கீஅஂகீத
ਗੀਅਂਚੇਤਨ	கீஅஂசேதந
ਗੀਅਂਜੋਤ	கீஅஂஜோத
ਗੀਅਂਪ੍ਰਿਤ	கீஅஂப்ரித
ਗੀਅਂਰੂਪ	கீஅஂரூப
ਗੀਅਨੀਨਦੇਰ	கீஅநீநதேர
ਗੀਅਨ੍ਬੀਰ	கீஅந்பீர
ਗੀਆਨਪ੍ਰਿਤ	கீஆநப்ரித
ਗੀਆਨਲੀਨ	கீஆநலீந
ਗੀਤ	கீத
ਗੀਤਲੀਨ	கீதலீந
ਗੀਤੀਨਦੇਰ	கீதீநதேர
ਗੁਣਿਤ	குணித
ਗੁਨ ਦਾਤ	குந தாத
ਗੁਨਕਿਰਤ	குநகிரத
ਗੁਨਜਸ	குநஜஸ
ਗੁਨਜਿਤ	குநஜித
ਗੁਨਜੀਵਨ	குநஜீவந
ਗੁਨਜੁਨ	குநஜுந
ਗੁਨਜੋਤ	குநஜோத
ਗੁਨਪ੍ਰਿਤ	குநப்ரித
ਗੁਨਮਿਤ	குநமித
ਗੁਨਰਾਜ	குநராஜ
ਗੁਨਸ਼ਾਂਤ	குநஶாஂத
ਗੁਨਾਤਮ	குநாதம
ਗੁਨਿਤਪੁਲ	குநிதபுல
ਗੁਨਿਤਪ੍ਰਿਤ	குநிதப்ரித
ਗੁਨ੍ਰਿਤ	குந்ரித
ਗੁਰਕਮਲ਼	குரகமல
ਗੁਰਗਿਯਨ	குரகியந
ਗੁਰਜਾਸ	குரஜாஸ
ਗੁਰਜੀਵਨ	குரஜீவந
ਗੁਰਜੋਗ	குரஜோக
ਗੁਰਜੋਤ	குரஜோத
ਗੁਰਝੀਲ	குரசீல
ਗੁਰਤਰਣ	குரதரண
ਗੁਰਤਿਰਥ	குரதிரத
ਗੁਰਦਰ੍ਸ਼ਨ	குரதர்ஶந
ਗੁਰਦਿਤ	குரதித
ਗੁਰਦੀਤ੍ਤਾ	குரதீத்தா
ਗੁਰਦ੍ਵੀਪ	குரத்வீப
ਗੁਰਨਾਦ	குரநாத
ਗੁਰਨਾਮਾਸ੍ਕਾਰ	குரநாமாஸ்கார
ਗੁਰਨੀਧ	குரநீத
ਗੁਰਨੀਰ੍ਮਾਲ	குரநீர்மால
ਗੁਰਨੀਸ਼ਾਨ	குரநீஶாந
ਗੁਰਨ੍ਯਮ	குரந்யம
ਗੁਰਪਰ੍ਵਿਨ	குரபர்விந
ਗੁਰਪੀਨਦੇਰ	குரபீநதேர
ਗੁਰਪ੍ਰੀਤਮ	குரப்ரீதம
ਗੁਰਬਕ੍ਸ਼	குரபக்ஶ
ਗੁਰਬਲੀਹਾਰ	குரபலீஹார
ਗੁਰਬੀਨ੍ਦੇਰ	குரபீந்தேர
ਗੁਰਬੀਰ	குரபீர
ਗੁਰਭਜਨ	குரபஜந
ਗੁਰਭਾਗਤ	குரபாகத
ਗੁਰਮਾਰ	குரமார
ਗੁਰਮਾਹੇਰ	குரமாஹேர
ਗੁਰਮੁਖ	குரமுக
ਗੁਰਮੇਹਾਰ	குரமேஹார
ਗੁਰਮੈਲ	குரமைல
ਗੁਰਮ੍ਰਿਤ	குரம்ரித
ਗੁਰਲੋਚਨ	குரலோசந
ਗੁਰਵਿਂਦਰ	குரவிஂதர
ਗੁਰਵੀਨ੍ਦੇਰ	குரவீந்தேர
ਗੁਰਵੀਰ	குரவீர
ਗੁਰਸਨ੍ਦੀਪ	குரஸந்தீப
ਗੁਰਸ਼ਾਨ	குரஶாந
ਗੁਰਸੁਖ	குரஸுக
ਗੁਰਸੇਵ	குரஸேவ
ਗੁਰਹਾਰ੍ਪਾਲ	குரஹார்பால
ਗੁਰਿਂਦਰ	குரிஂதர
ਗੁਰੀਨਦੇਰ੍ਪਾਲ	குரீநதேர்பால
ਗੁਰੁਕਾਰ	குருகார
ਗੁਰੁਗੁਲ੍ਝਾਰ	குருகுல்சார
ਗੁਰੁਚਰਣ	குருசரண
ਗੁਰੁਦਰ੍ਸ਼ਨ	குருதர்ஶந
ਗੁਰੁਦਾਸ	குருதாஸ
ਗੁਰੁਦੀਪ	குருதீப
ਗੁਰੁਪ੍ਰੇਮ	குருப்ரேம
ਗੁਰੁਬੀਰ	குருபீர
ਗੁਰੁਮਾਂਨ੍ਦੀਰ	குருமாஂந்தீர
ਗੁਰੁਸੀਮ੍ਰਣ	குருஸீம்ரண
ਗੁਰ੍ਕੀਰਣ	குர்கீரண
ਗੁਰ੍ਕੀਰਪਾਲ	குர்கீரபால
ਗੁਰ੍ਚਾਰਾਨ੍ਜੋਤ	குர்சாராந்ஜோத
ਗੁਰ੍ਜਨਪਾਲ	குர்ஜநபால
ਗੁਰ੍ਜੁ	குர்ஜு
ਗੁਰ੍ਤੇਜ	குர்தேஜ
ਗੁਰ੍ਨੀਵਾਝ	குர்நீவாச
ਗੁਰ੍ਨੂਰ	குர்நூர
ਗੁਰ੍ਪ੍ਰਿਤੀ	குர்ப்ரிதீ
ਗੁਰ੍ਮੀਤ	குர்மீத
ਗੁਰ੍ਮੀਨਦੇਰ	குர்மீநதேர
ਗੁਰ੍ਮੁਖਨੀਹਲ	குர்முகநீஹல
ਗੁਰ੍ਸ਼ਣ	குர்ஶண
ਗੁਰ੍ਸ਼ਾਂਤ	குர்ஶாஂத
ਗੁਰ੍ਸ਼ੀਲ	குர்ஶீல
ਗੁਰ੍ਸਾਹੇਬ	குர்ஸாஹேப
ਗੁਲਦੀਪ	குலதீப
ਗੁਲਵਂਤ	குலவஂத
ਗੁਲਸ਼ਾਨ੍ਰੂਪ	குலஶாந்ரூப
ਗੁਲ੍ਵਾਨ੍ਤਪ੍ਰਿਤ	குல்வாந்தப்ரித
ਗੁਲ੍ਸ਼ਾਨਪ੍ਰਿਤ	குல்ஶாநப்ரித
ਗੁਲ੍ਸ਼ਾਨਮਿਤ	குல்ஶாநமித
ਗੋਪਲਪ੍ਰਿਤ	கோபலப்ரித
ਗੋਬਿਂਦ	கோபிஂத
ਗੋਬੀਨਦੇਰ	கோபீநதேர
ਗੋਬੀਨਦੇਰ੍ਜਿਤ	கோபீநதேர்ஜித
ਗੋਬੀਨ੍ਦਰਾਈ	கோபீந்தராஈ
ਗੌਰਵ੍ਪ੍ਰਿਤ	கௌரவ்ப்ரித
ਘਮਾਂਨਦ੍ਜਿਤ	கமாஂநத்ஜித
ਘਮਾਂਨਦ੍ਪਾਲ	கமாஂநத்பால
ਚਂਚਲਜਿਤ	சஂசலஜித
ਚਂਚਲ੍ਪ੍ਰੀਤ	சஂசல்ப்ரீத
ਚਂਦਨ	சஂதந
ਚਂਦਨਦੀਪ	சஂதநதீப
ਚਮਕੌਰ	சமகௌர
ਚਮਨਜਿਤ	சமநஜித
ਚਮਨਪ੍ਰਿਤ	சமநப்ரித
ਚਮਨਰੂਪ	சமநரூப
ਚਰਨਕਾਨ੍ਵਾਲ	சரநகாந்வால
ਚਰਨਜੋਤ /ਚਰਨਜ੍ਯੋਤ	சரநஜோத /சரநஜ்யோத
ਚਰਨਪ੍ਰੇਮ	சரநப்ரேம
ਚਾਂਦ	சாஂத
ਚਿਤਰਾਮਣ	சிதராமண
ਚਿਤਸਰੂਪ	சிதஸரூப
ਚੀਤਪ੍ਰਿਤ	சீதப்ரித
ਚੇਤਨ੍ਦੀਪ	சேதந்தீப
ਜਗਜੀਤ	ஜகஜீத
ਜਗਜੀਵ	ஜகஜீவ
ਜਗਜੀਵਨ	ஜகஜீவந
ਜਗਤਜੀਤ	ஜகதஜீத
ਜਗਤਪ੍ਰੇਮ	ஜகதப்ரேம
ਜਗਤਰਣ	ஜகதரண
ਜਗਤਰੂਪ	ஜகதரூப
ਜਗਨ	ஜகந
ਜਗਪਾਲ	ஜகபால
ਜਗਪ੍ਰਿਤ	ஜகப்ரித
ਜਗਪ੍ਰੇਮ	ஜகப்ரேம
ਜਗਮਿਤ	ஜகமித
ਜਗਮੇਹਾਰ	ஜகமேஹார
ਜਗਮੋਹਨ	ஜகமோஹந
ਜਗਰਾਜ	ஜகராஜ
ਜਗਰੂਪ	ஜகரூப
ਜਗਵੀਨ੍ਦੇਰ	ஜகவீந்தேர
ਜਗਵੀਰ	ஜகவீர
ਜਗੀਨਦੇਰ	ஜகீநதேர
ਜਗੀਨ੍ਦੇਰਪਾਲ	ஜகீந்தேரபால
ਜਗ੍ਵੀਰ	ஜக்வீர
ਜਘ੍ਰ	ஜக்ர
ਜਤੀਨਦੇਰ੍ਜਿਤ	ஜதீநதேர்ஜித
ਜਤੀਨਦੇਰ੍ਬੀਰ	ஜதீநதேர்பீர
ਜਤੀਨਦੇਰ੍ਮਿਤ	ஜதீநதேர்மித
ਜਨਜਿਤ	ஜநஜித
ਜਨਜੋਤ	ஜநஜோத
ਜਨਪ੍ਰਿਤ	ஜநப்ரித
ਜਨਰਾਜ	ஜநராஜ
ਜਨਿਸ਼	ஜநிஶ
ਜਪਜਿਤ	ஜபஜித
ਜਪਧਾਰਾਮ	ஜபதாராம
ਜਪਧਿਰ	ஜபதிர
ਜਪਨਾਮ	ஜபநாம
ਜਪਸ਼ੇਰ	ஜபஶேர
ਜਪੁਜੀ	ஜபுஜீ
ਜਬਰਜਂਗ	ஜபரஜஂக
ਜਮੀਲ	ஜமீல
ਜਯਂਸ਼	ஜயஂஶ
ਜਯਪਾਲ	ஜயபால
ਜਰ੍ਨੈਲ	ஜர்நைல
ਜਲਿਨ੍ਦ੍ਰ	ஜலிந்த்ர
ਜਲ੍ਬੀਰ	ஜல்பீர
ਜਸਂਜੋਤ	ஜஸஂஜோத
ਜਸਂਪਾਲ	ஜஸஂபால
ਜਸਂਮਿਤ	ஜஸஂமித
ਜਸਕੀਰਣ	ஜஸகீரண
ਜਸਗੁਰ੍ਕੀਰ੍ਤਤ	ஜஸகுர்கீர்தத
ਜਸਜੀਨ੍ਦੇਰ	ஜஸஜீந்தேர
ਜਸਜੀਵਨ	ஜஸஜீவந
ਜਸਜੋਤ	ஜஸஜோத
ਜਸਤਰਣ	ஜஸதரண
ਜਸਨਾਮ	ஜஸநாம
ਜਸਪਾਲ (ਪੁਲ )	ஜஸபால (புல )
ਜਸਬੀਰ	ஜஸபீர
ਜਸਭੂਪ	ஜஸபூப
ਜਸਮਿਂਦਰ	ஜஸமிஂதர
ਜਸਮੋਹਨ	ஜஸமோஹந
ਜਸਰੂਪ	ஜஸரூப
ਜਸ੍ਕਰਣ	ஜஸ்கரண
ਜਸ੍ਕੀਰਿਤ	ஜஸ்கீரித
ਜਸ੍ਕੀਰ੍ਪਲ	ஜஸ்கீர்பல
ਜਸ੍ਗੁਨ	ஜஸ்குந
ਜਸ੍ਮਿਤ	ஜஸ்மித
ਜਸ੍ਮੀਨਪ੍ਰਿਤ	ஜஸ்மீநப்ரித
ਜਸ੍ਰਜਪ੍ਰਿਤ	ஜஸ்ரஜப்ரித
ਜਸ੍ਸੀ	ஜஸ்ஸீ
ਜਾਗ	ஜாக
ਜਾਗਰੀਤ	ஜாகரீத
ਜਾਤਵਂਤ	ஜாதவஂத
ਜਾਤਿਨਦੇਰ੍ਦੀਪ	ஜாதிநதேர்தீப
ਜਾਨਾਕਪ੍ਰਿਤ	ஜாநாகப்ரித
ਜਾਪਮਾਨ	ஜாபமாந
ਜਾਸਨਿਤ	ஜாஸநித
ਜਾਸ਼ਾਨਪ੍ਰਿਤ	ஜாஶாநப்ரித
ਜਾਸ੍ਮੀਲ	ஜாஸ்மீல
ਜੀਵਨਦੀਪ ; ਜੀਵਨਦੀਪ ; ਜੀਵਨਦੀਪ	ஜீவநதீப ; ஜீவநதீப ; ஜீவநதீப
ਜੀਵਨਪਲ	ஜீவநபல
ਜੀਵਨਪ੍ਰਿਤ	ஜீவநப்ரித
ਜੀਵਾਨਬੀਰ	ஜீவாநபீர
ਜੁਗਦ	ஜுகத
ਜੁਪੀਨਦੇਰਦੀਪ	ஜுபீநதேரதீப
ਜੁਪੀਨਦੇਰ੍ਬੀਰ	ஜுபீநதேர்பீர
ਜੁਸਜਿਤ	ஜுஸஜித
ਜੁਸਪੁਲ	ஜுஸபுல
ਜੁਸਮੈਲ	ஜுஸமைல
ਜੇਬਾ	ஜேபா
ਜੇਸਪਾਲ	ஜேஸபால
ਜੈਕਾਰ	ஜைகார
ਜੈਪ੍ਰਜ	ஜைப்ரஜ
ਜੈਪ੍ਰਤਨ	ஜைப்ரதந
ਜੈਬੀਰ	ஜைபீர
ਜੈਸਂਗਤ	ஜைஸஂகத
ਜੈਸੁਖਬੀਰ	ஜைஸுகபீர
ਜੋਗਧੀਆਨ	ஜோகதீஆந
ਜੋਗਪ੍ਰਕਾਸ਼	ஜோகப்ரகாஶ
ਜੋਗੀਨਦੇਰ੍ਬੀਰ	ஜோகீநதேர்பீர
ਜੋਗੀਨਦੇਰ੍ਮਿਤ	ஜோகீநதேர்மித
ਜੋਗੇਨਦੇਰ	ஜோகேநதேர
ਜੋਤਪ੍ਰਕਾਸ਼	ஜோதப்ரகாஶ
ਜੋਬਨਰੂਪ	ஜோபநரூப
ਜੋਹਾਰ	ஜோஹார
ਜ੍ਞਾਨਜਿਤ	ஜ்ஞாநஜித
ਜ੍ਞਾਨਜੋਤ	ஜ்ஞாநஜோத
ਜ੍ਞਾਨਪ੍ਰਿਤ	ஜ்ஞாநப்ரித
ਜ੍ਞਾਨਰੂਪ	ஜ்ஞாநரூப
ਜ੍ਞਾਨਵੀਰ	ஜ்ஞாநவீர
ਜ੍ਞਾਨੇਨ੍ਦੇਰ	ஜ்ஞாநேந்தேர
ਜ੍ਹਮਕ	ஜ்ஹமக
ਜ੍ਹਾਗਰ	ஜ்ஹாகர
ਝਈਤੂਨ	சஈதூந
ਝਹਾਗਨ	சஹாகந
ਝਾਮੀਨਾਹ	சாமீநாஹ
ਝੀਤੁਨ	சீதுந
ਝੀਲ	சீல
ਝੁਲਾਖਾ	சுலாகா
ਝੁਲ੍ਫਾ	சுல்பா
ਝੇਬਵਂਤ	சேபவஂத
ਝੋਰਾਵਾਰ	சோராவார
ਟੇਇਜਿਨ੍ਦੇਰ	டேஇஜிந்தேர
ਤਕਦੀਰ	தகதீர
ਤਖਤ	தகத
ਤਤਜੋਗ	ததஜோக
ਤਤਬੀਰ	ததபீர
ਤਤਵਿਚਾਰ	ததவிசார
ਤਤ੍ਰਾਤਨ	தத்ராதந
ਤਦਬੀਰ	ததபீர
ਤਨਦੀਪ	தநதீப
ਤਨਵੀਰ	தநவீர
ਤਮਨ੍ਪ੍ਰਿਤ	தமந்ப்ரித
ਤਰਣਵੀਰ	தரணவீர
ਤਰਲੋਚਨ	தரலோசந
ਤਰਸੇਮ	தரஸேம
ਤਰੁਨਜਿਤ	தருநஜித
ਤਲਵਿਨ	தலவிந
ਤਾਜਦਾਰ	தாஜதார
ਤਾਜੀਨਦੇਰ੍ਦੀਪ	தாஜீநதேர்தீப
ਤਾਜੀਨਦੇਰ੍ਪ੍ਰੇਮ	தாஜீநதேர்ப்ரேம
ਤਾਨੁਪ੍ਰਿਤ	தாநுப்ரித
ਤਾਪਨਪਾਲ	தாபநபால
ਤੀਰਨ /ਤਿਹ੍ਰਣ /ਤੇਯ੍ਰੁਣ	தீரந /திஹ்ரண /தேய்ருண
ਤੀਰਾਥ੍ਰਾਮ	தீராத்ராம
ਤੁਵਿਜਾਤ	துவிஜாத
ਤੇਕਜੀਤ	தேகஜீத
ਤੇਕਦੀਪ	தேகதீப
ਤੇਕਪ੍ਰਿਤ	தேகப்ரித
ਤੇਕ੍ਪਾਲ	தேக்பால
ਤੇਘਬਹਾਦੁਰ	தேகபஹாதுர
ਤੇਜਧਾਰਾਮ	தேஜதாராம
ਤੇਜਨਾਮ	தேஜநாம
ਤੇਜਪ੍ਰਤਾਪ	தேஜப்ரதாப
ਤੇਜ਼	தேஜ
ਤੇਜਾਸਵੀਰ	தேஜாஸவீர
ਤੇਜੀਨਦੇਰ੍ਜੀਤ	தேஜீநதேர்ஜீத
ਤੇਜੀਨਦੇਰ੍ਪਾਲ	தேஜீநதேர்பால
ਤੋਤਾਸਿਂਹ	தோதாஸிஂஹ
ਤ੍ਰਿਪਲ	த்ரிபல
ਤ੍ਰਿਲੋਚਨ	த்ரிலோசந
ਤ੍ਰੀਭਾਵਾਨ	த்ரீபாவாந
ਤ੍ਰੀਸ਼ਾਨਜੋਤ	த்ரீஶாநஜோத
ਤ੍ਰੀਸ਼ਾਨਦੀਪ	த்ரீஶாநதீப
ਤ੍ਰੀਸ਼ਾਨਬੀਰ	த்ரீஶாநபீர
ਥਾਕੁਰਨਾਮ	தாகுரநாம
ਥਾਲਭੂਪ	தாலபூப
ਥਾਲਰਾਜ	தாலராஜ
ਥੀਰਮਾਨ	தீரமாந
ਥੀਰ੍ਧੀਆਨ	தீர்தீஆந
ਦਮਨਜਿਤ	தமநஜித
ਦਮਨਜੋਤ	தமநஜோத
ਦਯਾਜੋਤ	தயாஜோத
ਦਯਾਦੀਪ	தயாதீப
ਦਰਮੀਨ੍ਦੇਰ	தரமீந்தேர
ਦਰ੍ਪ੍ਰਿਤ	தர்ப்ரித
ਦਲਜੋਧ	தலஜோத
ਦਲਬੀਨਦੇਰ	தலபீநதேர
ਦਲਬੀਨ੍ਦੇਰ੍ਜਿਤ	தலபீந்தேர்ஜித
ਦਲਰਾਜ	தலராஜ
ਦਲੇਰ	தலேர
ਦਵੀਨ੍ਦੇਰ	தவீந்தேர
ਦਿਦਾਰ	திதார
ਦਿਨਤੇਕ	திநதேக
ਦਿਪਲੀਨ	திபலீந
ਦਿਲਜੋਤ	திலஜோத
ਦਿਲਨਿਤ	திலநித
ਦਿਲਪ੍ਰਿਤ	திலப்ரித
ਦਿਲਮਿਤ	திலமித
ਦਿਲਰਿਤ	திலரித
ਦਿਲਸ਼ਾਨ	திலஶாந
ਦਿਲਸ਼ੇਰ	திலஶேர
ਦਿਵ੍ਯਜ੍ਯੋਤ	திவ்யஜ்யோத
ਦੀਲਜੀਤ	தீலஜீத
ਦੀਲਬਾਘ	தீலபாக
ਦੀਲ੍ਜਿਤ	தீல்ஜித
ਦੀਵ੍ਯਜੋਤ	தீவ்யஜோத
ਦੇਵਜੀਤ	தேவஜீத
ਦੇਵਪ੍ਰਿਤ	தேவப்ரித
ਦੇਵਾਤ੍ਮਾ	தேவாத்மா
ਦੇਵੀਨ੍ਦੇਰ	தேவீந்தேர
ਧਰਮਜ੍ਯੋਤ	தரமஜ்யோத
ਧਰਮਪਾਲ	தரமபால
ਧਰਮਪ੍ਰੀਤ	தரமப்ரீத
ਧਰਮਲੀਨ	தரமலீந
ਧੀਅਨ੍ਜੋਗ	தீஅந்ஜோக
ਨਕ੍ਸ਼ਤ੍ਰਾ	நக்ஶத்ரா
ਨਮ੍ਰੀਤਾਬੀਰ	நம்ரீதாபீர
ਨਯਨਦੀਪ	நயநதீப
ਨਰਿਨ੍ਦਰ	நரிந்தர
ਨਰੇਨ੍ਦ੍ਰ	நரேந்த்ர
ਨਵਜੀਤ	நவஜீத
ਨਵਜੀਵਨ	நவஜீவந
ਨਵਦੀਪ	நவதீப
ਨਵਬੀਰ	நவபீர
ਨਵਮਿਤ	நவமித
ਨਵ੍ਜੀਨ੍ਦੇਰ	நவ்ஜீந்தேர
ਨਾਗਂਦਰ	நாகஂதர
ਨਾਨਕੀ	நாநகீ
ਨਾਨਵੀਰ	நாநவீர
ਨਾਨ੍ਦਾਨਜਿਤ	நாந்தாநஜித
ਨਾਨ੍ਦਾਨਪ੍ਰਿਤ	நாந்தாநப்ரித
ਨਾਮਜੀਵ	நாமஜீவ
ਨਾਮਜੋਗ	நாமஜோக
ਨਾਮਜੋਤ	நாமஜோத
ਨਾਮਜੋਧ	நாமஜோத
ਨਾਮਧਾਰ	நாமதார
ਨਾਮਧਿਯਨ	நாமதியந
ਨਾਮਧਿਰ	நாமதிர
ਨਾਮਨੀਰ੍ਮਾਲ	நாமநீர்மால
ਨਾਮਨੀਵਾਸ	நாமநீவாஸ
ਨਾਮਪ੍ਰਿਤ	நாமப்ரித
ਨਾਮਪ੍ਰੇਮ	நாமப்ரேம
ਨਾਮਭਾਗਤ	நாமபாகத
ਨਾਮਵਿਚਾਰ	நாமவிசார
ਨਾਮਸ਼ਰਣ	நாமஶரண
ਨਾਮਾਂਡੋਲ਼	நாமாஂடோல
ਨਾਮਾਹਾਰ	நாமாஹார
ਨਾਮੁਤ੍ਤਮ	நாமுத்தம
ਨਾਮ੍ਰਾਤਨ	நாம்ராதந
ਨਾਮ੍ਰਿਤਾ	நாம்ரிதா
ਨਾਮ੍ਰੀਤਾਜੋਤ	நாம்ரீதாஜோத
ਨਾਮ੍ਰੀਤਾਦੀਪ	நாம்ரீதாதீப
ਨਾਮ੍ਰੀਤਾਪ੍ਰਿਤ	நாம்ரீதாப்ரித
ਨਾਰ	நார
ਨਾਰਂਜਨ	நாரஂஜந
ਨਾਰੀਤਪਲ	நாரீதபல
ਨਾਰੀਨਦੇਰਦੀਪ	நாரீநதேரதீப
ਨਾਰੈਨ	நாரைந
ਨਾਵਿਨਜਿਤ	நாவிநஜித
ਨਾਵ੍ਕੀਰਣ	நாவ்கீரண
ਨਾਵ੍ਕੀਰਨਜੋਤ	நாவ்கீரநஜோத
ਨਾਵ੍ਪ੍ਰਿਤ	நாவ்ப்ரித
ਨਿਮਾਈ	நிமாஈ
ਨਿਰਂਜਨ	நிரஂஜந
ਨਿਰਂਜਨਾ	நிரஂஜநா
ਨਿਰ੍ਮਲਜੀਤ	நிர்மலஜீத
ਨਿਲਾਮਜੋਤ	நிலாமஜோத
ਨਿਲਾਮਪੁਲ	நிலாமபுல
ਨਿਲਾਮਪ੍ਰਿਤ	நிலாமப்ரித
ਨਿਲਾਮਬੇਰ	நிலாமபேர
ਨਿਸ਼ਾ	நிஶா
ਨਿਹ੍ਚਾਲਤੇਕ	நிஹ்சாலதேக
ਨਿਹ੍ਚਾਲਮਿਤ	நிஹ்சாலமித
ਨੀਤਨਾਮ	நீதநாம
ਨੀਨਦੇਰ੍ਬੀਰ	நீநதேர்பீர
ਨੀਮਮਾਂਪ੍ਰਿਤ	நீமமாஂப்ரித
ਨੀਮਮਾਂਰ੍ਦੀਪ	நீமமாஂர்தீப
ਨੀਮ੍ਮਾਂਰਤਾ	நீம்மாஂரதா
ਨੀਮ੍ਰਤ	நீம்ரத
ਨੀਰਮਾਂਲਦੀਪ	நீரமாஂலதீப
ਨੀਰਮਾਂਲਬੀਰ	நீரமாஂலபீர
ਨੀਰਮੋਲ	நீரமோல
ਨੀਰਵੈਰ	நீரவைர
ਨੀਰ੍ਭਾਉ	நீர்பாஉ
ਨੀਰ੍ਮਾਂਲਕਾਰਾਮ	நீர்மாஂலகாராம
ਨੀਰ੍ਮਾਂਲਜੀਵ	நீர்மாஂலஜீவ
ਨੀਰ੍ਮਾਂਲਜੋਤ	நீர்மாஂலஜோத
ਨੀਰ੍ਮਾਂਲਤੇਕ	நீர்மாஂலதேக
ਨੀਰ੍ਮਾਂਲਧਾਰਾਮ	நீர்மாஂலதாராம
ਨੀਰ੍ਮਾਂਲਪ੍ਰਿਤ	நீர்மாஂலப்ரித
ਨੀਸ਼ਾਨ੍ਦੀਪ	நீஶாந்தீப
ਨੀਹ੍ਚਾਲ੍ਪ੍ਰੇਮ	நீஹ்சால்ப்ரேம
ਨੂਰਦੇਵ	நூரதேவ
ਨੂਰਨਿਤ	நூரநித
ਨੂਰਪ੍ਰਿਤ	நூரப்ரித
ਨੇਕਨਾਮ	நேகநாம
ਨੇਕੀਨਦੇਰ	நேகீநதேர
ਨੇਕ੍ਦੀਪ	நேக்தீப
ਨੇਕ੍ਪਾਲ	நேக்பால
ਨੇਹ੍ਚਾਲਪ੍ਰਿਤ	நேஹ்சாலப்ரித
ਨੈਨਤਾਰ	நைநதார
ਨੈਨਦੀਪ	நைநதீப
ਨੈਨੀਨਦੇਰ	நைநீநதேர
ਨੋਉਲਖ	நோஉலக
ਨੌਹਨੀਹਲ	நௌஹநீஹல
ਨ੍ਰੀਪਜੋਤ	ந்ரீபஜோத
ਪਤਵਂਤ	பதவஂத
ਪਤਵੀਰ	பதவீர
ਪਦਾਮਜਿਤ	பதாமஜித
ਪਦਾਮਪ੍ਰੇਮ	பதாமப்ரேம
ਪਦ੍ਮਸ਼੍ਰੀ	பத்மஶ்ரீ
ਪਰਤਾਪ ; ਪਰਤਾਪ	பரதாப ; பரதாப
ਪਰਤਾਪੀ	பரதாபீ
ਪਰਦੀਪ	பரதீப
ਪਰਬੀਨ	பரபீந
ਪਰਮਕਮਲ਼	பரமகமல
ਪਰਮਕਿਰਤ	பரமகிரத
ਪਰਮਗੁਨ	பரமகுந
ਪਰਮਜਾਪ	பரமஜாப
ਪਰਮਜੀਤ ; ਪਰਮਜੀਤ	பரமஜீத ; பரமஜீத
ਪਰਮਜੁਗਤ	பரமஜுகத
ਪਰਮਜੋਗ	பரமஜோக
ਪਰਮਜੋਧ	பரமஜோத
ਪਰਮਠਾਕਰ	பரமடாகர
ਪਰਮਤੇਕ	பரமதேக
ਪਰਮਦੀਪ	பரமதீப
ਪਰਮਧਾਰਾਮ	பரமதாராம
ਪਰਮਧਿਰ	பரமதிர
ਪਰਮਪਾਲ	பரமபால
ਪਰਮਪ੍ਰੇਮ	பரமப்ரேம
ਪਰਮਬੋਧ	பரமபோத
ਪਰਮਯੋਗ	பரமயோக
ਪਰਮਰਂਗ	பரமரஂக
ਪਰਮਲੀਨ	பரமலீந
ਪਰਮਸ਼ਾਂਤ	பரமஶாஂத
ਪਰਮਸਿਤਾਲ	பரமஸிதால
ਪਰਮਸੁਖ	பரமஸுக
ਪਰਮਸੇਵਕ	பரமஸேவக
ਪਰਮਾਧਾਰ	பரமாதார
ਪਰਮਾਰ੍ਥ	பரமார்த
ਪਰਮਿਂਦਰ	பரமிஂதர
ਪਰਮੀਤ	பரமீத
ਪਰਮ੍ਦਯਾ	பரம்தயா
ਪਰਸਂਜੀਤ	பரஸஂஜீத
ਪਰਸ਼ੋਤਮ	பரஶோதம
ਪਰਾਮਨੀਵਾਸ	பராமநீவாஸ
ਪਰੀਦਰ੍ਸ਼ਨ	பரீதர்ஶந
ਪਰ੍ਗਤ	பர்கத
ਪਰ੍ਵੀਨ੍ਦੇਰ	பர்வீந்தேர
ਪਲਬੀਨਦੇਰ	பலபீநதேர
ਪਲਵੀਨ੍ਦੇਰ੍ਪਾਲ	பலவீந்தேர்பால
ਪਵਾਨਜੋਤ	பவாநஜோத
ਪਵਾਨਦੀਪ	பவாநதீப
ਪਵਾਨਪ੍ਰਿਤ	பவாநப்ரித
ਪਵਾਨਵੀਰ	பவாநவீர
ਪਵੀਤ	பவீத
ਪਾਰਂਗਤ	பாரஂகத
ਪੁਨੀਤ	புநீத
ਪੁਨੀਤਪਾਲ	புநீதபால
ਪੁਰਾਨਪ੍ਰੇਮ	புராநப்ரேம
ਪੁਰਾਨ੍ਜੀਤ	புராந்ஜீத
ਪੁਸ਼ਪ੍ਰਿਤ	புஶப்ரித
ਪੁਸ਼੍ਪਿਤਾ	புஶ்பிதா
ਪੂਰਨਜੀਤ	பூரநஜீத
ਪ੍ਰਗਿਤ	ப்ரகித
ਪ੍ਰਜਨਾ	ப்ரஜநா
ਪ੍ਰਣਿਤ	ப்ரணித
ਪ੍ਰਨੀਤਾ	ப்ரநீதா
ਪ੍ਰਫੂਲਦੀਪ	ப்ரபூலதீப
ਪ੍ਰਭਕੀਰਤ	ப்ரபகீரத
ਪ੍ਰਭਕੀਰ੍ਪਾਲ	ப்ரபகீர்பால
ਪ੍ਰਭਗੀਤ	ப்ரபகீத
ਪ੍ਰਭਚਰਣ	ப்ரபசரண
ਪ੍ਰਭਚੇਤਨ	ப்ரபசேதந
ਪ੍ਰਭਜਿਤ	ப்ரபஜித
ਪ੍ਰਭਜੀਤ	ப்ரபஜீத
ਪ੍ਰਭਜੀਵਨ	ப்ரபஜீவந
ਪ੍ਰਭਜੋਗ	ப்ரபஜோக
ਪ੍ਰਭਜੋਤੇ	ப்ரபஜோதே
ਪ੍ਰਭਜੋਧ	ப்ரபஜோத
ਪ੍ਰਭਤਿਰਥ	ப்ரபதிரத
ਪ੍ਰਭਦਾਸ	ப்ரபதாஸ
ਪ੍ਰਭਧਿਯਨ	ப்ரபதியந
ਪ੍ਰਭਧਿਰਾਜ	ப்ரபதிராஜ
ਪ੍ਰਭਨਾਮ	ப்ரபநாம
ਪ੍ਰਭਨੂਰ	ப்ரபநூர
ਪ੍ਰਭਪਰ੍ਵਾਨ	ப்ரபபர்வாந
ਪ੍ਰਭਬੋਧ	ப்ரபபோத
ਪ੍ਰਭਮਿਤ	ப்ரபமித
ਪ੍ਰਭਮੇਹਾਰ	ப்ரபமேஹார
ਪ੍ਰਭਲੀਨ	ப்ரபலீந
ਪ੍ਰਭਵਿਚਾਰ	ப்ரபவிசார
ਪ੍ਰਭਸਂਗਤ	ப்ரபஸஂகத
ਪ੍ਰਭਸਿਤਾਲ	ப்ரபஸிதால
ਪ੍ਰਭਾਤਕੀਰਣ	ப்ரபாதகீரண
ਪ੍ਰਭ੍ਰਮਣ	ப்ரப்ரமண
ਪ੍ਰਭ੍ਰਾਤਨ	ப்ரப்ராதந
ਪ੍ਰਭ੍ਰੂਪ	ப்ரப்ரூப
ਪ੍ਰਸ਼ਾਰਨਬੀਰ	ப்ரஶாரநபீர
ਪ੍ਰਿਤਮੋਹਨ	ப்ரிதமோஹந
ਪ੍ਰਿਤੀਨ੍ਦੇਰ	ப்ரிதீந்தேர
ਪ੍ਰਿਤ੍ਵੀਰ	ப்ரித்வீர
ਪ੍ਰੀਤਪਾਲ	ப்ரீதபால
ਪ੍ਰੀਤਮ੍ਹਾਰੀ	ப்ரீதம்ஹாரீ
ਪ੍ਰੀਤਾਮਜਿਤ	ப்ரீதாமஜித
ਪ੍ਰੀਥਾਮ੍ਦੀਪ	ப்ரீதாம்தீப
ਪ੍ਰੀਥੀਪਾਲ	ப்ரீதீபால
ਪ੍ਰੀਥ੍ਵੀਪਾਲ	ப்ரீத்வீபால
ਪ੍ਰੇਮਜਿਤ	ப்ரேமஜித
ਪ੍ਰੇਮਤੇਕ	ப்ரேமதேக
ਪ੍ਰੇਮਪਾਲ	ப்ரேமபால
ਪ੍ਰੇਮਬਂਸ	ப்ரேமபஂஸ
ਪ੍ਰੇਮਭਾਗਤ	ப்ரேமபாகத
ਪ੍ਰੇਮਰਂਗ	ப்ரேமரஂக
ਪ੍ਰੇਮਰਮਣ	ப்ரேமரமண
ਪ੍ਰੇਮਰਸ	ப்ரேமரஸ
ਪ੍ਰੇਮਲੀਨ	ப்ரேமலீந
ਪ੍ਰੇਮਵਾਂਤ	ப்ரேமவாஂத
ਪ੍ਰੇਮਸੀਰੀ	ப்ரேமஸீரீ
ਪ੍ਰੇਮਸੁਖ	ப்ரேமஸுக
ਪ੍ਰੇਮ੍ਵੀਰ	ப்ரேம்வீர
ਫਕੀਰ	பகீர
ਫਤੇਹਕਾਰਾਮ	பதேஹகாராம
ਫਤੇਹਪ੍ਰਿਤ	பதேஹப்ரித
ਫਤੇਹਬੀਰ	பதேஹபீர
ਫਤੇਹ੍ਵਂਤ	பதேஹ்வஂத
ਫਾਜਲ	பாஜல
ਫੁਲਵਂਤ	புலவஂத
ਫੋਜੀਨਦੇਰ	போஜீநதேர
ਬਂਸਮਿਤ	பஂஸமித
ਬਕ੍ਸ਼ੀ	பக்ஶீ
ਬਚਾਨਬੀਰ	பசாநபீர
ਬਚੀਨ੍ਤ	பசீந்த
ਬਨੀਤ	பநீத
ਬਨੀਨਦੇਰ	பநீநதேர
ਬਰਿਨ੍ਦ੍ਰ	பரிந்த்ர
ਬਰੀਨ੍ਦੇਰ	பரீந்தேர
ਬਲਤੇਜ	பலதேஜ
ਬਲਦੀਪ	பலதீப
ਬਲਦੇਵ	பலதேவ
ਬਲਮੋਹਨ	பலமோஹந
ਬਲਰਾਜ	பலராஜ
ਬਲਵਿਂਦਰ	பலவிஂதர
ਬਲੀਨਦੇਰ	பலீநதேர
ਬਲੀਹਾਰ	பலீஹார
ਬਲ੍ਵਿਨ੍ਦ੍ਰ	பல்விந்த்ர
ਬਲ੍ਵੀਨ੍ਦੇਰ	பல்வீந்தேர
ਬਹਾਦਰ	பஹாதர
ਬਾਲਮਿਤ	பாலமித
ਬਿਸ਼ਨਪਾਲ	பிஶநபால
ਬਿਸ੍ਮੀਤ	பிஸ்மீத
ਬੀਨਦੇਰ	பீநதேர
ਬੀਨਾ	பீநா
ਬੀਬੀਨਾਨਾਕੀ	பீபீநாநாகீ
ਬੀਮਾਂਲਜੋਤ	பீமாஂலஜோத
ਬੀਰੀਨਦਾਰ	பீரீநதார
ਬੀਸਮਾਧ	பீஸமாத
ਬੀਸ਼੍ਮਿਤ	பீஶ்மித
ਬੁਜੀ	புஜீ
ਬੁਧ੍ਪ੍ਰਿਤ	புத்ப்ரித
ਬੁਧ੍ਰੂਪ	புத்ரூப
ਬੇਂਤ	பேஂத
ਬੇਨ੍ਨੀ	பேந்நீ
ਬੇਬੇ	பேபே
ਬੈਰਾਗੀ	பைராகீ
ਬ੍ਰਹਮਜੋਤ	ப்ரஹமஜோத
ਬ੍ਰਹਾਮਲੀਨ	ப்ரஹாமலீந
ਬ੍ਰਹਾਮ੍ਜੀਤ	ப்ரஹாம்ஜீத
ਬ੍ਰਹ੍ਮਲੀਨ	ப்ரஹ்மலீந
ਬ੍ਰਹ੍ਮਵੀਰ	ப்ரஹ்மவீர
ਬ੍ਰਿਜੇਂਦਰ	ப்ரிஜேஂதர
ਬ੍ਰੀਜੋਧ	ப்ரீஜோத
ਭਗਤ	பகத
ਭਗਵਾਨ	பகவாந
ਭਜਨਿਕ	பஜநிக
ਭਰਪੂਰ	பரபூர
ਭਾਘਵੀਨ੍ਦੇਰ	பாகவீந்தேர
ਭਾਜ੍ਨਾਮ	பாஜ்நாம
ਭਾਜ੍ਨਿਤ	பாஜ்நித
ਭਾਵਜਿਤ	பாவஜித
ਭਾਵਜੀਨ੍ਦੇਰ	பாவஜீந்தேர
ਭਾਵਨਦੀਪ	பாவநதீப
ਭਾਵਨੀਤ	பாவநீத
ਭਾਵਪਾਲ	பாவபால
ਭਾਵਪ੍ਰੇਮ	பாவப்ரேம
ਭਾਵਲੀਨ	பாவலீந
ਭੀਨਦੇਰ੍ਪਾਲ	பீநதேர்பால
ਭੁਪੀਨ੍ਦੇਰ	புபீந்தேர
ਮਂਗਲਾ	மஂகலா
ਮਂਤੇਕ	மஂதேக
ਮਜਾਲ	மஜால
ਮਣਿਪਾਲ	மணிபால
ਮਧੁਪ੍ਰਿਤ	மதுப்ரித
ਮਧੁਰਬੀਨ	மதுரபீந
ਮਧੁਵਂਤ	மதுவஂத
ਮਨਵਂਤ	மநவஂத
ਮਰਦੁਲਾ	மரதுலா
ਮਸ੍ਤਪ੍ਰੇਮ	மஸ்தப்ரேம
ਮਸ੍ਤਾਨ	மஸ்தாந
ਮਸ੍ਤੁਕ	மஸ்துக
ਮਸ੍ਤ੍ਵੀਰ	மஸ்த்வீர
ਮਹਨਬੀਰ	மஹநபீர
ਮਹਾਜਿਤ	மஹாஜித
ਮਹਾਨਗਿਯਨ	மஹாநகியந
ਮਹਾਨਗੀਤ	மஹாநகீத
ਮਹਾਨਗੁਨ	மஹாநகுந
ਮਹਾਨਜਿਤ	மஹாநஜித
ਮਹਾਨਜੀਵਨ	மஹாநஜீவந
ਮਹਾਨਜੋਤ	மஹாநஜோத
ਮਹਾਨਤੇਕ	மஹாநதேக
ਮਹਾਨਤ੍ਰੀਪਾਤ	மஹாநத்ரீபாத
ਮਹਾਨਦੀਪ	மஹாநதீப
ਮਹਾਨਪਾਲ	மஹாநபால
ਮਹਾਨਪ੍ਰੇਮ	மஹாநப்ரேம
ਮਹਾਨਭਗਤ	மஹாநபகத
ਮਹਿਨਦੇਰ੍ਪ੍ਰਿਤ	மஹிநதேர்ப்ரித
ਮਹੀਨਗਾ	மஹீநகா
ਮਹੀਨਦੇਰ੍ਪਾਲ	மஹீநதேர்பால
ਮਹੇਕਪ੍ਰਿਤ	மஹேகப்ரித
ਮਹੇਨਦੇਰ	மஹேநதேர
ਮਹੇਰਬਾਨੀ	மஹேரபாநீ
ਮਹੇਸ਼ੀਨਦੇਰ	மஹேஶீநதேர
ਮਾਂਨਕਰਣ	மாஂநகரண
ਮਾਂਨਗਲ੍ਪ੍ਰਿਤ	மாஂநகல்ப்ரித
ਮਾਂਨਵਾਨ੍ਤ੍ਬੀਰ	மாஂநவாந்த்பீர
ਮਾਂਨਸੀਰਤ	மாஂநஸீரத
ਮਾਂਨਾਵੀਨਦੇਰ	மாஂநாவீநதேர
ਮਾਂਨਾਸਪ੍ਰੇਮ	மாஂநாஸப்ரேம
ਮਾਂਨੀਨਦੇਰ੍ਬੀਰ	மாஂநீநதேர்பீர
ਮਾਂਨੋਹਾਰਜੋਤ	மாஂநோஹாரஜோத
ਮਾਂਨੋਹਾਰਦੀਪ	மாஂநோஹாரதீப
ਮਾਂਨੋਹਾਰ੍ਜੀਤ	மாஂநோஹார்ஜீத
ਮਾਂਨੋਹਾਰ੍ਪਲ	மாஂநோஹார்பல
ਮਾਂਨ੍ਗਲ੍ਜੀਤ	மாஂந்கல்ஜீத
ਮਾਂਨ੍ਗਲ੍ਪ੍ਰੇਮ	மாஂந்கல்ப்ரேம
ਮਾਂਨ੍ਸ਼ਿਤਾਲ	மாஂந்ஶிதால
ਮਾਦਨਬੀਰ	மாதநபீர
ਮਾਦਾਨਕੀਰ੍ਪਾਲ	மாதாநகீர்பால
ਮਾਦਾਨਪਾਲ	மாதாநபால
ਮਾਨਤੇਜ	மாநதேஜ
ਮਾਨਦੇਵ	மாநதேவ
ਮਾਨਪੁਲ	மாநபுல
ਮਾਨਬੀਰ	மாநபீர
ਮਾਨਰਿਤ	மாநரித
ਮਾਨਾਸਦੀਪ	மாநாஸதீப
ਮਾਨ੍ਕੀਰਣ	மாந்கீரண
ਮਾਨ੍ਗਲ੍ਜੋਤ	மாந்கல்ஜோத
ਮਾਨ੍ਪ੍ਰੀਯਾ	மாந்ப்ரீயா
ਮਾਯ੍ਰਾਯ	மாய்ராய
ਮਿਤ੍ਰਾ	மித்ரா
ਮਿਤ੍ਰਾਜ	மித்ராஜ
ਮੀਰਾ	மீரா
ਮੁਕੁਂਦਾ	முகுஂதா
ਮੁਕੁਨਦ੍ਪ੍ਰਿਤ	முகுநத்ப்ரித
ਮੁਖ੍ਤਯਾਰ	முக்தயார
ਮੁਦ੍ਰਾ	முத்ரா
ਮੁਨਦੀਪ	முநதீப
ਮੁਨਲੇਨੇ	முநலேநே
ਮੇਸ਼	மேஶ
ਮੇਹਰ	மேஹர
ਮੇਹਾਰਤੇਕ	மேஹாரதேக
ਮੇਹਾਰਪਲ	மேஹாரபல
ਮੇਹਾਰਪ੍ਰਿਤ	மேஹாரப்ரித
ਮੇਹਾਰਭੂਪ	மேஹாரபூப
ਮੇਹਾਰਮਿਤ	மேஹாரமித
ਮੇਹੇਰ	மேஹேர
ਮੇਹੇਰਬਾਨੀ	மேஹேரபாநீ
ਮੋਨੀਨ੍ਦੇਰ	மோநீந்தேர
ਮੋਹਨਤੇਕ	மோஹநதேக
ਮੋਹਨਮਿਤ	மோஹநமித
ਮੋਹਨਲੀਨ	மோஹநலீந
ਮੋਹਨਵਂਤ	மோஹநவஂத
ਮੋਹਨਵੀਰ	மோஹநவீர
ਮੋਹਿਨ੍ਦੇਰਪਾਲ	மோஹிந்தேரபால
ਮੋਹੇਨਪਲ	மோஹேநபல
ਮੋਹੇਨਪ੍ਰਿਤ	மோஹேநப்ரித
ਯਕਿਨ	யகிந
ਯਸ਼ਜੋਤ	யஶஜோத
ਯਸ਼ਨੂਰ	யஶநூர
ਯਸ਼ਪਾਲ	யஶபால
ਯਸ਼ਵਂਤ	யஶவஂத
ਯਸ਼੍ਦੀਪ	யஶ்தீப
ਯਾਤੀਨਪਾਲ	யாதீநபால
ਯਾਦਲੀਨ	யாதலீந
ਯਾਦਵੀਰ	யாதவீர
ਯਾਦ੍ਬੀਰ	யாத்பீர
ਯਾਸ੍ਮੀਨੇ	யாஸ்மீநே
ਯੁਵਰਾਨੀ	யுவராநீ
ਯੋਗੇਸ਼ਪਾਲ	யோகேஶபால
ਰਂਗ ਰਮਨ	ரஂக ரமந
ਰਂਗਜੋਤ	ரஂகஜோத
ਰਂਗਪ੍ਰਿਤ	ரஂகப்ரித
ਰਂਗਾਤਮ	ரஂகாதம
ਰਂਗੀਵਨ	ரஂகீவந
ਰਂਜੀਤ	ரஂஜீத
ਰਘੁਜਿਤ	ரகுஜித
ਰਘੁਬਂਸ	ரகுபஂஸ
ਰਚਨਜਿਤ	ரசநஜித
ਰਚਨਜੋਤ	ரசநஜோத
ਰਚ੍ਪੀਨਦੇਰ੍ਜਿਤ	ரச்பீநதேர்ஜித
ਰਜੀਨਦਾਰ	ரஜீநதார
ਰਣਦੀਪ	ரணதீப
ਰਣਬੀਰ	ரணபீர
ਰਤਨ੍ਕਾਰਾਮ	ரதந்காராம
ਰਤ੍ਤਾਨਜੋਤ	ரத்தாநஜோத
ਰਤ੍ਤਾਨਦੀਪ	ரத்தாநதீப
ਰਨਗ੍ਰਤ੍ਤੀ	ரநக்ரத்தீ
ਰਨਪ੍ਰਿਤ	ரநப்ரித
ਰਪੀਨਦੇਰ	ரபீநதேர
ਰਮਚੇਤਨ	ரமசேதந
ਰਮਣੀਕ	ரமணீக
ਰਮਨਜਿਤ	ரமநஜித
ਰਮਨਦੀਪ	ரமநதீப
ਰਮਨਿਤ	ரமநித
ਰਮਨੀਵਾਸ	ரமநீவாஸ
ਰਮਲੀਨ	ரமலீந
ਰਮਾਂਨਜੋਤ	ரமாஂநஜோத
ਰਮਾਂਨਰੂਪ	ரமாஂநரூப
ਰਮਾਂਨਸੁਖ	ரமாஂநஸுக
ਰਮਿਤ	ரமித
ਰਮਿਨਾਜੀਤ	ரமிநாஜீத
ਰਮੀਨਦੇਰ੍ਜਿਤ	ரமீநதேர்ஜித
ਰਮੀਨਦੇਰ੍ਪਾਲ	ரமீநதேர்பால
ਰਮੀਨਦੇਰ੍ਪ੍ਰਿਤ	ரமீநதேர்ப்ரித
ਰਮੀਨਦੇਰ੍ਬੀਰ	ரமீநதேர்பீர
ਰਮੇਸ਼ਪਲ	ரமேஶபல
ਰਮੇਸ਼ਮਿਤ	ரமேஶமித
ਰਵਜੋਤ	ரவஜோத
ਰਵਨੀਤ	ரவநீத
ਰਵਿਨ੍ਦਰ	ரவிந்தர
ਰਵਿਰਾਜ	ரவிராஜ
ਰਵੀਦੀਪ	ரவீதீப
ਰਵੀਨਦੇਰ੍ਦੀਪ	ரவீநதேர்தீப
ਰਵੀਨਦੇਰ੍ਮਿਤ	ரவீநதேர்மித
ਰਸਂਜਿਤ	ரஸஂஜித
ਰਸਂਜੋਤ	ரஸஂஜோத
ਰਸਂਮਿਤ	ரஸஂமித
ਰਸਗੁਨ	ரஸகுந
ਰਸਜੋਤ	ரஸஜோத
ਰਸਧਾਰਮ	ரஸதாரம
ਰਸਨਂਦ	ரஸநஂத
ਰਸਪ੍ਰਿਤ	ரஸப்ரித
ਰਸਬੀਰ	ரஸபீர
ਰਸਭਾਗਤ	ரஸபாகத
ਰਸਮ	ரஸம
ਰਸਮ੍ਰਿਤ	ரஸம்ரித
ਰਸਲੀਨ	ரஸலீந
ਰਸਵਂਤ	ரஸவஂத
ਰਸ਼ਾਨ੍ਪ੍ਰਿਤ	ரஶாந்ப்ரித
ਰਸੁਤ੍ਤਮ	ரஸுத்தம
ਰਹੁਲਜੀਤ	ரஹுலஜீத
ਰਹੁਲਦੀਪ	ரஹுலதீப
ਰਾਖਨਾਂ	ராகநாஂ
ਰਾਖਬੀਰ	ராகபீர
ਰਾਜਕਿਰਣ	ராஜகிரண
ਰਾਜਦੀਪ	ராஜதீப
ਰਾਜਨਾਰੀਨ੍ਦ	ராஜநாரீந்த
ਰਾਜਪਰਾਮ	ராஜபராம
ਰਾਜਪਾਲ	ராஜபால
ਰਾਜਪ੍ਰਤਾਪ	ராஜப்ரதாப
ਰਾਜਮਂਦਰ	ராஜமஂதர
ਰਾਜਮਿਤ	ராஜமித
ਰਾਜਸ਼ਰਣ	ராஜஶரண
ਰਾਜਸੁਖ	ராஜஸுக
ਰਾਜਾਨਜਿਤ	ராஜாநஜித
ਰਾਜਾਨਮਿਤ	ராஜாநமித
ਰਾਜਾਨ੍ਦੀਪ	ராஜாந்தீப
ਰਾਤਾਨਗੀਤ	ராதாநகீத
ਰਾਤਾਨਚੇਤਨ	ராதாநசேதந
ਰਾਤਾਨਜੀਵਨ	ராதாநஜீவந
ਰਾਤਾਨਪ੍ਰਿਤ	ராதாநப்ரித
ਰਾਤਾਨਮਿਤ	ராதாநமித
ਰਾਤਾਨਵਂਤ	ராதாநவஂத
ਰਾਤਾਨਾਤਮ	ராதாநாதம
ਰਾਮਦਾਸ	ராமதாஸ
ਰਾਮਪਾਲ	ராமபால
ਰਾਮਰਂਗ	ராமரஂக
ਰਾਮਰਤ੍ਤਨ	ராமரத்தந
ਰਾਮਸੁਖ	ராமஸுக
ਰਾਸਰਮਣ	ராஸரமண
ਰਾਸ਼੍ਪਲ	ராஶ்பல
ਰਾਸ਼੍ਮੀਨਦੇਰ	ராஶ்மீநதேர
ਰਿਧਿਮਾ	ரிதிமா
ਰੀਜਕ	ரீஜக
ਰੀਤੀਨਦੇਰ	ரீதீநதேர
ਰੀਪਨ੍ਜੋਤ	ரீபந்ஜோத
ਰੀਪੁਦਮ	ரீபுதம
ਰੂਂਗ / ਰਂਗ	ரூஂக / ரஂக
ਰੂਪਦੀਪ	ரூபதீப
ਰੂਪਦੇਵ	ரூபதேவ
ਰੂਪਵਂਤ	ரூபவஂத
ਰੇਗੇਨਦਰ	ரேகேநதர
ਰੋਸ਼ਨਦੀਪ	ரோஶநதீப
ਰੌਸ਼ਾਨਪ੍ਰੇਮ	ரௌஶாநப்ரேம
ਰੌਸ਼ਾਨਬੀਰ	ரௌஶாநபீர
ਲਕ੍ਸ਼੍ਮੀ	லக்ஶ்மீ
ਲਖਪ੍ਰਿਤ	லகப்ரித
ਲਖਮਿਤ	லகமித
ਲਖਰੂਪ	லகரூப
ਲਖਵੀਰ	லகவீர
ਲਵੇਨਿਤ	லவேநித
ਲਾਜਵਂਤ	லாஜவஂத
ਲਾਵਪ੍ਰਿਤ	லாவப்ரித
ਲਾਵਿਨਦੀਪ	லாவிநதீப
ਲੀਵਗੀਆਨ	லீவகீஆந
ਲੀਵਚਿਤ	லீவசித
ਲੀਵਚੇਤ	லீவசேத
ਲੀਵਜੋਤ	லீவஜோத
ਲੀਵਨਾਮ	லீவநாம
ਲੀਵਸ਼ਰਣ	லீவஶரண
ਲੀਵਾਵਤਰ	லீவாவதர
ਲੋਕਪਾਲ	லோகபால
ਲੋਕਪ੍ਰਿਤ	லோகப்ரித
ਲੋਕਰੂਪ	லோகரூப
ਲੋਕ੍ਪ੍ਰੇਮ	லோக்ப்ரேம
ਲੋਵਪ੍ਰੇਮ	லோவப்ரேம
ਲੋਵੇਦੀਪ	லோவேதீப
ਵਰੀਨਦੇਰ੍ਪਾਲ	வரீநதேர்பால
ਵਰੁਨਜਿਤ	வருநஜித
ਵਰੁਨਦੀਪ	வருநதீப
ਵਸਂਤਪ੍ਰਿਤ	வஸஂதப்ரித
ਵਸੁਂਧਰਾ	வஸுஂதரா
ਵਾਦਭਾਗ	வாதபாக
ਵਾਮਾਂਨਜੀਤ	வாமாஂநஜீத
ਵਾਰੀਨਦੇਰ	வாரீநதேர
ਵਾਸੀਮਬੀਰ	வாஸீமபீர
ਵਾਹੀਦਪ੍ਰਿਤ	வாஹீதப்ரித
ਵਾਹੇਗੁਰੁ	வாஹேகுரு
ਵਿਕ੍ਰਮਜੀਤ	விக்ரமஜீத
ਵਿਕ੍ਰਮਜੋਤ	விக்ரமஜோத
ਵਿਚਾਰ੍ਚੇਤਨ	விசார்சேதந
ਵਿਚਾਰ੍ਦੀਪ	விசார்தீப
ਵਿਚਾਰ੍ਲੀਨ	விசார்லீந
ਵਿਜਯਪ੍ਰਤਾਪ	விஜயப்ரதாப
ਵਿਜਯਪ੍ਰਿਤ	விஜயப்ரித
ਵਿਜੇਂਦਰ	விஜேஂதர
ਵਿਨਾਯਦੀਪ	விநாயதீப
ਵਿਨਾਯਪੁਲ	விநாயபுல
ਵਿਨਾਯ੍ਬਿਰ	விநாய்பிர
ਵਿਮਾਂਲਜਿਤ	விமாஂலஜித
ਵਿਮਾਂਲਜੋਤ	விமாஂலஜோத
ਵਿਮਾਂਲਪ੍ਰੇਮ	விமாஂலப்ரேம
ਵਿਰੀਨਦਾਰ ; ਵਿਰੀਨਦੇਰ	விரீநதார ; விரீநதேர
ਵਿਰੀਨਦੇਰ	விரீநதேர
ਵਿਸਮਦ	விஸமத
ਵਿਸ਼ਾਲਦੀਪ	விஶாலதீப
ਵਿਸ਼ਾਲਪ੍ਰਿਤ	விஶாலப்ரித
ਵਿਸ਼੍ਵਰ੍ਪ੍ਰਿਤ	விஶ்வர்ப்ரித
ਵਿਸ਼੍ਵਾਤਮ	விஶ்வாதம
ਵਿਸਾਹ	விஸாஹ
ਵੀਜਯਮਿਤ	வீஜயமித
ਵੀਰ	வீர
ਵੀਰ /ਵੀਰ	வீர /வீர
ਵੀਰਪਾਲ	வீரபால
ਵੀਵੇਕ੍ਬੀਰ	வீவேக்பீர
ਵੀਸ੍ਰਮਣ	வீஸ்ரமண
ਵੇਰਾਜ	வேராஜ
ਵੈਭਵ	வைபவ
ਸਂਗਜਾਪ	ஸஂகஜாப
ਸਂਗਤਪ੍ਰਿਤ	ஸஂகதப்ரித
ਸਂਗਤਰੂਪ	ஸஂகதரூப
ਸਂਗਤ੍ਰਸ	ஸஂகத்ரஸ
ਸਂਗੀਤਾ	ஸஂகீதா
ਸਂਗ੍ਰਾਮ	ஸஂக்ராம
ਸਂਜੀਤ	ஸஂஜீத
ਸਂਜੋਗ	ஸஂஜோக
ਸਂਤਕੀਰੀਨ	ஸஂதகீரீந
ਸਂਤਪ੍ਰਕਾਸ਼	ஸஂதப்ரகாஶ
ਸਂਤਪ੍ਰੇਮ	ஸஂதப்ரேம
ਸਂਤਬੀਰ	ஸஂதபீர
ਸਂਤੋਖਜੀਤ	ஸஂதோகஜீத
ਸਂਤੋਖਜੋਤ	ஸஂதோகஜோத
ਸਂਤੋਖਪ੍ਰਿਤ	ஸஂதோகப்ரித
ਸਂਤੋਖਬੀਰ	ஸஂதோகபீர
ਸਂਦੀਪ	ஸஂதீப
ਸਗਲਜੋਤ	ஸகலஜோத
ਸਚਕਿਰਤ	ஸசகிரத
ਸਚਜੋਗ	ஸசஜோக
ਸਚਪਾਲ	ஸசபால
ਸਚਪ੍ਰਧਾਨ	ஸசப்ரதாந
ਸਚਭਾਗਤ	ஸசபாகத
ਸਚਮਾਨ	ஸசமாந
ਸਚਰੂਪ	ஸசரூப
ਸਚਵੀਰ	ஸசவீர
ਸਚਸੁਖ	ஸசஸுக
ਸਚਸੇਵਕ	ஸசஸேவக
ਸਚਾਮ੍ਰਿਤ	ஸசாம்ரித
ਸਚ੍ਦੀਪ	ஸச்தீப
ਸਜੀਨਦੇਰ	ஸஜீநதேர
ਸਤਕਿਰਤ	ஸதகிரத
ਸਤਕੀਰਤ	ஸதகீரத
ਸਤਕੀਰ੍ਤਨ	ஸதகீர்தந
ਸਤਗੁਨ	ஸதகுந
ਸਤਗੁਰ	ஸதகுர
ਸਤਜੋਤ	ஸதஜோத
ਸਤਨਾਮ	ஸதநாம
ਸਤਪਾਲ	ஸதபால
ਸਤਪ੍ਰਕਾਸ਼	ஸதப்ரகாஶ
ਸਤਪ੍ਰਿਤ	ஸதப்ரித
ਸਤਪ੍ਰੇਮ	ஸதப்ரேம
ਸਤਬਚਨ	ஸதபசந
ਸਤਮਿਤ	ஸதமித
ਸਤਰਜਿਤ	ஸதரஜித
ਸਤਰਾਜ	ஸதராஜ
ਸਤਲੀਨ	ஸதலீந
ਸਤਵਂਤ	ஸதவஂத
ਸਤਸਂਗਤ	ஸதஸஂகத
ਸਤਸਂਤੋਖ	ஸதஸஂதோக
ਸਤਸਰਂਗ	ஸதஸரஂக
ਸਤਸੁਖ	ஸதஸுக
ਸਤੀਨਦੇਰ੍ਜਿਤ	ஸதீநதேர்ஜித
ਸਤ੍ਯਜਿਤ	ஸத்யஜித
ਸਤ੍ਯਪ੍ਰੇਮ	ஸத்யப்ரேம
ਸਥਿਨ੍ਦਰ	ஸதிந்தர
ਸਦਜੀਵਨ	ஸதஜீவந
ਸਦਸੁਖ	ஸதஸுக
ਸਨਮੁਖ	ஸநமுக
ਸਨਾਨਤਨ	ஸநாநதந
ਸਪਨਦੀਪ	ஸபநதீப
ਸਪਾਹੀ	ஸபாஹீ
ਸਬੂਰੀ	ஸபூரீ
ਸਭਾਜੀਤ	ஸபாஜீத
ਸਮਰਜੀਤ	ஸமரஜீத
ਸਮਰਣ	ஸமரண
ਸਮਰਵੀਰ	ஸமரவீர
ਸਮਰ੍ਥ	ஸமர்த
ਸਮਾਂਰਬੀਰ	ஸமாஂரபீர
ਸਮਾਂਰ੍ਜੋਤ	ஸமாஂர்ஜோத
ਸਮਾਈ	ஸமாஈ
ਸਮੀਨਦੀਪ	ஸமீநதீப
ਸਮੀਰ	ஸமீர
ਸਰਦਾਰ	ஸரதார
ਸਰਨਦਾਯਲ	ஸரநதாயல
ਸਰਨਦੀਪ	ஸரநதீப
ਸਰਨਾਗਤ	ஸரநாகத
ਸਰਬਜੀਤ / ਸਰਬਜੀਤ	ஸரபஜீத / ஸரபஜீத
ਸਰਬਨੀਵਾਸ	ஸரபநீவாஸ
ਸਰਬਪ੍ਰਿਤ	ஸரபப்ரித
ਸਰਬਸੁਖ	ஸரபஸுக
ਸਰਬੁਤ੍ਤਮ	ஸரபுத்தம
ਸਰਬ੍ਗਿਆਨ	ஸரப்கிஆந
ਸਰਬ੍ਜਿਤ	ஸரப்ஜித
ਸਰਬ੍ਦਾਯਲ	ஸரப்தாயல
ਸਰਬ੍ਦੀਪ	ஸரப்தீப
ਸਰਬ੍ਦੇਵ	ஸரப்தேவ
ਸਰਬ੍ਧਾਰਾਮ	ஸரப்தாராம
ਸਰਲਜਿਤ	ஸரலஜித
ਸਰਲਬੀਰ	ஸரலபீர
ਸਰਾਬ੍ਰਜ	ஸராப்ரஜ
ਸਰੂਪ	ஸரூப
ਸਰੂਰ	ஸரூர
ਸਰ੍ਜਿਤ	ஸர்ஜித
ਸਰ੍ਮੀਨਦੇਰ	ஸர்மீநதேர
ਸਵਾਨਪ੍ਰਿਤ	ஸவாநப்ரித
ਸਵਾਰਜਦੀਪ	ஸவாரஜதீப
ਸਵਾਰਜਬੀਰ	ஸவாரஜபீர
ਸਵਾਰਨਜੋਤ	ஸவாரநஜோத
ਸਵਾਰਨਪ੍ਰਿਤ	ஸவாரநப்ரித
ਸਵੀਤੀਨਦੇਰ	ஸவீதீநதேர
ਸਵੀਤੋਜ	ஸவீதோஜ
ਸਵੀਨਦੇਰ	ஸவீநதேர
ਸਹੀਲਮਿਤ	ஸஹீலமித
ਸ਼ਯ੍ਮ੍ਸੁਨ੍ਦਾਰ	ஶய்ம்ஸுந்தார
ਸ਼ਰਨਪਾਲ	ஶரநபால
ਸ਼ਰਨਬੀਰ	ஶரநபீர
ਸ਼ਰਨ੍ਜੀਤ੍ਕੌਰ	ஶரந்ஜீத்கௌர
ਸ਼ਾਂਤਚਿਤ	ஶாஂதசித
ਸ਼ਾਂਤਦੀਪ	ஶாஂததீப
ਸ਼ਾਂਤਪ੍ਰਕਾਸ਼	ஶாஂதப்ரகாஶ
ਸ਼ਾਂਤਪ੍ਰਿਤ	ஶாஂதப்ரித
ਸ਼ਾਂਤਬੀਰ	ஶாஂதபீர
ਸ਼ਾਂਤਲੀਨ	ஶாஂதலீந
ਸ਼ਾਨਤ੍ਨੀਵਾਸ	ஶாநத்நீவாஸ
ਸ਼ਾਬਦਚੇਤ	ஶாபதசேத
ਸ਼ਾਬਦਤੇਕ	ஶாபததேக
ਸ਼ਾਬਦ੍ਰਾਸ	ஶாபத்ராஸ
ਸ਼ਾਬਾਦ੍ਦੀਪ	ஶாபாத்தீப
ਸ਼ਾਲੀਨ	ஶாலீந
ਸ਼ਾਸ਼ੀਪ੍ਰਿਤ	ஶாஶீப்ரித
ਸ਼ਿਵਚਰਣ	ஶிவசரண
ਸ਼ਿਵ੍ਚਾਰਨ੍ਜੀਤ	ஶிவ்சாரந்ஜீத
ਸ਼ੁਕਾਰਿਯਨ	ஶுகாரியந
ਸ਼ੁਭਦੀਪ	ஶுபதீப
ਸ਼ੂਰਵੀਰ	ஶூரவீர
ਸ਼ੇਰ	ஶேர
ਸ਼ੇਰਪੁਲ	ஶேரபுல
ਸ਼ੇਰਬਹਾਦੁਰ	ஶேரபஹாதுர
ਸ਼ੇਹ੍ਬਾਝ	ஶேஹ்பாச
ਸਾਕਰਥ	ஸாகரத
ਸਾਖ	ஸாக
ਸਾਗਰ	ஸாகர
ਸਾਜ	ஸாஜ
ਸਾਤਪੁਲ	ஸாதபுல
ਸਾਧਨਾਹ	ஸாதநாஹ
ਸਾਧਿਕਾ	ஸாதிகா
ਸਾਬਰ	ஸாபர
ਸਾਰ	ஸார
ਸਿਂਦਾ	ஸிஂதா
ਸਿਓਪਰਿਤ	ஸிஓபரித
ਸਿਤਾਲਜੀਤ	ஸிதாலஜீத
ਸਿਤਾਲਜੋਤ	ஸிதாலஜோத
ਸਿਮਰਨ	ஸிமரந
ਸੀਖਲ	ஸீகல
ਸੀਮਾਂਰ੍ਜਿਤ	ஸீமாஂர்ஜித
ਸੀਮਾਂਰ੍ਨਾਮ	ஸீமாஂர்நாம
ਸੀਮਾਂਰ੍ਪ੍ਰਿਤ	ஸீமாஂர்ப்ரித
ਸੀਮਾਂਰ੍ਲੀਨ	ஸீமாஂர்லீந
ਸੀਮ੍ਰਤ	ஸீம்ரத
ਸੀਮ੍ਰਨਪਾਲ	ஸீம்ரநபால
ਸੀਮ੍ਰਨਪ੍ਰਿਤ	ஸீம்ரநப்ரித
ਸੀਮ੍ਰਨ੍ਕੌਰ	ஸீம்ரந்கௌர
ਸੀਮ੍ਰਨ੍ਜੀਤ	ஸீம்ரந்ஜீத
ਸੀਮ੍ਰੀਤਾ	ஸீம்ரீதா
ਸੀਰਤ	ஸீரத
ਸੀਰੀਪ੍ਰੀਤਮ	ஸீரீப்ரீதம
ਸੀਰੀਵੇਦ੍ਯਾ	ஸீரீவேத்யா
ਸੀਰੀਸੀਮ੍ਰਣ	ஸீரீஸீம்ரண
ਸੀਰੀਸੇਵਾ	ஸீரீஸேவா
ਸੁਖਚੈਨ	ஸுகசைந
ਸੁਖਜੀਵਨ	ஸுகஜீவந
ਸੁਖਜੋਤ	ஸுகஜோத
ਸੁਖਜੋਧ	ஸுகஜோத
ਸੁਖਦਾਯਲ	ஸுகதாயல
ਸੁਖਦੀਪ	ஸுகதீப
ਸੁਖਦੇਵ	ஸுகதேவ
ਸੁਖਬੀਰ	ஸுகபீர
ਸੁਖਮਾਂ	ஸுகமாஂ
ਸੁਖਰੂਪ	ஸுகரூப
ਸੁਖਸਿਤਾਲ	ஸுகஸிதால
ਸੁਖਸੀਮ੍ਰਣ	ஸுகஸீம்ரண
ਸੁਖਾਨਂਦ	ஸுகாநஂத
ਸੁਖਿਤ	ஸுகித
ਸੁਖੀਨ	ஸுகீந
ਸੁਖੀਨ੍ਦੇਰ	ஸுகீந்தேர
ਸੁਖ੍ਚਾਰਨ੍ਜੀਤ	ஸுக்சாரந்ஜீத
ਸੁਖ੍ਜਿਤ	ஸுக்ஜித
ਸੁਚਦੀਪ	ஸுசதீப
ਸੁਚਦੇਵ	ஸுசதேவ
ਸੁਚਮ	ஸுசம
ਸੁਜਨਰੂਪ	ஸுஜநரூப
ਸੁਜਨ੍ਬੀਰ	ஸுஜந்பீர
ਸੁਜ੍ਜਨ	ஸுஜ்ஜந
ਸੁਧਬੁਧ	ஸுதபுத
ਸੁਧਸੁਰਤ	ஸுதஸுரத
ਸੁਭਪ੍ਰਿਤ	ஸுபப்ரித
ਸੁਹੇਜਦੀਪ	ஸுஹேஜதீப
ਸੇਵਾਕਪ੍ਰਿਤ	ஸேவாகப்ரித
ਸੇਵਾਕਪ੍ਰੇਮ	ஸேவாகப்ரேம
ਸੇਵਾਕਰਣ	ஸேவாகரண
ਸੇਵਾਪ੍ਰੀਤ	ஸேவாப்ரீத
ਸੇਹਜ	ஸேஹஜ
ਸੇਹੇਜਬੀਰ	ஸேஹேஜபீர
ਸੈਲੇਸ਼ਦੀਪ	ஸைலேஶதீப
ਸੈਹਜ	ஸைஹஜ
ਸੈਹਾਜਨੀਵਾਸ	ஸைஹாஜநீவாஸ
ਸੈਹਾਜਲੀਨ	ஸைஹாஜலீந
ਸੈਹਾਜਾਧਾਰ	ஸைஹாஜாதார
ਸੋਚੀ	ஸோசீ
ਸੋਨਹਨ	ஸோநஹந
ਸੋਭਾਵਂਤ	ஸோபாவஂத
ਸੋਹੀਨਦੇਰ	ஸோஹீநதேர
ਸੋਹੁਨ	ஸோஹுந
ਸ੍ਵਰ੍ਨ	ஸ்வர்ந
ਹਕਾਮਪ੍ਰਿਤ	ஹகாமப்ரித
ਹਨ੍ਸ੍ਪਾਲ	ஹந்ஸ்பால
ਹਰਕਾਨ੍ਵਾਲ	ஹரகாந்வால
ਹਰਕੀਰਣ	ஹரகீரண
ਹਰਗੀਤ	ஹரகீத
ਹਰਗੁਰ੍ਮਿਤ (ਮਿਤ )	ஹரகுர்மித (மித )
ਹਰਗੋਬੀਨ੍ਦ	ஹரகோபீந்த
ਹਰਚਰਣ	ஹரசரண
ਹਰਜਪ	ஹரஜப
ਹਰਜੀ	ஹரஜீ
ਹਰਜੀਤ	ஹரஜீத
ਹਰਜੀਨ੍ਦੇਰ	ஹரஜீந்தேர
ਹਰਜੀਵ	ஹரஜீவ
ਹਰਜੁਗਤ	ஹரஜுகத
ਹਰਜੋਗ	ஹரஜோக
ਹਰਜੋਧ	ஹரஜோத
ਹਰਜ੍ਯੋਤ	ஹரஜ்யோத
ਹਰਤਿਰਥ	ஹரதிரத
ਹਰਤੇਜ੍ਪਾਲ	ஹரதேஜ்பால
ਹਰਦਯਾਲ	ஹரதயால
ਹਰਦਾਸ	ஹரதாஸ
ਹਰਦਿਪਾ	ஹரதிபா
ਹਰਦੀਪ	ஹரதீப
ਹਰਧਨ	ஹரதந
ਹਰਨਾਮ	ஹரநாம
ਹਰਨਾਰਾਯਣ	ஹரநாராயண
ਹਰਨਿਤ	ஹரநித
ਹਰਨੀਰ੍ਮਲ	ஹரநீர்மல
ਹਰਨੀਹਲ	ஹரநீஹல
ਹਰਪਰ੍ਸਨ੍ਨ	ஹரபர்ஸந்ந
ਹਰਪਾਲ	ஹரபால
ਹਰਪ੍ਰੇਮ੍ਜੀਤ	ஹரப்ரேம்ஜீத
ਹਰਬਿਂਦਰ	ஹரபிஂதர
ਹਰਬਿਰ	ஹரபிர
ਹਰਭਗਤ	ஹரபகத
ਹਰਮਨਾਦ	ஹரமநாத
ਹਰਮਾਂਨ੍ਦੇਰ	ஹரமாஂந்தேர
ਹਰਮੀਤ	ஹரமீத
ਹਰਮੀਲਨ	ஹரமீலந
ਹਰਮੂਰਤ	ஹரமூரத
ਹਰਰਾਈ	ஹரராஈ
ਹਰਰੂਪ	ஹரரூப
ਹਰਵਂਤ	ஹரவஂத
ਹਰਵਿਨ	ஹரவிந
ਹਰਸ਼ਰਣ	ஹரஶரண
ਹਰਸਿਤਾਲ	ஹரஸிதால
ਹਰਸੀਮ੍ਰਣ	ஹரஸீம்ரண
ਹਰਸੀਮ੍ਰਨ੍ਜੋਤ	ஹரஸீம்ரந்ஜோத
ਹਰਸੀਮ੍ਰਿਤ	ஹரஸீம்ரித
ਹਰਸੁਖ	ஹரஸுக
ਹਰਾਨੂਪ	ஹராநூப
ਹਰਾਮ੍ਰੀਤ	ஹராம்ரீத
ਹਰਿਕੀਰ੍ਤਨ	ஹரிகீர்தந
ਹਰਿਦਰ੍ਸ਼ਨ	ஹரிதர்ஶந
ਹਰਿਨਾਰਾਯਣ	ஹரிநாராயண
ਹਰਿਪ੍ਰੀਤ	ஹரிப்ரீத
ਹਰੀਅਮ੍ਰਿਤ	ஹரீஅம்ரித
ਹਰੀਸਰੂਪ	ஹரீஸரூப
ਹਰੀਸੀਮਾਂਰਣ	ஹரீஸீமாஂரண
ਹਰ੍ਕਾਰਾਨ੍ਜੀਤ	ஹர்காராந்ஜீத
ਹਰ੍ਕੀਰਨ੍ਜੀਤ	ஹர்கீரந்ஜீத
ਹਰ੍ਕੀਰਪਾਲ	ஹர்கீரபால
ਹਰ੍ਜਸ	ஹர்ஜஸ
ਹਰ੍ਤੇਇਜ	ஹர்தேஇஜ
ਹਰ੍ਨੀਝ	ஹர்நீச
ਹਰ੍ਬਂਸ	ஹர்பஂஸ
ਹਰ੍ਮਾਂਨਜਿਤ	ஹர்மாஂநஜித
ਹਰ੍ਮਾਂਨਪਾਲ	ஹர்மாஂநபால
ਹਰ੍ਮੀਨ੍ਦੇਰ	ஹர்மீந்தேர
ਹਰ੍ਮੇਂਦ੍ਰ	ஹர்மேஂத்ர
ਹਰ੍ਸ਼ਰ੍ਧਾ	ஹர்ஶர்தா
ਹਰ੍ਸ਼ਵਰ੍ਧਨ	ஹர்ஶவர்தந
ਹਰ੍ਸ਼ਾਗੁਨ	ஹர்ஶாகுந
ਹਰ੍ਸਿਰਤ	ஹர்ஸிரத
ਹਸਨ	ஹஸந
ਹਾਰਭਾਗ	ஹாரபாக
ਹਿਤੀਨਦੇਰ	ஹிதீநதேர
ਹਿਤੇਨਦੇਰ	ஹிதேநதேர
ਹਿਮ੍ਮਤ	ஹிம்மத
ਹਿਰੀਸ਼	ஹிரீஶ
ਹੁਅਲੀਨਾ	ஹுஅலீநா
ਹੁਕੁਮਪਰਿਤ	ஹுகுமபரித
ਹੂਜਓਏ	ஹூஜஓஏ
ਹੇਤ	ஹேத
ਹੇਤਬੀਰ	ஹேதபீர
ਹੇਮੀਨਦੇਰ	ஹேமீநதேர
ਹੇਯ੍ਮਾਂਨ੍ਪ੍ਰਿਤ	ஹேய்மாஂந்ப்ரித
ਹੇਰਹੋ	ஹேரஹோ
#
#
# Territory names from CLDR
ਅਸੈਂਸ਼ਨ ਟਾਪੂ	அஸைஂஶந டாபூ
ਅੰਡੋਰਾ	அடோரா
ਸੰਯੁਕਤ ਅਰਬ ਅਮੀਰਾਤ	ஸயுகத அரப அமீராத
ਅਫ਼ਗਾਨਿਸਤਾਨ	அபகாநிஸதாந
ਐਂਟੀਗੁਆ ਅਤੇ ਬਾਰਬੁਡਾ	ஐஂடீகுஆ அதே பாரபுடா
ਅੰਗੁਇਲਾ	அகுஇலா
ਅਲਬਾਨੀਆ	அலபாநீஆ
ਅਰਮੀਨੀਆ	அரமீநீஆ
ਅੰਗੋਲਾ	அகோலா
ਅੰਟਾਰਕਟਿਕਾ	அடாரகடிகா
ਅਰਜਨਟੀਨਾ	அரஜநடீநா
ਅਮੈਰੀਕਨ ਸਮੋਆ	அமைரீகந ஸமோஆ
ਆਸਟਰੀਆ	ஆஸடரீஆ
ਆਸਟ੍ਰੇਲੀਆ	ஆஸட்ரேலீஆ
ਅਰੂਬਾ	அரூபா
ਅਲੈਂਡ ਟਾਪੂ	அலைஂட டாபூ
ਅਜ਼ਰਬਾਈਜਾਨ	அஜரபாஈஜாந
ਬੋਸਨੀਆ ਅਤੇ ਹਰਜ਼ੇਗੋਵੀਨਾ	போஸநீஆ அதே ஹரஜேகோவீநா
ਬਾਰਬਾਡੋਸ	பாரபாடோஸ
ਬੰਗਲਾਦੇਸ਼	பகலாதேஶ
ਬੈਲਜੀਅਮ	பைலஜீஅம
ਬੁਰਕੀਨਾ ਫ਼ਾਸੋ	புரகீநா பாஸோ
ਬੁਲਗਾਰੀਆ	புலகாரீஆ
ਬਹਿਰੀਨ	பஹிரீந
ਬੁਰੁੰਡੀ	புருடீ
ਬੇਨਿਨ	பேநிந
ਸੇਂਟ ਬਾਰਥੇਲੇਮੀ	ஸேஂட பாரதேலேமீ
ਬਰਮੂਡਾ	பரமூடா
ਬਰੂਨੇਈ	பரூநேஈ
ਬੋਲੀਵੀਆ	போலீவீஆ
ਕੈਰੇਬੀਆਈ ਨੀਦਰਲੈਂਡ	கைரேபீஆஈ நீதரலைஂட
ਬ੍ਰਾਜ਼ੀਲ	ப்ராஜீல
ਬਹਾਮਾਸ	பஹாமாஸ
ਭੂਟਾਨ	பூடாந
ਬੌਵੇਟ ਟਾਪੂ	பௌவேட டாபூ
ਬੋਟਸਵਾਨਾ	போடஸவாநா
ਬੇਲਾਰੂਸ	பேலாரூஸ
ਬੇਲੀਜ਼	பேலீஜ
ਕੈਨੇਡਾ	கைநேடா
ਕੋਕੋਸ (ਕੀਲਿੰਗ) ਟਾਪੂ	கோகோஸ (கீலிக) டாபூ
ਕਾਂਗੋ - ਕਿੰਸ਼ਾਸਾ	காஂகோ - கிஶாஸா
ਕਾਂਗੋ ਲੋਕਤੰਤਰੀ ਗਣਰਾਜ	காஂகோ லோகததரீ கணராஜ
ਕੇਂਦਰੀ ਅਫ਼ਰੀਕੀ ਗਣਰਾਜ	கேஂதரீ அபரீகீ கணராஜ
ਕਾਂਗੋ - ਬ੍ਰਾਜ਼ਾਵਿਲੇ	காஂகோ - ப்ராஜாவிலே
ਕਾਂਗੋ ਗਣਰਾਜ	காஂகோ கணராஜ
ਸਵਿਟਜ਼ਰਲੈਂਡ	ஸவிடஜரலைஂட
ਕੋਟ ਡੀਵੋਆਰ	கோட டீவோஆர
ਆਇਵਰੀ ਕੋਸਟ	ஆஇவரீ கோஸட
ਕੁੱਕ ਟਾਪੂ	குக டாபூ
ਚਿਲੀ	சிலீ
ਕੈਮਰੂਨ	கைமரூந
ਚੀਨ	சீந
ਕੋਲੰਬੀਆ	கோலபீஆ
ਕਲਿੱਪਰਟਨ ਟਾਪੂ	கலிபரடந டாபூ
ਕੋਸਟਾ ਰੀਕਾ	கோஸடா ரீகா
ਕਿਊਬਾ	கிஊபா
ਕੇਪ ਵਰਡੇ	கேப வரடே
ਕੁਰਾਕਾਓ	குராகாஓ
ਕ੍ਰਿਸਮਿਸ ਟਾਪੂ	க்ரிஸமிஸ டாபூ
ਸਾਇਪ੍ਰਸ	ஸாஇப்ரஸ
ਚੈਕ ਗਣਰਾਜ	சைக கணராஜ
ਜਰਮਨੀ	ஜரமநீ
ਡੀਇਗੋ ਗਾਰਸੀਆ	டீஇகோ காரஸீஆ
ਜ਼ੀਬੂਤੀ	ஜீபூதீ
ਡੈਨਮਾਰਕ	டைநமாரக
ਡੋਮੀਨਿਕਾ	டோமீநிகா
ਡੋਮੀਨਿਕਾਈ ਗਣਰਾਜ	டோமீநிகாஈ கணராஜ
ਅਲਜੀਰੀਆ	அலஜீரீஆ
ਸਿਓਟਾ ਅਤੇ ਮੇਲਿੱਲਾ	ஸிஓடா அதே மேலிலா
ਇਕਵੇਡੋਰ	இகவேடோர
ਇਸਟੋਨੀਆ	இஸடோநீஆ
ਮਿਸਰ	மிஸர
ਪੱਛਮੀ ਸਹਾਰਾ	பசமீ ஸஹாரா
ਇਰੀਟ੍ਰਿਆ	இரீட்ரிஆ
ਸਪੇਨ	ஸபேந
ਇਥੋਪੀਆ	இதோபீஆ
ਯੂਰਪੀ ਯੂਨੀਅਨ	யூரபீ யூநீஅந
ਫਿਨਲੈਂਡ	பிநலைஂட
ਫ਼ਿਜੀ	பிஜீ
ਫ਼ਾਕਲੈਂਡ ਟਾਪੂ	பாகலைஂட டாபூ
ਫ਼ਾਕਲੈਂਡ ਟਾਪੂ (ਆਈਲਾਸ ਮਾਲਵਿਨਾਸ)	பாகலைஂட டாபூ (ஆஈலாஸ மாலவிநாஸ)
ਮਾਇਕ੍ਰੋਨੇਸ਼ੀਆ	மாஇக்ரோநேஶீஆ
ਫੈਰੋ ਟਾਪੂ	பைரோ டாபூ
ਫ਼ਰਾਂਸ	பராஂஸ
ਗਬੋਨ	கபோந
ਯੂਨਾਈਟਡ ਕਿੰਗਡਮ	யூநாஈடட கிகடம
ਗ੍ਰੇਨਾਡਾ	க்ரேநாடா
ਜਾਰਜੀਆ	ஜாரஜீஆ
ਫ਼ਰੈਂਚ ਗੁਆਨਾ	பரைஂச குஆநா
ਗਰਨਜੀ	கரநஜீ
ਘਾਨਾ	காநா
ਜਿਬਰਾਲਟਰ	ஜிபராலடர
ਗ੍ਰੀਨਲੈਂਡ	க்ரீநலைஂட
ਗੈਂਬੀਆ	கைஂபீஆ
ਗਿਨੀ	கிநீ
ਗੁਆਡੇਲੋਪ	குஆடேலோப
ਭੂ-ਖੰਡੀ ਗਿਨੀ	பூ-கடீ கிநீ
ਗ੍ਰੀਸ	க்ரீஸ
ਦੱਖਣੀ ਜਾਰਜੀਆ ਅਤੇ ਦੱਖਣੀ ਸੈਂਡਵਿਚ ਟਾਪੂ	தகணீ ஜாரஜீஆ அதே தகணீ ஸைஂடவிச டாபூ
ਗੁਆਟੇਮਾਲਾ	குஆடேமாலா
ਗੁਆਮ	குஆம
ਗਿਨੀ-ਬਿਸਾਉ	கிநீ-பிஸாஉ
ਗੁਯਾਨਾ	குயாநா
ਹਾਂਗ ਕਾਂਗ ਐਸਏਆਰ ਚੀਨ	ஹாஂக காஂக ஐஸஏஆர சீந
ਹਾਂਗ ਕਾਂਗ	ஹாஂக காஂக
ਹਰਡ ਤੇ ਮੈਕਡੋਨਾਲਡ ਟਾਪੂ	ஹரட தே மைகடோநாலட டாபூ
ਹੋਂਡੁਰਸ	ஹோஂடுரஸ
ਕਰੋਏਸ਼ੀਆ	கரோஏஶீஆ
ਹੈਤੀ	ஹைதீ
ਹੰਗਰੀ	ஹகரீ
ਕੇਨਾਰੀ ਟਾਪੂ	கேநாரீ டாபூ
ਇੰਡੋਨੇਸ਼ੀਆ	இடோநேஶீஆ
ਆਇਰਲੈਂਡ	ஆஇரலைஂட
ਇਜ਼ਰਾਈਲ	இஜராஈல
ਆਇਲ ਆਫ ਮੈਨ	ஆஇல ஆப மைந
ਭਾਰਤ	பாரத
ਬਰਤਾਨਵੀ ਹਿੰਦ ਮਹਾਂਸਾਗਰ ਪ੍ਰਦੇਸ਼	பரதாநவீ ஹித மஹாஂஸாகர ப்ரதேஶ
ਇਰਾਕ	இராக
ਈਰਾਨ	ஈராந
ਆਈਸਲੈਂਡ	ஆஈஸலைஂட
ਇਟਲੀ	இடலீ
ਜਰਸੀ	ஜரஸீ
ਜਮਾਇਕਾ	ஜமாஇகா
ਜਾਰਡਨ	ஜாரடந
ਜਪਾਨ	ஜபாந
ਕੀਨੀਆ	கீநீஆ
ਕਿਰਗਿਜ਼ਸਤਾਨ	கிரகிஜஸதாந
ਕੰਬੋਡੀਆ	கபோடீஆ
ਕਿਰਬਾਤੀ	கிரபாதீ
ਕੋਮੋਰੋਸ	கோமோரோஸ
ਸੈਂਟ ਕਿਟਸ ਐਂਡ ਨੇਵਿਸ	ஸைஂட கிடஸ ஐஂட நேவிஸ
ਉੱਤਰੀ ਕੋਰੀਆ	உதரீ கோரீஆ
ਦੱਖਣੀ ਕੋਰੀਆ	தகணீ கோரீஆ
ਕੁਵੈਤ	குவைத
ਕੇਮੈਨ ਟਾਪੂ	கேமைந டாபூ
ਕਜ਼ਾਖਸਤਾਨ	கஜாகஸதாந
ਲਾਓਸ	லாஓஸ
ਲੈਬਨਾਨ	லைபநாந
ਸੇਂਟ ਲੂਸੀਆ	ஸேஂட லூஸீஆ
ਲਿਚੇਂਸਟਾਇਨ	லிசேஂஸடாஇந
ਸ੍ਰੀ ਲੰਕਾ	ஸ்ரீ லகா
ਲਾਈਬੀਰੀਆ	லாஈபீரீஆ
ਲੇਸੋਥੋ	லேஸோதோ
ਲਿਥੁਆਨੀਆ	லிதுஆநீஆ
ਲਕਜ਼ਮਬਰਗ	லகஜமபரக
ਲਾਟਵੀਆ	லாடவீஆ
ਲੀਬੀਆ	லீபீஆ
ਮੋਰੱਕੋ	மோரகோ
ਮੋਨਾਕੋ	மோநாகோ
ਮੋਲਡੋਵਾ	மோலடோவா
ਮੋਂਟੇਨੇਗਰੋ	மோஂடேநேகரோ
ਸੇਂਟ ਮਾਰਟਿਨ	ஸேஂட மாரடிந
ਮੈਡਾਗਾਸਕਰ	மைடாகாஸகர
ਮਾਰਸ਼ਲ ਟਾਪੂ	மாரஶல டாபூ
ਮੈਕਡੋਨੀਆ	மைகடோநீஆ
ਮੈਕਡੋਨੀਆ (ਪੂਰਵ ਯੂਗੋਸਲਾਵ ਮੈਕਡੋਨੀਆਈ ਗਣਰਾਜ)	மைகடோநீஆ (பூரவ யூகோஸலாவ மைகடோநீஆஈ கணராஜ)
ਮਾਲੀ	மாலீ
ਮਿਆਂਮਾਰ (ਬਰਮਾ)	மிஆஂமார (பரமா)
ਮੰਗੋਲੀਆ	மகோலீஆ
ਮਕਾਉ ਐਸਏਆਰ ਚੀਨ	மகாஉ ஐஸஏஆர சீந
ਮਕਾਉ	மகாஉ
ਉੱਤਰੀ ਮਾਰੀਆਨਾ ਟਾਪੂ	உதரீ மாரீஆநா டாபூ
ਮਾਰਟੀਨਿਕ	மாரடீநிக
ਮੋਰਿਟਾਨੀਆ	மோரிடாநீஆ
ਮੋਂਟਸੇਰਾਤ	மோஂடஸேராத
ਮਾਲਟਾ	மாலடா
ਮੌਰਿਸ਼ਸ	மௌரிஶஸ
ਮਾਲਦੀਵ	மாலதீவ
ਮਲਾਵੀ	மலாவீ
ਮੈਕਸੀਕੋ	மைகஸீகோ
ਮਲੇਸ਼ੀਆ	மலேஶீஆ
ਮੋਜ਼ਾਮਬੀਕ	மோஜாமபீக
ਨਾਮੀਬੀਆ	நாமீபீஆ
ਨਿਊ ਕੈਲੇਡੋਨੀਆ	நிஊ கைலேடோநீஆ
ਨਾਈਜਰ	நாஈஜர
ਨੋਰਫੌਕ ਟਾਪੂ	நோரபௌக டாபூ
ਨਾਈਜੀਰੀਆ	நாஈஜீரீஆ
ਨਿਕਾਰਾਗੁਆ	நிகாராகுஆ
ਨੀਦਰਲੈਂਡ	நீதரலைஂட
ਨਾਰਵੇ	நாரவே
ਨੇਪਾਲ	நேபால
ਨਾਉਰੂ	நாஉரூ
ਨਿਯੂ	நியூ
ਨਿਊਜ਼ੀਲੈਂਡ	நிஊஜீலைஂட
ਓਮਾਨ	ஓமாந
ਪਨਾਮਾ	பநாமா
ਪੇਰੂ	பேரூ
ਫਰੈਂਚ ਪੋਲੀਨੇਸ਼ੀਆ	பரைஂச போலீநேஶீஆ
ਪਾਪੂਆ ਨਿਊ ਗਿਨੀ	பாபூஆ நிஊ கிநீ
ਫਿਲੀਪੀਂਸ	பிலீபீஂஸ
ਪਾਕਿਸਤਾਨ	பாகிஸதாந
ਪੋਲੈਂਡ	போலைஂட
ਸੈਂਟ ਪੀਅਰੇ ਐਂਡ ਮਿਕੇਲਨ	ஸைஂட பீஅரே ஐஂட மிகேலந
ਪਿਟਕੇਰਨ ਟਾਪੂ	பிடகேரந டாபூ
ਪਿਊਰਟੋ ਰਿਕੋ	பிஊரடோ ரிகோ
ਫਿਲੀਸਤੀਨੀ ਖੇਤਰ	பிலீஸதீநீ கேதர
ਫਿਲੀਸਤੀਨ	பிலீஸதீந
ਪੁਰਤਗਾਲ	புரதகால
ਪਲਾਉ	பலாஉ
ਪੈਰਾਗਵੇ	பைராகவே
ਕਤਰ	கதர
ਆਊਟਲਾਇੰਗ ਓਸ਼ੀਨੀਆ	ஆஊடலாஇக ஓஶீநீஆ
ਰਿਯੂਨੀਅਨ	ரியூநீஅந
ਰੋਮਾਨੀਆ	ரோமாநீஆ
ਸਰਬੀਆ	ஸரபீஆ
ਰੂਸ	ரூஸ
ਰਵਾਂਡਾ	ரவாஂடா
ਸਾਊਦੀ ਅਰਬ	ஸாஊதீ அரப
ਸੋਲੋਮਨ ਟਾਪੂ	ஸோலோமந டாபூ
ਸੇਸ਼ਲਸ	ஸேஶலஸ
ਸੂਡਾਨ	ஸூடாந
ਸਵੀਡਨ	ஸவீடந
ਸਿੰਗਾਪੁਰ	ஸிகாபுர
ਸੇਂਟ ਹੇਲੇਨਾ	ஸேஂட ஹேலேநா
ਸਲੋਵੇਨੀਆ	ஸலோவேநீஆ
ਸਵਾਲਬਰਡ ਅਤੇ ਜਾਨ ਮਾਯੇਨ	ஸவாலபரட அதே ஜாந மாயேந
ਸਲੋਵਾਕੀਆ	ஸலோவாகீஆ
ਸਿਏਰਾ ਲਿਓਨ	ஸிஏரா லிஓந
ਸੈਨ ਮਰੀਨੋ	ஸைந மரீநோ
ਸੇਨੇਗਲ	ஸேநேகல
ਸੋਮਾਲੀਆ	ஸோமாலீஆ
ਸੂਰੀਨਾਮ	ஸூரீநாம
ਦੱਖਣੀ ਸੂਡਾਨ	தகணீ ஸூடாந
ਸਾਓ ਟੋਮ ਅਤੇ ਪ੍ਰਿੰਸੀਪੇ	ஸாஓ டோம அதே ப்ரிஸீபே
ਅਲ ਸਲਵਾਡੋਰ	அல ஸலவாடோர
ਸਿੰਟ ਮਾਰਟੀਨ	ஸிட மாரடீந
ਸੀਰੀਆ	ஸீரீஆ
ਸਵਾਜ਼ੀਲੈਂਡ	ஸவாஜீலைஂட
ਟ੍ਰਿਸਟਾਨ ਦਾ ਕੁੰਹਾ	ட்ரிஸடாந தா குஹா
ਟੁਰਕਸ ਅਤੇ ਕੈਕੋਸ ਟਾਪੂ	டுரகஸ அதே கைகோஸ டாபூ
ਚਾਡ	சாட
ਫਰੈਂਚ ਦੱਖਣੀ ਪ੍ਰਦੇਸ਼	பரைஂச தகணீ ப்ரதேஶ
ਟੋਗੋ	டோகோ
ਥਾਈਲੈਂਡ	தாஈலைஂட
ਤਾਜਿਕਿਸਤਾਨ	தாஜிகிஸதாந
ਟੋਕੇਲਾਉ	டோகேலாஉ
ਤਿਮੋਰ-ਲੇਸਤੇ	திமோர-லேஸதே
ਪੂਰਬੀ ਤਿਮੋਰ	பூரபீ திமோர
ਤੁਰਕਮੇਨਿਸਤਾਨ	துரகமேநிஸதாந
ਟਿਊਨੀਸ਼ੀਆ	டிஊநீஶீஆ
ਟੌਂਗਾ	டௌஂகா
ਤੁਰਕੀ	துரகீ
ਟ੍ਰਿਨੀਡਾਡ ਅਤੇ ਟੋਬਾਗੋ	ட்ரிநீடாட அதே டோபாகோ
ਟੁਵਾਲੂ	டுவாலூ
ਤਾਇਵਾਨ	தாஇவாந
ਤਨਜ਼ਾਨੀਆ	தநஜாநீஆ
ਯੂਕਰੇਨ	யூகரேந
ਯੂਗਾਂਡਾ	யூகாஂடா
ਸੰਯੁਕਤ ਰਾਜ	ஸயுகத ராஜ
ਉਰੂਗਵੇ	உரூகவே
ਉਜ਼ਬੇਕਿਸਤਾਨ	உஜபேகிஸதாந
ਵੈਟੀਕਨ ਸਿਟੀ	வைடீகந ஸிடீ
ਸੇਂਟ ਵਿਨਸੈਂਟ ਐਂਡ ਗ੍ਰੇਨਾਡੀਨਸ	ஸேஂட விநஸைஂட ஐஂட க்ரேநாடீநஸ
ਵੇਨੇਜ਼ੂਏਲਾ	வேநேஜூஏலா
ਬ੍ਰਿਟਿਸ਼ ਵਰਜਿਨ ਟਾਪੂ	ப்ரிடிஶ வரஜிந டாபூ
ਯੂ ਐਸ ਵਰਜਿਨ ਟਾਪੂ	யூ ஐஸ வரஜிந டாபூ
ਵੀਅਤਨਾਮ	வீஅதநாம
ਵਾਨੂਆਟੂ	வாநூஆடூ
ਵਾਲਿਸ ਅਤੇ ਫੂਟੂਨਾ	வாலிஸ அதே பூடூநா
ਸਾਮੋਆ	ஸாமோஆ
ਕੋਸੋਵੋ	கோஸோவோ
ਯਮਨ	யமந
ਮਾਯੋਟੀ	மாயோடீ
ਦੱਖਣੀ ਅਫਰੀਕਾ	தகணீ அபரீகா
ਜ਼ਾਮਬੀਆ	ஜாமபீஆ
ਜ਼ਿੰਬਾਬਵੇ	ஜிபாபவே
ਅਣਪਛਾਤਾ ਖੇਤਰ	அணபசாதா கேதர
