ሀብታምነት	habetāmennat
ሀቻምና	haccāmenā
ሀች	hacc
ሁለ	hulla
ሁለመና	hullamanā
ሁለተ	hulatta
ሁለቴ	hulatté
ሁለት	hulatt
ሁሉ	hullu
ሁሉም	hullum
ሁሌ	hullé
ሁል	hull
ሁልጊዜ	hullegizé
ሁነኛ	hunaññā
ሁከተኛ	hukataññā
ሂስና	hisennā
ሃያኛ	hāyāññā
ሃይማኖተኛ	hāyemānotaññā
ህላዌ	hellāwé
ህልውና	hellewenā
ህክምና	hekkemennā
ሆሳዕና	hossāʻenā
ሆነለት	honallat
ሆነበት	honabbat
ሆኖም	honomm
ሆጃ	hoǧǧā
ለመለመ	lamallama
ለመሰሰ	lamassasa
ለመነ	lammana
ለመዘገ	lamazzaga
ለመደ	lammada
ለመጠ	lammaṭa
ለመጥ	lammaṭṭ
ለማ	lammā
ለማመደ	lamāmmada
ለማኝ	lammāñ
ለማኝነት	lammāñennat
ለማዳ	lammādā
ለማዳነት	lammādānnat
ለማጣ	lammāṭā
ለምነት	lamennat
ለሰለሰ	lasallasa
ለሰሰ	lassasa
ለሰነ	lassana
ለሱ	lassu
ለሳኝ	lassāñ
ለስ	lass
ለስላሳ	laselāssā
ለስላሳነት	laselāssānnat
ለሸለሸ	lašallaša
ለቀለቀ	laqallaqa
ለቀመ	laqqama
ለቀም	laqamm
ለቀስተኛ	laqqasetaññā
ለቀቀ	laqqaqa
ለቀቅ	laqqaq
ለቃቀመ	laqāqqama
ለቅለቅ	laqelaqq
ለቅላቂ	laqellāqi
ለበለበ	laballaba
ለበሰ	labassa
ለበቀ	labbaqa
ለበበ	labbaba
ለበደ	labbada
ለበጠ	labbaṭa
ለባቃ	labbāqqā
ለባበሰ	labābbasa
ለብ	labb
ለብታ	labbetā
ለብቻ	labbeccā
ለተመ	lattama
ለካ	lakkā
ለኮሰ	lakkosa
ለኮፈ	lakkofa
ለወሰ	lawassa
ለወጠ	lawwaṭa
ለዋሳ	lawwāssā
ለዘበ	lazzaba
ለዘብተኛ	lazzabetaññā
ለዛ	lazzā
ለዛው	lazzāw
ለየ	layya
ለየብቻ	layyabeccā
ለያየ	layāyya
ለይስሙላ	layesemullā
ለጅ	laǧǧ
ለገመ	laggama
ለገሰ	laggasa
ለጋ	laggā
ለጋስ	laggās
ለጋስነት	laggāsennat
ለግላጋ	lagelāggā
ለጎን	lagonn
ለጎደ	laggoda
ለጐመ	laggwama
ለጠለጠ	laṭallaṭa
ለጫካ	laċākkā
ለፈለፈ	lafallafa
ለፈፈ	laffafa
ለፋ	laffā
ሊቅነት	liqennat
ላላ	lāllā
ላምባ	lāmebbā
ላሸ	lāšša
ላሸቀ	lāššaqa
ላቂያ	lāqqiyā
ላቅ	lāqq
ላቆጠ	lāqqoṭa
ላከከ	lākkaka
ላይኛ	lāyeññā
ላጲስ	lāp̣p̣is
ሌብነት	lébennat
ሌጣነት	léṭānnat
ልመና	lemmanā
ልማደኛ	lemādaññā
ልምምድ	lememmed
ልምጥ	lemmeṭṭ
ልምጭ	lemmeċ
ልሳነ	lessāna
ልሳን	lessān
ልስላሴ	lesellāssé
ልስን	lessen
ልቃሚ	leqqāmi
ልቃቂ	leqqāqi
ልቃቂት	leqqāqit
ልቅ	leqq
ልቅም	leqqem
ልቅቅ	leqeqq
ልቅነት	leqqennat
ልበ	lebba
ልቡ	lebbu
ልቡና	lebbunā
ልባም	lebbām
ልባሽ	lebbāš
ልባዊ	lebbāwi
ልብ	lebb
ልብስ	lebbes
ልብቅ	lebbeq
ልብዳት	lebbedāt
ልብድ	lebbed
ልብጥ	lebbeṭ
ልኩን	lekkun
ልክ	lekk
ልዋጭ	lewwāċ
ልውውጥ	lewewweṭ
ልዕልና	leʻelennā
ልዝብ	lezzeb
ልዩ	leyyu
ልዩነት	leyyunnat
ልጃገረድነት	leǧāgaradennat
ልጅነት	leǧennat
ልጉም	leggum
ልግመኛ	legemaññā
ልግስና	leggesennā
ልጥፋት	lleṭṭefāt
ልጨኛ	leċċaññā
ልፈፋ	leffafā
ልፊያ	leffiyā
ልፋጫም	leffāċām
ልፋጭ	leffāċ
ሎሌነት	lolénnat
ሎቲ	lotti
ሐማል	ḥammāl
ሐማልነት	ḥammālennat
ሐሜተኛ	ḥamétaññā
ሐሜት	ḥammét
ሐሰተኛ	ḥassataññā
ሐሰት	ḥassat
ሐሳብ	ḥassāb
ሐሳዌ	ḥassāwé
ሐቀኛ	ḥaqqaññā
ሐቀኛነት	ḥaqqaññānnat
ሐቅ	ḥaqq
ሐተተኛ	ḥatataññā
ሐች	ḥacc
ሐካይ	ḥakkāy
ሐኬተኛ	ḥakétaññā
ሐኬተኝነት	ḥakétaññennat
ሐዋላ	ḥawwālā
ሐዋርያነት	ḥawāreyānnat
ሐዘንተኛ	ḥazanetaññā
ሐዲስ	ḥaddis
ሑር	ḥurr
ሑርነት	ḥurrennat
ሕመምተኛ	ḥemamettañā
ሕቅ	ḥeqq
ሕቅታ	ḥeqqetā
ሕክምና	ḥekkemennā
ሕያውነት	ḥeyāwennat
ሕገ	ḥegga
ሕጋዊ	ḥeggāwi
ሕጋዊነት	ḥeggāwinnat
ሕግ	ḥegg
ሕጓ	ḥeggwā
ሕፃንነት	ḥeṡānnennat
መሀንዲስነት	mahanedisennat
መሀከለኛ	mahakkalaññā
መሀከል	mahakkal
መሃይም	mahāyyem
መሃይምነት	mahāyyemennat
መለለ	mallala
መለማመጃ	mallamāmaǧā
መለሰ	mallasa
መለቃለቂያ	mallaqālaqiyā
መለኮትነት	malakotennat
መለወጫ	mallawaċċā
መለዮ	mallayyo
መለጠ	mallaṭa
መላ	mallā
መላሽ	mallāš
መላክተኛ	malāketaññā
መላጣነት	malāṭānnat
መልመጃ	mallemaǧā
መልሶ	malleso
መልቲነት	maletinnat
መልእክተኛ	maleʼeketaññā
መልከኛ	malekaññā
መሐለቅ	maḥallaq
መሐላ	maḥallā
መመሪያ	mammariyā
መመነኛ	mamannañā
መመዘኛ	mamazzañā
መመዝገቢያ	mammazegabiyā
መመጻደቅ	mammaṣādaq
መማለጃ	mammālaǧā
መምህርነት	mameherennat
መሠሪ	maśarri
መሠሪነት	maśarrinnat
መሠዊያ	maśawwiyā
መሠውር	maśawwer
መሣሪያ	maśśāriyā
መሥዋዕትነት	maśewāʻetennat
መረመረ	marammara
መረማመጃ	marramāmaǧā
መረረ	marrara
መረረው	marraraw
መረቀ	marraqa
መረቀዘ	maraqqaza
መረባ	marabbā
መረተ	marrata
መረነ	marrana
መረዋ	marawwā
መረዘ	marraza
መረጃ	marraǧā
መረገ	marraga
መረገጫ	marragaċā
መረጋገጫ	marragāgaċā
መረጠ	marraṭa
መሪነት	marinnat
መራ	marrā
መራራነት	marrārānat
መራር	marrār
መራርነት	marrārennat
መራቂ	marrāqi
መራቢያ	marrābiyā
መራዥ	marrāž
መራገጫ	marrāgaċā
መራጭነት	marāċennat
መር	marr
መርከበኛ	marekabaññā
መርዘኛ	marezaññā
መሰለ	massala
መሰብሰቢያ	massabesabiyā
መሰነ	massana
መሰናዘሪያ	massanāzariyā
መሰናዶ	massanādo
መሰከረ	masakkarra
መሰከነ	masakkana
መሰኪያ	masakkiyā
መሰደጃ	massadaǧā
መሰገ	massaga
መሰጠ	massaṭa
መሳ	massā
መሳለሚያ	massālamiyā
መሳለቂያ	massālaqiyā
መሳጭ	massāċ
መሳፍቻ	massāfeccā
መስቀልኛ	maseqaleññā
መስቀልያ	maseqaleyyā
መስተአምር	masetaammer
መስካሪነት	masekārinnat
መስኮብኛ	masekobeññā
መስፈሪያ	massefariyā
መሸ	mašša
መሸለቻ	mašallacā
መሸሸጊያ	maššašagiyā
መሸቀጫ	mašaqqaċā
መሸበቢያ	mašabbabiyā
መሸተ	maššata
መሸተኛ	mašataññā
መሸኛ	mašaññā
መሸገ	maššaga
መሸጋሸጊያ	maššagāšagiyā
መሸፈቻ	mašaffacā
መሸፈኛ	mašaffañā
መሻገሪያ	maššāgariyā
መቀለጃ	maqallaǧā
መቀመጫ	maqqamaċā
መቀቀያ	maqaqqayā
መቀነት	maqannat
መቀነቻ	maqannacā
መቀየሻ	maqayyašā
መቀጣጫ	maqqaṭāċā
መቀጫ	maqqaċā
መቀጮ	maqqaċo
መቃጠሪያ	maqqāṭariyā
መቆያ	maqoyyā
መቆጣጠሪያ	maqqoṭāṭariyā
መቆፈሪያ	maqoffariyā
መቋቋሚያ	maqqwāqwāmiyā
መቍጠሪያ	maqqweṭariyā
መበለት	maballat
መበላት	mabbalāt
መበየጃ	mabayyaǧā
መበያ	mabbayā
መበደሪያ	mabbadariyā
መተላለፊያ	mattalālafiyā
መተማመኛ	mattamāmañā
መተረ	mattara
መተረቻ	matarracā
መተረክያ	matarrakeyā
መተተኛ	matataññā
መተኛ	mataññā
መተከዣ	matakkažā
መተከያ	mattakayā
መተዳደሪያ	mattadādariyā
መታ	mmatā
መታመኛ	mattāmañā
መታሠሪያ	mattāśariyā
መታረቂያ	mattāraqiyā
መታሰቢያ	mattāsabiyā
መታሻ	mattāšā
መታተረ	matāttara
መታታ	matāttā
መታወቂያ	mattāwaqiyā
መታጠቂያ	mattāṭaqiyā
መታጠቢያ	mattāṭabiyā
መታጠፊያ	mattāṭafiyā
መታጫ	mattāċā
መትረየስ	materayyas
መቶኛ	matoññā
መቼም	maccém
መቼውንም	maccéwenem
መነመነ	manammana
መነሣት	mannaśāt
መነሻ	mannašā
መነሾ	mannašo
መነቀረ	manaqqara
መነቃቀረ	manaqāqqara
መነተፈ	manattafa
መነቸከ	manaccaka
መነነ	mannana
መነኰሰ	manakkwasa
መነዘረ	manazzara
መነዛዘረ	manazāzzara
መነገገ	managgaga
መነጥር	manaṭṭer
መነጽር	manaṣṣer
መና	mannā
መናኛ	manāññā
መናኝ	mannāñ
መናገሻ	mannāgašā
መናፈሻ	mannāfašā
መንማና	manemānnā
መንቃራ	maneqārrā
መንቻካ	manecākkā
መንደረኛ	manedaraññā
መንደርተኛ	manedaretaññā
መንገደኛ	manegadaññā
መንጠቆ	maneṭaqqo
መንጫራ	maneċārrā
መንጫቃ	maneċċāqqā
መንፈሳዊነት	manefasāwinnat
መኖ	manno
መኝታ	maññetā
መከለሻ	makallašā
መከላከያ	makkalākayā
መከማቻ	makkamācā
መከረ	makkara
መከረኛ	makarrañā
መከተ	makkata
መከነ	makkana
መከናነቢያ	makkanānabiyā
መከዳ	makkaddā
መከፈኛ	makaffañā
መካች	makkāc
መካን	makkān
መካንነት	makkānennat
መካከለኛ	makākkalaññā
መካከል	makākkal
መካከረ	makākkara
መኰንን	makwannen
መወሰኛ	mawassaññā
መዋጮ	mawwāċo
መዐተኛ	maʻataññā
መዘመዘ	mazammaza
መዘምራን	mazammerān
መዘምር	mazammer
መዘበረ	mazabbara
መዘባበቻ	mazzabābacā
መዘነ	mazzana
መዘክር	mazakker
መዘውር	mazawwer
መዘዘኛ	mazazaññā
መዘገበ	mazaggaba
መዛኝ	mazzāññ
መደለዣ	madallažā
መደለያ	maddalayā
መደመደ	madammada
መደረቢያ	madarrabiyā
መደቆሻ	madaqqošā
መደበ	maddaba
መደበኛ	madabaññā
መደብ	maddab
መደብር	madabber
መደደ	madadda
መደገፊያ	maddagafiyā
መድሃኒተኛ	madehānitaññā
መድጎሚያ	madeggomiyā
መድፈኛ	madefaññā
መጀመሪያ	maǧammariyā
መገለ	maggala
መገመገ	magammaga
መገበ	maggaba
መገነዣ	magannažā
መገጣጠሚያ	maggaṭāṭamiyā
መጋረጃ	maggāraǧā
መጋቢ	maggābi
መጋቢት	maggābit
መጋዞ	maggāzo
መጋዣ	magāžžā
መጎናጠፊያ	maggonāṭafiyā
መጎናጸፊ	maggonāṣafi
መጓጓዣ	maggwāgwāžā
መጠመጠ	maṭammaṭa
መጠነኛ	maṭanaññā
መጠወተ	maṭawwata
መጠይቅ	maṭayyeq
መጥቼ	maṭeccé
መጨመጨ	maċammaċa
መጫኛ	maċāññā
መጸወተ	maṣawwata
መፈተኛ	mafattañā
መፈናፈኛ	maffanāfañā
መፈክር	mafakker
ሙሀቻ	muhaccā
ሙላጭ	mullāċ
ሙልል	mulell
ሙረዳ	murradā
ሙሽሪት	mušerrit
ሙሽራ	muššerā
ሙትቻ	muteccā
ሙከራ	mukkarā
ሙክት	mukket
ሙክክ	mukekk
ሙዋለጠ	muwāllaṭa
ሙዋሙዋ	muwāmmuwā
ሙዋርተኛ	muwāretaññā
ሙዋሸሸ	muwāššaša
ሙዋጠጠ	muwāṭṭaṭa
ሙዚቀኛ	muziqaññā
ሙዝዝ	muzezz
ሙያሌ	muyyālé
ሙያተኛ	muyātaññā
ሙዳ	muddā
ሙጃ	muǧǧā
ሙጃማ	muǧǧāmmā
ሙጅር	muǧǧer
ሙግት	mugget
ሙግግ	mugegg
ሙጥኝ	muṭṭeññ
ሚሊዮን	milliyon
ሚዳቋ	midāqqwā
ማለለ	māllala
ማለቢያ	mālabbiyā
ማለደ	māllada
ማለገ	māllaga
ማላ	māllā
ማላጋነት	mālāgānnat
ማሕሌተኛ	māḥelétaññā
ማመላለሻ	māmmalālašā
ማመሻ	māmmašā
ማሚቴ	māmmité
ማሚቶ	māmmito
ማማሰያ	māmmāsayā
ማምረቻና	māmeracānnā
ማሞ	māmmo
ማሞኛ	māmoññā
ማሟያ	māmmwāyā
ማረረ	mārrara
ማረከ	mārraka
ማረገኛ	māragaññā
ማራቢያ	mārrābiyā
ማራገቢያ	mārrāgabiyā
ማሰሻ	māssašā
ማሰፊያ	māssafiyā
ማሳመኛ	māsāmmañā
ማሳተሚያ	māsāttamiyā
ማስረጃ	māseraǧǧā
ማስቀመጫ	māseqammaċā
ማስወረድ	māsewarrad
ማስጠሎ	māseṭallo
ማሸጊያ	māššagiyā
ማሻሻያ	māššāšāyā
ማሽላ	māšellā
ማሾለቂያ	māšollaqiyā
ማቀቀ	māqqaqa
ማቋረጫ	māqqwāraċā
ማተሚያ	māttamiyā
ማኅበረተኛ	māẖebarataññā
ማኅበርተኛ	māẖebaretaññā
ማኅበርተኝነት	māẖebaretaññennat
ማነቃቂያ	mānnaqāqiyā
ማናበቢያ	mānnābabiyā
ማን	mānn
ማንም	mānemm
ማንኛውም	mānneññāwem
ማእድ	māʼedd
ማከፋፈያ	mākkafāfayā
ማካፈል	mākkāfal
ማክሰኞ	mākesañño
ማዋሐጃ	māwwāḥaǧā
ማዕረገኛ	māʻeragaññā
ማዕድ	māʻedd
ማዕድን	māʻedden
ማይክሮስኮፕ	māyekerosekopp
ማደያ	māddayā
ማዳመጫ	māddāmaċā
ማድጋ	mādeggā
ማገረ	māggara
ማገደ	māggada
ማገጃ	māggaǧā
ማገጠ	māggaṭa
ማጋጣነት	māgāṭānnat
ማጋጭነት	māgāċennat
ማግሰኞ	māgesañño
ማፈኛ	māffañā
ሜዳማ	médāmmā
ምላሰኛ	melāsaññā
ምላሰኝነት	melāsaññennat
ምላሽ	mellāš
ምልስ	melles
ምልክት	melekket
ምረቃ	merraqā
ምረት	merrat
ምሩቅ	merruq
ምሪት	merrit
ምራጭ	merrāċ
ምሬት	merrét
ምር	merr
ምርምር	meremmer
ምርር	mererr
ምርቃት	merreqāt
ምርኮኛ	merekoññā
ምርጊት	meregitt
ምሰሶ	mesasso
ምሳሌ	messālé
ምሳር	messār
ምስ	mess
ምስሪት	messerit
ምስራች	meserācc
ምስኪንነት	mesekinennat
ምስክር	mesekker
ምስግ	messeg
ምስጢረኛ	meseṭiraññā
ምስፍና	mesefennā
ምሽት	meššet
ምሽግ	meššeg
ምቀኛ	meqqaññā
ምቀኝነት	meqqaññennat
ምትክ	metekk
ምቹ	meccu
ምቹነት	meccunnat
ምች	mecc
ምቾት	meccot
ምነና	mennanā
ምናኔ	mennāné
ምንም	menemm
ምንኛ	meneññā
ምንኩስና	menekusennā
ምንደኛ	menedaññā
ምንጅላት	meneǧellāt
ምንጠራ	meneṭṭarā
ምኞት	meññot
ምክትል	mekettel
ምደባ	meddabā
ምድጃ	medeǧǧā
ምጥዋተኛ	meṭewātaññā
ሞለለ	mollala
ሞለሞለ	molammola
ሞለጨ	mollaċa
ሞለፈጠ	molaffaṭa
ሞላ	mollā
ሞላላ	molāllā
ሞላላነት	molāllānnat
ሞላጫ	mollāċċā
ሞልሟላ	molemmwāllā
ሞልቃቃ	moleqāqqā
ሞረሞረ	morammora
ሞረደ	morrada
ሞረድ	morrad
ሞሸለቀ	mošallaqa
ሞሸረ	moššara
ሞሽላቃ	mošelāqqā
ሞቀሞቀ	moqammoqa
ሞቀኝ	moqaññ
ሞቃት	moqqāt
ሞቅሟቃ	moqemwāqqā
ሞነተፈ	monattafa
ሞከረ	mokkara
ሞከተ	mokkata
ሞከከ	mokkaka
ሞካሪ	mokkāri
ሞካች	mokkāc
ሞዘዘ	mozzaza
ሞዛዛነት	mozāzānnat
ሞያተኛ	moyātaññā
ሞጀረ	moǧǧara
ሞገተ	moggata
ሞገደኛ	mogaddaññā
ሞገገ	moggaga
ሞጋች	moggāc
ሞጨለፈ	moċallafa
ሞጨሞጨ	moċammoċa
ሟለጠ	mwāllaṭa
ሟሟ	mwāmmwā
ሟሸሸ	mwāššaša
ሟከከ	mwākkaka
ሟጠጠ	mwāṭṭaṭa
ሠለሰ	śallasa
ሠለጠ	śallaṭa
ሠላጤ	śallāṭé
ሠመረ	śammara
ሠረሠረ	śaraśśara
ሠረገ	śarraga
ሠራ	śarrā
ሠራተኛ	śarrātaññā
ሠራው	śarrāw
ሠራጊ	śarrāgi
ሠቀሠቀ	śaqaśśaqa
ሠቀቀ	śaqqaqa
ሠናይ	śannāy
ሠወረ	śawwara
ሠወርዋራ	śawarewārrā
ሠዊ	śawwi
ሠዋ	śawwā
ሠዋራ	śawwārrā
ሠዓሊነት	śaʻālinnat
ሠየመ	śayyama
ሠያሚ	śayyāmi
ሠገረ	śaggara
ሠጋ	śaggā
ሠጋር	śaggār
ሣሣ	śāśśā
ሣርማ	śāremmā
ሥሉስ	śellus
ሥሉጥ	śelluṭ
ሥላሴ	śellāsé
ሥልጣኔ	śelleṭṭāné
ሥሡ	śeśśu
ሥሥት	śeśśet
ሥሥነት	śeśennat
ሥርቻ	śereccā
ሥቅቅ	śeqeqq
ሥያሜ	śeyyāmé
ሦስተኛ	śosetaññā
ረመጠ	rammaṭa
ረሰረሰ	rasarrasa
ረሳ	rassā
ረቀቀ	raqqaqa
ረቂቅነት	raqiqennat
ረበረበ	rabarraba
ረበሸ	rabbaša
ረበበ	rabbaba
ረባ	rabbā
ረባዳ	rabbāddā
ረብሸኛ	rabešaññā
ረታ	rattā
ረኅብተኛ	raẖebetaññā
ረከሰ	rakkasa
ረካ	rakkā
ረኸጥነት	raxaṭennat
ረዘመ	razzama
ረዘረዘ	razarraza
ረዘቀ	razzaqa
ረዥም	ražžem
ረዳ	raddā
ረዳት	raddāt
ረጅም	raǧǧem
ረገመ	raggama
ረገበ	raggaba
ረገብ	ragabb
ረገጠ	raggaṭa
ረገፈ	raggafa
ረጋ	raggā
ረጋገጠ	ragāggaṭa
ረፈረፈ	rafarrafa
ረፈደ	raffada
ረፋድ	raffād
ሩሩ	rurru
ሩስኛ	ruseññā
ራራ	rārrā
ራብተኛ	rābetaññā
ርሚጦ	remmiṭo
ርቀት	reqqat
ርችት	reccet
ርካሽ	rekkāš
ርክክብ	rekekkeb
ርዝራዥ	rezerrāž
ርጋጭ	reggāċ
ርጋፊ	reggāfi
ሮሮ	rorro
ሰለለ	sallala
ሰለመ	sallama
ሰለሰለ	salassala
ሰለቀ	sallaqa
ሰለቀጠ	salaqqaṭa
ሰለበ	sallaba
ሰለተ	sallata
ሰለቸ	salacca
ሰላ	sallā
ሰላላ	sallālā
ሰላማዊነት	salāmāwinnat
ሰላች	sallāc
ሰላይ	sallāy
ሰልካካ	salekākkā
ሰልፈኛ	salefaññā
ሰመመ	sammama
ሰመጠ	sammaṭa
ሰማ	sammā
ሰማዕትነት	samāʻetennat
ሰምና	samennā
ሰሞንኛ	samoneññā
ሰረረ	sarrara
ሰረሰረ	sarassara
ሰረቀ	sarraqa
ሰረዘ	sarraza
ሰረገላ	saragallā
ሰረጎደ	saraggoda
ሰራረዘ	sarārraza
ሰሰነ	sassana
ሰቀለ	saqqala
ሰቀቀ	saqqaqa
ሰቀቀኝ	saqqaqaññ
ሰቀዘ	saqqaza
ሰቅ	saqq
ሰበረ	sabbara
ሰበሰበ	sabassaba
ሰበቀ	sabbaqa
ሰበበኛ	sababaññā
ሰበከ	sabbaka
ሰባ	sabbā
ሰባሰበ	sabāssaba
ሰባበረ	sabābbara
ሰባተኛ	sabāttaññā
ሰባት	sabātt
ሰባኛ	sabāññā
ሰብሳባ	sabesābbā
ሰተረ	sattara
ሰተት	satatt
ሰታራ	sattārā
ሰነቀ	sannaqa
ሰነቀረ	sanaqqara
ሰነበተ	sanabbata
ሰነበጠ	sanabbaṭa
ሰነኘ	sanañña
ሰነከለ	sanakkala
ሰነዘረ	sanazzara
ሰነገ	sannaga
ሰነፈ	sannafa
ሰነፈጠ	sanaffaṭa
ሰኔና	sanénnā
ሰንከሎ	sanekallo
ሰንካላ	sanekāllā
ሰኞ	sañño
ሰከረ	sakkara
ሰከሰከ	sakassaka
ሰከነ	sakkana
ሰካ	sakkā
ሰካራም	sakkārām
ሰውነቱ	sawennatu
ሰውነቱን	sawennatun
ሰውነት	sawennat
ሰውየው	saweyyaw
ሰውየውን	saweyyawen
ሰውዬ	saweyyé
ሰየመ	sayyama
ሰየፈ	sayyafa
ሰያፊ	sayyāfi
ሰያፍ	sayyāf
ሰይፈኛ	sayefaññā
ሰደበ	saddaba
ሰደደ	saddada
ሰገሰገ	sagassaga
ሰገነት	sagannat
ሰገደ	saggada
ሰገገ	saggaga
ሰጉዳት	sagguddāt
ሰጐደ	saggwada
ሰጓዳ	sagwāddā
ሰጠ	saṭṭa
ሰጠመ	saṭṭama
ሰፈረ	saffara
ሰፈረተኛ	safarataññā
ሰፈርተኛ	safaretaññā
ሰፈነ	saffana
ሰፈፈ	saffafa
ሰፊ	ssafi
ሰፊው	saffiw
ሰፋ	saffā
ሰፍሳፋ	safesāffā
ሱረት	surrat
ሱሪ	surri
ሱሰኛ	susaññā
ሱካር	sukkār
ሱፋጭ	suffāċ
ሲል	sill
ሲቀድ	siqadd
ሳሌ	sāllé
ሳሎን	sāllon
ሳማ	sāmmā
ሳምንታዊ	sāmmenetāwi
ሳምንት	sāmmenet
ሳቂታ	sāqqittā
ሳቅ	sāqq
ሳቢያ	sābbiyā
ሳንባማ	sānebāmmā
ሳይንሰኛ	sāyenesaññā
ሳዱላ	sādullā
ሴረኛ	séraññā
ሴሰነ	séssana
ሴሰኛ	sésaññā
ሴሰኛነት	sésaññānnat
ሴሰኝነት	sésaññennat
ሴተኛ	sétaññā
ሴትነት	sétennat
ስለላ	sellalā
ስለሱ	selassu
ስለዚህ	selazzih
ስለዚያ	selazziyā
ስሌት	sellét
ስልም	sellem
ስልምልም	selemelemm
ስልሳኛ	selesāññā
ስልቅ	selleq
ስልቻ	selleccā
ስልከኛ	selekaññā
ስመኛ	semaññā
ስሜት	semmét
ስምም	sememm
ስምምነት	sememennat
ስምንተኛ	semenetaññā
ስምንት	semmenet
ስሞተኛ	semotaññā
ስረዛ	serrazā
ስሪያ	serriyā
ስርቅ	serreq
ስርቅታ	serreqetā
ስርዝ	serrez
ስቅላት	seqqelāt
ስቅቅ	seqqeq
ስባሪ	sebbāri
ስብራት	sebberāt
ስብስብ	sebesebb
ስተተኛ	setataññā
ስትር	setter
ስንባጭ	senebbāċ
ስንተኛ	senetaññā
ስንኝ	seneññ
ስንግ	senneg
ስንጣሪ	senneṭṭāri
ስንፍና	senefennā
ስኳር	sekkwār
ስውር	sewwer
ስያሜ	seyyāmé
ስደተኛ	seddataññā
ስደት	seddat
ስድ	sedd
ስድሳኛ	sedesāññā
ስድስተኛ	seddesetaññā
ስድስት	seddeset
ስጋጃ	segāǧǧā
ስግስግ	segesegg
ስፋፊ	seffāfi
ስፍስፍ	sefeseff
ስፖርተኛ	seporetaññā
ሶመሶመ	somassomma
ሶምሶማ	somessomā
ሸለለ	šallala
ሸለመ	šallama
ሸለሸለ	šalaššala
ሸለቀቀ	šalaqqaqa
ሸለብ	šallabb
ሸለተ	šallata
ሸለገ	šallaga
ሸላለመ	šalāllama
ሸላሚ	šallāmi
ሸላች	šallāc
ሸላይ	šallāy
ሸመቀ	šammaqa
ሸመቀቀ	šamaqqaqa
ሸመተ	šammata
ሸመታ	šammatā
ሸመደደ	šamaddada
ሸመድማዳ	šamademāddā
ሸመገለ	šamaggala
ሸማቂ	šammāqi
ሸማች	šammāc
ሸማኔ	šammāné
ሸሜኔ	šamméné
ሸምቀቆ	šameqaqqo
ሸምቃቃ	šameqāqqā
ሸምበቆ	šamebaqqo
ሸረሞጠ	šarammoṭa
ሸረሸረ	šaraššara
ሸረኛ	šarrañā
ሸረኝነት	šaraññennat
ሸረከተ	šarakkata
ሸረካከተ	šarakākkata
ሸረደደ	šaraddada
ሸረፈ	šarrafa
ሸራረፈ	šarārrafa
ሸር	šarr
ሸሻጊ	šaššāgi
ሸቀለ	šaqqala
ሸቀሸቀ	šaqaššaqa
ሸቀበ	šaqqaba
ሸቀጠ	šaqqaṭa
ሸቃቢ	šaqqābi
ሸቃይ	šaqqāy
ሸቃጭ	šaqqāċ
ሸበለለ	šaballala
ሸበሸበ	šabaššaba
ሸበበ	šabbaba
ሸበተ	šabbata
ሸበቶ	šabbato
ሸብ	šabb
ሸብራቃ	šaberāqqā
ሸተተ	šattata
ሸተተው	šattataw
ሸተት	šatatt
ሸተትያ	šatateyyā
ሸነሸነ	šanaššana
ሸነቀረ	šannaqqara
ሸነቀጠ	šanaqqaṭa
ሸነቆረ	šanaqqora
ሸነቆጠ	šanaqqoṭa
ሸነተረ	šanattara
ሸነታተረ	šanatāttara
ሸነከፈ	šanakkafa
ሸነደረ	šanaddara
ሸነገለ	šanaggala
ሸነጠ	šannaṭa
ሸና	šannā
ሸንበቆ	šanebaqqo
ሸንተረርማ	šanetararemmā
ሸንከሎ	šanekallo
ሸንካፋ	šanekkāfā
ሸንዳራ	šanedārrā
ሸኘ	šañña
ሸኚ	šaññi
ሸከሸከ	šakaššaka
ሸከፈ	šakkafa
ሸካፋ	šakkāfā
ሸኮተ	šakkota
ሸውራራ	šawerrārā
ሸውሻዋ	šawešāwwā
ሸየኛ	šayaññā
ሸጐረ	šaggwara
ሸጐጠ	šaggwaṭa
ሸጠኝ	šaṭaññ
ሸፈተ	šaffata
ሸፈነ	šaffana
ሸፈጠ	šaffaṭa
ሸፈፈ	šaffafa
ሸፋጭ	šaffāċ
ሸፋፈነ	šafāffana
ሸፍጠኛ	šafeṭaññā
ሹሩባ	šurrubbā
ሹራብ	šurrāb
ሹርቤ	šurebbé
ሹካ	šukkā
ሹክ	šukk
ሹክክ	šukekk
ሺህኛ	šiheññā
ሻምበል	šāmeball
ሻቀለ	šāqqala
ሻንቅላ	šāneqellā
ሻኛ	šāññā
ሻከረ	šākkara
ሻከር	šākarr
ሻገተ	šāggata
ሻግያ	šāgeyyā
ሻፈደ	šāffada
ሽለላ	šellalā
ሽልማት	šellemāt
ሽልም	šellem
ሽልት	šellet
ሽልግ	šelleg
ሽልጦ	šelleṭo
ሽመቃ	šemmaqā
ሽሚያ	šemmiyā
ሽማግሌ	šemāgellé
ሽምብራ	šemeberrā
ሽምግልና	šemegellenā
ሽር	šerr
ሽርሙጥና	šeremuṭennā
ሽርሽር	šerrešerr
ሽርክና	šerekennā
ሽርጥ	šerreṭ
ሽርፋት	šerrefāt
ሽሽት	šeššet
ሽሽግ	šeššeg
ሽቀላ	šeqqalā
ሽቀባ	šeqqabā
ሽቅብ	šeqqeb
ሽብልቅ	šebelleq
ሽብር	šebber
ሽቱ	šettu
ሽታ	šettā
ሽታው	šettāw
ሽቶ	šetto
ሽንፍላ	šenefellā
ሽክ	šekk
ሽክና	šekkenā
ሽክፍ	šekkef
ሽኮኮ	šekokko
ሽው	šeww
ሽውታ	šewwetā
ሽያጭ	šeyyāċ
ሽጉር	šeggur
ሽጉጥ	šegguṭṭ
ሽፋች	šeffāc
ሽፍ	šeff
ሽፍታ	šeffetā
ሽፍትነት	šefetennat
ሽፍን	šeffen
ሾለከ	šollakka
ሾላካ	šollākā
ሾከከ	šokkaka
ሾጥ	šoṭṭ
ቀለለ	qallala
ቀለል	qalall
ቀለመ	qallama
ቀለሰ	qallasa
ቀለበ	qallaba
ቀለበሰ	qalabbasa
ቀለብ	qallab
ቀለብላባ	qalabellābā
ቀለብተኛ	qallabetaññā
ቀለደ	qallada
ቀለጠ	qallaṭa
ቀላ	qallā
ቀላለሰ	qalāllasa
ቀላለደ	qalāllada
ቀላል	qallāl
ቀላመደ	qalāmmada
ቀላማጅነት	qalāmāǧǧennat
ቀላቢ	qallābi
ቀላወጠ	qalāwwaṭa
ቀላጅ	qallāǧ
ቀልማዳ	qalemāddā
ቀልቃላ	qaleqāllā
ቀልደኛ	qaledaññā
ቀልጠፍ	qaleṭaff
ቀልጣፋ	qaleṭāffā
ቀመለ	qammala
ቀመመ	qammama
ቀመሰ	qammasa
ቀመስ	qammas
ቀመቀመ	qamaqqama
ቀማ	qammā
ቀማመሰ	qamāmmasa
ቀማሚ	qammāmi
ቀማኛ	qammāññā
ቀሠረ	qaśśara
ቀሠፈ	qaśśafa
ቀረ	qarra
ቀረረ	qarrara
ቀረሽ	qarraš
ቀረቀረ	qaraqqara
ቀረቀበ	qaraqqaba
ቀረበ	qarraba
ቀረና	qarannā
ቀረደደ	qaraddada
ቀረጠ	qarraṭa
ቀረጸ	qarraṣa
ቀረፈ	qarrafa
ቀራረመ	qarārrama
ቀራረፈ	qarārrafa
ቀር	qarr
ቀርፋፋ	qarefāffā
ቀሰመ	qassama
ቀሰረ	qassara
ቀሰሰ	qassasa
ቀሰስተኛ	qasasetaññā
ቀሰስተኛነት	qasasetaññānnat
ቀሰቀሰ	qasaqqasa
ቀሰተ	qassata
ቀሳሰመ	qasāssama
ቀሳፈተ	qasāffata
ቀስ	qass
ቀስተኛ	qasetaññā
ቀስታ	qassetā
ቀቀለ	qaqqala
ቀቃይ	qaqqāy
ቀበሌኛ	qabaléññā
ቀበቀበ	qabaqqaba
ቀበተተ	qabattata
ቀበቶ	qabatto
ቀበኛ	qabaññā
ቀበዝባዛ	qabazebāzzā
ቀበጠ	qabbaṭa
ቀባ	qabbā
ቀባባ	qabābbā
ቀባጀረ	qabāǧǧara
ቀብራራ	qaberārrā
ቀብቃባ	qabeqābbā
ቀተረ	qattara
ቀነሰ	qannasa
ቀነቀነ	qanaqqana
ቀነበረ	qanabbara
ቀነተ	qannata
ቀነዘረ	qanazzara
ቀነደበ	qanaddaba
ቀነፈ	qannafa
ቀና	qannā
ቀናተኛ	qannātaññā
ቀናነሰ	qanānnasa
ቀን	qann
ቀንደኛ	qanedaññā
ቀኖና	qannonā
ቀኛዝማች	qaññāzemāc
ቀኝ	qaññ
ቀውላላ	qawelāllā
ቀዘቀዘ	qazaqqaza
ቀዘቀዘው	qazaqqazaw
ቀዘነ	qazzana
ቀዘዘ	qazzaza
ቀዘፈ	qazzafa
ቀዝቃዛ	qazeqāzzā
ቀዥቃዣ	qažeqāžžā
ቀየሠ	qayyaśa
ቀየረ	qayyara
ቀየደ	qayyada
ቀየጠ	qayyaṭa
ቀያሽ	qayyāš
ቀያቴ	qayyāté
ቀያየረ	qayāyyara
ቀያየጠ	qayāyyaṭa
ቀይ	qayy
ቀደመ	qaddama
ቀደምትነት	qaddametennat
ቀደሰ	qaddasa
ቀደደ	qaddada
ቀዳሚነት	qadāminnat
ቀዳሽ	qaddāš
ቀዶ	qaddo
ቀጠቀጠ	qaṭaqqaṭa
ቀጣፊነት	qaṭāfinnat
ቀጨቀጨ	qaċaqqaċa
ቀፈረረ	qafarrara
ቀፈቀፈ	qafaqqafa
ቀፈደደ	qafaddada
ቀፈፈ	qaffafa
ቀፍራራ	qaferrārā
ቁለላ	qullalā
ቁሌት	qullét
ቁልም	qulemm
ቁልፍ	qulleff
ቁማርተኛ	qumāretaññā
ቁማጭ	qummāċ
ቁምጥ	qummeṭṭ
ቁምጥና	qumeṭennā
ቁራሽ	qurrāš
ቁራኛ	qurāññā
ቁራጭ	qurrāċ
ቁር	qurr
ቁርጥምጥም	qureṭemeṭemm
ቁስለኛ	quselaññā
ቁቅ	quqq
ቁና	qunnā
ቁንን	qunnen
ቁንጅና	quneǧennā
ቁጥር	quṭṭer
ቁፈራ	quffarā
ቁፋሪ	quffāri
ቁፋሮ	quffāro
ቁፍር	quffer
ቂመኛ	qimaññā
ቂጥኝ	qiṭeññ
ቃልቻ	qālleccā
ቃረመ	qārrama
ቃሬ	qārré
ቃበዘ	qābbaza
ቃተተ	qāttata
ቃኘ	qāñña
ቃዠ	qāžža
ቄንጠኛ	qéneṭaññā
ቅሌተኛ	qellétaññā
ቅሌታም	qellétām
ቅሌት	qellét
ቅልሽስሽ	qelešesešš
ቅልቅል	qeleqqel
ቅልብ	qelleb
ቅልጥ	qelleṭṭ
ቅልጥፍና	qeleṭefennā
ቅልጥፍጥፍ	qeleṭeffeṭef
ቅመማ	qemmamā
ቅሚያ	qemmiyā
ቅምምጦሽ	qememmeṭoš
ቅምብቻ	qemebeccā
ቅምጥ	qemmeṭ
ቅሥር	qeśśer
ቅሪላ	qerillā
ቅሪት	qerrit
ቅራሪ	qerrāri
ቅራፊ	qerrāfi
ቅሬታ	qerrétā
ቅር	qerr
ቅርጥፍ	qereṭeff
ቅርፊት	qerefitt
ቅርፍፍ	qerefeff
ቅስት	qesset
ቅስና	qessennā
ቅቅል	qeqqel
ቅበላ	qebbalā
ቅባቅዱስ	qebāqeddus
ቅብብል	qebebbel
ቅብብሎሽ	qebebbeloš
ቅነሳ	qennasā
ቅናሽ	qennāš
ቅንብር	qenebber
ቅንነት	qenennat
ቅንዝረኛ	qenezeraññā
ቅንዲላ	qenedillā
ቅንፍ	qennef
ቅኝ	qeññ
ቅኝት	qeññet
ቅዝቃዜ	qezeqqāzé
ቅዝዝ	qezzez
ቅዥቅዥ	qežeqežž
ቅየሣ	qeyyaśā
ቅያሜ	qeyyāmé
ቅያሪ	qeyyāri
ቅይድ	qeyyed
ቅይጥ	qeyyeṭ
ቅዱሳን	qeddusān
ቅዱስ	qeddus
ቅዱስነት	qeddusennat
ቅዳሴ	qeddāsé
ቅዳጅ	qeddāǧ
ቅድ	qedd
ቅድም	qeddem
ቅድሳት	qeddesāt
ቅድስተ	qeddeseta
ቅድስት	qeddeset
ቅድስና	qeddesenā
ቅጅ	qeǧǧ
ቅጠልያ	qeṭaleyyā
ቅጥረኛ	qeṭeraññā
ቅጥቃጤ	qeṭeqqāṭé
ቅፍር	qeferr
ቅፍርር	qefererr
ቆለለ	qollala
ቆለመመ	qolammama
ቆለኛ	qollaññā
ቆላ	qollā
ቆሌ	qollé
ቆልማማ	qolemāmmā
ቆልቋላ	qoleqwāllā
ቆመጠ	qommaṭa
ቆም	qomm
ቆራረሰ	qorārrasa
ቆራጥ	qorrāṭ
ቆርቆሮ	qoreqorro
ቆርጦኝ	qoreṭoññ
ቆሸሸ	qoššaša
ቆሽማዳ	qošemāddā
ቆነጀ	qonaǧǧa
ቆነጣጠረ	qonaṭṭāṭṭara
ቆየ	qoyya
ቆይታ	qoyyetā
ቆጠቆጠ	qoṭaqqoṭa
ቆጶስ	qop̣p̣os
ቆፈረ	qoffara
ቆፈነነ	qofannana
ቆፋሪ	qoffāri
ቆፋፈረ	qofāffara
ቈለመመ	qwalammama
ቈለቈለ	qwalaqqwala
ቈለፈ	qwallafa
ቈላለፈ	qwalāllafa
ቈላፋ	qwallāffā
ቈላፍ	qwallāf
ቈረመደ	qwarammada
ቈረሰ	qwarrasa
ቈረቈረ	qwaraqqwara
ቈረቈሰ	qwaraqqwasa
ቈረበ	qwarraba
ቈረጠ	qwarraṭa
ቈረፈደ	qwaraffada
ቈራ	qwarrā
ቈራረጠ	qwarārraṭa
ቈራጥ	qwarrāṭ
ቈርማዳ	qwaremāddā
ቈርቈዘ	qwareqqwaza
ቈርቋዛ	qwareqqwāzā
ቈርፋዳ	qwarefāddā
ቈሰለ	qwassala
ቈሰቈሰ	qwasaqqwasa
ቈነሰ	qwannasa
ቈነነ	qwannana
ቈነደደ	qwanaddada
ቈነጐለ	qwanaggwala
ቈንቋና	qwaneqwānnā
ቋመጠ	qwāmmaṭa
ቋቅ	qwāqq
ቋቅታ	qwāqqettā
ቋቍቻ	qwāqqweccā
ቋያ	qwāyyā
ቋጥኝ	qwāṭṭeññ
ቍልጭ	qwelleċċ
ቍራጭ	qwerrāċ
ቍርጥ	qwerreṭ
ቍስለ	qwesella
በለቀጠ	balaqqaṭa
በለተ	ballata
በለኝ	balaññ
በለዘ	ballaza
በለገ	ballaga
በለጠ	ballaṭa
በሉጥ	balluṭ
በሊታ	ballitā
በላ	ballā
በሌለበት	baléllabat
በል	ball
በመጀመሪያው	bamaǧammariyāw
በሞላ	bamollā
በረሃማ	barahāmmā
በረረ	barrara
በረቀ	barraqa
በረቀሰ	baraqqasa
በረቃቀሰ	baraqāqqasa
በረበረ	barabbara
በረታ	barattā
በረኛ	barraññā
በረከተ	barakkata
በረኸኛ	baraxaññā
በረዘ	barraza
በረደ	barrada
በረደኝ	barradaññ
በረገደ	baraggada
በረገገ	baraggaga
በረጋገደ	baragāggada
በራ	barrā
በራረዘ	barārraza
በራዥ	barrāž
በራድ	barrād
በራፍ	barrāf
በር	barr
በርበሬ	barebarré
በርካታ	barekāttā
በርዳማ	baredāmmā
በርጩማ	bareċummā
በሰለ	bassala
በሰበሰ	basabbasa
በሰፊው	basaffiw
በሳ	bassā
በሳል	bassāl
በስባሳ	basebāssā
በሶ	basso
በሸቀ	baššaqa
በሸቀጠ	bašaqqaṭa
በሽተኛ	baššetaññā
በሽታ	baššetā
በቀለ	baqqala
በቀለኛ	baqalaññā
በቀል	baqqal
በቀስ	baqass
በቀስታ	baqassetā
በቀተ	baqqata
በቀደም	baqaddam
በቃ	baqqā
በቃኝ	baqqāñ
በቅበቃ	baqebaqqā
በቆሎ	baqqollo
በቈልት	baqqwalet
በቡጢ	babuṭṭi
በተለይ	batalayy
በተረፈ	batarrafa
በተነ	battana
በተጨማሪ	bataċammāri
በታተነ	batāttana
በትር	batter
በነነ	bannana
በአጋጣሚ	baagāṭṭāmi
በከለ	bakkala
በከተ	bakkata
በኩል	bakkul
በካይ	bakkāy
በወዘ	bawwaza
በዘበዘ	bazabbaza
በዚህ	bazzih
በዚህም	bazihemm
በዚያ	bazziyā
በዛ	bazzā
በየሰዓቱ	bayyasaʻātu
በየቀኑ	bayyaqanu
በየተራ	bayyatarā
በየነ	bayyana
በየወቅቱ	bayyawaqetu
በየዓመቱ	bayyaʻāmatu
በየደ	bayyada
በየጊዜው	bayyagizéw
በየግል	bayyagell
በየፊናው	bayyafināw
በያለበት	bayyāllabbat
በያኝ	bayyāññ
በያጅ	bayyāǧ
በደለ	baddala
በደለኛ	badalaññā
በደል	baddal
በደዊ	badawwi
በዱላ	badullā
በዳ	baddā
በዳይ	baddāy
በድጋሚ	badeggāmi
በጀ	baǧǧa
በጅምር	baǧemmer
በገነ	baggana
በገዛ	bagazzā
በግላጭ	bagellāċ
በግል	bagell
በግምት	bagemmet
በግድ	bagedd
በጐ	baggwa
በጐነት	baggwannat
በጠቅላላ	baṭaqelāllā
በጠቅላላው	baṭaqelāllāw
በጠበጠ	baṭabbaṭa
በጡጫ	baṭuċċā
በጥሞና	baṭemmonā
በጥያቄ	baṭeyyāqé
በጥፊ	baṭeffi
በጭራሽ	baċerrāš
በጭካኔ	baċekkāné
በጭፍን	baċeffen
ቡላ	bullā
ቡልቅ	bulleqq
ቡልቅታ	bulleqetā
ቡረቃ	burraqā
ቡራቡሬ	burrāburré
ቡራኬ	burrāké
ቡሬ	burré
ቡሬማ	burrémmā
ቡቃያ	buqāyyā
ቡቡ	bubbu
ቡትርፍ	butereff
ቡችላ	buccellā
ቡና	bunnā
ቡናማ	bunnāmmā
ቡናኝ	bunnāñ
ቡን	bunn
ቡንኝ	bunneññ
ቡዳነት	budānnat
ቡድስ	buddes
ቡድነት	budennat
ቡግ	bugg
ቡፍ	buff
ቢሆንም	bihonemm
ቢላዋ	billāwā
ቢላዎ	billāwo
ቢል	bill
ቢልቢላ	bilebillā
ቢራቢሮ	birrābirro
ቢዘገይም	bizagayyem
ባለሥልጣኖች	bālaśeleṭānocc
ባለሳምንት	bālasāmmenet
ባለስድስት	bālaseddeset
ባለብር	bālaberr
ባለእጅ	bālaʼeǧǧ
ባለጅ	bālaǧǧ
ባለገ	bāllaga
ባለጉዳይ	bālaguddāy
ባለጌነት	bālagénnat
ባለጠጋ	bālaṭaggā
ባለጥግ	bālaṭegg
ባለፀጋ	bālaṡaggā
ባላ	bāllā
ባላባት	bālābbāt
ባላባትነት	bālābbātennat
ባላንጣነት	bālāneṭānnat
ባልትና	bāletennā
ባልና	bālennā
ባልንጀርነት	bāleneǧarennat
ባልጩት	bāleċutt
ባረቀ	bārraqa
ባረከ	bārraka
ባርማሽላ	bāremāšellā
ባርነት	bārennat
ባሻ	bāššā
ባባ	bābbā
ባነነ	bānnana
ባንድነት	bānedennat
ባኞ	bāñño
ባከነ	bākkana
ባዘቀ	bāzzaqa
ባዘተ	bāzzata
ቤተኛ	bétaññā
ቤዛ	bézzā
ብላታ	belāttā
ብላቴና	belātténā
ብላቴን	belāttén
ብላጊ	bellāgi
ብልሃተኛ	belehātaññā
ብልሹ	beleššu
ብልት	bellet
ብልኮ	bellekko
ብልዝ	bellezz
ብልግ	bellegg
ብልግና	belegennā
ብልጥግና	beleṭeggennā
ብልጫ	belleċā
ብልጭ	belleċ
ብልጭታ	belleċetā
ብልፅግና	beleṡeggennā
ብሎት	bellot
ብሔረተኛ	beḥérataññā
ብሕትውና	beḥetewennā
ብረድስት	beraddeset
ብራ	berrā
ብራቢሮ	berābirro
ብራና	berānnā
ብራኳ	berākkwā
ብር	berr
ብርሌ	berellé
ብርቅስቅስ	bereqeseqqes
ብርኩማ	berekummā
ብርካቴ	berekkāté
ብርግድ	beregedd
ብርጭቆ	bereċeqqo
ብስባሽ	besebbāš
ብስጭትጭት	beseċeteċċet
ብቁነት	beqqunnat
ብቅ	beqq
ብቡ	bebbu
ብብት	bebbet
ብትቶ	betetto
ብትቷም	betettwām
ብትን	betten
ብቸኛ	beccaññā
ብቸኝነት	beccaññennat
ብቻ	beccā
ብናኝ	bennāññ
ብኩርና	bekurennā
ብኩንነት	bekunennat
ብካች	bekkāc
ብክል	bekkel
ብክት	bekket
ብው	beww
ብየዳ	beyyaddā
ብያኔ	beyyāné
ብዬ	beyyé
ብይ	beyy
ብይን	beyyen
ብይድ	beyyed
ብድር	bedder
ብድግ	bedegg
ብጥብጥ	beṭebbeṭ
ቦሎቄ	bolloqé
ቦረቀ	borraqa
ቦረቦረ	borabbora
ቦራቂ	borrāqi
ቦርቃቃ	boreqāqqā
ቦቃማ	boqāmmā
ቦተረፈ	botarrafa
ቦታ	bottā
ቦነነ	bonnana
ቦከቦከ	bokabboka
ቦካ	bokkā
ቦዘነ	bozzana
ቦዘንተኛ	bozanetaññā
ቦደሰ	boddasa
ቦግ	bogg
ቦግታ	boggetā
ቦጨቅ	boċċaq
ቦጫጨረ	boċċāċara
ቦጭ	boċċ
ቧገተ	bwāggata
ተለመ	tallama
ተለመለመ	talamallama
ተለመሰሰ	talamassasa
ተለመነ	talammana
ተለመዘገ	talamazzaga
ተለመደ	talammada
ተለመጠ	talammaṭa
ተለማመነ	talamāmmana
ተለማመደ	talamāmmada
ተለማመጠ	talamāmmaṭa
ተለማኝ	talammāñ
ተለማጅ	talammāǧ
ተለማጭ	talammāċ
ተለሰነ	talassana
ተለሳለሰ	talasāllasa
ተለቀ	tallaqa
ተለቀለቀ	talaqallaqa
ተለቀመ	talaqqama
ተለቀቀ	tallaqqaqa
ተለቃለቀ	talaqāllaqa
ተለበለበ	talaballaba
ተለበቀ	talabbaqa
ተለበበ	talabbaba
ተለበደ	talabbada
ተለበጠ	talabbaṭa
ተለባቂ	talabbāqi
ተለባበሰ	talabābbasa
ተለተለ	talattala
ተለተመ	talattama
ተለወጠ	talawwaṭa
ተለዋወጠ	talawāwwaṭa
ተለዋጭ	talawwāċ
ተለየ	talayya
ተለያየ	talayāyya
ተለጠለጠ	talaṭallaṭa
ተለፈፈ	talaffafa
ተለፋለፈ	talafāllafa
ተለፋላፊ	talafāllāfi
ተላ	tallā
ተላለቀ	talāllaqa
ተላለፈ	talāllafa
ተላላኪነት	talālākinnat
ተላላፊ	talāllāfi
ተላመደ	talāmmada
ተላመጠ	talāmmaṭa
ተላቀሰ	talāqqasa
ተላቀቀ	talāqqaqa
ተላከከ	talākkaka
ተላወሰ	talāwassa
ተላፋ	talāffā
ተልከስከሰ	talekasekkasa
ተልከፈከፈ	talekafakkafa
ተልካሳ	talekāssā
ተልፈሰፈሰ	talefasaffasa
ተመለሰ	tamallasa
ተመለከ	tamallaka
ተመለከተ	tamalakkata
ተመለጠ	tamallaṭa
ተመላለሰ	tamalāllasa
ተመላለጠ	tamalāllaṭa
ተመላሽ	tamallāš
ተመላኪ	tamallāki
ተመመ	tammama
ተመሠረተ	tamaśśarata
ተመሠጠ	tammaśśaṭa
ተመሥጦ	tamaśśeṭo
ተመረመረ	tamarammara
ተመረረ	tamarrara
ተመረቀ	tamarraqa
ተመረኰዘ	tamarakkwaza
ተመረዘ	tamarraza
ተመረገ	tamarraga
ተመረጠ	tamarraṭa
ተመራ	tamarrā
ተመራመረ	tamarāmmara
ተመራቂ	tamarrāqi
ተመራጭ	tamarrāċ
ተመራጭነት	tamarrāċennat
ተመሰለ	tamassala
ተመሰቃቀለ	tamasaqāqqala
ተመሰከረ	tamasakkara
ተመሰገነ	tamasaggana
ተመሰጠ	tamassaṭa
ተመሳቀለ	tamasāqqala
ተመሳከረ	tamasākkara
ተመተመ	tamattama
ተመተረ	tamattara
ተመታ	tamattā
ተመቸ	tamacca
ተመቻቸ	tamacācca
ተመነ	tammana
ተመነቃቀረ	tamanaqāqqara
ተመነተፈ	tamanattafa
ተመነዘረ	tamanazzara
ተመናቀረ	tamanāqqara
ተመኘ	tamañña
ተመከረ	tamakkara
ተመከተ	tamakkata
ተመካ	tamakkā
ተመካከረ	tamakākkara
ተመዘመዘ	tamazammaza
ተመዘበረ	tamazabbara
ተመዘነ	tamazzana
ተመዘዘ	tamazzaza
ተመዘገበ	tamazaggaba
ተመዛዘነ	tamazāzzana
ተመደበ	tamaddaba
ተመገበ	tamaggaba
ተመጋቢ	tamaggābbi
ተመጠወተ	tamaṭawwata
ተመጻደቀ	tamaṣāddaqa
ተማለደ	tamāllada
ተማመነ	tamāmmana
ተማማ	tamāmmā
ተማረረ	tamārrara
ተማረከ	tamārraka
ተማረዘ	tamārraza
ተማራ	tamārrā
ተማሰለ	tamāssala
ተማታ	tamāttā
ተማከረ	tamākkara
ተማዘዘ	tamāzzaza
ተማገረ	tamāggara
ተማገደ	tamāggada
ተምቦጫቦጨ	tameboċābboċa
ተምታታ	tametāttā
ተምነሸነሸ	tamenašannaša
ተምዘአዘገ	tamezaazzaga
ተምዘገዘገ	tamezagazzaga
ተሞለጨ	tamollaċa
ተሞላ	tamollā
ተሞላቀቀ	tamolāqqaqa
ተሞላፈጠ	tamolāffaṭa
ተሞረደ	tamorrada
ተሞሸለቀ	tamošallaqa
ተሞሸረ	tamoššara
ተሞከረ	tamokkara
ተሞከተ	tamokkata
ተሞካከረ	tamokākkara
ተሞክሮ	tamokkero
ተሞጀረ	tamoǧǧara
ተሞገሰ	tamoggasa
ተሞጋሽ	tamoggāš
ተሞጋገሰ	tamogāggasa
ተሞጨለፈ	tamoċallafa
ተሟላ	tamwāllā
ተሟሸ	tamwāšša
ተሟከረ	tamwākkara
ተሟገተ	tamwāggata
ተሟጋች	tamwāggāc
ተሠረሠረ	taśaraśśara
ተሠረገ	taśarraga
ተሠቀሠቀ	taśaqaśśaqa
ተሠወረ	taśawwara
ተሠዋሪ	taśawwāri
ተሠየመ	taśayyama
ተሣሠረ	taśāśśara
ተረማመደ	taramāmmada
ተረሳ	tarassā
ተረሳሳ	tarasāssā
ተረበ	tarraba
ተረበረበ	tarabarraba
ተረበኛ	tarabaññā
ተረባረበ	tarabārraba
ተረተ	tarrata
ተረተረ	tarattara
ተረታ	tarattā
ተረኛ	taraññā
ተረከበ	tarakkaba
ተረከከ	tarakkaka
ተረካቢ	tarakkābi
ተረካከበ	tarakākkaba
ተረኰሰ	tarakkwasa
ተረዳ	taraddā
ተረዳዳ	taradāddā
ተረገመ	taraggama
ተረገረገ	taragarraga
ተረገዘ	taraggaza
ተረገጠ	taraggaṭa
ተረጋጋ	taragāggā
ተረጐመ	taraggwama
ተረፈ	tarrafa
ተራመደ	tarāmmada
ተራረመ	tarārrama
ተራረደ	tarārrada
ተራራማ	tarārāmmā
ተራቀቀ	tarāqqaqa
ተራቢ	tarrābi
ተራባ	tarābbā
ተራች	tarrāc
ተራኪ	tarrāki
ተራኰተ	tarākkwata
ተራገመ	tarāggama
ተራገጠ	tarāggaṭa
ተራገፈ	tarāggafa
ተርመሰመሰ	taremasammasa
ተርመጠመጠ	taremaṭammaṭa
ተርበተበተ	tarebatabbata
ተርበደበደ	tarebadabbada
ተርከፈከፈ	tarekafakkafa
ተርካካ	tarekākkā
ተርገበገበ	taregabaggaba
ተሰለለ	tasallala
ተሰለቀ	tasallaqa
ተሰለበ	tasallaba
ተሰለቸ	tasalacca
ተሰለቻቸ	tasalacācca
ተሰለፈ	tasallafa
ተሰላቸ	tasalācca
ተሰላፊ	tasallāfi
ተሰሚነት	tasaminnat
ተሰማ	tasammā
ተሰማማ	tasamāmmā
ተሰረረ	tasarrara
ተሰረሰረ	tasarassara
ተሰረቀ	tasarraqa
ተሰረነቀ	tasarannaqa
ተሰረዘ	tasarraza
ተሰረጐደ	tasaraggwadda
ተሰራረቀ	tasarārraqa
ተሰቀለ	tasaqqala
ተሰቀቀ	tasaqqaqa
ተሰቃየ	tasaqāyya
ተሰቃይ	tasaqqāy
ተሰበረ	tasabbara
ተሰበሰበ	tasabassaba
ተሰበከ	tasabbaka
ተሰባሪ	tasabbāri
ተሰባበረ	tasabābbara
ተሰተረ	tasattara
ተሰነቀ	tasannaqa
ተሰነቀረ	tasanaqqara
ተሰነቀረብኝ	tasanaqqarabeññ
ተሰነባበተ	tasanabābbata
ተሰነከለ	tasanakkala
ተሰነዳዳ	tasanadāddā
ተሰነገ	tasannaga
ተሰናበተ	tasanābbata
ተሰናከለ	tasanākkala
ተሰናዘረ	tasanāzzara
ተሰናዳ	tasanāddā
ተሰኘ	tasañña
ተሰካ	tasakkā
ተሰወጠ	tasawwaṭa
ተሰየፈ	tasayyafa
ተሰደበ	tasaddaba
ተሰደደ	tasaddada
ተሰዳደበ	tasadāddaba
ተሰገሰገ	tasagassaga
ተሳለመ	tasāllama
ተሳለቀ	tasāllaqa
ተሳረረ	tassārrara
ተሳረቀ	tasārraqa
ተሳሰበ	tasāssaba
ተሳቀቀ	tasāqqaqa
ተሳበበ	tasābbaba
ተሳተፈ	tasāttafa
ተሳከረ	tasākkara
ተሳካ	tasākkā
ተሳደበ	tasāddaba
ተሳደደ	tasāddada
ተስለመለመ	taselamallama
ተስለከለከ	taselakallaka
ተስማማ	tasemāmmā
ተስገበገበ	tasegabaggaba
ተስፋፋ	tasefāffā
ተሸለመ	tašallama
ተሸለቀቀ	tašalaqqaqa
ተሸለተ	tašallata
ተሸላለመ	tašalāllama
ተሸላሚ	tašallāmi
ተሸመቀቀ	tašamaqqaqa
ተሸመተ	tašammata
ተሸማቀቀ	tašamāqqaqa
ተሸረሸረ	tašaraššara
ተሸረከተ	tašarakkata
ተሸረካከተ	tašarakākkata
ተሸረፈ	tašarrafa
ተሸራረፈ	tašarārrafa
ተሸራፊ	tašarrāfi
ተሸሸገ	tašaššaga
ተሸቀበ	tašaqqaba
ተሸበረ	tašabbara
ተሸበበ	tašabbaba
ተሸነሸነ	tašanaššana
ተሸነተረ	tašanattara
ተሸናነፈ	tašanānnafa
ተሸናፊ	tašannāfi
ተሸኘ	tašañña
ተሸከመ	tašakkama
ተሸከሸከ	tašakaššaka
ተሸካሚ	tašakkāmi
ተሸካከመ	tašakākkama
ተሸጋሸገ	taššagāššaga
ተሸጋገረ	tašagāggara
ተሸጐረ	tašaggwara
ተሸጐጠ	tašaggwaṭa
ተሸፈነ	tašaffana
ተሸፋፈነ	tašafāffana
ተሹለከለከ	tašulakallaka
ተሻማ	tašāmmā
ተሻረከ	tašārraka
ተሻሸ	tašāšša
ተሻኰተ	tašākkwata
ተሻገረ	tašāggara
ተሽመደመደ	tašemadammada
ተሽቀዳደመ	tašeqadāddama
ተሽቆጠቆጠ	tašeqoṭaqqoṭa
ተሽበለበለ	tašebalabbala
ተሽከረከረ	tašekarakkara
ተሽኮረመመ	tašekorammama
ተቀለሰ	taqallasa
ተቀለበ	taqallaba
ተቀለበሰ	taqalabbasa
ተቀላ	taqallā
ተቀላለደ	taqalāllada
ተቀላቀለ	taqalāqqala
ተቀላቢ	taqallābi
ተቀመለ	taqammala
ተቀመመ	taqammama
ተቀመሰ	taqammasa
ተቀመጠ	taqammaṭa
ተቀማ	taqammā
ተቀማጭ	taqammāċ
ተቀረቀረ	taqaraqqara
ተቀረቀበ	taqaraqqaba
ተቀረደደ	taqaraddada
ተቀረጠ	taqarraṭa
ተቀረጸ	taqarraṣa
ተቀረፈ	taqarrafa
ተቀራረፈ	taqarārrafa
ተቀሰመ	taqassama
ተቀሰረ	taqassara
ተቀሰቀሰ	taqasaqqasa
ተቀሰተ	taqassata
ተቀቀለ	taqaqqala
ተቀበለ	taqabbala
ተቀበረ	taqabbara
ተቀበቀበ	taqabaqqaba
ተቀበተተ	taqabattata
ተቀባ	taqabbā
ተቀባበለ	taqabābbala
ተቀባይ	taqabbāy
ተቀተረ	taqattara
ተቀነሰ	taqannasa
ተቀነባበረ	taqqanabābbara
ተቀነፈ	taqannafa
ተቀናሽ	taqannāš
ተቀናቀነ	taqanāqqana
ተቀናቃኝ	taqanāqāññ
ተቀናበረ	taqanābbara
ተቀናነሰ	taqanānnasa
ተቀናና	taqannānā
ተቀኘ	taqañña
ተቀዘፈ	taqazzafa
ተቀዛቀዘ	taqazāqqaza
ተቀየመ	taqayyama
ተቀየሠ	taqayyaśa
ተቀየረ	taqayyara
ተቀየደ	taqayyada
ተቀየጠ	taqayyaṭa
ተቀደመ	taqaddama
ተቀደሰ	taqaddasa
ተቀደደ	taqaddada
ተቀዳ	taqaddā
ተቀዳሚ	taqaddāmi
ተቀዳደመ	taqadāddama
ተቀዳደደ	taqadāddada
ተቀዳጀ	taqadāǧǧa
ተቀጠቀጠ	taqaṭaqqaṭa
ተቀፈረረ	taqafarrara
ተቀፈቀፈ	taqafaqqafa
ተቀፈደደ	taqafaddada
ተቀፈፈ	taqaffafa
ተቁለጨለጨ	taqulaċallaċċa
ተቁነጠነጠ	taqunaṭannaṭa
ተቃለለ	taqāllala
ተቃለደ	taqāllada
ተቃመሰ	taqāmmasa
ተቃማ	taqāmmā
ተቃረመ	taqārrama
ተቃረበ	taqārraba
ተቃረነ	taqārrana
ተቃቀፈ	taqāqqafa
ተቃባ	taqābbā
ተቃና	taqānnā
ተቃኘ	taqāñña
ተቃወመ	taqāwwama
ተቃወሰ	taqāwwasa
ተቅለሰለሰ	taqelasallasa
ተቅለበለበ	taqelaballaba
ተቅለጠለጠ	taqelaṭallaṭa
ተቅበዘበዘ	taqebazabbaza
ተቅነዘነዘ	taqenazannaza
ተቆለለ	taqollala
ተቆላ	taqollā
ተቆረሰ	taqorrasa
ተቆረቆረ	taqoraqqora
ተቆረጠ	taqorraṭa
ተቆራረሰ	taqorārrasa
ተቆራኘ	taqorāñña
ተቆፈረ	taqoffara
ተቈለመመ	taqwalammama
ተቈለፈ	taqwallafa
ተቈረቈረ	taqwaraqqwara
ተቈረጠ	taqwarraṭa
ተቈራ	taqwarrā
ተቈራመደ	taqwarāmmada
ተቈራረጠ	taqwarārraṭa
ተቈራቈሰ	taqwarāqqwasa
ተቈራጭ	taqwarrāċ
ተቈሰቈሰ	taqwasaqqwasa
ተቈነነ	taqwannana
ተቈነደደ	taqwanaddada
ተቈናኝ	taqwannāññ
ተቋለፈ	taqwāllafa
ተቋላ	taqwāllā
ተቋረጠ	taqwārraṭa
ተቋራጭ	taqwārrāċ
ተበለቀጠ	tabalaqqaṭa
ተበለጠ	taballaṭa
ተበላ	taballā
ተበላለጠ	tabalāllaṭa
ተበላሸ	tabalāšša
ተበላቀጠ	tabalāqqaṭa
ተበረቀሰ	tabaraqqasa
ተበረቃቀሰ	tabaraqāqqasa
ተበረበረ	tabarabbara
ተበረዘ	tabarraza
ተበረጋገደ	tabaragāggada
ተበራከተ	tabarākkata
ተበሳ	tabassā
ተበሳሳ	tabasāssā
ተበሳበሰ	tabasābbasa
ተበሻቀጠ	tabašāqqaṭa
ተበቀለ	tabaqqala
ተበቃይ	tabaqqāy
ተበተበ	tabattaba
ተበታተነ	tabatāttana
ተበከለ	tabakkala
ተበካከለ	tabakākkala
ተበዘበዘ	tabazabbaza
ተበየነ	tabayyana
ተበየደ	tabayyada
ተበያጅ	tabayyāǧ
ተበደለ	tabaddala
ተበደረ	tabaddara
ተበዳ	tabaddā
ተበዳሪ	tabaddāri
ተበዳይ	tabaddāy
ተበዳደረ	tabadāddara
ተበጀ	tabaǧǧa
ተበጃጀ	tabaǧāǧǧa
ተበገረ	tabaggara
ተበጠበጠ	tabaṭabbaṭa
ተበጣበጠ	tabaṭābbaṭa
ተባ	tabbā
ተባላ	tabāllā
ተባረረ	tabārrara
ተባረከ	tabārraka
ተባረደ	tabārrada
ተባሸቀ	tabāššaqa
ተባቃ	tabāqqā
ተባበረ	tabābbara
ተባዛ	tabāzzā
ተብለጠለጠ	tabelaṭallaṭa
ተብለጨለጨ	tabelaċallaċa
ተብላላ	tabelāllā
ተብረቀረቀ	taberaqarraqa
ተብረከረከ	taberakarraka
ተብራራ	taberārrā
ተብሰለሰለ	tabesalassala
ተብታባ	tabetābbā
ተብከነከነ	tabekanakkana
ተቦረቦረ	taborabbora
ተቦተረፈ	tabotarrafa
ተቦካ	tabokkā
ተቦደሰ	taboddasa
ተቧደነ	tabwāddana
ተተለተለ	tatalattala
ተተመተመ	tatamattama
ተተመነ	tatammana
ተተረማመሰ	tataramāmmasa
ተተረተረ	tatarattara
ተተረከ	tatarraka
ተተረከከ	tatarakkaka
ተተረኰሰ	tatarakkwasa
ተተረጐመ	tataraggwama
ተተራመሰ	tatarāmmasa
ተተበተበ	tatabattaba
ተተቸ	tatacca
ተተነተነ	tatanattana
ተተናኮለ	tatanākkola
ተተከለ	tatakkala
ተተካ	tatakkā
ተተካይ	tatakkāy
ተተኰሰ	tatakkwasa
ተታለለ	tatāllala
ተታኰሰ	tatākkwasa
ተታፋ	tatāffā
ተትረፈረፈ	taterafarrafa
ተቸ	tacca
ተቸለሰ	tacallasa
ተቸበቸበ	tacabaccaba
ተቸነከረ	tacanakkara
ተቸከለ	tacakkala
ተቸገረ	tacaggara
ተቸፈቸፈ	tacafaccafa
ተቸፈገ	tacaffaga
ተቺ	tacci
ተቻኰለ	tacākkwala
ተነሣ	tanaśśā
ተነሣሣ	tanaśśāśśā
ተነሰነሰ	tanasannasa
ተነሳ	tannasā
ተነቀለ	tanaqqala
ተነቀሰ	tanaqqasa
ተነቀነቀ	tanaqannaqa
ተነቀፈ	tanaqqafa
ተነቃቀፈ	tanaqāqqafa
ተነቃቃ	tanaqāqqā
ተነቃነቀ	tanaqānnaqa
ተነበበ	tanabbaba
ተነበየ	tanabbaya
ተነባበረ	tanabābbara
ተነባቢ	tanabbābi
ተነተነ	tanattana
ተነተገ	tanattaga
ተነታረከ	tanatārraka
ተነነ	tannana
ተነከረ	tanakkara
ተነከሰ	tanakkasa
ተነካ	tanakkā
ተነካከሰ	tanakākkasa
ተነካካ	tanakākkā
ተነኰሰ	tanakkwasa
ተነኰተ	tanakkwata
ተነዘነዘ	tanazannaza
ተነዛ	tanazzā
ተነዛነዘ	tanazānnaza
ተነደፈ	tanaddafa
ተነዳ	tanaddā
ተነዳደፈ	tanadāddafa
ተነገተ	tanaggata
ተነጋገረ	tanagāggara
ተነጋገደ	tanagāggada
ተነጐረ	tanaggwara
ተነጫነጨ	tanaċānnaċa
ተነፈሰ	tanaffasa
ተነፈገ	tanaffaga
ተነፋ	tanaffā
ተነፋረቀ	tanafārraqa
ተነፋነፈ	tanafānnafa
ተነፋፈሰ	tanafāffasa
ተነፋፈቀ	tanafāffaqa
ተነፋፈገ	tanafāffaga
ተነፋፋ	tanafāffā
ተናበበ	tanābbaba
ተናባቢ	tanābbābi
ተናነቀ	tanānnaqa
ተናነቀው	tanānnaqaw
ተናኘ	tanāñña
ተናከሰ	tanākkasa
ተናዘዘ	tanāzzaza
ተናደደ	tanāddada
ተናገሠ	tanāggaśa
ተናገረ	tanāggara
ተናጋ	tanāggā
ተናፈሰ	tanāffasa
ተናፈቀ	tanāffaqa
ተናፈጠ	tanāffaṭa
ተናፋ	tanāffā
ተን	tann
ተንሠቀሠቀ	taneśaqaśśaqa
ተንሰቀሰቀ	tanesaqassaqa
ተንሰፈሰፈ	tanesafassafa
ተንሳፈፈ	tanesāffafa
ተንሶለሶለ	tanesolassola
ተንሸረሸረ	tanešaraššara
ተንሸራተተ	tanešarāttata
ተንሸዋረረ	tanešawārrara
ተንሻተተ	tanešāttata
ተንቀለቀለ	taneqalaqqala
ተንቀረበበ	taneqarabbaba
ተንቀረፈፈ	taneqaraffaffa
ተንቀሳቀሰ	taneqasāqqasa
ተንቀበቀበ	taneqabaqqaba
ተንቀበደደ	taneqabaddada
ተንቀባረረ	taneqabārrara
ተንቀባደደ	taneqabāddada
ተንቀዋለለ	taneqawāllala
ተንቀዠቀዠ	taneqažaqqaža
ተንቀጠቀጠ	taneqaṭaqqaṭa
ተንቀፈደደ	taneqafaddada
ተንበለበለ	tanebalabbala
ተንበረከከ	tanebarakkaka
ተንበሸበሸ	tanebaššabbaša
ተንቦለቦለ	tanebolabbola
ተንቦረቀቀ	taneboraqqaqa
ተንቦራቀቀ	taneborāqqaqa
ተንቦገቦገ	tanebogabboga
ተንቦጨቦጨ	taneboċabboċa
ተንቦጫበጨ	taneboċābbaċa
ተንቦጫቦጨ	taneboċābboċa
ተንተረከከ	tanetarakkaka
ተንተባተበ	tanetabāttaba
ተንተከተከ	tanetakattaka
ተንቶሰቶሰ	tanetosattosa
ተንቻቻ	tanecāccā
ተንከላወሰ	tanekalāwwasa
ተንከረፈፈ	tanekaraffafa
ተንከራተተ	tanekarāttata
ተንከባለለ	tanekabāllala
ተንከባከበ	tanekabākkaba
ተንከተከተ	tanekatakkata
ተንከታከተ	tanekatākkata
ተንከዋተተ	tanekawāttata
ተንከፈረረ	tanekafarrara
ተንኮለኛ	tanekolaññā
ተንኳኳ	tanekwākkwā
ተንኳፈፈ	tanekwāffafa
ተንዘረፈጠ	tanezaraffaṭa
ተንዘረፈፈ	tanezaraffafa
ተንዘራፈጠ	tanezarāffaṭa
ተንዘፈዘፈ	tanezaffazafa
ተንዛዛ	tanezāzzā
ተንዠረገገ	tanežaraggaga
ተንዠቀዠቀ	tanežaqažžaqa
ተንዠባረረ	tanežabārrara
ተንዣበበ	tanežābbaba
ተንደላቀቀ	tanedalāqqaqa
ተንደረበበ	tanedarabbaba
ተንደረከከ	tanedarakkaka
ተንደረደረ	tanedaraddara
ተንደቀደቀ	tanedaqaddaqa
ተንደበደበ	tanedabaddaba
ተንደባለለ	tanedabāllala
ተንደባደበ	tanedabāddaba
ተንደከደ	tanedakkada
ተንደፋደፈ	tanedafāddafa
ተንዶለዶለ	tanedoladdola
ተንጀላጀለ	taneǧalāǧǧala
ተንጀረገገ	taneǧaraggaga
ተንገላታ	tanegalāttā
ተንገላወደ	tanegalāwwada
ተንገላጀጀ	tanegalāǧǧaǧa
ተንገረገበ	tanegaraggaba
ተንገሸገሸ	tanegašaggaša
ተንገበገበ	tanegabaggaba
ተንገዋለለ	tanegawāllala
ተንገደገደ	tanegadaggada
ተንገዳገደ	tanegadāggada
ተንገጫገጨ	tanegaċāggaċa
ተንገፈገፈ	tanegafaggafa
ተንጋለለ	tanegāllala
ተንጋደደ	tanegāddada
ተንጋጋ	tanegāggā
ተንጎራደደ	tanegorāddada
ተንጐራደደ	tanegwarāddada
ተንጓለለ	tanegwāllala
ተንጓደደ	tanegwāddada
ተንጠረበበ	taneṭarabbaba
ተንጠረዘዘ	taneṭarazzaza
ተንጠራራ	taneṭarrārā
ተንጠራወዘ	taneṭarāwwaza
ተንጣለለ	taneṭāllala
ተንጸባረቀ	taneṣabārraqa
ተንፈላሰሰ	tanefalāssasa
ተንፈራገጠ	tanefarāggaṭa
ተንፈራፈረ	tanefarāffara
ተንፈስ	tanefass
ተንፈቀፈቀ	tanefaqaffaqa
ተንፋነፈ	tanefānnafa
ተንፏቀቀ	tanefwāqqaqa
ተንፏፏ	tanefwāffwā
ተኛ	taññā
ተኛት	taññāt
ተኝቶ	taññeto
ተኝቷል	taññetwāl
ተአምረኛ	taammeraññā
ተአምራታዊ	taammerātāwi
ተአምር	taammer
ተከለ	takkala
ተከለለ	takallala
ተከለሰ	takallasa
ተከለበሰ	takalabbasa
ተከለከለ	takalakkala
ተከላከለ	takalākkala
ተከመቻቸ	takamacācca
ተከመከመ	takamakkama
ተከማቸ	takammāca
ተከሠተ	takaśśata
ተከረበተ	takarabbata
ተከረተፈ	takarattafa
ተከረከመ	takarakkama
ተከራከረ	takarākkara
ተከራየ	takarāyya
ተከሰሰ	takassasa
ተከሰከሰ	takasakkasa
ተከሳሽ	takassāš
ተከሳከሰ	takasākkasa
ተከበረ	takabbara
ተከበበ	takabbaba
ተከባበረ	takabābbara
ተከተለ	takattala
ተከተለበ	takatallaba
ተከተል	takattal
ተከተረ	takattara
ተከተበ	takattaba
ተከተተ	takattata
ተከተከ	takattaka
ተከተከተ	takatakkata
ተከተፈ	takattafa
ተከታተለ	takatāttala
ተከታከተ	takatākkata
ተከታይ	takattāy
ተከነ	takkana
ተከናነበ	takanānnaba
ተከናወነ	takanāwwana
ተከካ	takakkā
ተከዘ	takkaza
ተከደነ	takaddana
ተከፈለ	takaffala
ተከፈተ	takaffata
ተከፈነ	takaffana
ተከፈከፈ	takafakkafa
ተከፈፈ	takaffafa
ተከፋ	takaffā
ተከፋች	takaffāc
ተከፋይ	takaffāy
ተከፋፈለ	takafāffala
ተከፋፈተ	takafāffata
ተኩረፈረፈ	takurafarrafa
ተኩራራ	takurārrā
ተኩስ	takkus
ተኩነሰነሰ	takunasannasa
ተካ	takkā
ተካለለ	takāllala
ተካለሰ	takāllasa
ተካረረ	takārrara
ተካሰሰ	takāssasa
ተካበደ	takābbada
ተካከለ	takkākkala
ተካዥ	takkāž
ተካፈለ	takāffala
ተካፈተ	takāffata
ተክለፈለፈ	takelafallafa
ተክበሰበሰ	takebasabbasa
ተኮላሸ	takolāšša
ተኮማተረ	takomāttara
ተኮረተመ	takorattama
ተኮረጀ	takorraǧa
ተኮረፈ	takorrafa
ተኮራመተ	takorāmmata
ተኮራፊ	takorrāfi
ተኮሳተረ	takosāttara
ተኮተኮተ	takotakkota
ተኮፈሰ	takoffasa
ተኮፋሽ	takoffāš
ተኰላተፈ	takwalāttafa
ተኰረተመ	takwarattama
ተኰረታተመ	takwaratāttama
ተኰሰ	takkwasa
ተኰሳተረ	takwasāttara
ተኰነነ	takwannana
ተኳረፈ	takwārrafa
ተኳሽ	takkwāš
ተኳሽነት	takwāšennat
ተኳኰሰ	takwākkwasa
ተወለደ	tawallada
ተወለጋገደ	tawalagāggada
ተወላመመ	tawalāmmama
ተወላከፈ	tawalākkafa
ተወላጅ	tawallāǧ
ተወላገደ	tawalāggada
ተወረረ	tawarrara
ተወረሰ	tawarrasa
ተወረወረ	tawarawwara
ተወረደ	tawarrada
ተወራ	tawarrā
ተወራረሰ	tawarārrasa
ተወራረደ	tawarārrada
ተወራሽ	tawarrāš
ተወራወረ	tawarāwwara
ተወራጅ	tawarrāǧ
ተወሰነ	tawassana
ተወሰወሰ	tawasawwasa
ተወሰደ	tawassada
ተወሳ	tawassā
ተወቀሰ	tawaqqasa
ተወቀጠ	tawaqqaṭa
ተወቃ	tawaqqā
ተወቃቀሰ	tawaqāqqasa
ተወተፈ	tawattafa
ተወነባበደ	tawanabābbada
ተወነጃጀለ	tawanaǧāǧǧala
ተወናበደ	tawanābbada
ተወናፈለ	tawanāffala
ተወንጀለ	tawaneǧǧala
ተወከለ	tawakkala
ተወካይ	tawakkāy
ተወዘፈ	tawazzafa
ተወዛወዘ	tawazāwwaza
ተወደደ	tawaddada
ተወዳደረ	tawadāddara
ተወዳጀ	tawadāǧǧa
ተወዳጅ	tawaddāǧ
ተወገረ	tawaggara
ተወገደ	tawaggada
ተወጋ	tawaggā
ተወጫመደ	tawaċāmmada
ተዋለደ	tawāllada
ተዋልቀ	tawālleqa
ተዋረደ	tawārrada
ተዋሰነ	tawāssana
ተዋቀረ	tawāqqara
ተዋቀሰ	tawāqqasa
ተዋከበ	tawākkaba
ተዋወቀ	tawāwwaqa
ተዋደቀ	tawāddaqa
ተዋደደ	tawāddada
ተዋጋ	tawāggā
ተውለበለበ	tawelaballaba
ተውረገረገ	taweragarraga
ተውተረተረ	tawetarattara
ተውተበተበ	tawetabattaba
ተውተፈተፈ	tawetafattafa
ተዘለለ	tazallala
ተዘለቀ	tazallaqa
ተዘመዘመ	tazamazzama
ተዘረረ	tazarrara
ተዘረነቀ	tazarranaqa
ተዘረከተ	tazarakkata
ተዘረካከተ	tazarakākkata
ተዘረዘረ	tazarazzara
ተዘረገፈ	tazaraggafa
ተዘረጋ	tazaraggā
ተዘረፈ	tazarrafa
ተዘረፈጠ	tazaraffaṭa
ተዘራ	tazarrā
ተዘራረፈ	tazarārrafa
ተዘቀዘቀ	tazaqazzaqa
ተዘበራረቀ	tazabarārraqa
ተዘባረቀ	tazabārraqa
ተዘባበተ	tazabābbata
ተዘባነነ	tazabānnana
ተዘነቀ	tazannaqa
ተዘነተረ	tazanattara
ተዘነጋ	tazanaggā
ተዘነጋጋ	tazanagāggā
ተዘናከተ	tazanākkata
ተዘናጋ	tazanāggā
ተዘናፈለ	tazanāffala
ተዘከረ	tazakkara
ተዘከዘከ	tazakazzaka
ተዘካሪ	tazakkāri
ተዘወተረ	tazawattara
ተዘዋወረ	tazawāwwara
ተዘያየረ	tazayāyyara
ተዘገረረ	tazagarrara
ተዘገጃጀ	tazagaǧāǧǧa
ተዘጋ	tazzaggā
ተዘጋጀ	tazagāǧǧa
ተዘፈቀ	tazaffaqa
ተዘፈዘፈ	tazafazzafa
ተዛለለ	tazāllala
ተዛለፈ	tazāllafa
ተዛመተ	tazāmmata
ተዛመደ	tazāmmada
ተዛባ	tazzābbā
ተዛነቀ	tazānnaqa
ተዛነፈ	tazānnafa
ተዛና	tazānnā
ተዛናና	tazānānnā
ተዛወረ	tazāwwara
ተዛዘበ	tazāzzaba
ተዛዘነ	tazāzzana
ተዛፈቀ	tazāffaqa
ተዝለገለገ	tazelagallaga
ተዝለፈለፈ	tazelafallafa
ተዝረበረበ	tazerabarraba
ተዝረከረከ	tazerakarraka
ተዝረጠረጠ	tazeraṭarraṭa
ተዝረፈረፈ	tazerafarrafa
ተዝናና	tazenānnā
ተዝጎረጎረ	tazegoraggora
ተዝጐረጐረ	tazegwaraggwara
ተዠለጠ	tažallaṭa
ተዥጎረገረ	tažegoraggara
ተዥጎደጎደ	tažegodaggoda
ተያየ	tayāyya
ተደለለ	tadallala
ተደለቀ	taddallaqa
ተደለደለ	tadaladdala
ተደላደለ	tadalāddala
ተደመመ	tadammama
ተደመረ	tadammara
ተደመሰሰ	tadamassasa
ተደመደመ	tadamaddama
ተደመጠ	tadammaṭa
ተደማመጠ	tadamāmmaṭa
ተደማሪ	tadammāri
ተደማጭ	tadammāċ
ተደረሰ	tadarrasa
ተደረሰመ	tadarassama
ተደረበ	tadarraba
ተደረተ	tadarrata
ተደረደረ	tadaraddara
ተደረገ	tadarraga
ተደረገመ	tadaraggama
ተደራረበ	tadarārraba
ተደራረገ	tadarārraga
ተደራቢ	tadarrābi
ተደራደረ	tadarāddara
ተደራጀ	tadarāǧǧa
ተደራጊ	tadarrāgi
ተደሰተ	tadassata
ተደሳች	tadassāc
ተደቀነ	tadaqqana
ተደቆሰ	tadaqqosa
ተደበለለ	tadaballala
ተደበለቀ	tadaballaqa
ተደበላለቀ	tadabalāllaqa
ተደበቀ	tadabbaqa
ተደበደበ	tadabaddaba
ተደባለቀ	tadabāllaqa
ተደባበቀ	tadabābbaqa
ተደባደበ	tadabāddaba
ተደነቀ	tadannaqa
ተደነቀረ	tadanaqqara
ተደነቀረብኝ	tadanaqqarabeññ
ተደናቀፈ	tadanāqqafa
ተደናቂ	tadannāqi
ተደናበረ	tadanābbara
ተደናበዘ	tadanābbaza
ተደናገረ	tadannāggara
ተደናገጠ	tadanāggaṭa
ተደከመ	tadakkama
ተደወለ	tadawwala
ተደገመ	tadaggama
ተደገሰ	tadaggasa
ተደገነ	tadaggana
ተደገፈ	tadaggafa
ተደጋገመ	tadagāggama
ተደጋገፈ	tadagāggafa
ተደጎመ	tadaggoma
ተደፈረ	tadaffara
ተደፈቀ	tadaffaqa
ተደፈነ	tadaffana
ተደፋ	tadaffā
ተደፋፈረ	tadafāffara
ተዳመረ	tadāmmara
ተዳመጠ	tadāmmaṭa
ተዳረሰ	tadārrasa
ተዳረቀ	tadārraqa
ተዳረገ	tadārraga
ተዳራ	tadārrā
ተዳቀለ	tadāqqala
ተዳቀቀ	tadāqqaqa
ተዳበለ	tadābbala
ተዳነቀ	tadānnaqa
ተዳኘ	tadāñña
ተዳከመ	tadākkama
ተዳደረ	tadāddara
ተዳፈረ	tadāffara
ተዳፈቀ	tadāffaqa
ተዳፈነ	tadāffana
ተዳፋ	tadāffā
ተድረቀረቀ	taderaqarraqa
ተድበለበለ	tadebalabbala
ተድበሰበሰ	tadebasabbasa
ተድቦለቦለ	tadebolabbola
ተድፈነፈነ	tadefanaffana
ተጀመረ	taǧammara
ተጀነነ	taǧannana
ተገለለ	tagallala
ተገለማመጠ	tagalamāmmaṭa
ተገለበጠ	tagalabbaṭa
ተገለባበጠ	tagalabābbaṭa
ተገለጠ	tagallaṭa
ተገለፈፈ	tagalaffafa
ተገላመጠ	tagalāmmaṭa
ተገላበጠ	tagalābbaṭa
ተገላገለ	tagalāggala
ተገመሰ	tagammasa
ተገመተ	tagammata
ተገመደለ	tagamaddala
ተገመገመ	tagamaggama
ተገረመ	tagarrama
ተገረዘ	tagarraza
ተገረፈ	tagarrafa
ተገራ	tagarrā
ተገሰሰ	tagassasa
ተገሸለጠ	tagašallaṭa
ተገሸረ	tagaššara
ተገበያየ	tagabayāyya
ተገቢ	tagabbi
ተገባደደ	tagabāddada
ተገታ	tagattā
ተገታተረ	tagatāttara
ተገነዘበ	taganazzaba
ተገነጣጠለ	taganaṭāṭṭala
ተገናኘ	taganāñña
ተገናዘበ	taganāzzaba
ተገኘ	tagañña
ተገዘተ	tagazzata
ተገዛ	tagazzā
ተገዛዛ	tagazzāzzā
ተገደለ	tagaddala
ተገደደ	tagaddada
ተገፈፈ	tagaffafa
ተገፋ	tagaffā
ተገፋተረ	tagafāttara
ተገፋፋ	tagafāffā
ተጉመጠመጠ	tagumaṭammaṭa
ተጉረበረበ	tagurabarraba
ተጋ	taggā
ተጋለጠ	tagāllaṭa
ተጋመሰ	tagāmmasa
ተጋማ	tagāmmā
ተጋረደ	tagārrada
ተጋረጠ	tagārraṭa
ተጋራ	tagārrā
ተጋበዘ	tagābbaza
ተጋባ	tagābbā
ተጋተረ	tagāttara
ተጋነነ	tagānnana
ተጋዘ	tagāzza
ተጋዛ	tagāzzā
ተጋደለ	tagāddala
ተጋገረ	tagāggara
ተጋገዘ	tagāggaza
ተጋፈጠ	tagāffaṭa
ተጋፋ	tagāffā
ተግ	tagg
ተግማማ	tagemāmmā
ተግባባ	tagebābbā
ተግተለተለ	tagetalattala
ተግተረተረ	tagetarattara
ተግደረደረ	tagedaraddara
ተግፈለፈለ	tagefalaffala
ተጎማለለ	tagomāllala
ተጎማዘዘ	tagomāzzaza
ተጎራበተ	tagorābbata
ተጎዳ	tagoddā
ተጎዳኘ	tagodāñña
ተጐለተ	tagwallata
ተጐላመመ	tagwalāmmama
ተጐላደፈ	tagwalāddafa
ተጐሳቈለ	tagwasāqqwala
ተጐተተ	tagwattata
ተጐታች	tagwattāc
ተጐነጐነ	tagwanaggwana
ተጐናዘለ	tagwanāzzala
ተጓተተ	tagwāttata
ተጓደለ	tagwāddala
ተጓደደ	tagwāddada
ተጕመጠመጠ	tagwemaṭammaṭa
ተጠለለ	taṭallala
ተጠለፈ	taṭallafa
ተጠላ	taṭallā
ተጠላላፊ	taṭalāllāfi
ተጠመቀ	taṭammaqa
ተጠመዘዘ	taṭamazzaza
ተጠመደ	taṭammada
ተጠማ	taṭammā
ተጠማዘዘ	taṭamāzzaza
ተጠረመሰ	taṭarammasa
ተጠረቃቀመ	taṭaraqāqqama
ተጠራ	taṭarrā
ተጠራቀመ	taṭarāqqama
ተጠቀመ	taṭaqqama
ተጠቃ	taṭaqqā
ተጠቃለለ	taṭaqāllala
ተጠቃሚ	taṭaqqāmi
ተጠቃሽ	taṭaqqāš
ተጠቃቀሰ	taṭaqāqqasa
ተጠቆመ	taṭaqqoma
ተጠበቀ	taṭabbaqa
ተጠበበ	taṭabbaba
ተጠባበቀ	taṭabābbaqa
ተጠነቀቀ	taṭanaqqaqa
ተጠና	taṭannā
ተጠናቀቀ	taṭanāqqaqa
ተጠናቆለ	taṭanāqqola
ተጠናበሰ	taṭanābbasa
ተጠናከረ	taṭanākkara
ተጠናወተ	taṭanāwwata
ተጠየቀ	taṭayyaqa
ተጠየቅ	taṭayyaq
ተጠየፈ	taṭayyafa
ተጠያቂ	taṭayyāqi
ተጠያየቀ	taṭayāyyaqa
ተጠያፊ	taṭayyāfi
ተጠጋ	taṭaggā
ተጠጋገነ	taṭagāggana
ተጠጋጋ	taṭagāggā
ተጠፋፋ	taṭafāffā
ተጣላ	taṭṭālā
ተጣመመ	taṭāmmama
ተጣመረ	taṭāmmara
ተጣመደ	taṭāmmada
ተጣረረ	taṭārrara
ተጣራ	taṭārrā
ተጣበቀ	taṭābbaqa
ተጣበበ	taṭābbaba
ተጣባ	taṭābbā
ተጣደፈ	taṭāddafa
ተጣዳ	taṭāddā
ተጣፋ	taṭāffā
ተጥለቀለቀ	taṭelaqallaqa
ተጥመለመለ	taṭemalammala
ተጥመሰመሰ	taṭemasammasa
ተጥመዘመዘ	taṭemazammaza
ተጥናና	taṭenānnā
ተጧጧፈ	taṭwāṭṭwāfa
ተጨለጠ	taċallaṭa
ተጨመላለቀ	taċamalāllaqa
ተጨመረ	taċċammara
ተጨመቀ	taċammaqa
ተጨመታተረ	taċamatāttara
ተጨማለቀ	taċamāllaqa
ተጨማሪ	taċammāri
ተጨማተረ	taċamāttara
ተጨማደደ	taċamāddada
ተጨረሰ	taċċarrasa
ተጨራመመ	taċarāmmama
ተጨራመተ	taċarāmmata
ተጨራመደ	taċarāmmada
ተጨቆነ	taċaqqona
ተጨቋኝ	taċaqqwāñ
ተጨበተ	taċabbata
ተጨበጨበለት	taċabaċċaballat
ተጨባበጠ	taċabābbaṭa
ተጨባበጡ	taċabābbaṭu
ተጨባጭ	taċabbāċ
ተጨነቀ	taċannaqa
ተጨናነቀ	taċanānnaqa
ተጨናገፈ	taċanāggafa
ተጨናጎለ	taċanāggola
ተጨካከነ	taċakākkana
ተጨዋወተ	taċawāwwata
ተጨፈለቀ	taċafallaqa
ተጨፋጨፈ	taċafāċċaffa
ተጨፋፈቀ	taċafāffaqa
ተጫማ	taċāmmā
ተጫረሰ	taċċārrasa
ተጫወተ	taċāwwata
ተጫወተበት	taċāwwatabbat
ተጫፈረ	taċāffara
ተጭበረበረ	taċebarabbara
ተጸለየ	taṣallaya
ተጸናወተ	taṣanāwwata
ተጸየፈ	taṣayyafa
ተጸዳዳ	taṣadāddā
ተጻረረ	taṣārrara
ተጽናና	taṣenānnā
ተፀነሰ	taṡannasa
ተፈለቀቀ	tafalaqqaqa
ተፈለገ	tafallaga
ተፈለጠ	tafallaṭa
ተፈለፈለ	tafalaffala
ተፈላ	tafallā
ተፈላለገ	tafalāllaga
ተፈላሰፈ	tafalāssafa
ተፈላጊ	tafallāgi
ተፈላጭ	tafallāċ
ተፈረመ	tafarrama
ተፈረከሰ	tafarakkasa
ተፈረደ	tafarrada
ተፈረፈረ	tafaraffara
ተፈራ	tafarrā
ተፈራረመ	tafarārrama
ተፈራራ	tafarārrā
ተፈቃቀረ	tafaqāqqara
ተፈቃቀደ	tafaqāqqada
ተፈተለ	tafattala
ተፈተለከ	tafatallaka
ተፈተሸ	tafattaša
ተፈተነ	tafattana
ተፈተገ	tafattaga
ተፈታ	tafattā
ተፈታተሸ	tafatāttaša
ተፈታተነ	tafattātana
ተፈታኝ	tafattāñ
ተፈነቀለ	tafanaqqala
ተፈነቸረ	tafanaccara
ተፈነከተ	tafanakkata
ተፈነገለ	tafanaggala
ተፈናቀለ	tafanāqqala
ተፈናከተ	tafanākkata
ተፈናፈነ	tafanāffana
ተፈወሰ	tafawwasa
ተፈጀ	tafaǧǧa
ተፈገፈገ	tafagaffaga
ተፈጋፈገ	tafagāffaga
ተፋ	taffā
ተፋለመ	tafāllama
ተፋለሰ	tafāllasa
ተፋረሰ	tafārrasa
ተፋረደ	tafārrada
ተፋሰሰ	tafāssasa
ተፋቀረ	tafāqqara
ተፋተገ	tafāttaga
ተፋታ	tafāttā
ተፋዘዘ	tafāzzaza
ተፋጀ	tafāǧǧa
ተፋፈነ	tafāffana
ተፋፈገ	tafāffaga
ተፌ	taffé
ተፍ	taff
ተፍለቀለቀ	tafelaqallaqa
ተፍለከለከ	tafelakallaka
ተፍረቀረቀ	taferaqarraqa
ተፍረከረከ	taferakarraka
ተፍረጠረጠ	taferaṭarraṭa
ተፍታታ	tafetāttā
ተፎካከረ	tafokākkara
ቱር	turr
ቱስ	tuss
ቱሽ	tušš
ቱባ	tubbā
ቱቦ	tubbo
ቱታ	tuttā
ቱግ	tugg
ቱፋሕ	tuffāḥ
ታለበ	tāllaba
ታለፈ	tāllafa
ታላቅ	tāllāq
ታመመ	tāmmama
ታመሰ	tāmmasa
ታመቀ	tāmmaqa
ታመነ	tāmmana
ታማ	tāmmā
ታማኝ	tāmmāñ
ታምረኛ	tāmmeraññā
ታምራታዊ	tāmmerātāwi
ታምር	tāmmer
ታሠሠ	tāśśaśa
ታሠረ	tāśśara
ታረመ	tārrama
ታረሰ	tārrasa
ታረቀ	tārraqa
ታረዘ	tārraza
ታረደ	tārrada
ታሪከኛ	tārikaññā
ታሰበ	tāssaba
ታስቦ	tāssebo
ታሸ	tāšša
ታሸመ	tāššama
ታሸገ	tāššaga
ታቀደ	tāqqada
ታቀፈ	tāqqafa
ታበለ	tābbala
ታበየ	tābbaya
ታተመ	tāttama
ታተረ	tāttara
ታተተ	tāttata
ታታ	tāttā
ታነቀ	tānnaqa
ታነጠ	tānnaṭa
ታናሽ	tānnāš
ታንከኛ	tānekaññā
ታኘከ	tāññaka
ታከለ	tākkala
ታከመ	tākkama
ታከተ	tākkata
ታከከ	tākkaka
ታካሚ	tākkāmi
ታወረ	tāwwara
ታወሰው	tāwwasaw
ታወቀ	tāwwaqa
ታወከ	tāwwaka
ታዘለ	tāzzala
ታዘበ	tāzzaba
ታዘዘ	tāzzaza
ታዛቢ	tāzzābi
ታዛዥ	tāzzāž
ታየ	tāyya
ታደለ	tāddala
ታደመ	tāddama
ታደገ	tāddaga
ታዲያሳ	tādiyāssā
ታዲያስ	tādiyāss
ታዳጊ	tāddāgi
ታጀለ	tāǧǧala
ታጀበ	tāǧǧaba
ታገለ	tāggala
ታገሠ	tāggaśa
ታገደ	tāggada
ታጋሽ	tāggāš
ታጐረ	tāggwara
ታፈረ	tāffara
ታፈነ	tāffana
ታፈገ	tāffaga
ታፋሪ	tāffāri
ቴሌስኮፕ	télésekopp
ቴፕ	tépp
ትሉግሉግ	telugelugg
ትላንትና	telānetennā
ትልቅ	telleq
ትልቅነት	telleqennat
ትሕትና	teḥetennā
ትምቡሽ	temebušš
ትምትም	temetemm
ትምክህተኛ	temekehetaññā
ትራፊ	terrāfi
ትር	terr
ትርምስ	teremmes
ትርታ	terretā
ትርክክ	terekekk
ትርኳሽ	terekkwāš
ትሻለህ	tešāllah
ትቢተኛ	tebitaññā
ትቢያ	tebbiyā
ትብብር	tebebber
ትብትብ	tebetebb
ትችት	teccet
ትናንትና	tenānetennā
ትናጋ	tennāgā
ትንሽ	tenneš
ትንቢተኛ	tenebitaññā
ትንኝ	teneññ
ትንፋሽ	teneffāš
ትእቢተኛ	teʼebitaññā
ትእግሥተኛ	teʼegeśetaññā
ትከሻ	tekaššā
ትከሻማ	tekaššāmmā
ትከሻም	tekaššām
ትኩሳት	tekkusāt
ትኩስ	tekkus
ትካዜ	tekkāzé
ትክ	tekk
ትክለኛ	tekelaññā
ትክል	tekkel
ትክት	tekket
ትክዝ	tekkezz
ትውልድ	teweledd
ትዕይንት	teʻeyyenet
ትዝ	tezz
ትዝብት	tezzebet
ትዝታ	tezzetā
ትይዩ	teyeyyu
ትግሥተኛ	tegeśetaññā
ትግርኛ	tegereññā
ትግያ	tegeyyā
ትጥቅና	teṭeqennā
ቶስቷሳ	tosetwāssā
ቸለል	calall
ቸለሰ	callasa
ቸል	call
ቸልተኛ	calletaññā
ቸልታ	calletā
ቸረቸመ	caraccama
ቸረቸረ	caraccara
ቸርቻማ	carecāmmā
ቸርነት	carennat
ቸሰሰ	cassasa
ቸበቸበ	cabaccaba
ቸብቸቦ	cabecabbo
ቸነከረ	canakkara
ቸከለ	cakkala
ቸኰለ	cakkwala
ቸኳይ	cakkwāy
ቸገረ	caggara
ቸፈቸፈ	cafaccafa
ቸፈገ	caffaga
ቸፍግ	caffegg
ችላ	cellā
ችስ	cess
ችቦ	cebbo
ችኩል	cekkul
ችክ	cekk
ችክል	cekkell
ችኮ	cekko
ችኰላ	cekkwalā
ችግረኛ	ceggeraññā
ችግር	cegger
ችግኝ	ceggeñ
ችፍ	ceff
ችፍርግ	ceferegg
ችፍቻፊ	cefeccāfi
ችፍግ	ceffeg
ኅሊና	ẖellinā
ኅብረተሰብአዊነት	ẖeberatasabeʼawinnat
ኅያል	ẖeyyāl
ኅይለኛ	ẖeyelaññā
ኅይለኝነት	ẖeyelaññennat
ኅዳግ	ẖeddāg
ኅጢአተኛ	ẖeṭiataññā
ኅጢአተኝነት	ẖeṭiataññennat
ኋለኛ	ẖwālaññā
ነሣ	naśśā
ነረተ	narrata
ነሰረ	nassara
ነሰነሰ	nasannasa
ነሳነሰ	nasānnasa
ነሸጠ	naššaṭa
ነቀለ	naqqala
ነቀሰ	naqqasa
ነቀዘ	naqqaza
ነቃ	naqqā
ነቃቀለ	naqāqqala
ነቃቀዘ	naqāqqaza
ነቃቀፈ	naqāqqafa
ነቃቃ	naqāqqā
ነቈጠ	naqqwaṭa
ነበረ	nabbara
ነበር	nabbar
ነበበ	nabbaba
ነበዘ	nabbaza
ነቢይ	nabiyy
ነባር	nabbār
ነብርማ	naberemmā
ነቦጨ	nabboċċa
ነተረከ	natarraka
ነተበ	nattaba
ነኁላላ	naẖulāllā
ነኈለለ	naẖwallala
ነኝ	naññ
ነከረ	nakkara
ነከሰ	nakkasa
ነከስ	nakass
ነከተ	nakkata
ነካ	nakkā
ነካከሰ	nakākkasa
ነካካ	nakākkā
ነክ	nakk
ነኰተ	nakkwata
ነውረኛ	naweraññā
ነዘረ	nazzara
ነዘነዘ	nazannaza
ነዛ	nazzā
ነዝናዛ	nazenāzzā
ነደለ	naddala
ነደደ	naddada
ነደፈ	naddafa
ነዳ	naddā
ነዳደለ	nadāddala
ነዳደፈ	nadāddafa
ነገሠ	naggaśa
ነገረ	naggara
ነገረኛ	nagaraññā
ነገረኝ	naggaraññ
ነገረው	naggaraw
ነገደ	naggada
ነጋ	naggā
ነጋዴ	naggādé
ነጋድራስ	naggāderās
ነጋገረ	nagāggara
ነጋገደ	nagāggada
ነጋጋ	nagāggā
ነጐረ	naggwara
ነጻነት	naṣānnat
ነፈለለ	nafallala
ነፈረ	naffara
ነፈረቀ	nafarraqa
ነፈሰ	naffasa
ነፈሰበት	naffasabbat
ነፈነፈ	nafannafa
ነፈገ	naffaga
ነፊ	naffi
ነፋ	naffā
ነፋሻ	naffāššā
ነፋፈሰ	nafāffasa
ነፋፋ	nafāffā
ነፍላላ	nafelāllā
ነፍራቃ	naferāqqā
ነፍናፋ	nafenāffā
ነፍጠኛ	nafeṭaññā
ናሙና	nāmmunā
ናቸው	nāccaw
ናችሁ	nāccehu
ናኘ	nāñña
ናወዘ	nāwwaza
ናዋዥ	nāwwāž
ናፈቀ	nāffaqa
ንስሐ	nesseḥa
ንቃሽ	neqqāš
ንቃይ	neqqāy
ንቅል	neqqel
ንቅሳታም	neqqesātām
ንቅሳት	neqqesāt
ንቅናቄ	neqennāqé
ንብብር	nebebber
ንብዝ	nebbez
ንብዝብዝ	nebezebezz
ንትርክ	neterrek
ንክሳት	nekkesāt
ንክስ	nekkes
ንክኪት	nekekkit
ንክክ	nekekk
ንኳቸ	nekkwāca
ንዝራት	nezzerāt
ንዴተኛ	nedétaññā
ንዴታም	neddétām
ንዴት	neddét
ንገዳ	neggadā
ንግር	negger
ንግርተኛ	neggeretaññā
ንግርት	neggeret
ንግግር	negegger
ንጹሕነት	neṣuḥennat
ንጽሕና	neṣeḥennā
ንፊት	neffit
ንፋሽ	neffāš
አሁኑኑ	ahunnunu
አሁንም	ahunemm
አሁንስ	ahuness
አህያ	aheyyā
አለ	alla
አለሁ	allahu
አለለ	allala
አለል	alall
አለሎ	alallo
አለመ	allama
አለመለመ	alamallama
አለመደ	alammada
አለመጠ	alammaṭa
አለማ	alammā
አለማለም	allamāllam
አለማመነ	allamāmmana
አለማመደ	allamāmmada
አለሳለስ	allasālas
አለቀ	allaqa
አለቀለቀ	alaqallaqa
አለቀመ	alaqqama
አለቀሰ	alaqqasa
አለቃለቀ	allaqāllaqa
አለቃቀሰ	alaqāqqasa
አለቅነት	alaqennat
አለበ	allaba
አለበለዚያ	alaballazziyā
አለበሰ	allabbasa
አለበት	allabat
አለባበሰ	alabābbasa
አለብኝ	allabbeññ
አለኝታ	allaññetā
አለከለከ	alakallaka
አለው	allaw
አለዘበ	alazzaba
አለያየ	allayyāya
አለጎመ	alaggoma
አለጐመ	alaggwama
አለጠ	allaṭa
አለጠለጠ	alaṭallaṭa
አለፈ	allafa
አለፈበት	allafabbat
አለፋ	alaffā
አለፋጨቀ	allafāċċaqa
አላላ	alāllā
አላላም	allālām
አላላከ	allālāka
አላመነ	allāmmana
አላመደ	allāmada
አላመጠ	allāmmaṭa
አላሚ	allāmi
አላማኝ	allāmāñ
አላሰነ	allāssana
አላሸ	alāšša
አላሸቀ	alāššaqa
አላቀመ	allāqqama
አላቀሰ	allāqqasa
አላቀቀ	allāqqaqa
አላቃሽ	allāqāš
አላቆጠ	alāqqoṭa
አላጋ	allāggā
አላጋጭ	allāgāċ
አላፊነት	alāfinnat
አልቃሻ	aleqāššā
አልባሌ	alebbālé
አልባነት	alebānnat
አልከሰከሰ	alekasakkasa
አልኮሰኮሰ	alekosakkosa
አልገባኝም	alegabbāññem
አልጐመጐመ	alegwamaggwama
አልጨረሰም	aleċarrasam
አልጫ	alleċċā
አልፈሰፈሰ	alefasaffasa
አሎሎ	alollo
አመለመለ	amalammala
አመለኛ	amalaññā
አመለከ	amallaka
አመለከተ	amalakkata
አመለጠ	amallaṭa
አመለጠው	amallaṭaw
አመላለስ	ammalāllas
አመላላሽ	ammalāllāš
አመመ	ammama
አመሠራረት	ammaśarārat
አመረረ	amarrara
አመረቀዘ	amaraqqaza
አመረተ	amarrata
አመራ	amarrā
አመራመረ	ammarāmmara
አመራመር	ammarāmar
አመራማሪ	ammarāmāri
አመራር	ammarār
አመሰ	ammasa
አመሰቃቀለ	ammasaqāqqala
አመሰቃቃይ	ammasaqāqāy
አመሰኳ	amasakkwā
አመሰገነ	amasaggana
አመሰጋገነ	amasagāggana
አመሳሰል	ammasāsal
አመሳቀለ	ammasāqqala
አመሳከረ	ammasākkara
አመሳካሪ	ammasākāri
አመሸ	ammašša
አመሸህ	amaššah
አመቀ	ammaqa
አመቸ	amacca
አመቺ	amacci
አመቻቸ	ammacācca
አመነ	ammana
አመነመነ	amanammana
አመነቃቀረ	ammanaqāqqara
አመነታ	amanattā
አመነታታ	amanatāttā
አመነቸከ	amanaccaka
አመነኰሰ	amanakkwasa
አመነዘረ	amanazzara
አመነጫጨቀ	ammanaċāċċaqqa
አመናቀረ	ammanāqqara
አመናጨቀ	ammanāċċaqa
አመከነ	amakkana
አመካኘ	ammakāña
አመዘነ	amazzana
አመዛዘነ	ammazāzzana
አመዛዛኝ	ammazāzāñ
አመገ	ammaga
አመገለ	ammaggala
አመጋገብ	ammagāgab
አመጣጠነ	ammaṭāṭṭana
አመጻደቀ	ammaṣāddaqa
አማ	ammā
አማለደ	ammālada
አማላጅ	ammālāǧ
አማላጅነት	ammālāǧennat
አማመመ	amāmmama
አማረረ	ammārrara
አማረዘ	ammārraza
አማረገ	ammārraga
አማረጠ	ammārraṭa
አማሪኛው	amāriññāw
አማራሪ	ammārāri
አማራጭ	ammārāċ
አማርኛ	amāreññā
አማሰለ	ammāssala
አማሸ	ammāšša
አማሺ	ammāši
አማሽ	ammāš
አማተበ	ammāttaba
አማታ	ammātā
አማች	ammāc
አማከረ	amākkara
አማካሪ	ammākāri
አማካኝ	ammākāñ
አማገረ	ammāggara
አማገጠ	amāggaṭa
አማጣ	ammāṭā
አማጭ	ammāċ
አሜተኛ	amétaññā
አምሳኛ	amesāññā
አምሳያ	amesāyyā
አምስተኛ	ammesetaññā
አምስት	ammeset
አምበል	ameball
አምቡላ	amebullā
አምባረቀ	amebārraqa
አምባሻ	amebāššā
አምባጋሮኛ	amebāgāroññā
አምቦልክ	amebolekk
አምቦረቀቀ	ameboraqqaqa
አምቦጨቦጨ	ameboċabboċa
አምቧቧ	amebwābbwā
አምታታ	ametāttā
አምነሸነሸ	amenašannaša
አምዘገዘገ	amezagazzaga
አሞለጨ	amollaċa
አሞላ	amollā
አሞላላ	ammolāllā
አሞላቀቀ	amolāqqaqa
አሞቀሞቀ	amoqammoqa
አሞኘ	amoñña
አሞካከረ	ammokākkara
አሞገሰ	amoggasa
አሞጋሽ	amoggāš
አሞጋገሰ	amogāggasa
አሞጠሞጠ	amoṭammoṭa
አሟላ	ammwāllā
አሟሟቀ	ammwāmwāqa
አሟሟቂ	ammwāmwāqi
አሟረተ	amwārrata
አሟሸ	amwāšša
አሟከረ	ammwākkara
አሟገተ	ammwāggata
አሟጋች	ammwāgāc
አሠለሰ	aśallasa
አሠልጣኝ	aśaleṭāññ
አሠመረ	aśammara
አሠማመረ	aśamāmmara
አሠሠ	aśśaśa
አሠረ	aśśara
አሠዋ	aśśawwā
አሠየመ	aśayyama
አሠገረ	aśaggara
አሠጋ	aśaggā
አሠጋገር	aśśagāgar
አሣሣ	aśāśśā
አሣረኛ	aśāraññā
አረመ	arrama
አረመኔነት	aramanénnat
አረሰ	arrasa
አረሳሳ	arasāssā
አረቀ	arraqa
አረቀቀ	araqqaqa
አረበደ	arrabbada
አረባ	arabbā
አረባጅ	arabbāǧ
አረከሰ	arakkasa
አረካ	arakkā
አረካከበ	arrakākkaba
አረካካቢ	arrakākābi
አረዘመ	arazzama
አረደ	arrada
አረዳ	araddā
አረጀ	araǧǧa
አረገረገ	aragarraga
አረገበ	araggaba
አረገዘ	araggaza
አረገደ	araggada
አረገፈ	araggafa
አረጋ	araggā
አረጋገጠ	arragāggaṭa
አረጋገፈ	arragāggafa
አረጋጋ	arragāggā
አረጠ	arraṭa
አረጠረጠ	araṭarraṭa
አረፈደ	araffada
አረፋፈደ	araffāfada
አራ	arrā
አራመደ	arrāmmada
አራሙቻ	arrāmuccā
አራሚ	arrāmi
አራረሰ	arārrasa
አራራ	arārrā
አራራቀ	arrārāqa
አራቈተ	arrāqwata
አራባ	arrābā
አራተኛ	arāttaññā
አራት	arātt
አራገበ	arrāggaba
አራገፈ	arrāggafa
አራጋፊ	arrāggāfi
አርመጠመጠ	aremaṭammaṭa
አርበተበተ	arebatabbata
አርበኛ	arebaññā
አርበኛነት	arebaññānat
አርበኝነት	arebaññennat
አርበደበደ	arebadabbada
አርባኛ	arebāññā
አርነት	arennat
አርአያነት	areʼayānnat
አርከፈከፈ	arekafakkafa
አርገበገበ	aregabaggaba
አርጩሜ	areċummé
አሯሯጠ	arrwārwāṭa
አሰለለ	assallala
አሰለመ	asallama
አሰለሰለ	asalassala
አሰለበ	assalaba
አሰለቸ	asalacca
አሰለፈ	asallafa
አሰላ	asallā
አሰላሰለ	assalāssala
አሰላይ	assallāy
አሰላፊ	assallāfi
አሰማ	assammā
አሰረ	assara
አሰረቀ	assaraqa
አሰረዘ	assarraza
አሰራጨ	assarāċa
አሰሰ	assasa
አሰሳ	assasā
አሰቀለ	assaqqala
አሰቀቀ	assaqqaqa
አሰቃቂ	assaqqāqi
አሰቃየ	assaqāyya
አሰበ	assaba
አሰበረ	assabbara
አሰበከ	asabbaka
አሰበጣጠረ	assabaṭāṭṭara
አሰባ	asabbā
አሰባሰበ	assabāssaba
አሰባጠረ	assabāṭṭara
አሰት	assat
አሰነቀ	assannaqa
አሰነበተ	asanabbata
አሰነካከለ	assanakākkala
አሰነዳዳ	assanadāddā
አሰነጠቀ	assanaṭṭaqa
አሰነፈ	asannafa
አሰናበተ	assanābbata
አሰናከለ	assanākkala
አሰናካይ	assanākāy
አሰናዳ	assanāddā
አሰናጅ	assanāǧ
አሰኘ	assañña
አሰኘው	assaññaw
አሰከረ	asakkara
አሰከነ	asakkana
አሰካ	assakkā
አሰየፈ	assayyafa
አሰደበ	assaddaba
አሰዳቢ	asaddābi
አሰገደ	assagadda
አሰገገ	asaggaga
አሰጠ	assaṭṭa
አሰፈረ	assaffara
አሰፈሰፈ	asafassafa
አሰፈፈ	asaffafa
አሰፋ	assaffā
አሳለ	assāla
አሳለበ	asāllaba
አሳለፈ	asāllafa
አሳመ	assāma
አሳመመ	asāmmama
አሳመሰ	asāmmasa
አሳመቀ	asāmmaqa
አሳመነ	asāmmana
አሳማኝ	asāmmāñ
አሳሠረ	asāśśara
አሳረመ	asārrama
አሳረረ	assārrara
አሳረሰ	asārrasa
አሳረደ	asārrada
አሳረፈ	asārrafa
አሳራ	asārrā
አሳራሪ	assārāri
አሳራሽ	asārrāš
አሳሰበ	asāssaba
አሳሳመ	assāsāma
አሳሳቀ	assāsāqa
አሳሳበ	assāsāba
አሳሳቢ	asāssābi
አሳሳተ	assāsāta
አሳሳች	assāsāc
አሳሸ	asāšša
አሳሸገ	asāššaga
አሳቀ	assāqa
አሳቀለ	assāqqala
አሳቀቀ	assāqqaqa
አሳቀደ	asāqqada
አሳቀፈ	asāqqafa
አሳበ	assāba
አሳበረ	assābbara
አሳበቀ	assābbaqa
አሳበበ	assābbaba
አሳበደ	asābbada
አሳበጠ	asābbaṭa
አሳቢ	assābi
አሳባሪ	assābāri
አሳባቂ	assābāqi
አሳብ	assāb
አሳተ	assāta
አሳተመ	asāttama
አሳተፈ	assāttafa
አሳታሚ	asāttāmi
አሳቻ	assāccā
አሳች	assāc
አሳነሰ	asānnasa
አሳነቀ	asānnaqa
አሳነጠ	asānnaṭa
አሳነፈ	assānnafa
አሳከለ	asākkala
አሳከመ	asākkama
አሳከረ	assākkara
አሳከተ	asākkata
አሳከከ	asākkaka
አሳካ	assākkā
አሳካሚ	asākkāmi
አሳወቀ	asāwwaqa
አሳዘነ	asāzzana
አሳዘዘ	asāzzaza
አሳዛኝ	asāzzāññ
አሳየ	asāyya
አሳደለ	asāddala
አሳደደ	assāddada
አሳደገ	asāddaga
አሳደፈ	asāddafa
አሳዳጅ	assādāǧ
አሳዳጊ	asāddāgi
አሳጀለ	asāǧǧala
አሳጀበ	asāǧǧaba
አሳገደ	asāggada
አሳጣ	assāṭṭā
አሳጪ	assāċi
አሳፈረ	assāffara
አሳፈሰ	asāffasa
አሳፈነ	asāffana
አሳፋሪ	assāfāri
አስለመነ	aselammana
አስለመደ	aselammada
አስለማ	aselammā
አስለማጅ	aselammāǧ
አስለሰነ	aselassana
አስለቀለቀ	aselaqallaqa
አስለቀመ	aselaqqama
አስለቀሰ	aselaqqasa
አስለቀቀ	aselaqqaqa
አስለቃሽ	aselaqqāš
አስለበለበ	aselaballaba
አስለበሰ	aselabbasa
አስለበበ	aselabbaba
አስለበደ	aselabbada
አስለበጠ	aselabbaṭa
አስለጎመ	aselaggoma
አስለፈለፈ	aselafallafa
አስለፈፈ	aselaffafa
አስለፋ	aselaffā
አስመለሰ	asemallasa
አስመለከተ	asemalakkata
አስመለጠ	asemallaṭa
አስመሠረተ	asemaśśarata
አስመረመረ	asemarammara
አስመረረ	asemarrara
አስመረቀ	asemarraqa
አስመረዘ	asemarraza
አስመረገ	asemarraga
አስመረጠ	asemarraṭa
አስመራ	asemarrā
አስመሰለ	asemassala
አስመሰከረ	asemasakkara
አስመሰገነ	asemasaggana
አስመሳይ	asemassāy
አስመሸ	asemašša
አስመሸገ	asemaššaga
አስመተረ	asemattara
አስመታ	asemattā
አስመነታ	asemanattā
አስመነነ	asemannana
አስመነኰሰ	asemanakkwasa
አስመነዘረ	asemanazzara
አስመኘ	asemañña
አስመከረ	asemakkara
አስመዘነ	asemazzana
አስመዘዘ	asemazzaza
አስመዘገበ	asemazaggaba
አስመደበ	asemaddaba
አስመገበ	asemaggaba
አስመጠወተ	asemaṭawwata
አስማማ	asemāmmā
አስማተኛ	asemātaññā
አስማገረ	asemāggara
አስሞላ	asemollā
አስሞረደ	asemorrada
አስሞከተ	asemokkata
አስሞገተ	asemoggata
አስሞጨለፈ	asemoċallafa
አስረረ	asserrara
አስረሳ	aserassā
አስረቀቀ	aseraqqaqa
አስረበረበ	aserabarraba
አስረከበ	aserakkaba
አስረካቢ	aserakkābi
አስረዳ	aseraddā
አስረጀ	aseraǧǧa
አስረገመ	aseraggama
አስረገዘ	aseraggaza
አስረገጠ	aseraggaṭa
አስረገፈ	aseraggafa
አስረፈደ	aseraffada
አስቀለሰ	aseqallasa
አስቀለበሰ	aseqalabbasa
አስቀለጠ	aseqallaṭa
አስቀመለ	aseqammala
አስቀመመ	aseqammama
አስቀመሰ	aseqammasa
አስቀመቀመ	aseqamaqqama
አስቀመጠ	aseqammaṭa
አስቀማ	aseqammā
አስቀሠፈ	aseqaśśafa
አስቀረ	aseqarra
አስቀረደደ	aseqaraddada
አስቀረጠ	aseqarraṭa
አስቀረጸ	aseqarraṣa
አስቀረፈ	aseqarrafa
አስቀሰተ	aseqassata
አስቀሳፈተ	aseqasāffata
አስቀቀለ	aseqaqqala
አስቀበለ	aseqabbala
አስቀበረ	aseqabbara
አስቀበቀበ	aseqabaqqaba
አስቀባ	aseqabbā
አስቀነሰ	aseqannasa
አስቀና	aseqannā
አስቀዘነ	aseqazzana
አስቀዘፈ	aseqazzafa
አስቀየመ	aseqayyama
አስቀየሠ	aseqayyaśa
አስቀየደ	aseqayyada
አስቀየጠ	aseqayyaṭa
አስቀያሚ	aseqayyāmi
አስቀደመ	aseqaddama
አስቀደሰ	aseqaddasa
አስቀደደ	aseqaddada
አስቀዳ	aseqaddā
አስቀዳሽ	aseqaddāš
አስቀድሞ	aseqaddemo
አስቀጠቀጠ	aseqaṭaqqaṭa
አስቀፈቀፈ	aseqafaqqafa
አስቀፈደደ	aseqafaddada
አስቂኝ	asseqiññ
አስቃረመ	aseqārrama
አስቆለለ	aseqollala
አስቆለፈ	aseqollafa
አስቆላ	aseqollā
አስቆረሰ	aseqorrasa
አስቆየ	aseqoyya
አስቆፈረ	aseqoffara
አስቈለመመ	aseqwalammama
አስቈረቈረ	aseqwaraqqwara
አስቈረበ	aseqwarraba
አስቈረጠ	aseqwarraṭa
አስቈራ	aseqwarrā
አስበላ	aseballā
አስበረቀሰ	asebaraqqasa
አስበረበረ	asebarabbara
አስበረዘ	asebarraza
አስበረደ	asebarrada
አስበረገገ	asebaraggaga
አስበራ	asebarrā
አስበሰለ	asebassala
አስበተነ	asebattana
አስበከለ	asebakkala
አስበዘበዘ	asebazabbaza
አስበየነ	asebayyana
አስበየደ	asebayyada
አስበደለ	asebaddala
አስበዳ	asebaddā
አስበጂ	asebaǧǧi
አስበጠበጠ	asebaṭabbaṭa
አስባረከ	asebārraka
አስተለተለ	asetalattala
አስተላለቀ	asetalāllaqa
አስተላለፈ	asetalāllafa
አስተመተመ	asetamattama
አስተማመነ	asetamāmmana
አስተማረ	asetammāra
አስተሣሠረ	asetaśāśśara
አስተረተረ	asetarattara
አስተረጐመ	asetaraggwama
አስተራረሰ	asetarārrasa
አስተሳሰበ	asetasāssaba
አስተሻሸ	asetašāšša
አስተባበለ	asetabābbala
አስተባበረ	asetabābbara
አስተቸ	asetacca
አስተነተነ	asetanattana
አስተነፈሰ	asetanaffasa
አስተናበረ	asetanābbara
አስተናገደ	asetanāggada
አስተኛ	asettañā
አስተከዘ	asetakkaza
አስተካከለ	asetakākkala
አስተኰሰ	asetakkwasa
አስተዋወቀ	asetawāwwaqa
አስተዛዘበ	asetazāzzaba
አስተያየ	asetayāyya
አስተዳደረ	asetadāddara
አስተጋባ	asetagābbā
አስተፋ	asetaffā
አስታረቀ	asetārraqa
አስታቀፈ	asetāqqafa
አስታከከ	asetākkaka
አስታወሰ	asetāwwasa
አስታወቀ	asetāwwaqa
አስታገሠ	asetāggaśa
አስታጐለ	asetāggwala
አስቸረቸረ	aseccaraccara
አስቸነከረ	asecanakkara
አስቸከለ	asecakkala
አስቸኰለ	asecakkwala
አስቸኳይ	asecakkwāy
አስቸገረ	asecaggara
አስቸጋሪ	asecaggāri
አስነሣ	asennaśā
አስነረተ	asenarrata
አስነሰነሰ	asenasannasa
አስነሺ	asenašši
አስነቀለ	asenaqqala
አስነቀሰ	asenaqqasa
አስነቀፈ	asenaqqafa
አስነቃፊ	asenaqqāfi
አስነበበ	asenabbaba
አስነከረ	asenakkara
አስነከሰ	asenakkasa
አስነካ	asenakkā
አስነወረ	asenawwara
አስነዋሪ	asenawwāri
አስነደለ	asenaddala
አስነደፈ	asenaddafa
አስነዳ	asenaddā
አስነገረ	asenaggara
አስነገተ	asenaggata
አስነገደ	asenaggada
አስነጋ	asenaggā
አስነጐረ	asenaggwara
አስነፈሰ	asenaffasa
አስነፋ	asenaffā
አስከለለ	asekallala
አስከለበሰ	asekalabbasa
አስከለከለ	asekalakkala
አስከመረ	asekammara
አስከረተፈ	asekarattafa
አስከረከመ	asekarakkama
አስከሰለ	asekassala
አስከሰሰ	asekassasa
አስከሰከሰ	asekasakkasa
አስከበረ	asekabbara
አስከበበ	asekabbaba
አስከባሪ	asekabbāri
አስከተለ	asekattala
አስከተረ	asekattara
አስከተበ	asekattaba
አስከተተ	asekattata
አስከተከተ	asekatakkata
አስከነዳ	asekannadā
አስከደነ	asekaddana
አስከዳ	asekaddā
አስከፈለ	asekaffala
አስከፈነ	asekaffana
አስከፈከፈ	asekafakkafa
አስከፈፈ	asekaffafa
አስከፊ	asekaffi
አስከፋ	asekaffā
አስካካ	asekākkā
አስኮላሸ	asekolāšša
አስኮረጀ	asekorraǧa
አስኮረፈ	asekorrafa
አስኮበለለ	asekoballala
አስኮተኮተ	asekotakkota
አስኰነነ	asekwannana
አስኰናኝ	asekwannāñ
አስወለቀ	asewallaqa
አስወለደ	asewallada
አስወረረ	asewarrara
አስወረወረ	asewarawwara
አስወረደ	asewarrada
አስወራ	asewarrā
አስወሰነ	asewassana
አስወሰደ	asewassada
አስወቀረ	asewaqqara
አስወቀጠ	asewaqqaṭa
አስወቃ	asewaqqā
አስወተፈ	asewattafa
አስወነጀለ	asewanaǧǧala
አስወደደ	asewaddada
አስወገረ	asewaggara
አስወገደ	asewaggada
አስወጋ	asewaggā
አስዋኘ	asewāñña
አስደለደለ	asedaladdala
አስደመረ	asedammara
አስደመሰሰ	asedamassasa
አስደረተ	asedarrata
አስደረደረ	asedaraddara
አስደረገ	asedarraga
አስደራጊ	asedarrāgi
አስደሰተ	asedassata
አስደሳች	asedassāc
አስደቀቀ	asedaqqaqa
አስደበለቀ	asedaballaqa
አስደበቀ	asedabbaqa
አስደባለቀ	asedabāllaqa
አስደነሰ	asedannasa
አስደነቀ	asedannaqa
አስደነበረ	asedanabbara
አስደነገጠ	asedanaggaṭa
አስደናቂ	asedannāqi
አስደወለ	asedawwala
አስደገመ	asedaggama
አስደገሰ	asedaggasa
አስደገደገ	asedagaddaga
አስደፈረ	asedaffara
አስደፈቀ	asedaffaqa
አስደፈነ	asedaffana
አስደፈጠ	asedaffaṭa
አስጀመረ	aseǧammara
አስገለበጠ	asegalabbaṭa
አስገመሰ	asegammasa
አስገመተ	asegammata
አስገመገመ	asegamaggama
አስገረመ	asegarrama
አስገረዘ	asegarraza
አስገራ	asegarrā
አስገራሚ	asegarrāmi
አስገባ	asegabbā
አስገነዘበ	aseganazzaba
አስገኘ	asegañña
አስገዘተ	asegazzata
አስገደለ	asegaddala
አስገደደ	asegaddada
አስገደፈ	asegaddafa
አስጎመጀ	asegomaǧǧa
አስጐበኘ	asegwabañña
አስጐነበሰ	asegwanabbasa
አስጠለለ	aseṭallala
አስጠላ	aseṭallā
አስጠመደ	aseṭammada
አስጠማ	aseṭammā
አስጠራ	aseṭarrā
አስጠቃ	aseṭaqqā
አስጠነቀቀ	aseṭanaqqaqa
አስጠና	aseṭannā
አስጠኚ	aseṭaññi
አስጠየፈ	aseṭayyafa
አስጠያፊ	aseṭayyāfi
አስጠይ	aseṭayy
አስጠገነ	aseṭaggana
አስጠጋ	aseṭaggā
አስጨመረ	aseċammara
አስጨመቀ	aseċammaqa
አስጨበጨበ	aseċabaċċaba
አስጨነቀ	aseċannaqa
አስጨናቂ	aseċannāqi
አስጨፈለቀ	aseċafallaqa
አስጨፈረ	aseċaffara
አስጸየፈ	aseṣṣayyafa
አስጸያፊ	aseṣṣayyāfi
አስፈለገ	asefallaga
አስፈለገኝ	asefallagaññ
አስፈለፈለ	asefalaffala
አስፈላ	asefallā
አስፈረመ	asefarrama
አስፈረደ	aseffarada
አስፈሪ	asefarri
አስፈራ	asefarrā
አስፈራራ	asefarārrā
አስፈሳ	asefassā
አስፈሳው	asefassāw
አስፈቀደ	asefaqqada
አስፈተሸ	asefattaša
አስፈተነ	asefattana
አስፈተገ	asefattaga
አስፈታ	asefattā
አስፈጀ	asefaǧǧa
አስፋፋ	asefāffā
አሶመሰመ	asomassama
አሸ	ašša
አሸለለ	aššallala
አሸለመ	ašallama
አሸለቀቀ	aššalaqqaqa
አሸለበ	ašallaba
አሸለተ	aššallata
አሸመ	aššama
አሸመተ	ašammata
አሸመገለ	ašamaggala
አሸመጠጠ	aššamaṭṭaṭa
አሸረሞጠ	ašarammoṭa
አሸረጠ	ašarraṭa
አሸረፈ	ašarrafa
አሸሸ	aššaša
አሸሸገ	aššaššaga
አሸቀለ	aššaqqala
አሸቀበ	ašaqqaba
አሸበረ	aššabbara
አሸበረቀ	ašabarraqa
አሸበሸበ	ašabaššaba
አሸበበ	aššabbaba
አሸበተ	ašabbata
አሸባሪ	aššabbāri
አሸተተ	ašattata
አሸነሸነ	aššanaššana
አሸነፈ	aššannafa
አሸና	aššannā
አሸናፊ	aššannāfi
አሸኘ	aššañña
አሸኛኘት	aššañāñat
አሸከመ	aššakkama
አሸካሸከ	aššakāššaka
አሸዋማ	ašawāmmā
አሸዋነት	ašawānnat
አሸገ	aššaga
አሸጋሸገ	aššagāššaga
አሸጋገረ	aššagāggara
አሸጠ	aššaṭa
አሸፈተ	ašaffata
አሸፈነ	aššaffana
አሻለ	aššāla
አሻማ	aššāmmā
አሻረ	aššāra
አሻረከ	aššārraka
አሻሸ	ašāšša
አሻሻለ	aššāšāla
አሻሻጠ	aššāšāṭa
አሻሻጭ	aššāšāċ
አሻቀበ	ašāqqaba
አሻንጉሊት	ašānegullit
አሻከረ	ašākkara
አሻገረ	ašāggara
አሻገተ	ašāggata
አሻፈረኝ	ašāffarañ
አሻፈደ	ašāffada
አሽሙረኛ	ašemuraññā
አሽሟጣጭነት	ašemwāṭāċennat
አሽቀዳደመ	ašeqadāddama
አሽቆጠቆጠ	ašeqoṭaqqoṭa
አሽበለበለ	ašebalabbala
አሽታ	aššetā
አሽከረከረ	ašekarakkara
አሽከርነት	ašekarennat
አሽካካ	ašekkākā
አሽኮረመመ	ašekorammama
አሾለቀ	ašollaqa
አሾለከ	ašollaka
አሾላቂ	ašollāqi
አሾመ	aššoma
አሾከሾከ	ašokaššoka
አቀለለ	aqallala
አቀለመ	aqallama
አቀለጠ	aqallaṭa
አቀላ	aqallā
አቀላል	aqqalāl
አቀላቀለ	aqqalāqqala
አቀላጠፈ	aqqalāṭṭafa
አቀመሰ	aqammasa
አቀማመጥ	aqqamāmaṭ
አቀማጠለ	aqqamāṭṭala
አቀረረ	aqarrara
አቀረቀረ	aqaraqqara
አቀረበ	aqarraba
አቀረና	aqarannā
አቀረጣጠፈ	aqqaraṭāṭṭafa
አቀራረበ	aqqarārraba
አቀሰሰ	aqassasa
አቀበለ	aqabbala
አቀበጠ	aqabbaṭa
አቀባበለ	aqqabābbala
አቀባበረ	aqqabābbara
አቀባባይ	aqqabābāy
አቀባይ	aqabbāy
አቀነቀነ	aqanaqqana
አቀነበጠ	aqanabbaṭa
አቀነባበረ	aqqanabābbara
አቀነባባሪ	aqqanabābbāri
አቀና	aqannā
አቀናበረ	aqqanābbara
አቀናበር	aqqanābbar
አቀናባሪ	aqqanābāri
አቀናነሰ	aqqanānnasa
አቀዘቀዘ	aqazaqqaza
አቀዛቀዘ	aqqazāqaza
አቀያየረ	aqqayāyyara
አቀያየደ	aqayāyyada
አቀያየጠ	aqqayāyyaṭa
አቀዳጀ	aqadāǧǧa
አቀጣጠረ	aqqaṭāṭara
አቀጣጠነ	aqqaṭāṭana
አቀፈ	aqqafa
አቀፍ	aqqaf
አቁለጨለጨ	aqulaċallaċa
አቁላላ	aqulāllā
አቁነጠነጠ	aqunaṭannaṭa
አቃለለ	aqqāllala
አቃመሰ	aqāmmasa
አቃረበ	aqqāraba
አቃራመ	aqqārrāma
አቃሰተ	aqāssata
አቃበረ	aqqābbara
አቃባ	aqqābbā
አቃነሰ	aqqānnasa
አቃና	aqqānnā
አቃወሰ	aqāwwasa
አቃዋሽ	aqqāwāš
አቃዠ	aqāžža
አቃጠለ	aqqāṭṭala
አቃጠረ	aqqāṭara
አቃጠፈ	aqqāṭṭafa
አቃጣሪ	aqqāṭāri
አቅለሸለሸ	aqelašallaša
አቅለበለበ	aqelaballaba
አቅማማ	aqemāmmā
አቅራቢያ	aqerābbiyā
አቅበዘበዘ	aqebazabbaza
አቅነዘነዘ	aqenazannaza
አቅጣጫ	aqeṭāċċā
አቆለቆለ	aqolaqqola
አቆላለፈ	aqqolāllafa
አቆላመጠ	aqqolāmmaṭa
አቆራኘ	aqqorāñña
አቆሸሸ	aqoššaša
አቆነጀ	aqonaǧǧa
አቆየ	aqoyya
አቆጠቆጠ	aqoṭaqqoṭa
አቈለቈለ	aqwalaqqwala
አቈላለፈ	aqwalāllafa
አቈረቈዘ	aqwaraqqwaza
አቈረበ	aqwarraba
አቈረፈደ	aqwaraffada
አቈራመደ	aqqwarāmmada
አቈራረጠ	aqqwarārraṭa
አቈሰለ	aqwassala
አቈሳሰለ	aqwasāssala
አቈነሰ	aqwannasa
አቈጣጠረ	aqqwaṭāṭṭara
አቋለፈ	aqqwāllafa
አቋመጠ	aqwāmmaṭa
አቋረጠ	aqqwārraṭa
አቋራጭ	aqqwārāċ
አቋቋመ	aqqwāqwāma
አቋቋሚ	aqqwāqwāmi
አቋቋም	aqqwāqwām
አቋፈረ	aqqwāffara
አበለ	abbala
አበለዘ	aballaza
አበለጠ	aballaṭa
አበላ	aballā
አበላለጠ	abalāllaṭa
አበላሸ	abalāšša
አበል	aball
አበረ	abbara
አበረረ	abarrara
አበረታ	abarattā
አበረከተ	abarakkata
አበረደ	abarrada
አበረገገ	abaraggaga
አበራ	abarrā
አበራከተ	abbarākkata
አበራየ	abarāyya
አበር	abbar
አበሰ	abbasa
አበሰለ	abassala
አበሰረ	abassara
አበሰበሰ	abasabbasa
አበሳጨ	abbasāċċa
አበሸቀ	abaššaqa
አበሸቀጠ	abbašaqqaṭa
አበሻቀጠ	abbašāqqaṭa
አበቀለ	abaqqala
አበቃ	abaqqā
አበቃቃ	abbaqāqqā
አበበ	abbaba
አበባማ	ababāmmā
አበታተነ	abbatāttana
አበከተ	abakkata
አበካከነ	abakākkana
አበዛ	abazzā
አበደረ	abaddara
አበዳሪ	abaddāri
አበጀ	abaǧǧa
አበጃጀ	abaǧāǧǧa
አበገነ	abaggana
አበጠ	abbaṭa
አበጣበጠ	abbaṭābbaṭa
አበጣባጭ	abbaṭābāċ
አባ	abbā
አባለገ	abāllaga
አባለጠ	abāllaṭa
አባላ	abāllā
አባልነት	abālennat
አባረረ	abbārrara
አባረቀ	abārraqa
አባራ	abārrā
አባራሪ	abbārāri
አባቃ	abāqqā
አባበለ	abābbala
አባበጠ	abābbaṭa
አባባ	abbābbā
አባባለ	abbābāla
አባባል	abbābāl
አባባሰ	abbābāsa
አባቴ	abbāté
አባት	abbāt
አባነነ	abānnana
አባከነ	abākkana
አባካኝ	abākāññ
አባወራ	abbāwarrā
አባዛ	abāzzā
አባዥ	abbāž
አባዬ	abbāyé
አባይ	abbāy
አባይነት	abāyennat
አባዳ	abbādā
አባጨጓሬ	abbāċaggwārré
አብላላ	abellālā
አብረቀረቀ	aberaqarraqa
አብረከረከ	aberakarraka
አብራራ	aberārrā
አብሰለሰለ	abesalassala
አብቃቃ	abeqāqqā
አብነት	abennat
አብዛኛው	abezāññāw
አብዛኛውን	abezāññāwen
አቦ	abbo
አቦነነ	abonnana
አቦካ	abokkā
አቦዘነ	abozzana
አቧለተ	abwāllata
አቧራማ	abwārrāmā
አቧደነ	abbwāddana
አተላ	atallā
አተመ	attama
አተመተመ	atamattama
አተረማመሰ	attaramāmmasa
አተረፈ	atarrafa
አተራመሰ	attarāmmasa
አተራማሽ	attarāmāš
አተራረፈ	atarārrafa
አተራተረ	attarāttara
አተበ	attaba
አተተ	attata
አተኛኘት	attañāñat
አተኛኝ	attañāñ
አተከነ	atakkana
አተኮረ	atakkora
አተኰሰ	atakkwasa
አታለለ	attālala
አታላይ	attālāy
አታሚ	attāmi
አታቢ	attābi
አታች	attāc
አታከለ	attākkala
አታከተ	atākkata
አታገለ	attāggala
አታጋይ	attāgāy
አትራ	atterā
አትክልተኛ	atekelettañā
አትጠራጠር	atteṭṭarāṭar
አቶሰቶሰ	atosattosa
አቶፈቶፈ	atofattofa
አቸነፈ	accannafa
አቻ	accā
አቻምና	accāmenā
አቻቻለ	accācāla
አቻኳይ	accākwāy
አነሣ	anaśśā
አነሣሣ	annaśāśśā
አነሣሽ	annaśāš
አነሰ	annasa
አነሰረ	anassara
አነስተኛ	anasetaññā
አነቀ	annaqa
አነቀዘ	anaqqaza
አነቀፈ	anaqqafa
አነቃ	anaqqā
አነቃቂ	annaqāqi
አነቃቃ	annaqāqqā
አነቃነቀ	annaqānnaqa
አነቃናቂ	annaqānāqi
አነቈረ	anaqqwara
አነበበ	anabbaba
አነበነበ	anabannaba
አነበዘ	anabbaza
አነባ	anabbā
አነባበረ	annabābbara
አነባበሮ	annabābaro
አነባበበ	anabābbaba
አነታረከ	annatārraka
አነኈለለ	anaẖwallala
አነከሰ	anakkasa
አነከተ	anakkata
አነካከሰ	anakākkasa
አነካኪ	annakāki
አነካካ	annakākkā
አነኰረ	anakkwara
አነኰተ	anakkwata
አነኳኰተ	anakwākkwata
አነወረ	anawwara
አነዘረ	anazzara
አነደደ	anaddada
አነዳድ	annadād
አነገሠ	anaggaśa
አነገበ	anaggaba
አነገተ	anaggata
አነጋ	anaggā
አነጋገር	annagāgar
አነጋጋ	anagāggā
አነጋጋሪ	annagāgāri
አነጐረ	anaggwara
አነጐተ	anaggwata
አነጐድ	anaggwad
አነጠ	annaṭa
አነጠነጠ	anaṭannaṭa
አነጣጠለ	annaṭāṭṭala
አነጣጠረ	annaṭāṭṭara
አነጣጣሪ	annaṭāṭāri
አነጫነጨ	anaċānnaċa
አነጻጸረ	annaṣāṣṣara
አነፈረ	anaffara
አነፈረቀ	anafarraqa
አነፈሰ	anaffasa
አነፈነ	annafana
አነፈነፈ	anafannafa
አነፋረቀ	annafārraqa
አነፋፈሰ	anafāffasa
አናረ	annāra
አናቀለ	annāqqala
አናበበ	annābbaba
አናባቢ	annābābi
አናከሰ	annākkasa
አናኪ	annāki
አናካ	annākkā
አናዘዘ	annāzzaza
አናዛዥ	annāzāž
አናደደ	annāddada
አናደፈ	annāddafa
አናዳ	annāddā
አናዳጅ	annādāǧ
አናገሠ	annāggaśa
አናገረ	annāggara
አናጊ	annāgi
አናጋ	annāggā
አናጋሪ	annāgāri
አናጋሽ	annāgāš
አናጠቀ	annāṭṭaqa
አናጠበ	annāṭṭaba
አናጠፈ	annāṭafa
አናጢነት	anāṭinnat
አናፈሰ	annāffasa
አናፋ	anāffā
አንሰፈሰፈ	anesafassafa
አንሸረሸረ	anešaraššara
አንሸዋረረ	anešawārrara
አንሻተተ	anešāttata
አንሻፈፈ	anešāffafa
አንሾካሾከ	anešokāšokka
አንሿከከ	anešwākkaka
አንሿካኪ	anešwākkāki
አንቀለቀለ	aneqalaqqala
አንቀላፋ	aneqalāffā
አንቀረበበ	aneqarabbaba
አንቀረፈፈ	aneqaraffafa
አንቀሰቀሰ	aneqasaqqasa
አንቀሳቀሰ	aneqasāqqasa
አንቀባረረ	aneqabārrara
አንቀዋለለ	aneqawāllala
አንቀጠቀጠ	aneqaṭaqqaṭa
አንቃረረ	aneqārrara
አንቆረቆረ	aneqoraqqora
አንቋሸሸ	aneqwāššaša
አንበለበለ	anebalabbala
አንበረከከ	anebarakkaka
አንበሳ	anebassā
አንበሸበሸ	anebašabbaša
አንቦራቀቀ	aneborāqqaqa
አንቦገቦገ	anebogabboga
አንቦጨቦጨ	aneboċċabboċa
አንቦጫቦጨ	aneboċċābboċa
አንተላከሰ	anetalākkasa
አንተረከከ	anetarakkaka
አንተከተከ	anetakattaka
አንተገተገ	anetagattaga
አንቺዬ	aneciyyé
አንከረፈፈ	anekaraffafa
አንከራተተ	anekarāttata
አንከበከበ	anekabakkaba
አንከባለለ	anekabāllala
አንከባከበ	anekabākkaba
አንከተከተ	anekatakkata
አንከታከተ	anekatākkata
አንከፈረረ	anekafarrara
አንካላ	anekāllā
አንካሳ	anekāssā
አንካሴ	anekāssé
አንኳሰሰ	anekwāssasa
አንኳኳ	anekwākkwā
አንዘላዘለ	anezalāzzala
አንዘረፈጠ	anezaraffaṭa
አንዘረፈፈ	anezaraffafa
አንዘፈዘፈ	anezafazzafa
አንዛረጠ	anezārraṭa
አንዛዛ	anezāzzā
አንዠቀዘቀ	anežaqazzaqa
አንዠቀዠቀ	anežaqažžaqa
አንዣበበ	anežābbaba
አንዣባቢ	anežābbābi
አንደላቀቀ	anedalāqqaqa
አንደረበበ	anedarabbaba
አንደቀደቀ	anedaqaddaqa
አንደበደበ	anedabaddaba
አንደባለለ	anedabāllala
አንደኛ	anedaññā
አንደፋደፈ	anedafāddafa
አንዳች	anedācc
አንድም	anedemm
አንድነት	anedennat
አንጀረገገ	aneǧaraggaga
አንጀተ	aneǧǧata
አንገላታ	anegalāttā
አንገረገበ	anegaraggaba
አንገራገረ	anegarāggara
አንገሸገሸ	anegašaggaša
አንገበገበ	anegabaggaba
አንገዋለለ	anegawāllala
አንገደገደ	anegadaggada
አንገዳገደ	anegadāggada
አንገጫገጨ	anegaċāggaċa
አንገፈገፈ	anegafaggafa
አንጋለለ	anegāllala
አንጋሬ	anegārré
አንጋደደ	anegāddada
አንጋጋ	anegāggā
አንጋፋ	anegāffā
አንግዋለለ	anegewāllala
አንጐራደደ	anegwarāddada
አንጐራጐረ	anegwarāggwara
አንጐደጐደ	anegwadaggwada
አንጓለለ	anegwāllala
አንጕራጐረ	anegwerāggwara
አንጠራራ	aneṭarrārā
አንጠራራኝ	aneṭarārāññ
አንጠራወዘ	aneṭarāwwaza
አንጥረኛ	aneṭeraññā
አንጨረፈፈ	aneċaraffafa
አንጸባረቀ	aneṣabārraqa
አንፈራገጠ	anefarāggaṭa
አንፈራፈረ	anefarāffara
አንፈቀፈቀ	anefaqaffaqa
አንፏቀቀ	anefwāqqaqa
አንፏቃቂ	anefwāqqāqi
አኘከ	aññaka
አኢሉባቦር	aʼilubbābor
አከለ	akkala
አከላከለ	akkalākkala
አከል	akkal
አከመ	akkama
አከመቻቸ	akamacācca
አከማቸ	akkamācca
አከረመ	akarrama
አከረረ	akarrara
አከረፋ	akaraffā
አከራካሪ	akkarākāri
አከራየ	akkarāyya
አከሰለ	akassala
አከሰመ	akassama
አከሰረ	akassara
አከሰከሰ	akasakkasa
አከሳ	akassā
አከበረ	akabbara
አከበደ	akabbada
አከባበረ	akabābbara
አከባበር	akkabābar
አከተ	akkata
አከተመ	akattama
አከታተለ	akkatāttala
አከነነ	akannana
አከነፈ	akannafa
አከናነበ	akkanānnaba
አከናወ	akkannāwa
አከናወነ	akkanāwwana
አከከ	akkaka
አከድዬ	akkadeyyé
አከፈለ	akaffala
አከፋ	akaffā
አከፋፈለ	akkafāffala
አከፋፋይ	akkafāfāy
አካለለ	akkālala
አካለሰ	akkāllasa
አካመረ	akkāmmara
አካሚ	akkāmi
አካሰሰ	akkāssasa
አካበበ	akkābbaba
አካበተ	akābbata
አካባቢ	akkābābi
አካተተ	akkāttata
አካቴ	akkāté
አካከከ	akākkaka
አካካሰ	akkākāsa
አካደነ	akkāddana
አካፈለ	akkāffala
አካፋ	akāffā
አካፋይ	akkāfāy
አክ	akk
አክለፈለፈ	akelafallafa
አክታ	akketā
አኮላሸ	akkolāšša
አኮመታተረ	akkomatāttara
አኮማተረ	akkomāttara
አኮረፈ	akorrafa
አኮራ	akorrā
አኮራመተ	akkorāmmata
አኮሰመነ	akosammana
አኮበለለ	akoballala
አኰረተ	akwarrata
አኰሰሰ	akwassasa
አኰበኰበ	akwabakkwaba
አኰቴት	akkwatét
አኳሁዋን	akkwāhuwān
አኳሰሰ	akwāssasa
አወለቀ	awallaqa
አወለወለ	awalawwala
አወለጋገደ	awwalagāggada
አወላለቀ	awalāllaqa
አወላመመ	awwalāmmama
አወላከፈ	awwalākkafa
አወላካፊ	awwalākāfi
አወላወለ	awwalāwwala
አወላገደ	awwalāggada
አወረሰ	awarrasa
አወረዛ	awarazzā
አወረደ	awarrada
አወራ	awarrā
አወራረሰ	awarārrasa
አወራረደ	awarārrada
አወራጨ	awwarāċa
አወሰለተ	awasallata
አወሳ	awassā
አወበቀ	awabbaqa
አወናበደ	awwanābbada
አወናባጅ	awwanābbāǧ
አወናከረ	awwanākkara
አወናፈለ	awwanāffala
አወከ	awwaka
አወካ	awakkā
አወዛወዘ	awwazāwwaza
አወደለ	awaddala
አወደመ	awaddama
አወደሰ	awaddasa
አወዳደረ	awwadāddara
አወዳዳሪ	awwadādāri
አወጋ	awaggā
አወጣ	awaṭṭā
አወጣጣ	awwaṭāṭṭā
አወፈረ	awaffara
አዋለደ	awwāllada
አዋላጅ	awwālāǧ
አዋልደጌሻ	awāledagéššā
አዋሐደ	awwāḥada
አዋረደ	awwārrada
አዋራ	awwārā
አዋሰነ	awwāssana
አዋሰደ	awwāssada
አዋሳኝ	awwāsāñ
አዋሸከ	awwāššaka
አዋቀጠ	awwāqqaṭa
አዋቃ	awwāqqā
አዋኪ	awwāki
አዋዋለ	awwāwāla
አዋዋይ	awwāwāy
አዋዛ	awwāzzā
አዋየ	awwāya
አዋደደ	awwāddada
አዋጊ	awwāgi
አዋጋ	awwāggā
አዋጠረ	awwāṭṭara
አዋጣ	awwāṭṭā
አዋጪ	awwāċi
አውለበለበ	awelaballaba
አውላላ	awelāllā
አውራጃ	awerrāǧā
አውሬነት	awerénnat
አውሮፓ	aweroppā
አውሮፕላን	aweroppelān
አውተረተረ	awetarattara
አውተፈተፈ	awetafattafa
አውታታ	awetāttā
አውደለደለ	awedaladdala
አውድማ	awedemmā
አውጫጭኝ	aweċāċċeññ
አዘለ	azzala
አዘለለ	azzalala
አዘለቀ	azallaqa
አዘለፈ	azzallafa
አዘመመ	azammama
አዘመረ	azammara
አዘመተ	azammata
አዘረዘረ	azzarazzara
አዘረገፈ	azzaraggafa
አዘረጋ	azzaragā
አዘረጋጋ	azzaragāggā
አዘረጠ	azarraṭa
አዘረጠጠ	azzaraṭaṭa
አዘረፈ	azzarrafa
አዘራ	azzarā
አዘቀዘቀ	azaqazzaqa
አዘቀጠ	azaqqaṭa
አዘበራረቀ	azzabarārraqa
አዘባረቀ	azzabārraqa
አዘባነነ	azzabānnana
አዘነ	azzana
አዘነበ	azannaba
አዘነበለ	azanabbala
አዘነጋ	azanaggā
አዘነጠለ	azzanaṭṭala
አዘናከተ	azzanākkata
አዘናጋ	azzanāggā
አዘንተኛ	azanetaññā
አዘከረ	azakkara
አዘከዘከ	azzakazzaka
አዘወረ	azzawwara
አዘወተረ	azawattara
አዘዘ	azzaza
አዘገመ	azaggama
አዘገነ	azzaggana
አዘገየ	azagayya
አዘገጀ	azzagaǧǧa
አዘጋ	azzaggā
አዘጋጀ	azzagāǧǧa
አዘጋገመ	azagāggama
አዘጠዘጠ	azaṭazzaṭa
አዘፈቀ	azaffaqa
አዘፈነ	azzaffana
አዛለቀ	azzāllaqa
አዛመተ	azzāmmata
አዛመደ	azzāmmada
አዛማች	azzāmāc
አዛማጅ	azzāmāǧ
አዛቀ	azzāqa
አዛባ	azzābbā
አዛነፈ	azzānnafa
አዛወረ	azzāwwara
አዛዘነ	azāzzana
አዛዥ	azzāž
አዛጋ	azzāggā
አዛፈነ	azzāffana
አዝለገለገ	azelagallaga
አዝማሚያ	azemāmmiyā
አዝረበረበ	azerabbarraba
አዝረከረከ	azerakarraka
አዝረጠረጠ	azeraṭarraṭa
አዝረፈረፈ	azerafarrafa
አዝናና	azenānnā
አዝጎረጎረ	azegoragorra
አዞ	azzo
አዠ	ažža
አዠለጠ	ažžallaṭa
አዥጎረጎረ	ažegoraggora
አዥጎደጎደ	ažegodaggoda
አዥጐረጐረ	ažegwaraggwara
አየ	ayya
አየለ	ayyala
አየር	ayyar
አየው	ayyaw
አያ	ayyā
አያሌ	ayyālé
አያያ	ayyāyyā
አያያዘ	ayyāyāza
አያያዝ	ayyāyāz
አይልም	ayelemm
አይቀርም	ayeqaremm
አይደለም	ayedallam
አይገባኝም	ayegabāññem
አይጥማ	ayeṭemmā
አደለ	addala
አደለበ	adallaba
አደላ	adallā
አደላደለ	addalāddala
አደላዳይ	addalādāy
አደመ	addama
አደመቀ	adammaqa
አደመጠ	adammaṭa
አደማ	adammā
አደረ	addara
አደረሰ	adarrasa
አደረገ	addarraga
አደረገው	adarragaw
አደራ	adarrā
አደራረግ	addarārag
አደራደረ	addarāddara
አደራጀ	adarāǧǧa
አደራጅ	addarāǧ
አደር	addar
አደርክ	addarek
አደሰ	addasa
አደሸደሸ	adašaddaša
አደቀቀ	adaqqaqa
አደበ	addaba
አደበነ	adabbana
አደበዘዘ	adabazzaza
አደባ	addabā
አደባለቀ	adabāllaqa
አደባባይ	addabābāy
አደባየ	adabāyya
አደብ	addab
አደነ	addana
አደነቀ	adannaqa
አደነቆረ	adanaqqora
አደነዘ	adannaza
አደነዘዘ	adanazzaza
አደነጋገረ	addanagāggara
አደናቀፈ	addanāqqafa
አደናበረ	addanābbara
አደናባሪ	addanābāri
አደናገረ	addanāggara
አደናገጠ	addanāggaṭa
አደናጋሪ	addanāgāri
አደን	addan
አደንጓሬ	adanegwārré
አደከመ	adakkama
አደኸየ	adaxayya
አደዘደዘ	adazaddaza
አደደበ	adaddaba
አደገ	addaga
አደገኛ	adagaññā
አደገደ	adaggada
አደግ	addag
አደፈ	addafa
አደፈረሰ	addafarasa
አደፈጠ	adaffaṭa
አደፋፈረ	addafāffara
አዱኛ	adduññā
አዲስ	addis
አዳለጠ	adāllaṭa
አዳላ	addāllā
አዳመረ	addāmmara
አዳመቀ	addāmmaqa
አዳመጠ	addāmmaṭa
አዳሚ	addāmi
አዳማቂ	addāmmāqi
አዳም	addām
አዳምና	addāmennā
አዳረሰ	addārrasa
አዳራሽ	addārāš
አዳሽ	addāš
አዳቀለ	addāqqala
አዳቀቀ	addāqqaqa
አዳበለ	addābbala
አዳበረ	adābbara
አዳባይ	addābāy
አዳነቀ	adānnaqa
አዳኝ	addāñ
አዳከመ	addākkama
አዳወረ	adāwwara
አዳይ	addāy
አዳደለ	adāddala
አዳደሰ	adāddasa
አዳገተ	adāggata
አዳፈነ	adāffana
አዳፋ	addāffā
አዳፍኔ	addāfené
አድሎኛ	adeloññā
አድመኛ	ademaññā
አድረገ	aderraga
አድራሻ	aderāššā
አድበለበለ	adebalabbala
አድበሰበሰ	adebasabbasa
አድቦለቦለ	adebolabbola
አድፈነፈነ	adefanaffana
አድፋፋ	adefāffā
አዶ	addo
አዶለዶመ	adoladdoma
አጀለ	aǧǧala
አጀበ	aǧǧaba
አጃ	aǧǧā
አጃቢ	aǧǧābi
አጃጃለ	aǧǧāǧāla
አጃገነ	aǧǧāgana
አጅሬ	aǧǧeré
አገለለ	agallala
አገለሞተ	agalammota
አገለደመ	agaladdama
አገለገለ	agallagala
አገላበጠ	aggalābbaṭa
አገመ	aggama
አገማ	agammā
አገሣ	agaśśā
አገረሸ	agarašša
አገረሸበት	agaraššabbat
አገሸሸ	agaššaša
አገባ	agabbā
አገባብ	aggabāb
አገባት	agabbāt
አገባደደ	aggabāddada
አገተ	aggata
አገነፋ	aganaffā
አገናኘ	aganāñña
አገናኝ	agganāññ
አገናዘበ	agganāzaba
አገናዛቢ	agganāzābi
አገኘ	agañña
አገዘ	aggaza
አገዝ	aggaz
አገደ	aggada
አገደመ	agaddama
አገደፈ	agaddafa
አገድ	aggad
አገገመ	agaggama
አገጋሚ	agaggāmi
አገጫጨ	aggaċāċċa
አጋለጠ	aggāllaṭa
አጋመሰ	aggāmmasa
አጋሚ	aggāmi
አጋማሽ	aggāmāš
አጋሪ	aggāri
አጋራ	aggārā
አጋር	aggār
አጋሰሰ	agāssasa
አጋሰስ	agāssas
አጋበሰ	agābbasa
አጋባ	aggābbā
አጋተረ	aggāttara
አጋነነ	aggānnana
አጋኖ	aggānno
አጋዛ	aggāzzā
አጋዥ	aggāž
አጋየ	agāyya
አጋደለ	agāddala
አጋደመ	aggāddama
አጋደደ	aggāddada
አጋጅ	aggāǧ
አጋጋለ	aggāgāla
አጋጋመ	aggāgāma
አጋጠመ	aggāṭṭama
አጋጣሚ	aggāṭāmi
አጋጨ	aggāċa
አጋፈረ	aggāfara
አጋፈጠ	aggāffaṭa
አጋፋሪ	aggāfāri
አግበሰበሰ	agebasabbasa
አግተለተለ	agetalattala
አግዶኝ	ageddoññ
አግጣጫ	ageṭāċċā
አግፈለፈለ	agefalaffala
አጎላመሰ	agolāmmasa
አጎላማሽ	aggolāmāš
አጎመዘዘ	agomazzaza
አጎረሰ	agorrasa
አጎራበተ	aggorābbata
አጎት	aggot
አጎናጠፈ	aggonāṭṭafa
አጎደለ	agoddala
አጎፈረ	agoffara
አጐላ	agwallā
አጐረ	aggwara
አጐረና	agwarannā
አጐራ	agwarrā
አጐሳቈለ	agwasāqqwala
አጐበደደ	agwabaddada
አጐበጐበ	agwabaggwaba
አጐበጠ	agwabbaṭa
አጐተነ	agwattana
አጐነቈለ	agwanaqqwala
አጐነበሰ	agwanabbasa
አጐደጐደ	agwadaggwada
አጓመጠ	agwāmmaṭa
አጓራ	agwārrā
አጓት	aggwāt
አጓደደ	aggwāddada
አጓጐለ	agwāggwala
አጓጓዘ	aggwāgwāza
አጕመተመተ	agwematammata
አጕረመረመ	agweramarrama
አጕረጠረጠ	agweraṭarraṭa
አጕተመተመ	agwetamattama
አጠለለ	aṭallala
አጠለቀ	aṭallaqa
አጠለቀው	aṭallaqaw
አጠመቀ	aṭammaqa
አጠማ	aṭammā
አጠረሰ	aṭarrasa
አጠረኝ	aṭṭaraññ
አጠራ	aṭarrā
አጠራቀመ	aṭṭarāqqama
አጠቀሰ	aṭaqqasa
አጠቃ	aṭaqqā
አጠቃለለ	aṭṭaqāllala
አጠቆረ	aṭaqqora
አጠበቀ	aṭabbaqa
አጠበበ	aṭabbaba
አጠባ	aṭabbā
አጠነባ	aṭanabbā
አጠነነ	aṭannana
አጠነከረ	aṭanakkara
አጠነፈፈ	aṭanaffafa
አጠና	aṭannā
አጠናቀረ	aṭṭanāqqara
አጠናቀቀ	aṭṭanāqqaqa
አጠናከረ	aṭṭanākkara
አጠናጋ	aṭanāggā
አጠየቀ	aṭayyaqa
አጠያየፈ	aṭṭayāyyafa
አጠገበ	aṭaggaba
አጠጋጋ	aṭṭagāggā
አጠፈፈ	aṭaffafa
አጠፋ	aṭaffā
አጣላ	aṭṭālā
አጣመመ	aṭāmmama
አጣመረ	aṭāmmara
አጣመደ	aṭāmmada
አጣራ	aṭṭārā
አጣቀሰ	aṭṭāqqasa
አጣበቀ	aṭṭābbaqa
አጣበበ	aṭṭābbaba
አጣብቂኝ	aṭṭābeqiññ
አጣየቀ	aṭṭāyyaqa
አጣደፈ	aṭṭāddafa
አጣገበ	aṭṭāggaba
አጣፈረ	aṭṭāffara
አጣፈጠ	aṭāffaṭa
አጣፋ	aṭṭāffā
አጥለቀለቀ	aṭelaqallaqa
አጥላላ	aṭelāllā
አጥመለመለ	aṭemalammala
አጥመዘመዘ	aṭemazammaza
አጥበረበረ	aṭebarabbara
አጥናና	aṭenānnā
አጥወለወለ	aṭewalawwala
አጥፊና	aṭefinnā
አጨለመ	aċallama
አጨለገ	aċallaga
አጨማለቀ	aċċamāllaqa
አጨማተረ	aċċamāttara
አጨማደደ	aċċamāddada
አጨራመመ	aċċarāmmama
አጨራመደ	aċċarāmmada
አጨቀየ	aċaqayya
አጨባበጠ	aċċabābbaṭa
አጨነቆረ	aċanaqqora
አጨነጎለ	aċċanaggola
አጨናገፈ	aċċanāggafa
አጫረሰ	aċċārrasa
አጫረተ	aċċārrata
አጫወተ	aċċāwwata
አጭበረበረ	aċebarabbara
አጸለየ	aṣṣallaya
አጸና	aṣannā
አጸየፈ	aṣṣayyafa
አጸያፊ	aṣṣayyāfi
አጸደቀ	aṣaddaqa
አጸዳ	aṣaddā
አጽናና	aṣenānnā
አፈለሰ	afallasa
አፈለቀ	afallaqa
አፈላ	afallā
አፈረ	affara
አፈረጠ	afarraṭa
አፈረጠው	afarraṭaw
አፈራ	afarrā
አፈራረሰ	afarārrasa
አፈሰ	affasa
አፈሰሰ	affassasa
አፈቀረ	affaqqara
አፈተለከ	afatallaka
አፈታበት	afattābbat
አፈታተነ	affatāttana
አፈነ	affana
አፈነደደ	afanaddada
አፈነዳ	afanaddā
አፈነገጠ	afanaggaṭa
አፈነፈነ	afanaffana
አፈናቀለ	affanāqqala
አፈናጠረ	affanāṭṭara
አፈናጠጠ	affanāṭṭaṭa
አፈኛ	afaññā
አፈከፈ	afakkafa
አፈካ	afakkā
አፈዘዘ	afazzaza
አፈገ	affaga
አፈገመ	afaggama
አፈገፈገ	afagaffaga
አፈፈ	affafa
አፈፍ	afaff
አፋለመ	affāllama
አፋለሰ	affāllasa
አፋለገ	affāllaga
አፋረደ	affārada
አፋራም	affārām
አፋር	affār
አፋሰሰ	affāssasa
አፋሸገ	afāššaga
አፋቀረ	affāqqara
አፋተለ	affāttala
አፋተገ	affāttaga
አፋታ	affātā
አፋኝ	affāñ
አፋዘዘ	affāzzaza
አፋደሰ	afāddasa
አፋጀ	affāǧǧa
አፋጠነ	affāṭṭana
አፋጠጠ	affāṭṭaṭa
አፋጣኝ	affāṭāñ
አፋጨ	affāċċa
አፋፋመ	affāfāma
አፍለቀለቀ	afelaqallaqa
አፍለኛ	afelaññā
አፍታታ	afetāttā
አፍንጫማ	afeneċāmmā
አፍኖ	affeno
አፎካከረ	affokākkara
አፓርትማ	appāretemā
ኢትዮጲያ	iteyop̣p̣iyā
ኢትዮጲያዊ	iteyop̣p̣iyāwi
ኢትዮጵያዊት	iteyop̣p̣eyāwit
ኢየሩሳሌም	iyyarusālém
ኢየሱሳዊ	iyyasusāwi
ኢየሱስ	iyyasus
ኢዮቤልዩ	iyyobéleyu
ኢጣልያኛ	iṭāleyāññā
ኤክዌተር	ékkewétar
እላቂ	ellāqi
እልም	ellem
እልቂት	eleqitt
እልቅ	eleqq
እልቅት	elleqet
እልቅና	eleqennā
እልባት	ellebāt
እልከኛ	ellekaññā
እልክ	ellek
እልፊት	elefitt
እልፍኝ	elefeññ
እመ	emma
እመምተኛ	emametaññā
እመር	emmar
እመቤታችን	emmabétāccen
እመቤት	emmabét
እመት	emmat
እመጫት	emmaċāt
እማሆይ	emmāhoy
እሜቴ	emmété
እምር	emmer
እምስ	emmes
እምቢልተኛ	emebiletaññā
እምቢተኛ	emebitaññā
እምብዛም	emebezāmm
እምቦሳ	emebossā
እምዬ	emmeyé
እሥረኛ	eśeraññā
እሥራት	eśśerāt
እሥር	eśśer
እረኛ	erraññā
እረኝነት	erraññennat
እራሪ	errāri
እራሽ	errāš
እርማት	erremāt
እርምጃ	eremeǧǧā
እርይ	errey
እርጅና	ereǧennā
እርግዝና	eregezennā
እርግጠኛ	eregeṭaññā
እርግፍ	eregeff
እሮምታ	errometā
እሰይ	essay
እሳ	essā
እሳት	essāt
እሳትና	esātennā
እሳቸው	essāccaw
እስልምና	eselemennā
እስከነ	esekanna
እስከናካቴው	esekannākkātéw
እስከዚህ	esekazzih
እስከዚያ	esekazziyā
እስፓንኛ	esepāneññā
እሸትነት	ešatennat
እሹሩሩ	eššururu
እሺ	ešši
እሽ	ešš
እሽም	eššem
እሽሩሩ	eššeruru
እሽቅድድም	ešeqededdem
እሽግ	eššeg
እቀጭታ	eqqaċċetā
እቅፍ	eqqef
እበት	ebbat
እቡይ	ebbuy
እባካችሁ	ebākkāccehu
እባክህ	ebākkeh
እባክሽ	ebākkeš
እባክዎን	ebākkewon
እባጭ	ebbāċ
እብሪተኛ	eberitaññā
እብስ	ebbess
እቴዋ	etéwwā
እትማማች	etemmāmāc
እትማማችነት	etemmāmācennat
እትም	ettem
እትዬ	eteyyé
እትፍ	ettef
እትፍታ	ettefetā
እችግር	ecegger
እነ	enna
እነሆ	ennaho
እነማን	ennamānn
እነኋት	ennaẖwāt
እነኛ	ennaññā
እነዚያ	ennazziyā
እና	ennā
እናት	ennāt
እናትነት	ennātennat
እናትና	ennātennā
እንስሳነት	enesesānnat
እንስትነት	enesetennat
እንቃቅላ	eneqāqellā
እንቅስቃሴ	eneqesseqqāsé
እንቅጥቃጤ	eneqeṭeqqāṭé
እንቆቅልሽ	eneqoqelleš
እንቆቆ	eneqoqqo
እንብርክ	eneberekk
እንትና	enetennā
እንትፍ	eneteff
እንቺ	enecci
እንክርት	enekerret
እንክብል	enekebell
እንክብካቤ	enekebekkābé
እንኮኮ	enekokko
እንደልብ	enedalebb
እንደገና	enedagganā
እንዲሁም	enedihumm
እንጃለት	eneǧāllat
እንጃልህ	eneǧālleh
እንጃልሽ	eneǧālleš
እንጃልኝ	eneǧālleññ
እንጃባቱ	eneǧābbātu
እንጆሪ	eneǧorri
እንግሊዘኛ	enegelizaññā
እንግልት	enegelett
እንግዲማ	enegedimmā
እንግዲያስ	enegediyāss
እንጐቻ	enegwaccā
እንጕርጕሮ	enegwereggwero
እንፍሌ	enefellé
እኛ	eññā
እኝኝ	eññeññ
እኩለ	ekkula
እኩሌታ	ekkulétā
እኩል	ekkul
እኩያ	ekkuyyā
እክላም	ekkelām
እክል	ekkel
እኮ	ekko
እውልኛ	ewelleññā
እውነተኛ	ewenataññā
እውነተኛነት	ewenataññānnat
እውነትም	ewenatemm
እዚህ	ezzih
እዚያ	ezziyā
እየመጣ	eyyamaṭṭā
እየቅሉ	eyyaqelu
እየተጠና	eyataṭannā
እያንዳንዱ	eyyānedānedu
እያደር	eyyāddar
እደሳ	eddasā
እዳሪ	eddāri
እድለ	eddela
እድል	eddel
እድመኛ	edemaññā
እድር	edder
እድርተኛ	edderetaññā
እጀ	eǧǧa
እጀታ	eǧǧatā
እጁን	eǧǧun
እጄ	eǧǧé
እጅ	eǧǧ
እጅብ	eǧǧeb
እጅና	eǧǧenā
እጅጉን	eǧǧegun
እጅጌ	eǧǧegé
እጅግ	eǧegg
እገዛ	eggazā
እገዳ	eggadā
እግረኛ	egeraññā
እግድ	egged
እጥቤ	eṭṭebbé
እጭድ	eċċed
እፉኝት	efuññet
እፊያ	effiyā
እፋሽ	effāš
እፋፊ	effāfi
እፍ	eff
እፍኝ	effeñ
እፍግ	effeg
እፍግፍግ	efegefegg
እፎይ	effoy
እፎይታ	effoyetā
ከሁሉ	kahullu
ከለለ	kallala
ከለላ	kallalā
ከለሰ	kallasa
ከለበ	kallaba
ከለበሰ	kallabbasa
ከለቻ	kallaccā
ከለከለ	kalakkala
ከለፈ	kallafa
ከለፍላፋ	kalafelāffā
ከላሽ	kallāš
ከላባ	kallābā
ከል	kall
ከመረ	kammara
ከመቼ	kamaccé
ከመቼውም	kamaccéwemm
ከመከመ	kamakkama
ከማሪ	kammāri
ከሞላ	kamollā
ከሠተ	kaśśata
ከሠተለት	kaśśatallat
ከሠተበት	kaśśatabbat
ከረመ	karrama
ከረረ	karrara
ከረበተ	karabbata
ከረተፈ	karattafa
ከረከመ	karakkama
ከረከረ	karakkara
ከረደደ	karaddada
ከረፋ	karaffā
ከርታታ	karetāttā
ከርከሮ	karekarro
ከርዳዳ	karedāddā
ከርፋፋ	kareffāfā
ከሰለ	kassala
ከሰልማ	kasalemmā
ከሰመ	kassama
ከሰረ	kassara
ከሰሰ	kassasa
ከሰበ	kassaba
ከሰከሰ	kasakkasa
ከሲታ	kassittā
ከሳ	kassā
ከሳራ	kassārā
ከሳይ	kassāy
ከሸነ	kaššana
ከሸፈ	kaššafa
ከበረ	kabbara
ከበርቴ	kabbareté
ከበሰ	kabbasa
ከበበ	kabbaba
ከበተ	kabbata
ከበደ	kabbada
ከባዳ	kabbādā
ከባድ	kabbād
ከተለበ	katallaba
ከተል	kattall
ከተመ	kattama
ከተረ	kattara
ከተበ	kattaba
ከተተ	kattata
ከተከተ	katakkata
ከተፈ	kattafa
ከት	katt
ከትቢያ	katebbiyā
ከቶ	katto
ከቶውንም	kattowenemm
ከቸረ	kaccara
ከቸቸ	kaccaca
ከቻራ	kacārrā
ከች	kacc
ከነበለ	kanabbala
ከነቤተሰቡ	kannabétasabu
ከነተረ	kanattara
ከነነ	kannana
ከነአካቴው	kannaakkātéw
ከነከነ	kanakkana
ከነዳ	kanaddā
ከነፈ	kannafa
ከንቱነት	kanetunnat
ከካ	kakkā
ከውታታ	kawetāttā
ከውካዋ	kawekāwwā
ከዚህ	kazzih
ከዚህም	kazzihem
ከዚያ	kazziyā
ከደነ	kaddana
ከዳ	kaddā
ከዳተኛ	kadātaññā
ከጀለ	kaǧǧala
ከፈለ	kaffala
ከፈተ	kaffata
ከፈነ	kaffana
ከፈከፈ	kafakkafa
ከፈፈ	kaffafa
ከፋ	kaffā
ከፋኝ	kaffāñ
ከፋፈለ	kafāffala
ከፋፈተ	kafāffata
ከፍ	kaff
ከፍራራ	kaferrārā
ከፍተኛ	kaffetaññā
ከፍታ	kaffetā
ኩሊነት	kulinnat
ኩልሽት	kuleššet
ኩምትርትር	kumetereterr
ኩረጃ	kurraǧā
ኩራተኛ	kurātaññā
ኩራዝ	kurrāz
ኩርምት	kuremett
ኩርምትምት	kuremetemett
ኩርትም	kuretemm
ኩርትምትም	kuretemetemm
ኩባያ	kubbāyyā
ኩብ	kubb
ኩብኩባ	kubekubbā
ኩይሳ	kuyyesā
ኩፍ	kuff
ኩፍኝ	kuffeññ
ኪራየተኛ	kirāyataññā
ካባ	kābbā
ካቤላ	kābéllā
ካቦ	kābbo
ካቻምና	kāccāmenā
ካች	kācc
ካንዴላ	kānedéllā
ካካ	kākkā
ካውያ	kāweyyā
ካደመ	kāddama
ካዳሚ	kāddāmi
ካፊያ	kāffiyā
ካፍያ	kāffeyā
ካፒታሊዝም	kāppitālizem
ካፖርት	kāpporet
ኬላ	kéllā
ክለሳ	kellasā
ክልል	kellel
ክልስ	kelles
ክልብሽ	kelebešš
ክልብሽታ	kellebešetā
ክመራ	kemmarā
ክምር	kemmer
ክምቹ	kemeccu
ክምችት	kemeccet
ክር	kerr
ክርስትና	keresetennā
ክርክም	kerekkem
ክርክር	kerekker
ክርድ	keredd
ክርፍፍ	kerefeff
ክስ	kess
ክብ	kebb
ክብልል	kebelell
ክብርና	keberennā
ክብብ	kebebb
ክብነት	kebbennat
ክት	kett
ክትር	ketter
ክትባት	kettebāt
ክትትል	ketettel
ክትካች	ketekkāc
ክችች	keccec
ክንውን	kenewwen
ክካም	kekkām
ክክ	kekk
ክው	keww
ክውትት	kewetett
ክጀላ	keǧǧalā
ክፉኛ	kefuññā
ክፋተኛ	kefātaññā
ክፋይ	keffāy
ክፍ	keff
ክፍት	keffet
ክፍያ	kefeyyā
ኮምፓስ	komepāss
ኮረሸመ	koraššama
ኮረብታማ	korabetāmmā
ኮረጀ	korraǧa
ኮረጠ	korraṭa
ኮራ	korrā
ኮርማታ	koremāttā
ኮርቻ	koreccā
ኮሰመነ	kosammana
ኮስማና	kosemānnā
ኮስታራ	kosetārrā
ኮሸሽ	košašš
ኮበለለ	koballala
ኮተኮተ	kotakkota
ኮቴ	kotté
ኮትቻ	koteccā
ኮዳ	koddā
ኮፈኮፈ	kofakkofa
ኰለለ	kwallala
ኰለል	kwallal
ኰላ	kwallā
ኰልታፋ	kwaletāffā
ኰልኰሎ	kwalekwallo
ኰመኰመ	kwamakkwama
ኰረተመ	kwarattama
ኰረታተመ	kwaratāttama
ኰረኰመ	kwarakkwama
ኰረኰረ	kwarakkwara
ኰረዳ	kwaraddā
ኰረፈ	kwarrafa
ኰረፌ	kwarrafé
ኰሰሰ	kwassasa
ኰሰተረ	kwasattara
ኰሰኰሰ	kwasakkwasa
ኰሳሳ	kwassāsā
ኰሳሳነት	kwasāsānnat
ኰስታራ	kwasetārrā
ኰስኳሳ	kwasekwāssā
ኰነነ	kwannana
ኰናኝ	kwannāñ
ኵርፈኛ	kwerefaññā
ኵርፍተኛ	kwerrefetaññā
ወለል	walall
ወለም	walamm
ወለቀ	wallaqa
ወለወለ	walawwala
ወለደ	wallada
ወለድ	wallad
ወለገደ	walaggada
ወለጋ	wallagā
ወላለቀ	walāllaqa
ወላለደ	walāllada
ወላወለ	walāwwala
ወላይታ	walāyettā
ወላይትኛ	walāyeteññā
ወላድ	wallād
ወልማማ	walemmāmā
ወልካፋ	walekkāfā
ወልጋዳ	walegāddā
ወሎ	wallo
ወመቴ	wammaté
ወረረ	warrara
ወረርሽኝ	wararešeññ
ወረሰ	warrasa
ወረቦ	warabbo
ወረተኛ	warataññā
ወረክራካ	warakerākkā
ወረወረ	warawwara
ወረዛ	warazzā
ወረደ	warrada
ወረገኑ	warraganu
ወረፈ	warrafa
ወራረደ	warārrada
ወራዳ	warrāddā
ወራዳነት	warrāddānnat
ወራፊ	warrāfi
ወሬኛ	waréññā
ወርቃማ	wareqāmmā
ወርድና	waredennā
ወሮበላ	warroballā
ወሰለተ	wasallata
ወሰራ	wasarrā
ወሰነ	wassana
ወሰን	wassan
ወሰንተኛ	wasanetaññā
ወሰወሰ	wasawwasa
ወሰደ	wassada
ወሰደው	wassadaw
ወሰድ	wasadd
ወሳኝ	wassāñ
ወሳፍቻ	wassāfeccā
ወስላታ	waselāttā
ወስዋሳ	wasewāssā
ወሸለ	waššala
ወሸመ	waššama
ወሸቀ	waššaqa
ወሸከተ	wašakkata
ወሻቃ	waššāqqā
ወሽመላ	wašemallā
ወሽካታ	wašekāttā
ወቀረ	waqqara
ወቀሰ	waqqasa
ወቀሳ	waqassā
ወቀጠ	waqqaṭa
ወቃ	waqqā
ወበራ	wabarrā
ወበቀ	wabbaqa
ወባማ	wabāmmā
ወቦ	wabbo
ወተወተ	watawwata
ወተፈ	wattafa
ወተፍታፋ	watafetāffā
ወታደራዊ	wattāddarāwi
ወታደር	watāddar
ወታደርነት	watāddarennat
ወታፋ	wattāffā
ወትዋታ	watewwātā
ወነበደ	wanabbada
ወነከረ	wanakkara
ወነወነ	wanawwana
ወነጀለ	wanaǧǧala
ወንድማማችነት	wanedemmāmācennat
ወንድም	wanedemm
ወንድነት	wanedennat
ወንጀለኛ	waneǧalaññā
ወከለ	wakkala
ወከፍ	wakkaf
ወኪል	wakkil
ወካይ	wakkāy
ወዘተ	wazzata
ወዘተ\.	wazzata\.
ወዘወዘ	wazawwaza
ወዘፈ	wazzafa
ወዛ	wazzā
ወዛም	wazzām
ወዛደር	wazāddar
ወየበ	wayyaba
ወየው	wayyaw
ወያላ	wayyālā
ወይም	wayemm
ወይስ	wayess
ወይንማ	wayenemmā
ወዮ	wayyo
ወዮታ	wayyotā
ወደለ	waddala
ወደላ	wadallā
ወደመ	waddama
ወደረ	waddara
ወደረኛ	wadaraññā
ወደቀ	waddaqa
ወደዚህ	wadazzih
ወደዚያ	wadazziyā
ወደደ	waddada
ወደድ	waddad
ወደጎን	wadagonn
ወዲያልኝ	wadiyālleññ
ወዳድ	waddād
ወዳጅነት	wadāǧennat
ወዶ	waddo
ወገረ	waggara
ወገኛ	wagaññā
ወገግ	wagagg
ወገግታ	waggagetā
ወጋ	waggā
ወጋጋ	wagāggā
ወጌሻ	wagéššā
ወጣ	waṭṭā
ወጣራ	waṭṭārrā
ወጣትነት	waṭṭātennat
ወጣች	waṭācc
ወጥ	waṭṭ
ወጭማዳ	waċemāddā
ወፈረ	waffara
ወፈር	wafarr
ወፈፈ	waffafa
ወፈፌ	wafaffé
ወፈፍተኛ	wafafetaññā
ወፋፈረ	wafāffara
ዋለለ	wāllala
ዋስትና	wāsetennā
ዋሸ	wāšša
ዋሻ	wāššā
ዋተተ	wāttata
ዋነተኛ	wānataññā
ዋነኛ	wānnaññā
ዋና	wānnā
ዋኘ	wāñña
ዋዠ	wāžža
ዋጀ	wāǧǧa
ውሀማ	wehammā
ውለኛ	welaññā
ውላቂ	wellāqi
ውላጅ	wellāǧ
ውል	well
ውልቃት	welleqāt
ውልቅ	welleq
ውልብ	welleb
ውልታ	welletā
ውልክፍክፍ	welekefekeff
ውራ	werrā
ውራጅ	werrāǧ
ውር	werr
ውርር	werrer
ውርርድ	wererred
ውርንጭላ	wereneċellā
ውርጅብኝ	wereǧebbeññ
ውሳኔ	wessāné
ውስልትና	weseletennā
ውሻ	weššā
ውሻነት	weššānnat
ውሽማ	wešemmā
ውቂያ	weqqiyā
ውቃጭ	weqqāċ
ውቅራት	weqqerāt
ውትፍ	wettef
ውነተኛ	wenataññā
ውንብድና	wenebedennā
ውንድቢ	wenedebbi
ውከላ	wekkalā
ውክልና	wekkelennā
ውዝዋዜ	wezewwāzé
ውዝፍ	wezzef
ውይባት	weyyebāt
ውደሳ	weddasā
ውዳሴ	weddāsé
ውዳቂ	weddāqi
ውዴላ	weddéllā
ውድ	wedd
ውድነት	weddennat
ውድድር	wededder
ውጊያ	weggiyā
ውፋሬ	weffāré
ዐልቅት	ʻaleqqet
ዐመቀ	ʻammaqa
ዐመጠ	ʻammaṭa
ዐመጠኛ	ʻamaṭaññā
ዐመፀ	ʻammaṡa
ዐመፀኛ	ʻamaṡaññā
ዐሥረኛ	ʻaśeraññā
ዐሥር	ʻaśśer
ዐረቀ	ʻarraqa
ዐረበ	ʻarraba
ዐረብኛ	ʻarabeññā
ዐረገ	ʻarraga
ዐረፈ	ʻarrafa
ዐራቢ	ʻarrābi
ዐቀደ	ʻaqqada
ዐቃቢት	ʻaqqābit
ዐቃቤ	ʻaqqābé
ዐበደ	ʻabbada
ዐበድ	ʻabbad
ዐወቀ	ʻawwaqa
ዐወደ	ʻawwada
ዐወደኝ	ʻawwadaññ
ዐውድማ	ʻawedemmā
ዐየ	ʻayya
ዐይናማ	ʻayenāmmā
ዓለመኛ	ʻālamaññā
ዓለማዊነት	ʻālamāwinnat
ዕልል	ʻelell
ዕምቅ	ʻemmeq
ዕሴት	ʻessét
ዕቀዳ	ʻeqqadā
ዕቁብ	ʻeqqub
ዕቃ	ʻeqqā
ዕቅድ	ʻeqqed
ዕውር	ʻewwer
ዕውቀተኛ	ʻeweqataññā
ዕጮኛ	ʻeċoññā
ዘለለ	zallala
ዘለል	zalall
ዘለም	zalamm
ዘለሰ	zallasa
ዘለሰኛ	zalasaññā
ዘለቀ	zallaqa
ዘለዘለ	zalazzala
ዘለግ	zalagg
ዘለግላጋ	zalagellāgā
ዘለፈ	zallafa
ዘላበደ	zalābbada
ዘላን	zallān
ዘልዛላ	zalezzālā
ዘልዛልነት	zalezāllennat
ዘመመ	zammama
ዘመረ	zammara
ዘመተ	zammata
ዘመዘመ	zamazzama
ዘመዳሞች	zamadāmocc
ዘማ	zammā
ዘማዊ	zammāwi
ዘረረ	zarrara
ዘረነቀ	zarannaqa
ዘረኛ	zaraññā
ዘረከተ	zarakkata
ዘረክራካ	zarakerākkā
ዘረዘረ	zarazzara
ዘረገፈ	zaraggafa
ዘረጋ	zaraggā
ዘረፈ	zarrafa
ዘረፍራፋ	zaraferāffā
ዘራ	zarrā
ዘራሽ	zarrāš
ዘራፍ	zarrāf
ዘርካታ	zarekāttā
ዘርዛራ	zarezārrā
ዘርፋፋ	zarefāffā
ዘርፍና	zarefennā
ዘቀዘቀ	zaqazzaqa
ዘቀጠ	zaqqaṭa
ዘቅዛቃ	zaqezāqqā
ዘበለለ	zaballala
ዘበራረቀ	zabarārraqa
ዘበተ	zabbata
ዘበነ	zabbana
ዘበናይነት	zabanāyennat
ዘበኛ	zabaññā
ዘበዘበ	zabazzaba
ዘበጠ	zabbaṭa
ዘባ	zabbā
ዘባረቀ	zabārraqa
ዘብዛባ	zabezābbā
ዘብጥያ	zabeṭeyyā
ዘነመ	zannama
ዘነቀ	zannaqa
ዘነቆለ	zanaqqola
ዘነበ	zannaba
ዘነተረ	zanattara
ዘነነ	zannana
ዘነን	zanann
ዘነጋ	zanaggā
ዘነፈ	zannafa
ዘና	zannā
ዘናጭ	zannāċ
ዘንባላ	zanebāllā
ዘንካታ	zanekāttā
ዘንፋላ	zanefāllā
ዘከረ	zakkara
ዘከዘከ	zakazzaka
ዘኬ	zakké
ዘክዛካ	zakezākkā
ዘወረ	zawwara
ዘወርዋራ	zawarewārrā
ዘዋራ	zawwārrā
ዘው	zaww
ዘየረ	zayyara
ዘየነ	zayyana
ዘየደ	zayyada
ዘያጅ	zayyāǧ
ዘዴኛ	zadéññā
ዘገምተኛ	zagametaññā
ዘገረረ	zagarrara
ዘገበ	zaggaba
ዘገነ	zaggana
ዘገነነ	zagannana
ዘገየ	zagayya
ዘጋ	zaggā
ዘግየት	zageyatt
ዘጎርጓራ	zagoregwārrā
ዘጎነ	zaggona
ዘጠነኛ	zaṭanaññā
ዘጠኝ	zaṭaññ
ዘፈቀ	zaffaqa
ዘፈነ	zaffana
ዘፈዘፈ	zafazzafa
ዘፍ	zaff
ዙጥ	zuṭṭ
ዚቀኛ	ziqaññā
ዛተለ	zāttala
ዛቻ	zāccā
ዛኒጋባ	zānigābbā
ዛዘነ	zāzzana
ዛጎልማ	zāgolemmā
ዜመኛ	zémaññā
ዜንጠኛ	zéneṭaññā
ዝሊያ	zelliyā
ዝላይ	zellāy
ዝልል	zellel
ዝልስ	zelles
ዝመራ	zemmarā
ዝሙተኛ	zemmutaññā
ዝሙት	zemmut
ዝማሬ	zemmāré
ዝም	zemm
ዝምታ	zemmetā
ዝራጭ	zerrāċ
ዝር	zerr
ዝርክርክ	zerekerekk
ዝርክት	zerekkett
ዝርዛሪ	zerezzāri
ዝርዝር	zerezzer
ዝርያ	zerreyā
ዝርግነት	zeregennat
ዝርግፍ	zeregeff
ዝቀታ	zeqqatā
ዝቃጭ	zeqqāċ
ዝቅ	zeqq
ዝቅተኛ	zeqqetaññā
ዝብዝብ	zebezzeb
ዝተታም	zettatām
ዝተት	zettat
ዝነኛ	zennaññā
ዝነጣ	zennaṭā
ዝና	zennā
ዝናር	zennār
ዝናቢስ	zennābis
ዝንባሌ	zenebbālé
ዝንጅብል	zeneǧebell
ዝንፋት	zennefāt
ዝክዝክ	zekezekk
ዝውውር	zewewwer
ዝየራ	zeyyarā
ዝየና	zeyyanā
ዝየዳ	zeyyadā
ዝይ	zeyy
ዝግ	zegg
ዝግተኛ	zeggetaññā
ዝግታ	zeggetā
ዝግጁ	zegeǧǧu
ዝግጅት	zegeǧǧet
ዠለጠ	žallaṭa
ዠረር	žararr
ዠረገገ	žaraggaga
ዠርጋዳ	žaregāddā
ዠርጋጋ	žaregāggā
ዠቀዠቀ	žaqažžaqa
ዠበደ	žabbada
ዠበድ	žabbad
ዠብረር	žaberarr
ዠብራራ	žaberārrā
ዥማት	žemmāt
ዥዋዥዌ	žewwāžewwé
ዥው	žeww
ዦፌ	žoffé
የለለው	yalallaw
የለም	yallam
የለሽ	yallaš
የለኝም	yallaññem
የለውም	yallawem
የሌለ	yalélla
የሌለው	yalléllaw
የሐሰት	yaḥassat
የሕግ	yaḥegg
የመረረ	yamarrara
የመሸኛ	yamašaññā
የሚመጣው	yammimaṭāw
የሚበቃ	yammibaqā
የሚዘለቅ	yamizzallaq
የሚያህል	yammiyāhel
የሚያመሰኳ	yammiyāmasakkwā
የሚያሰለች	yammiyāsalacc
የሚያስቅ	yammiyāsseq
የሚያስተኛ	yammiyāsetaññā
የሚያከራክር	yammiyākkarākker
የሚጠልዝ	yammiṭallez
የማን	yamānn
የማዘጋጃ	yamāzzagāǧā
የማያከራክር	yammāyākkarākker
የማያዛልቅ	yammāyāzzālleq
የማይሆን	yammāyehon
የማይለወጥ	yammāyellawwaṭ
የማይለው	yammāyelaw
የማይል	yammāyel
የማይረባ	yammāyerabā
የማይሻር	yammāyeššār
የማይቀር	yammāyeqar
የማይበቃ	yammāyebaqā
የማይበገር	yammāyebbaggar
የማይታጠፍ	yammāyetāṭṭaf
የማይጠዳው	yammāyeṭadāw
የምሩን	yamerrun
የምር	yamerr
የምስራች	yamesserācc
የረሳው	yarassāw
የረፋድ	yaraffād
የሩጫ	yaruċċā
የርሱ	yaressu
የርሳቸው	yaresāccaw
የሰራ	yassarā
የሱ	yassu
የሳቸው	yassāccaw
የሸማኔ	yašammāné
የቀረ	yaqarra
የቀረች	yaqarrac
የቀረው	yaqarraw
የቆየ	yaqoyya
የቈላ	yaqwallā
የበለጠ	yaballaṭa
የበላይነት	yabalāyennat
የበቃ	yabaqqā
የባሰበት	yabāsabbat
የተለቀቀ	yatalaqqaqa
የተለያየ	yatalayāyya
የተሟላ	yatamwāllā
የተሟጠጠ	yatamwāṭṭaṭa
የተቀደሰ	yataqaddasa
የተንጠለጠለ	yataneṭalaṭṭala
የተወለደ	yatawwalada
የተወሰነ	yatawassana
የተዛባ	yatazābbā
የተጠላ	yataṭallā
የተጣላ	yataṭāllā
የተጣራ	yataṭārrā
የተጸውዖ	yataṣawweʻo
የታማ	yatāmmā
የትም	yatemm
የትና	yatennā
የትኛው	yateññāw
የትየለሌ	yateyyalalé
የነቃ	yanaqqā
የነጋዴዎች	yanaggādéwocc
የናት	yannāt
የንስሐ	yanesseḥa
የአህያ	yaaheyyā
የአየር	yaayyar
የአጋጣሚ	yaagāṭṭāmi
የእጅ	yaʼeǧǧ
የከበረ	yakabbara
የካቲት	yakkātit
የክት	yakett
የኮቴ	yakotté
የወረገኑ	yawarraganu
የወንድም	yawanedemm
የዋህ	yawwāh
የዋህነት	yawwāhennat
የዝናር	yazennār
የይ	yayy
የደምበኛ	yadamebaññā
የደራ	yadarrā
የደስደስ	yadasedass
የድመት	yademmat
የገዛ	yagazzā
የጉበት	yagubbat
የጋማ	yagāmmā
የግሥ	yageśś
የጎልማሶች	yagolemāsocc
የጎደለበት	yagoddalabbat
የጠለቀ	yaṭallaqa
የጠረጴዛ	yaṭarap̣p̣ézā
የጥሪ	yaṭerri
የጥቅል	yaṭeqqel
የጥያቄ	yaṭeyyāqé
የጫማ	yaċāmmā
የጭቅና	yaċeqqennā
የፈሰሰ	yafassasa
የፊታችን	yafitāccen
የፊጥኝ	yafiṭṭeññ
ያለ	yālla
ያለውድ	yālawedd
ያለግምት	yālagemmet
ያልተሟላ	yāletamwāllā
ያልተወሰነ	yāletawassana
ያልተገራ	yāletagarrā
ያልታሰበ	yāletāssaba
ያመዋል	yāmmawāl
ያም	yāmm
ያሳማ	yāssāmā
ያቻትና	yāccātennā
ያች	yācc
ያኔ	yānné
ያን	yānn
ያንማ	yānnemmā
ያንን	yānnen
ያኛው	yāññāw
ያውና	yāwennā
ያውኮ	yāwekko
ያዝ	yāzz
ያደረ	yāddara
ያገለገለ	yāgalaggala
ያጎት	yāggot
ይህም	yehemm
ይህን	yehenn
ይህኛው	yeheññāw
ይሉኝ	yeluññ
ይሉኝታ	yeluññetā
ይልቁንም	yelequnemm
ይልቁንስ	yelequness
ይልቅስ	yeleqess
ይስጠን	yeseṭann
ይስጣኝ	yeseṭāññ
ይስጥልኝ	yeseṭeleññ
ይሻላል	yeššālāl
ይብላኝ	yebelāññ
ይውልህ	yewelleh
ይግባኝ	yegebāññ
ደለለ	dallala
ደለቀ	dallaqa
ደለበ	dallaba
ደለኸ	dallaxa
ደለዘ	dallaza
ደለደለ	daladdala
ደለፈሰ	dalaffasa
ደላ	dallā
ደላላ	dallālā
ደላይ	dallāy
ደልቃቃ	daleqāqqā
ደልዳላ	daleddālā
ደመመ	dammama
ደመረ	dammara
ደመሰሰ	damassasa
ደመቀ	dammaqa
ደመና	dammanā
ደመኛ	damaññā
ደመወዝተኛ	damawazetaññā
ደመደመ	damaddama
ደማ	dammā
ደማቃ	dammāqā
ደማቅ	dammāq
ደም	damm
ደምበኛ	damebaññā
ደሞ	dammo
ደረሰ	darrasa
ደረሰለት	darrasallat
ደረሰመ	darassama
ደረሰበት	darrasabat
ደረሰኝ	darrasaññ
ደረቀ	darraqa
ደረበ	darraba
ደረተ	darrata
ደረደረ	daraddara
ደረጀ	daraǧǧa
ደረገመ	daraggama
ደራ	darrā
ደራሲነት	darāsinnat
ደርሽ	darrešš
ደርበብ	darebabb
ደርባባ	darebābbā
ደርካካ	darekākkā
ደሰመ	dassama
ደሰሰ	dassasa
ደስ	dass
ደስተኛ	dassetaññā
ደስታ	dassetā
ደቀ	daqqa
ደቀለ	daqqala
ደቀመዝሙር	daqqamazemur
ደቀቀ	daqqaqa
ደቀነ	daqqana
ደቀደቀ	daqaddaqa
ደቃ	daqqā
ደቃቃ	daqqāqā
ደቃቅ	daqqāq
ደቅደቂት	daqedaqqit
ደቆሰ	daqqosa
ደቆስቋሳ	daqoseqwāssā
ደቋቆሰ	daqwāqqosa
ደበለለ	daballala
ደበለቀ	daballaqa
ደበላለቀ	dabalāllaqa
ደበልባላ	dabalebāllā
ደበሰሰ	dabassasa
ደበስባሳ	dabasebāssā
ደበቀ	dabbaqa
ደበበ	dabbaba
ደበተ	dabbata
ደበነ	dabbana
ደበዘዘ	dabazzaza
ደበደበ	dabaddaba
ደባል	dabbāl
ደባቃ	dabbāqā
ደባበሰ	dabābbasa
ደባች	dabbāc
ደብሳሳ	dabesāssā
ደብዛዛ	dabezāzzā
ደብዳቤ	dabedābbé
ደቦለቦለ	dabolabbola
ደቦል	dabbol
ደቦልቧላ	dabolebwāllā
ደኅንነት	daẖenennat
ደነሰ	dannasa
ደነቀ	dannaqa
ደነቀረ	danaqqara
ደነቀፈ	danaqqafa
ደነቆለ	danaqqola
ደነቆረ	danaqqora
ደነበረ	danabbara
ደነበዘ	danabbaza
ደነባ	danabbā
ደነነ	dannana
ደነዘ	dannaza
ደነዘዘ	danazzaza
ደነደነ	danadanna
ደነገዘ	danaggaza
ደነገገ	danaggaga
ደነገጠ	danaggaṭa
ደነጎረ	danaggora
ደነፋ	danaffā
ደነፋፋ	danaffāfā
ደናማ	dannāmmā
ደናሽ	dannāš
ደን	dann
ደንቃፋ	daneqāffā
ደንበኛ	danebaññā
ደንባራ	danebārrā
ደንባዛ	danebāzzā
ደንደሮ	danedarro
ደንደሳም	daneddassām
ደንደስ	danedass
ደንዳና	danedānnā
ደንዳኔ	danedānné
ደንገሎ	danegallo
ደንጉላ	danegullā
ደንጋራ	danegārrā
ደንጋዛ	danegāzzā
ደከመ	dakkama
ደካማ	dakāmmā
ደኸየ	daxayya
ደወለ	dawwala
ደዋይ	dawwāy
ደደረ	daddara
ደደቀ	daddaqa
ደደበ	daddaba
ደደብ	daddab
ደጀ	daǧǧa
ደጃች	daǧǧāc
ደጃፍ	daǧǧāf
ደጅ	daǧǧ
ደገመ	daggama
ደገሰ	daggasa
ደገነ	daggana
ደገኛ	dagaññā
ደገደገ	dagaddaga
ደገፈ	daggafa
ደጉሰ	daggusa
ደጋደግ	daggādagg
ደጋፊ	daggāfi
ደግ	dagg
ደግነቱ	daggennatu
ደግነት	daggennat
ደግዳጋ	dagedāggā
ደግፍ	daggef
ደጎመ	daggoma
ደጎባ	daggobā
ደፈረ	daffara
ደፈረሰ	dafarrasa
ደፈቀ	daffaqa
ደፈነ	daffana
ደፈንፋና	dafanefānnā
ደፈደፈ	dafaddafa
ደፋ	daffā
ደፋር	daffār
ደፍ	daff
ዱለቻ	dullaccā
ዱለኛ	dullaññā
ዱላ	dullā
ዱርዬ	dureyyé
ዱባ	dubbā
ዱቤ	dubbé
ዱብ	dubb
ዲካ	dikkā
ዳለቻ	dālaccā
ዳለጠ	dāllaṭa
ዳሌ	dāllé
ዳመነ	dāmmana
ዳመና	dāmmanā
ዳመናማ	dāmannāmmā
ዳመናም	dāmmanām
ዳመጠ	dāmmaṭa
ዳረገ	dārraga
ዳርቻ	dāreccā
ዳርና	dārennā
ዳሰሰ	dāssasa
ዳሸቀ	dāššaqa
ዳበረ	dābbara
ዳበሰ	dābbasa
ዳበሳ	dābbasā
ዳባ	dābbā
ዳቦ	dābbo
ዳተኛ	dātaññā
ዳንሰኛ	dānesaññā
ዳንግሌ	dānegellé
ዳኘ	dāñña
ዳኛ	dāññā
ዳኝነት	dāññennat
ዳከረ	dākkara
ዳክዬ	dākkeyyé
ዳዋ	dāwwā
ዳውላ	dāwellā
ዳግመኛ	dāgemaññā
ድህነት	dehennat
ድለላ	dellalā
ድል	dell
ድልህ	delleh
ድልል	dellel
ድልኸ	dellexa
ድልኽ	dellex
ድልዝ	dellez
ድልድል	deleddel
ድሎትኛ	deloteññā
ድመራ	demmarā
ድመት	demmat
ድማሪ	demmāri
ድምር	demmer
ድምበረተኛ	demebarataññā
ድምቡሼ	demebuššé
ድሪያ	derriyā
ድራሹ	derrāšu
ድርቅ	derreq
ድርቅና	dereqennā
ድርብ	derreb
ድርት	derret
ድርና	derennā
ድርድር	deredder
ድርጁ	dereǧǧu
ድርጅት	dereǧǧet
ድርጊት	dereggit
ድርግም	deregemm
ድቁስ	deqqus
ድቅን	deqqenn
ድበቃ	debbaqā
ድበብ	debabb
ድቡሽት	debbušet
ድባኖ	debbāno
ድብ	debb
ድብልቅ	debelleq
ድብቅ	debbeq
ድብብቆሽ	debebbeqoš
ድብት	debbet
ድብን	debbenn
ድብኝት	debeññet
ድኅነት	deẖennat
ድንቁርና	denequrennā
ድንቄም	deneqémm
ድንቅ	denneq
ድንበረተኛ	denebarataññā
ድንበርተኛ	denebaretaññā
ድንቡሎ	denebullo
ድንች	dennecc
ድንክዬ	denekeyyé
ድንገተኛ	denegataññā
ድንጋጌ	deneggāgé
ድንጋጤ	deneggāṭé
ድንግልና	denegellenā
ድንግዝግዝ	denegezegezz
ድኝ	deññ
ድኩላ	dekkulā
ድኽነት	dexennat
ድወላ	dewwalā
ድው	deww
ድውር	dewwer
ድውይ	dewwey
ድዳም	deddām
ድድ	dedd
ድድር	dedder
ድድቅ	deddeq
ድገና	degganā
ድጋሚ	deggāmi
ድግስ	degges
ድግን	deggen
ድጎማ	deggomā
ድጕሳት	deggwesāt
ዶለተ	dollata
ዶለዶመ	doladdoma
ዶልዷላ	doledwāllā
ዶልዷሌ	doledwāllé
ዶልዷማ	doledwāmmā
ዶመኛ	domaññā
ዶኬ	dokké
ዶዮ	doyyo
ዶፈዶፈ	dofaddofa
ዶፍዷፋ	dofedwāffā
ጀመረ	ǧammara
ጀምሮ	ǧammero
ጀረገገ	ǧaraggaga
ጀሶ	ǧasso
ጀበበ	ǧabbaba
ጀበደ	ǧabbada
ጀብደኛ	ǧabedaññā
ጀቦነ	ǧabbona
ጀገነ	ǧaggana
ጀግንነት	ǧagenennat
ጂጌ	ǧiggé
ጃኬት	ǧākkét
ጃዊ	ǧāwwi
ጃውሳ	ǧāwwesā
ጃጀ	ǧāǧǧa
ጃፓናዊ	ǧāppānāwi
ጃፓን	ǧāppān
ጅላንጅል	ǧelāneǧǧel
ጅልነት	ǧelennat
ጅማታም	ǧemmātām
ጅማት	ǧemmāt
ጅምር	ǧemmer
ጅብ	ǧebb
ጅንን	ǧennen
ጅዋጅዌ	ǧewwāǧewwé
ጅው	ǧeww
ጆንያ	ǧoneyyā
ጆፌ	ǧoffé
ጆፍጆፌ	ǧofeǧoffé
ገሀነመ	gahannama
ገሀነም	gahannam
ገለል	galall
ገለልተኛ	galaletaññā
ገለልተኛነት	galaletaññānat
ገለማ	galammā
ገለሞተ	galammota
ገለበ	gallaba
ገለበጠ	galabbaṭa
ገለጀጀ	galaǧǧaǧa
ገለጠ	gallaṭa
ገለጸ	gallaṣa
ገለፈጠ	galaffaṭa
ገለፈፈ	galaffafa
ገላለጠ	galāllaṭa
ገላመጠ	galāmmaṭa
ገላገለ	galāggala
ገልዋዳ	galewāddā
ገመለ	gammala
ገመምተኛ	gamametaññā
ገመሰ	gammasa
ገመተ	gammata
ገመደ	gammada
ገመደለ	gamaddala
ገመገመ	gamaggama
ገመጠ	gammaṭa
ገማ	gammā
ገማች	gammāc
ገምባሌ	gamebāllé
ገሠሠ	gaśśaśa
ገሠጠ	gaśśaṭa
ገሠጸ	gaśśaṣa
ገረመ	garrama
ገረመመ	garammama
ገረረ	garrara
ገረዘ	garraza
ገረደፈ	garaddafa
ገረጀፈ	garaǧǧafa
ገረገረ	garaggara
ገረገደ	garragada
ገረፈ	garrafa
ገራ	garrā
ገራም	garrām
ገርበብ	garebabb
ገርባባ	garebābbā
ገርጃፋ	gareǧāffā
ገርጋራ	garegārrā
ገሰረ	gassara
ገሰሰ	gassasa
ገሰገሰ	gasaggasa
ገሸለጠ	gašallaṭa
ገሸረ	gaššara
ገሸሽ	gašašš
ገበረ	gabbara
ገበየ	gabayya
ገበያተኛ	gabayātaññā
ገቢና	gabinnā
ገባ	gabbā
ገባር	gabbār
ገባች	gabācc
ገባው	gabbāw
ገብ	gabb
ገብጋባ	gabeggābā
ገተረ	gattara
ገተት	gattat
ገታ	gattā
ገታራ	gattārā
ገትጋታ	gategāttā
ገቻ	gaccā
ገነባ	ganabbā
ገነተረ	ganattara
ገነት	gannat
ገነነ	gannana
ገነን	gannan
ገነዘ	gannaza
ገነደሰ	ganaddasa
ገነገነ	ganaggana
ገነፈለ	ganaffala
ገና	gannā
ገንባሌ	ganebāllé
ገንታራ	ganetārrā
ገዘተ	gazzata
ገዘገዘ	gazaggaza
ገዘፈ	gazzafa
ገዛ	gazzā
ገዝጋዛ	gazegāzzā
ገደ	gadda
ገደለ	gaddala
ገደለው	gaddalaw
ገደላማ	gadalāmmā
ገደርዳራ	gadaredārrā
ገደበ	gaddaba
ገደገደ	gadaggada
ገደፈ	gaddafa
ገዳማ	gaddāmmā
ገዳም	gaddām
ገዳዳ	gaddādā
ገዴ	gaddé
ገድ	gadd
ገድለኛ	gadelaññā
ገድጋዳ	gadegāddā
ገዶኝ	gaddoññ
ገገምተኛ	gagametaññā
ገገረ	gaggara
ገጠገጠ	gaṭaggaṭa
ገጠጠ	gaṭṭaṭa
ገጨኸኝ	gaċċaxaññ
ገፈተረ	gafattara
ገፈገፈ	gafaggafa
ገፈፈ	gaffafa
ገፈፋ	gafaffā
ገፋ	gaffā
ገፋፋ	gafāffā
ጉልላት	gullelāt
ጉልማ	gulemmā
ጉልበተኛ	gulebataññā
ጉልተኛ	guletaññā
ጉልቻ	gullecā
ጉማጅ	gummāǧ
ጉም	gumm
ጉረሮ	gurarro
ጉረኖ	guranno
ጉረኛ	guraññā
ጉራ	gurrā
ጉራሽ	gurrāš
ጉራቻ	gurrāccā
ጉራች	gurrācc
ጉራጅ	gurrāǧ
ጉሬዛማ	gurézāmmā
ጉርምስና	guremessennā
ጉርብርብ	gureberebb
ጉርብትና	gurebetennā
ጉሮሮ	gurorro
ጉበት	gubbat
ጉበኛ	gubaññā
ጉብ	gubb
ጉብታ	gubbetā
ጉብዝና	gubezennā
ጉቦ	gubbo
ጉቦኛ	gubboññā
ጉተታ	guttatā
ጉትቻ	guteccā
ጉትያ	guteyyā
ጉቶ	gutto
ጉያ	guyyā
ጉደኛ	gudaññā
ጉዳተኛ	gudātaññā
ጉዳዩ	guddāyu
ጉዳዬ	guddāyé
ጉዳይ	guddāy
ጉድ	gudd
ጉድለት	guddelat
ጉዶ	guddo
ጉጉት	guggut
ጋለበ	gāllaba
ጋማ	gāmmā
ጋሜ	gāmmé
ጋረደ	gārrada
ጋረጠ	gārraṭa
ጋራማ	gārāmmā
ጋሬ	gārré
ጋሸበ	gāššaba
ጋሻ	gāššā
ጋሼ	gāššé
ጋሽዬ	gāššeyé
ጋበዘ	gābbaza
ጋብቻ	gābeccā
ጋንድያ	gānedeyyā
ጋየ	gāyya
ጋገረ	gāggara
ጋጋ	gāggā
ጋጠኝ	gāṭaññ
ጌትነት	gétennat
ጌቶች	gétocc
ጌጅ	géǧǧ
ጌጠኛ	géṭaññā
ግለሂስ	gellahis
ግለኛ	gellaññā
ግላዊ	gellāwi
ግላጭ	gellāċ
ግል	gell
ግልሙትና	gelemutennā
ግልባጭ	gellebbāċ
ግልብነት	gelebennat
ግልግል	geleggel
ግልፋፊ	geleffāfi
ግልፍ	gelleff
ግልፍተኛ	gelefetaññā
ግልፍታም	gellefetām
ግማሽ	gemmāš
ግማደ	gemmāda
ግማጭ	gemmāċ
ግም	gemm
ግምል	gemmel
ግምበኛ	gemebaññā
ግምት	gemmet
ግሣዊ	geśśāwi
ግሣጼ	geśśāṣé
ግሥ	geśś
ግሦች	geśśoc
ግረዛ	gerrazā
ግራኝ	gerāññ
ግራዋ	gerāwwā
ግር	gerr
ግርዛት	gerrezāt
ግርድና	geredennā
ግርድፍ	gereddef
ግርግር	gerregerr
ግርፋት	gerrefāt
ግሳንግስ	gessāneges
ግስላ	gesselā
ግስጋሴ	geseggāsé
ግሽር	geššer
ግቢ	gebbi
ግብርና	geberennā
ግብዝ	gebbez
ግብዝና	gebezennā
ግብዣ	gebežžā
ግትር	getter
ግትርትር	getereterr
ግትቻ	geteccā
ግንበኛ	genebaññā
ግንኙነት	geneññunnat
ግንዛቤ	genezzābé
ግንዲላ	genedillā
ግኝት	geññet
ግዝት	gezzet
ግዞተኛ	gezotaññā
ግዥ	gežž
ግዳይ	geddāy
ግዳጅ	geddāǧ
ግዴ	geddé
ግዴታ	geddétā
ግድ	gedd
ግድብ	geddeb
ግድያ	gedeyyā
ግድግዳ	gedegeddā
ግግ	gegg
ግግር	gegger
ግጥም	geṭṭemm
ግፈኛ	gefaññā
ግፊት	geffit
ግፊያ	geffiyā
ጎለመሰ	golammasa
ጎልማሳ	golemāssā
ጎመን	gomman
ጎመዘዘ	gomazzaza
ጎመደ	gommada
ጎመጀ	gomaǧǧa
ጎሚስታ	gommisetā
ጎማ	gommā
ጎማህ	gommāh
ጎማሬ	gommāré
ጎምላላ	gomelāllā
ጎምዛዛ	gomezzāzā
ጎረመሰ	gorammasa
ጎረሰ	gorrasa
ጎረበ	gorraba
ጎረደ	gorrada
ጎረደመ	goraddama
ጎራረደ	gorārrada
ጎርደድ	goredadd
ጎሸመ	goššama
ጎሽ	gošš
ጎበበ	gobbaba
ጎበዘ	gobbaza
ጎታች	gottāc
ጎን	gonn
ጎንደርኛ	gonedareññā
ጎዘጎዘ	gozzaggoza
ጎዦ	gožžo
ጎደለ	goddala
ጎደል	goddal
ጎዳ	goddā
ጎዳኒሳ	godānissā
ጎጆ	goǧǧo
ጎጆና	goǧǧonā
ጎፈረ	goffara
ጎፈር	goffar
ጎፈነነ	gofannana
ጐለተ	gwallata
ጐለጐለ	gwalaggwala
ጐላ	gwallā
ጐልማማ	gwalemāmmā
ጐልዳፋ	gwaledāffā
ጐመራ	gwamarrā
ጐረበጠ	gwarabbaṭa
ጐረበጠኝ	gwarabbaṭaññ
ጐረና	gwarannā
ጐረጐረ	gwaraggwara
ጐረፈ	gwarrafa
ጐርናና	gwarenānnā
ጐርደድ	gwaredadd
ጐርዳዳ	gwaredāddā
ጐሰመ	gwassama
ጐሰረ	gwassara
ጐሰቈለ	gwasaqqwala
ጐሰጐሰ	gwasaggwasa
ጐስቋላ	gwaseqwāllā
ጐበኘ	gwabañña
ጐበጠ	gwabbaṭa
ጐባን	gwabbān
ጐተተ	gwattata
ጐተጐተ	gwataggwata
ጐነቈለ	gwanaqqwala
ጐነጐነ	gwanaggwana
ጐነጠ	gwannaṭa
ጐነፈ	gwannafa
ጐንበስ	gwanebass
ጐንዛላ	gwanezāllā
ጐደሪ	gwadarri
ጐደጐደ	gwadaggwada
ጐድጓዳ	gwadegwāddā
ጐጃሜ	gwaǧǧāmé
ጐጃም	gwaǧǧām
ጐፈየ	gwafayya
ጓሮኛ	gwāroññā
ጓያ	gwāyyā
ጓደኛ	gwādaññā
ጓደኛሞች	gwādaññāmoc
ጓደኝነት	gwāddaññennat
ጓድ	gwādd
ጓጐለ	gwāggwala
ጓጐረ	gwāggwara
ጓጐጠ	gwāggwaṭa
ጓጓ	gwāggwā
ጓጓላ	gwāggwālā
ጕላይ	gwellāy
ጕልት	gwellet
ጕልቻ	gweleccā
ጕሰማ	gwessamā
ጕስቈላ	gweseqwallā
ጕብኝት	gwebeññet
ጕተታ	gwettatā
ጕትት	gwettet
ጕትቻ	gweteccā
ጕነጣ	gwennaṭā
ጕዞኛ	gwezoññā
ጕጕ	gweggwe
ጕፋያ	gwefāyyā
ጠለለ	ṭallala
ጠለቀ	ṭallaqa
ጠለዘ	ṭallaza
ጠለፈ	ṭallafa
ጠላ	ṭallā
ጠል	ṭall
ጠመመ	ṭammama
ጠመረረ	ṭamarrara
ጠመሰሰ	ṭamassasa
ጠመቀ	ṭammaqa
ጠመዘዘ	ṭamazzaza
ጠመዝማዛ	ṭamazemāzzā
ጠመደ	ṭammada
ጠምባራ	ṭamebārrā
ጠምዛዛ	ṭamezāzzā
ጠምጣማ	ṭameṭāmmā
ጠረመሰ	ṭarammasa
ጠረረ	ṭarrara
ጠረሰ	ṭarrasa
ጠረቀመ	ṭaraqqama
ጠረበ	ṭarraba
ጠረነቀ	ṭarannaqa
ጠረዘ	ṭarraza
ጠረገ	ṭarraga
ጠረጴዛ	ṭarap̣p̣ézā
ጠራ	ṭarrā
ጠርባባ	ṭarebābbā
ጠርዛዛ	ṭarezāzzā
ጠሰቀ	ṭassaqa
ጠስቆ	ṭasseqo
ጠቀለለ	ṭaqallala
ጠቀመ	ṭaqqama
ጠቀሰ	ṭaqqasa
ጠቀስ	ṭaqqas
ጠቅላላ	ṭaqellālā
ጠቅላላውን	ṭaqelāllāwen
ጠቆረ	ṭaqqora
ጠበልተኛ	ṭabaletaññā
ጠበሰ	ṭabbasa
ጠበሰቀ	ṭabassaqa
ጠበቀ	ṭabbaqa
ጠበበ	ṭabbaba
ጠበኛ	ṭabaññā
ጠበደለ	ṭabaddala
ጠባ	ṭabbā
ጠባቂ	ṭabbāqi
ጠባብ	ṭabbāb
ጠብ	ṭabb
ጠብታ	ṭabbetā
ጠቦት	ṭabbot
ጠነሰሰ	ṭanassasa
ጠነቀቀ	ṭanaqqaqa
ጠነቆለ	ṭanaqqola
ጠነበዘ	ṭanabbaza
ጠነባ	ṭanabbā
ጠነነ	ṭannana
ጠነነኝ	ṭannanaññ
ጠነዛ	ṭanazzā
ጠነፈፈ	ṭanaffafa
ጠና	ṭannā
ጠኔ	ṭanné
ጠኔያም	ṭannéyām
ጠንቀኛ	ṭaneqaññā
ጠንቃቃ	ṭaneqāqqā
ጠንባራ	ṭanebārrā
ጠንባሳ	ṭanebāssā
ጠንባዛ	ṭanebāzzā
ጠንካራ	ṭanekkārā
ጠወለገ	ṭawallaga
ጠውላጋ	ṭawelāggā
ጠየመ	ṭayyama
ጠየቀ	ṭayyaqa
ጠያር	ṭayyār
ጠያቂ	ṭayyāqi
ጠያፍ	ṭayyāf
ጠይም	ṭayyem
ጠደቀ	ṭaddaqa
ጠዳ	ṭaddā
ጠጅ	ṭaǧǧ
ጠገበ	ṭaggaba
ጠገነ	ṭaggana
ጠገገ	ṭaggaga
ጠጋ	ṭaggā
ጠጋቢስ	ṭaggābis
ጠጋኝ	ṭaggāñ
ጠጠተ	ṭaṭṭata
ጠጠተኝ	ṭaṭṭataññ
ጠጣ	ṭaṭṭā
ጠፈረ	ṭaffara
ጠፈረተኛ	ṭafarataññā
ጠፈጠፈው	ṭafaṭṭafaw
ጠፈፈ	ṭaffafa
ጠፋ	ṭaffā
ጠፍ	ṭaff
ጠፍጣፋ	ṭafeṭāffā
ጡሌ	ṭullé
ጡል	ṭull
ጡረኛ	ṭuraññā
ጡርነት	ṭurennat
ጡብ	ṭubb
ጡንቸኛ	ṭunecaññā
ጡንቻማ	ṭunecāmmā
ጡጥ	ṭuṭṭ
ጢም	ṭimm
ጢሰኛ	ṭisaññā
ጢቅ	ṭiqq
ጢቅታ	ṭiqqetā
ጢን	ṭinn
ጣሰሰ	ṭāssasa
ጣጠኛ	ṭāṭaññā
ጣፈጠ	ṭāffaṭa
ጣፊያ	ṭāffiyā
ጤነኛ	ṭénaññā
ጤናማ	ṭénāmmā
ጤናዳም	ṭénāddām
ጥለኛ	ṭelaññā
ጥላማ	ṭelāmmā
ጥላቻ	ṭelāccā
ጥልቅ	ṭelleqq
ጥልቆ	ṭelleqo
ጥማድ	ṭemmād
ጥምልምል	ṭemelemell
ጥምር	ṭemmer
ጥምዝ	ṭemezz
ጥምጥም	ṭemeṭemm
ጥሞና	ṭemmonā
ጥሩምበኛ	ṭerumebaññā
ጥሪ	ṭerri
ጥራቢ	ṭerrābi
ጥራጊ	ṭerrāgi
ጥር	ṭerr
ጥርቃሚ	ṭereqqāmi
ጥርቃሞ	ṭereqqāmo
ጥርቅም	ṭereqqem
ጥርቅምአድርጎ	ṭereqemmeʼaderego
ጥርኝ	ṭereññ
ጥስቅ	ṭesseq
ጥቁም	ṭeqqum
ጥቃቅን	ṭeqāqqen
ጥቅል	ṭeqqel
ጥበቃ	ṭebbaqā
ጥበበኛ	ṭebabaññā
ጥበት	ṭebbat
ጥቢ	ṭebbi
ጥብቅ	ṭebbeq
ጥብቅና	ṭebeqennā
ጥብቆ	ṭebbeqo
ጥብኛ	ṭebbeññā
ጥቦት	ṭebbot
ጥንቃቄ	ṭeneqqāqé
ጥንካሬ	ṭenekkāré
ጥንዚዛ	ṭenezizzā
ጥየቃ	ṭeyyaqā
ጥዩፍ	ṭeyyuf
ጥያቄ	ṭeyyāqé
ጥይት	ṭeyyet
ጥይፍተኛ	ṭeyyefetaññā
ጥጃ	ṭeǧǧā
ጥገት	ṭeggat
ጥገና	ṭegganā
ጥገኛ	ṭeggaññā
ጥገኛነት	ṭeggaññānnat
ጥጋበኛ	ṭegābaññā
ጥግ	ṭegg
ጥግን	ṭeggen
ጥፊ	ṭeffi
ጥፋተኛ	ṭefātaññā
ጦልጣሏ	ṭoleṭāllwā
ጦልጧላ	ṭoleṭwāllā
ጦመኛ	ṭomaññā
ጦረኛ	ṭoraññā
ጦርነት	ṭorennat
ጦሰኛ	ṭosaññā
ጦስኝ	ṭoseññ
ጦሽ	ṭošš
ጦቢያ	ṭobbiyā
ጨለመ	ċallama
ጨለማ	ċallamā
ጨለጠ	ċallaṭa
ጨለፈ	ċallafa
ጨላጭ	ċallāċ
ጨሌ	ċallé
ጨመለቅ	ċamallaq
ጨመረ	ċammara
ጨመቀ	ċammaqa
ጨመተ	ċammata
ጨመደደ	ċamaddada
ጨምላቃ	ċamelāqqā
ጨምባሳ	ċamebāssā
ጨምታራ	ċametārrā
ጨምዳዳ	ċamedāddā
ጨረሰ	ċarrasa
ጨረታ	ċarratā
ጨረገደ	ċaraggada
ጨረፈ	ċarrafa
ጨርማማ	ċaremāmmā
ጨርማታ	ċaremāttā
ጨርማዳ	ċaremāddā
ጨርሶ	ċarreso
ጨርጫሳ	ċareċāssā
ጨቀየ	ċaqayya
ጨቅላነት	ċaqelānnat
ጨቅጫቃ	ċaqeċāqqā
ጨቆነ	ċaqqona
ጨቋኝ	ċaqqwāñ
ጨበጠ	ċabbaṭa
ጨቦደ	ċabboda
ጨነቀ	ċannaqa
ጨነገፈ	ċanaggafa
ጨንቋራ	ċaneqwārrā
ጨንባሳ	ċanebāssā
ጨከነ	ċakkana
ጨካኝ	ċakkāñ
ጨዋነት	ċawānnat
ጨውናና	ċawenānnā
ጨገገ	ċaggaga
ጨጓራ	ċaggwārrā
ጨፈለቀ	ċafallaqa
ጨፈረ	ċaffara
ጨፈነ	ċaffana
ጨፈገገ	ċafaggaga
ጨፋሪ	ċaffāri
ጨፋና	ċaffānā
ጨፌ	ċaffé
ጨፍራራ	ċaferārrā
ጨፍጋጋ	ċafegāggā
ጩርር	ċurerr
ጫማ	ċāmmā
ጫር	ċārr
ጫና	ċānnā
ጫን	ċānn
ጫካ	ċākkā
ጫካማ	ċākāmmā
ጫጩት	ċāċutt
ጫፍና	ċāfennā
ጭለማ	ċellamā
ጭላጭ	ċellāċ
ጭልጥ	ċelleṭṭ
ጭልፊት	ċelefitt
ጭማሪ	ċemmāri
ጭማቂ	ċemmāqi
ጭምር	ċemmer
ጭምት	ċemmet
ጭራሹ	ċerrāšu
ጭራሽ	ċerrāš
ጭር	ċerr
ጭርታ	ċerretā
ጭቁን	ċeqqun
ጭቃማ	ċeqāmmā
ጭቅቅታም	ċeqeqqetām
ጭቅቅት	ċeqeqqet
ጭቅና	ċeqennā
ጭቆና	ċeqqonā
ጭባጭ	ċebbāċ
ጭብጥ	ċebbeṭ
ጭብጦ	ċebbeṭo
ጭቦ	ċebbo
ጭቦኛ	ċebboññā
ጭንቅላታም	ċeneqellātām
ጭንቅላት	ċeneqqelāt
ጭከና	ċekkanā
ጭካኔ	ċekkāné
ጭኮ	ċekko
ጭው	ċeww
ጭውውት	ċewwewet
ጭፈራ	ċeffarā
ጭፍን	ċeffen
ጮሌ	ċollé
ጮረረ	ċorrara
ጮራ	ċorrā
ጮቤ	ċobbé
ጳጳሳት	p̣āp̣p̣āsāt
ጳጳስ	p̣āp̣p̣ās
ጸለየ	ṣallaya
ጸሎተኛ	ṣalotaññā
ጸበረቀ	ṣabarraqa
ጸነነ	ṣannana
ጸና	ṣannā
ጸያፍ	ṣayyāf
ጸደቀ	ṣaddaqa
ጸዳ	ṣaddā
ጸጋ	ṣaggā
ጸጥ	ṣaṭṭ
ጸጥተኛ	ṣaṭṭetaññā
ጸጸተ	ṣaṣṣata
ጸጸተኛ	ṣaṣataññā
ጽላተ	ṣellāta
ጽላት	ṣellāt
ጽኑነት	ṣenunnat
ጽዋ	ṣewwā
ጽጌረዳ	ṣeggéradā
ጾመኛ	ṣomaññā
ፀሐያማ	ṡaḥayāmmā
ፈለሰ	fallasa
ፈለሰመ	falassama
ፈለሰፈ	falassafa
ፈለቀ	fallaqa
ፈለቀቀ	falaqqaqa
ፈለገ	fallaga
ፈለጠ	fallaṭa
ፈለፈለ	falaffala
ፈሊጠኛ	faliṭaññā
ፈላ	fallā
ፈላሻ	fallāšā
ፈላጊ	fallāgi
ፈልሳሳ	falessāsā
ፈረመ	farrama
ፈረሰ	farrasa
ፈረሰኛ	farasaññā
ፈረሱላ	farasullā
ፈረንሳይኛ	faranesāyeññā
ፈረክራካ	farakerākkā
ፈረደ	farrada
ፈረደለት	farradalat
ፈረደበት	farradabbat
ፈረጠ	farraṭa
ፈረፈረ	faraffara
ፈሪነት	farinnat
ፈራ	farrā
ፈራሚ	farrāmi
ፈራረሰ	farārrasa
ፈርጣማ	fareṭāmmā
ፈሰሰ	fassasa
ፈሰከ	fassaka
ፈሰፈሰ	fasaffasa
ፈሳ	fassā
ፈቀቅ	faqaqq
ፈቀደ	faqqada
ፈቀደው	faqqadaw
ፈቀፈቀ	faqaffaqa
ፈቃደኛ	faqādaññā
ፈቃደኛነት	faqādaññānnat
ፈተለ	fattala
ፈተሸ	fattaša
ፈተነ	fattana
ፈተገ	fattaga
ፈተፈተ	fataffata
ፈታ	fattā
ፈታሽ	fattāš
ፈታታ	fatāttā
ፈታኝ	fattāñ
ፈት	fatt
ፈትለክ	fatelakk
ፈነቀለ	fanaqqala
ፈነከተ	fanakkata
ፈነደቀ	fanaddaqa
ፈነዳ	fanaddā
ፈነገለ	fanaggala
ፈንዳዳ	fanedāddā
ፈንጋላ	fanegāllā
ፈንጠዝያ	faneṭazeyyā
ፈንጣራ	faneṭārrā
ፈካ	fakkā
ፈወሰ	fawwasa
ፈዋሽ	fawwāš
ፈዘዘ	fazzaza
ፈዛዛ	fazāzzā
ፈየለ	fayyala
ፈየደ	fayyada
ፈጀ	faǧǧa
ፈጅ	faǧǧ
ፈገመ	faggama
ፈገገ	faggaga
ፈገፈገ	fagaffaga
ፈግጠው	faggeṭaw
ፈጠመ	faṭṭama
ፈጠፈጠ	faṭaffaṭa
ፈጸመ	faṣṣama
ፈጻሚ	faṣṣāmi
ፉት	futt
ፉከራ	fukkarā
ፉክክር	fukekker
ፉጉሎ	fugullo
ፊር	firr
ፊተኛው	fitaññāw
ፊትና	fitennā
ፊን	finn
ፊኛ	fiññā
ፊጥኝ	fiṭṭeññ
ፋነነ	fānnana
ፋንድያ	fāneddeyā
ፋኖ	fānno
ፋፋ	fāffā
ፌዘኛ	fézzaññā
ፍለጋ	fellagā
ፍላጎት	fellāgot
ፍልስፍና	felesefennā
ፍልቃቂ	felleqqāqi
ፍሥሐ	feśśeḥa
ፍራሽ	ferrāš
ፍራቻ	ferāccā
ፍሬያማ	feréyāmmā
ፍርምባ	feremebbā
ፍርስ	ferres
ፍርጥ	ferreṭ
ፍርፋሪ	fereffāri
ፍሳሽ	fessāš
ፍስስ	fesses
ፍስክ	fessek
ፍቅረኛ	feqeraññā
ፍቅፋቂ	feqeffāqi
ፍተሻ	fettašā
ፍተጋ	fettagā
ፍትወተኛ	fetewataññā
ፍትግ	fetteg
ፍች	fecc
ፍንካች	fenekkāc
ፍንክች	fenekecc
ፍንድቅ	feneddeqq
ፍየል	feyyal
ፍዳ	feddā
ፍዳውን	feddāwen
ፍጅት	feǧǧet
ፍግም	feggemm
ፍግፋጊ	fegeffāgi
ፍጥጥ	feṭeṭṭ
ፍጹምነት	feṣṣumennat
ፎሌ	follé
ፎልፏላ	folefwāllā
ፎረሸ	forraša
ፎቀቅ	foqqaq
ፎነነ	fonnana
ፎከረ	fokkara
ፎከተ	fokkata
ፎከት	fokatt
ፓኮ	pākko
ፓፓዬ	pāppāyé
ፕሮፓጋንዳ	peropāgāneddā
ፖሊቲከኛ	politikaññā
ፖስተኛ	posetaññā
