# Baby names
ਅਂਗਦ	انجد
ਅਂਗਦ ਦੇਵ	انجد ديو
ਅਂਗਾਰਿਕਾ	انجاريكا
ਅਂਤਰਜੋਤ	انترجوت
ਅਂਤਰਪ੍ਰਿਤ	انتربريت
ਅਂਤਰਾ	انترا
ਅਕਲਤਟ	اكلتط
ਅਕਲਰੂਪ	اكلروب
ਅਕਲਸ਼ਰਣ	اكلشرن
ਅਕਲਸੀਮਾਰ	اكلسيمار
ਅਕਾਲਜੋਗ	اكالجوج
ਅਕਾਲਦੀਪ	اكالديب
ਅਕਾਲਪ੍ਰੀਤ	اكالبريت
ਅਕਾਲਬੀਰ	اكالبير
ਅਗਮਜੀਤ	اجمجيت
ਅਗਮਜੋਤ	اجمجوت
ਅਗਮ੍ਪਾਲ	اجمبال
ਅਗਮ੍ਪ੍ਰੀਤ	اجمبريت
ਅਜ੍ਮੀਨ੍ਦੇਰ	اجميندير
ਅਝਾਦਬੀਰ	اجهادبير
ਅਝੀਝ	اجهيجه
ਅਤੀਨਦੇਰ੍ਜਿਤ	اتينديرجيت
ਅਤੀਨ੍ਦੇਰ	اتيندير
ਅਤ੍ਤਾਮਜਿਤ	اتتامجيت
ਅਨਂਤਦੇਵ	اننتديو
ਅਨਂਤਰ	اننتر
ਅਨਂਤਵੀਰ	اننتوير
ਅਨਂਤ੍ਜੀਤ	اننتجيت
ਅਨਾਹਤ	اناهت
ਅਨਿਂਦਿਤਾ	انينديتا
ਅਨਿਸ਼ਾ	انيشا
ਅਨੀਲਜੋਤ	انيلجوت
ਅਨੀਸ਼੍ਕੋਉਂਰ	انيشكوونر
ਅਨੁਂਜਪਾਲ	انونجبال
ਅਨੁਂਪਜੋਤ	انونبجوت
ਅਨੁਰਾਧਾ	انورادها
ਅਨੁਸ਼੍ਕਾ	انوشكا
ਅਨੂਪਜੋਤ	انوبجوت
ਅਨੂਪਬੀਰ	انوببير
ਅਨੂਪਲੋਕ	انوبلوك
ਅਪੂਰ੍ਵਾ	ابوروا
ਅਪ੍ਰੀਨਦੇਰ	ابريندير
ਅਬਨੀ	ابني
ਅਬਿਚਾਲ	ابيتشال
ਅਬਿਨਾਸ਼	ابيناش
ਅਭਿਜੀਤ	ابهيجيت
ਅਭਿਰੂਪ	ابهيروب
ਅਮਨਜੀਤ	امنجيت
ਅਮਰਜੋਤ	امرجوت
ਅਮਰਤ	امرت
ਅਮਰਿਂਦਰ	امريندر
ਅਮਰਿਤ	امريت
ਅਮਲਜੋਤ	املجوت
ਅਮਾਨਜੀਵਨ	امانجيون
ਅਮਾਨੀਨ੍ਦੇਰ	امانيندير
ਅਮਾਨ੍ਰੂਪ	امانروب
ਅਮਾਰ੍ਪਾਲ	اماربال
ਅਮਾਰ੍ਬੀਰ	اماربير
ਅਮਿਕ	اميك
ਅਮਿਤ	اميت
ਅਮਿਤੋਜ	اميتوج
ਅਮੀਤਪਾਲ	اميتبال
ਅਮੀਤ੍ਬੀਰ	اميتبير
ਅਮੋਲ੍ਰਸ	امولرس
ਅਮ੍ਨੀਨ੍ਦੇਰ	امنيندير
ਅਮ੍ਰੀਤਬਾਨ	امريتبان
ਅਮ੍ਰੀਤ੍ਪ੍ਰਿਤ	امريتبريت
ਅਮ੍ਰੀਤ੍ਵਾਨੀ	امريتواني
ਅਰਮਾਨੀ	ارماني
ਅਰਵਜੋਤ	اروجوت
ਅਰੀਨਾਜੇਤ	اريناجيت
ਅਰੀਨ੍ਦੇਰ੍ਜੀਤ	ارينديرجيت
ਅਰੁਨਜੀਤ	ارونجيت
ਅਰੁਨਜੋਤ	ارونجوت
ਅਰ੍ਚਨਾ	ارتشنا
ਅਰ੍ਦਮਨ	اردمن
ਅਰ੍ਨਾਲੀਨ੍ਦੇਰ	ارناليندير
ਅਰ੍ਸ਼੍ਦੀਪ	ارشديب
ਅਲੋਕ੍ਪਾਲ	الوكبال
ਅਲ੍ਪਨਾ	البنا
ਅਵਨੀਨਦੇਰ	اونيندير
ਅਵਿਰ	اوير
ਅਵ੍ਲੀਨ	اولين
ਅਸਂਖ	اسنكه
ਅਸ਼ਮਿਤ	اشميت
ਅਸ਼ਰ੍ਨਾਮ	اشرنام
ਅਸ਼ਰ੍ਪ੍ਰੀਤ	اشربريت
ਅਸ਼ਰ੍ਪ੍ਰੇਮ	اشربريم
ਅਸ਼ਰ੍ਵੀਰ	اشروير
ਅਸ਼ਿਮਾ	اشيما
ਅਸੀਮ	اسيم
ਅਸੀਸ	اسيس
ਅਸ੍ਨੇਹ	اسنيه
ਆਖਰੀ	آكهري
ਆਤ੍ਮਜਾ	آتمجا
ਆਨਂਦਮਯੀ	آنندميي
ਆਨਂਦਰੂਪ	آنندروب
ਆਯਕਾਰ	آيكار
ਆਯਾਤਪ੍ਰਿਤ	آياتبريت
ਆਯੁਸ਼੍ਮਤਿ	آيوشمتي
ਆਰਮਾਨ	آرمان
ਆਰਾਧ	آراده
ਆਰਾਧਨਾ	آرادهنا
ਆਰ੍ਯਨ	آرين
ਇਂਦਰਬੀਰ	إندربير
ਇਂਦਿਵਰ	إنديور
ਇਕਪ੍ਰਿਤ	إكبريت
ਇਕਬਾਲ	إكبال
ਇਕਰੂਪ	إكروب
ਇਕ੍ਪੂਜ	إكبوج
ਇਕ੍ਮਾਨ	إكمان
ਇਚ੍ਕਜਿਤ	إتشكجيت
ਇਨ੍ਦਾਰਤੇਜ	إندارتيج
ਇਨ੍ਦਾਰਮਿਤ	إندارميت
ਇਨ੍ਦਾਰ੍ਦੀਪ	إندارديب
ਇਨ੍ਦਾਰ੍ਪ੍ਰਿਤ	إنداربريت
ਇਨ੍ਦਾਰ੍ਪ੍ਰੇਮ	إنداربريم
ਇਨ੍ਦੇਰ	إندير
ਇਨ੍ਦੇਰਪਲ	إنديربل
ਇਨ੍ਦੇਰਮਾਨ	إنديرمان
ਇਨ੍ਦੇਰਹਾਰ੍ਜਿਤ	إنديرهارجيت
ਇਮਰਾਤ	إمرات
ਈਖ੍ਤਿਅਰ	إكهتيار
ਈਨ੍ਦਰ੍ਜੀਏਤ	إندرجييت
ਈਨ੍ਦੇਰਤੇਕ	إنديرتيك
ਈਨ੍ਦੇਰਵੀਰ	إنديروير
ਈਬਾਦਤ	إبادت
ਈਸ਼ਪਾਲ	إشبال
ਈਸ਼ਲੀਨ	إشلين
ਈਸ਼ਾਰਤੇਕ	إشارتيك
ਈਸ਼ਾਰਪਾਲ	إشاربال
ਈਸ਼੍ਤ੍ਵਰ੍ਜਿਤ	إشتورجيت
ਈਸ਼੍ਪ੍ਰਿਤ	إشبريت
ਈਸ਼੍ਵਾਰ੍ਜਿਤ	إشوارجيت
ਈਸ਼੍ਵੀਨਦੇਰ	إشويندير
ਉਖ੍ਤਿਅਰ	وكهتيار
ਉਚਪਾਲ	وتشبال
ਉਚਪ੍ਰਿਤ	وتشبريت
ਉਚੀਤਦੀਪ	وتشيتديب
ਉਚੀਤਪ੍ਰਿਤ	وتشيتبريت
ਉਚੀਤਬੀਰ	وتشيتبير
ਉਚੀਤਰੂਪ	وتشيتروب
ਉਚੀਤਲੋਕ	وتشيتلوك
ਉਚੀਤਵਂਤ	وتشيتونت
ਉਜਗਰ੍ਜੋਤ	وججرجوت
ਉਜਗਰ੍ਦੀਪ	وججرديب
ਉਜਗਰ੍ਬੀਰ	وججربير
ਉਜਾਗਰ	وجاجر
ਉਜਾਲਾ	وجالا
ਉਜ੍ਜਲਜੋਤ	وججلجوت
ਉਤ੍ਤਮ	وتتم
ਉਤ੍ਤਮਪਾਲ	وتتمبال
ਉਤ੍ਤਮਲੀਵ	وتتمليو
ਉਤ੍ਤਾਮਕਾਰਾਮ	وتتامكارام
ਉਤ੍ਤਾਮਜੋਧ	وتتامجوده
ਉਤ੍ਤਾਮਤਿਰਥ	وتتامتيرته
ਉਤ੍ਤਾਮਤੇਕ	وتتامتيك
ਉਤ੍ਤਾਮਦੀਪ	وتتامديب
ਉਤ੍ਤਾਮਪਦ	وتتامبد
ਉਤ੍ਤਾਮ੍ਰਸ	وتتامرس
ਉਤ੍ਤਾਮ੍ਰੂਪ	وتتامروب
ਉਤ੍ਰਕ੍ਸ਼	وتركش
ਉਦੀਤਦੀਪ	وديتديب
ਉਦੀਤਪ੍ਰਿਤ	وديتبريت
ਉਦੀਤਬੀਰ	وديتبير
ਉਦੈਬੀਰ	ودايبير
ਉਦੈਭਗਤ	ودايبهجت
ਉਦ੍ਦਾਮਜੀਤ	وددامجيت
ਉਪਕਰਮ	وبكرم
ਉਪਕਿਰਤ	وبكيرت
ਉਪਜਿਤ	وبجيت
ਉਪਨਿਤ	وبنيت
ਉਪੀਨਦੇਰ੍ਪ੍ਰਿਤ	وبينديربريت
ਉਪੇਨ੍ਦੇਰ	وبيندير
ਉਮੀਦ	وميد
ਊਤ੍ਤਮ੍ਗਿਆਨ	وتتمجيآن
ਏਕਂਕਰ	إيكنكر
ਏਕਬੀਰ	إيكبير
ਏਕਮ	إيكم
ਏਕਮਪੂਜ	إيكمبوج
ਏਕਮਬੀਰ	إيكمبير
ਏਕਮ੍ਜੋਤ	إيكمجوت
ਏਕਮ੍ਰੂਪ	إيكمروب
ਏਕਾਨਪ੍ਰੀਤ	إيكانبريت
ਏਕ੍ਕਾਮ	إيككام
ਏਤੀਬਾਰ	إيتيبار
ਏਤ੍ਤਲੀਨ	إيتتلين
ਏਰਸ਼ੀਨ	إيرشين
ਏਵੇਨਿਤ	إيوينيت
ਏਸ਼ਨਾ	إيشنا
ਏਸ਼੍ਵਰ	إيشور
ਓਨਕਾਰ੍ਜਿਤ	اونكارجيت
ਓਨਕਾਰ੍ਜੀਤ	اونكارجيت
ਓਨਕਾਰ੍ਪ੍ਰਿਤ	اونكاربريت
ਓਮਪ੍ਰਿਤ	اومبريت
ਕਂਵਲ	كنول
ਕਂਵਲਜੀਤ	كنولجيت
ਕਨਵਾਰ੍ਜਾਗਤ	كنوارجاجت
ਕਨਵਾਰ੍ਜਿਤ	كنوارجيت
ਕਨਵਾਰ੍ਪ੍ਰੇਮ	كنواربريم
ਕਨਵਾਲ੍ਜੋਤ	كنوالجوت
ਕਨਵਾਲ੍ਨੈਨ	كنوالناين
ਕਨਵਾਲ੍ਪਾਲ	كنوالبال
ਕਨਵਾਲ੍ਪ੍ਰੇਮ	كنوالبريم
ਕਨਵਾਲ੍ਬੀਰ	كنوالبير
ਕਨਵਾਲ੍ਰੂਪ	كنوالروب
ਕਨ੍ਚਨ੍ਦੀਪ	كنتشنديب
ਕਨ੍ਚਾਨ੍ਪਾਲ	كنتشانبال
ਕਨ੍ਵਾਰਪਾਲ	كنواربال
ਕਮਾਲ੍ਲਾ	كماللا
ਕਰਨਦੀਪ	كرنديب
ਕਰਨਪਾਲ	كرنبال
ਕਰਨਪ੍ਰਿਤ	كرنبريت
ਕਰਨਰੂਪ	كرنروب
ਕਰਮਪਲ	كرمبل
ਕਰਮਪੁਲ	كرمبول
ਕਰਮ੍ਜੋਤ	كرمجوت
ਕਰੁਨ੍ਯਾ	كرونيا
ਕਲਬੀਰ	كلبير
ਕਲਾਜੋਤ	كلاجوت
ਕਲਾਪ੍ਰੇਮ	كلابريم
ਕਵਨਿਤ	كونيت
ਕਵਨੀਰ	كونير
ਕਵਾਲ੍ਨਾਨ	كوالنان
ਕਵਿਰਾਜ	كويراج
ਕਸਮ	كسم
ਕਾਨਵਾਲੀਨ੍ਦੇਰ	كانواليندير
ਕਾਮਾਂਲਜੋਤ	كامانلجوت
ਕਾਮਾਂਲਮਿਤ	كامانلميت
ਕਾਮਾਂਲਮੋਹਨ	كامانلموهن
ਕਾਮਾਂਲ੍ਪਤਿ	كامانلبتي
ਕਾਰਮਨ	كارمن
ਕਾਵਾਲਪ੍ਰਿਤ	كاوالبريت
ਕਿਰਣਜੀਤ	كيرنجيت
ਕਿਰਨਰੂਪ	كيرنروب
ਕਿਰਨਸੁਖ	كيرنسوكه
ਕਿਸ਼ੇਨ	كيشين
ਕੁਂਵਰਜੀਤ	كونورجيت
ਕੁਲ	كول
ਕੁਲਜੋਤ	كولجوت
ਕੁਲਮਿਤ	كولميت
ਕੁਲਰਾਤਨ	كولراتن
ਕੁਲਰੂਪ	كولروب
ਕੁਲਵਂਠ	كولونطه
ਕੁਸ਼ਪ੍ਰਿਤ	كوشبريت
ਕੇਵਾਲਦੀਪ	كيوالديب
ਕੇਵਾਲਬੀਰ	كيوالبير
ਕੋਉਰ	كوور
ਕੋਮਾਂਲਜੀਤ	كومانلجيت
ਕੋਮਾਂਲਪ੍ਰੇਮ	كومانلبريم
ਕੋਮਾਲਦੀਪ	كومالديب
ਕੋਮਾਲਮਿਤ	كومالميت
ਕੌਰ	كاور
ਕ੍ਰਿਸ਼੍ਦੀਪ	كريشديب
ਕ੍ਸ਼ਾਗਨ	كشاجن
ਕ੍ਸ਼ਾਗਰ	كشاجر
ਕ੍ਸ਼ਿਤਿਜ	كشيتيج
ਕ੍ਸ਼੍ਹੀਮ	كشهيم
ਖਰਗ	كهرج
ਖਾਲਾਕ੍ਵੀਰ	كهالاكوير
ਖੁਂਸ਼ਜੋਤ	كهونشجوت
ਖੁਸ	كهوس
ਖੁਸ਼	كهوش
ਖੁਸ਼ਜੀਤ	كهوشجيت
ਖੇਮਵਂਤ	كهيمونت
ਗਗਨ	ججن
ਗਗਨਜੀਵ	ججنجيو
ਗਗਨਜੋਤ	ججنجوت
ਗਗਨਪ੍ਰਿਤ	ججنبريت
ਗਗਨਮਿਤ	ججنميت
ਗਤਲੀਨ	جتلين
ਗਤਸ਼ਰਣ	جتشرن
ਗਤਸੀਮਾਰ	جتسيمار
ਗਰੀਨ੍ਦੇਰ	جريندير
ਗਰ੍ਗੋਤ	جرجوت
ਗਾਤਨੀਵਾਸ	جاتنيواس
ਗਿਅਨ	جيان
ਗੀਂਜੀਵਨ	جينجيون
ਗੀਂਰਾਤਨ	جينراتن
ਗੀਂਲੀਨ	جينلين
ਗੀਅਂਗੀਤ	جيانجيت
ਗੀਅਂਚੇਤਨ	جيانتشيتن
ਗੀਅਂਜੋਤ	جيانجوت
ਗੀਅਂਪ੍ਰਿਤ	جيانبريت
ਗੀਅਂਰੂਪ	جيانروب
ਗੀਅਨੀਨਦੇਰ	جيانيندير
ਗੀਅਨ੍ਬੀਰ	جيانبير
ਗੀਆਨਪ੍ਰਿਤ	جيآنبريت
ਗੀਆਨਲੀਨ	جيآنلين
ਗੀਤ	جيت
ਗੀਤਲੀਨ	جيتلين
ਗੀਤੀਨਦੇਰ	جيتيندير
ਗੁਣਿਤ	جونيت
ਗੁਨ ਦਾਤ	جون دات
ਗੁਨਕਿਰਤ	جونكيرت
ਗੁਨਜਸ	جونجس
ਗੁਨਜਿਤ	جونجيت
ਗੁਨਜੀਵਨ	جونجيون
ਗੁਨਜੁਨ	جونجون
ਗੁਨਜੋਤ	جونجوت
ਗੁਨਪ੍ਰਿਤ	جونبريت
ਗੁਨਮਿਤ	جونميت
ਗੁਨਰਾਜ	جونراج
ਗੁਨਸ਼ਾਂਤ	جونشانت
ਗੁਨਾਤਮ	جوناتم
ਗੁਨਿਤਪੁਲ	جونيتبول
ਗੁਨਿਤਪ੍ਰਿਤ	جونيتبريت
ਗੁਨ੍ਰਿਤ	جونريت
ਗੁਰਕਮਲ਼	جوركمل
ਗੁਰਗਿਯਨ	جورجيين
ਗੁਰਜਾਸ	جورجاس
ਗੁਰਜੀਵਨ	جورجيون
ਗੁਰਜੋਗ	جورجوج
ਗੁਰਜੋਤ	جورجوت
ਗੁਰਝੀਲ	جورجهيل
ਗੁਰਤਰਣ	جورترن
ਗੁਰਤਿਰਥ	جورتيرته
ਗੁਰਦਰ੍ਸ਼ਨ	جوردرشن
ਗੁਰਦਿਤ	جورديت
ਗੁਰਦੀਤ੍ਤਾ	جورديتتا
ਗੁਰਦ੍ਵੀਪ	جوردويب
ਗੁਰਨਾਦ	جورناد
ਗੁਰਨਾਮਾਸ੍ਕਾਰ	جورناماسكار
ਗੁਰਨੀਧ	جورنيده
ਗੁਰਨੀਰ੍ਮਾਲ	جورنيرمال
ਗੁਰਨੀਸ਼ਾਨ	جورنيشان
ਗੁਰਨ੍ਯਮ	جورنيم
ਗੁਰਪਰ੍ਵਿਨ	جوربروين
ਗੁਰਪੀਨਦੇਰ	جوربيندير
ਗੁਰਪ੍ਰੀਤਮ	جوربريتم
ਗੁਰਬਕ੍ਸ਼	جوربكش
ਗੁਰਬਲੀਹਾਰ	جوربليهار
ਗੁਰਬੀਨ੍ਦੇਰ	جوربيندير
ਗੁਰਬੀਰ	جوربير
ਗੁਰਭਜਨ	جوربهجن
ਗੁਰਭਾਗਤ	جوربهاجت
ਗੁਰਮਾਰ	جورمار
ਗੁਰਮਾਹੇਰ	جورماهير
ਗੁਰਮੁਖ	جورموكه
ਗੁਰਮੇਹਾਰ	جورميهار
ਗੁਰਮੈਲ	جورمايل
ਗੁਰਮ੍ਰਿਤ	جورمريت
ਗੁਰਲੋਚਨ	جورلوتشن
ਗੁਰਵਿਂਦਰ	جورويندر
ਗੁਰਵੀਨ੍ਦੇਰ	جورويندير
ਗੁਰਵੀਰ	جوروير
ਗੁਰਸਨ੍ਦੀਪ	جورسنديب
ਗੁਰਸ਼ਾਨ	جورشان
ਗੁਰਸੁਖ	جورسوكه
ਗੁਰਸੇਵ	جورسيو
ਗੁਰਹਾਰ੍ਪਾਲ	جورهاربال
ਗੁਰਿਂਦਰ	جوريندر
ਗੁਰੀਨਦੇਰ੍ਪਾਲ	جورينديربال
ਗੁਰੁਕਾਰ	جوروكار
ਗੁਰੁਗੁਲ੍ਝਾਰ	جوروجولجهار
ਗੁਰੁਚਰਣ	جوروتشرن
ਗੁਰੁਦਰ੍ਸ਼ਨ	جورودرشن
ਗੁਰੁਦਾਸ	جوروداس
ਗੁਰੁਦੀਪ	جوروديب
ਗੁਰੁਪ੍ਰੇਮ	جوروبريم
ਗੁਰੁਬੀਰ	جوروبير
ਗੁਰੁਮਾਂਨ੍ਦੀਰ	جورومانندير
ਗੁਰੁਸੀਮ੍ਰਣ	جوروسيمرن
ਗੁਰ੍ਕੀਰਣ	جوركيرن
ਗੁਰ੍ਕੀਰਪਾਲ	جوركيربال
ਗੁਰ੍ਚਾਰਾਨ੍ਜੋਤ	جورتشارانجوت
ਗੁਰ੍ਜਨਪਾਲ	جورجنبال
ਗੁਰ੍ਜੁ	جورجو
ਗੁਰ੍ਤੇਜ	جورتيج
ਗੁਰ੍ਨੀਵਾਝ	جورنيواجه
ਗੁਰ੍ਨੂਰ	جورنور
ਗੁਰ੍ਪ੍ਰਿਤੀ	جوربريتي
ਗੁਰ੍ਮੀਤ	جورميت
ਗੁਰ੍ਮੀਨਦੇਰ	جورميندير
ਗੁਰ੍ਮੁਖਨੀਹਲ	جورموكهنيهل
ਗੁਰ੍ਸ਼ਣ	جورشن
ਗੁਰ੍ਸ਼ਾਂਤ	جورشانت
ਗੁਰ੍ਸ਼ੀਲ	جورشيل
ਗੁਰ੍ਸਾਹੇਬ	جورساهيب
ਗੁਲਦੀਪ	جولديب
ਗੁਲਵਂਤ	جولونت
ਗੁਲਸ਼ਾਨ੍ਰੂਪ	جولشانروب
ਗੁਲ੍ਵਾਨ੍ਤਪ੍ਰਿਤ	جولوانتبريت
ਗੁਲ੍ਸ਼ਾਨਪ੍ਰਿਤ	جولشانبريت
ਗੁਲ੍ਸ਼ਾਨਮਿਤ	جولشانميت
ਗੋਪਲਪ੍ਰਿਤ	جوبلبريت
ਗੋਬਿਂਦ	جوبيند
ਗੋਬੀਨਦੇਰ	جوبيندير
ਗੋਬੀਨਦੇਰ੍ਜਿਤ	جوبينديرجيت
ਗੋਬੀਨ੍ਦਰਾਈ	جوبيندراي
ਗੌਰਵ੍ਪ੍ਰਿਤ	جاوروبريت
ਘਮਾਂਨਦ੍ਜਿਤ	جهمانندجيت
ਘਮਾਂਨਦ੍ਪਾਲ	جهمانندبال
ਚਂਚਲਜਿਤ	تشنتشلجيت
ਚਂਚਲ੍ਪ੍ਰੀਤ	تشنتشلبريت
ਚਂਦਨ	تشندن
ਚਂਦਨਦੀਪ	تشندنديب
ਚਮਕੌਰ	تشمكاور
ਚਮਨਜਿਤ	تشمنجيت
ਚਮਨਪ੍ਰਿਤ	تشمنبريت
ਚਮਨਰੂਪ	تشمنروب
ਚਰਨਕਾਨ੍ਵਾਲ	تشرنكانوال
ਚਰਨਜੋਤ /ਚਰਨਜ੍ਯੋਤ	تشرنجوت /تشرنجيوت
ਚਰਨਪ੍ਰੇਮ	تشرنبريم
ਚਾਂਦ	تشاند
ਚਿਤਰਾਮਣ	تشيترامن
ਚਿਤਸਰੂਪ	تشيتسروب
ਚੀਤਪ੍ਰਿਤ	تشيتبريت
ਚੇਤਨ੍ਦੀਪ	تشيتنديب
ਜਗਜੀਤ	جججيت
ਜਗਜੀਵ	جججيو
ਜਗਜੀਵਨ	جججيون
ਜਗਤਜੀਤ	ججتجيت
ਜਗਤਪ੍ਰੇਮ	ججتبريم
ਜਗਤਰਣ	ججترن
ਜਗਤਰੂਪ	ججتروب
ਜਗਨ	ججن
ਜਗਪਾਲ	ججبال
ਜਗਪ੍ਰਿਤ	ججبريت
ਜਗਪ੍ਰੇਮ	ججبريم
ਜਗਮਿਤ	ججميت
ਜਗਮੇਹਾਰ	ججميهار
ਜਗਮੋਹਨ	ججموهن
ਜਗਰਾਜ	ججراج
ਜਗਰੂਪ	ججروب
ਜਗਵੀਨ੍ਦੇਰ	ججويندير
ਜਗਵੀਰ	ججوير
ਜਗੀਨਦੇਰ	ججيندير
ਜਗੀਨ੍ਦੇਰਪਾਲ	ججينديربال
ਜਗ੍ਵੀਰ	ججوير
ਜਘ੍ਰ	ججهر
ਜਤੀਨਦੇਰ੍ਜਿਤ	جتينديرجيت
ਜਤੀਨਦੇਰ੍ਬੀਰ	جتينديربير
ਜਤੀਨਦੇਰ੍ਮਿਤ	جتينديرميت
ਜਨਜਿਤ	جنجيت
ਜਨਜੋਤ	جنجوت
ਜਨਪ੍ਰਿਤ	جنبريت
ਜਨਰਾਜ	جنراج
ਜਨਿਸ਼	جنيش
ਜਪਜਿਤ	جبجيت
ਜਪਧਾਰਾਮ	جبدهارام
ਜਪਧਿਰ	جبدهير
ਜਪਨਾਮ	جبنام
ਜਪਸ਼ੇਰ	جبشير
ਜਪੁਜੀ	جبوجي
ਜਬਰਜਂਗ	جبرجنج
ਜਮੀਲ	جميل
ਜਯਂਸ਼	جينش
ਜਯਪਾਲ	جيبال
ਜਰ੍ਨੈਲ	جرنايل
ਜਲਿਨ੍ਦ੍ਰ	جليندر
ਜਲ੍ਬੀਰ	جلبير
ਜਸਂਜੋਤ	جسنجوت
ਜਸਂਪਾਲ	جسنبال
ਜਸਂਮਿਤ	جسنميت
ਜਸਕੀਰਣ	جسكيرن
ਜਸਗੁਰ੍ਕੀਰ੍ਤਤ	جسجوركيرتت
ਜਸਜੀਨ੍ਦੇਰ	جسجيندير
ਜਸਜੀਵਨ	جسجيون
ਜਸਜੋਤ	جسجوت
ਜਸਤਰਣ	جسترن
ਜਸਨਾਮ	جسنام
ਜਸਪਾਲ (ਪੁਲ )	جسبال (بول )
ਜਸਬੀਰ	جسبير
ਜਸਭੂਪ	جسبهوب
ਜਸਮਿਂਦਰ	جسميندر
ਜਸਮੋਹਨ	جسموهن
ਜਸਰੂਪ	جسروب
ਜਸ੍ਕਰਣ	جسكرن
ਜਸ੍ਕੀਰਿਤ	جسكيريت
ਜਸ੍ਕੀਰ੍ਪਲ	جسكيربل
ਜਸ੍ਗੁਨ	جسجون
ਜਸ੍ਮਿਤ	جسميت
ਜਸ੍ਮੀਨਪ੍ਰਿਤ	جسمينبريت
ਜਸ੍ਰਜਪ੍ਰਿਤ	جسرجبريت
ਜਸ੍ਸੀ	جسسي
ਜਾਗ	جاج
ਜਾਗਰੀਤ	جاجريت
ਜਾਤਵਂਤ	جاتونت
ਜਾਤਿਨਦੇਰ੍ਦੀਪ	جاتينديرديب
ਜਾਨਾਕਪ੍ਰਿਤ	جاناكبريت
ਜਾਪਮਾਨ	جابمان
ਜਾਸਨਿਤ	جاسنيت
ਜਾਸ਼ਾਨਪ੍ਰਿਤ	جاشانبريت
ਜਾਸ੍ਮੀਲ	جاسميل
ਜੀਵਨਦੀਪ ; ਜੀਵਨਦੀਪ ; ਜੀਵਨਦੀਪ	جيونديب ; جيونديب ; جيونديب
ਜੀਵਨਪਲ	جيونبل
ਜੀਵਨਪ੍ਰਿਤ	جيونبريت
ਜੀਵਾਨਬੀਰ	جيوانبير
ਜੁਗਦ	جوجد
ਜੁਪੀਨਦੇਰਦੀਪ	جوبينديرديب
ਜੁਪੀਨਦੇਰ੍ਬੀਰ	جوبينديربير
ਜੁਸਜਿਤ	جوسجيت
ਜੁਸਪੁਲ	جوسبول
ਜੁਸਮੈਲ	جوسمايل
ਜੇਬਾ	جيبا
ਜੇਸਪਾਲ	جيسبال
ਜੈਕਾਰ	جايكار
ਜੈਪ੍ਰਜ	جايبرج
ਜੈਪ੍ਰਤਨ	جايبرتن
ਜੈਬੀਰ	جايبير
ਜੈਸਂਗਤ	جايسنجت
ਜੈਸੁਖਬੀਰ	جايسوكهبير
ਜੋਗਧੀਆਨ	جوجدهيآن
ਜੋਗਪ੍ਰਕਾਸ਼	جوجبركاش
ਜੋਗੀਨਦੇਰ੍ਬੀਰ	جوجينديربير
ਜੋਗੀਨਦੇਰ੍ਮਿਤ	جوجينديرميت
ਜੋਗੇਨਦੇਰ	جوجيندير
ਜੋਤਪ੍ਰਕਾਸ਼	جوتبركاش
ਜੋਬਨਰੂਪ	جوبنروب
ਜੋਹਾਰ	جوهار
ਜ੍ਞਾਨਜਿਤ	جنانجيت
ਜ੍ਞਾਨਜੋਤ	جنانجوت
ਜ੍ਞਾਨਪ੍ਰਿਤ	جنانبريت
ਜ੍ਞਾਨਰੂਪ	جنانروب
ਜ੍ਞਾਨਵੀਰ	جنانوير
ਜ੍ਞਾਨੇਨ੍ਦੇਰ	جنانيندير
ਜ੍ਹਮਕ	جهمك
ਜ੍ਹਾਗਰ	جهاجر
ਝਈਤੂਨ	جهيتون
ਝਹਾਗਨ	جههاجن
ਝਾਮੀਨਾਹ	جهاميناه
ਝੀਤੁਨ	جهيتون
ਝੀਲ	جهيل
ਝੁਲਾਖਾ	جهولاكها
ਝੁਲ੍ਫਾ	جهولبها
ਝੇਬਵਂਤ	جهيبونت
ਝੋਰਾਵਾਰ	جهوراوار
ਟੇਇਜਿਨ੍ਦੇਰ	طييجيندير
ਤਕਦੀਰ	تكدير
ਤਖਤ	تكهت
ਤਤਜੋਗ	تتجوج
ਤਤਬੀਰ	تتبير
ਤਤਵਿਚਾਰ	تتويتشار
ਤਤ੍ਰਾਤਨ	تتراتن
ਤਦਬੀਰ	تدبير
ਤਨਦੀਪ	تنديب
ਤਨਵੀਰ	تنوير
ਤਮਨ੍ਪ੍ਰਿਤ	تمنبريت
ਤਰਣਵੀਰ	ترنوير
ਤਰਲੋਚਨ	ترلوتشن
ਤਰਸੇਮ	ترسيم
ਤਰੁਨਜਿਤ	ترونجيت
ਤਲਵਿਨ	تلوين
ਤਾਜਦਾਰ	تاجدار
ਤਾਜੀਨਦੇਰ੍ਦੀਪ	تاجينديرديب
ਤਾਜੀਨਦੇਰ੍ਪ੍ਰੇਮ	تاجينديربريم
ਤਾਨੁਪ੍ਰਿਤ	تانوبريت
ਤਾਪਨਪਾਲ	تابنبال
ਤੀਰਨ /ਤਿਹ੍ਰਣ /ਤੇਯ੍ਰੁਣ	تيرن /تيهرن /تييرون
ਤੀਰਾਥ੍ਰਾਮ	تيراتهرام
ਤੁਵਿਜਾਤ	توويجات
ਤੇਕਜੀਤ	تيكجيت
ਤੇਕਦੀਪ	تيكديب
ਤੇਕਪ੍ਰਿਤ	تيكبريت
ਤੇਕ੍ਪਾਲ	تيكبال
ਤੇਘਬਹਾਦੁਰ	تيجهبهادور
ਤੇਜਧਾਰਾਮ	تيجدهارام
ਤੇਜਨਾਮ	تيجنام
ਤੇਜਪ੍ਰਤਾਪ	تيجبرتاب
ਤੇਜ਼	تيج
ਤੇਜਾਸਵੀਰ	تيجاسوير
ਤੇਜੀਨਦੇਰ੍ਜੀਤ	تيجينديرجيت
ਤੇਜੀਨਦੇਰ੍ਪਾਲ	تيجينديربال
ਤੋਤਾਸਿਂਹ	توتاسينه
ਤ੍ਰਿਪਲ	تريبل
ਤ੍ਰਿਲੋਚਨ	تريلوتشن
ਤ੍ਰੀਭਾਵਾਨ	تريبهاوان
ਤ੍ਰੀਸ਼ਾਨਜੋਤ	تريشانجوت
ਤ੍ਰੀਸ਼ਾਨਦੀਪ	تريشانديب
ਤ੍ਰੀਸ਼ਾਨਬੀਰ	تريشانبير
ਥਾਕੁਰਨਾਮ	تهاكورنام
ਥਾਲਭੂਪ	تهالبهوب
ਥਾਲਰਾਜ	تهالراج
ਥੀਰਮਾਨ	تهيرمان
ਥੀਰ੍ਧੀਆਨ	تهيردهيآن
ਦਮਨਜਿਤ	دمنجيت
ਦਮਨਜੋਤ	دمنجوت
ਦਯਾਜੋਤ	دياجوت
ਦਯਾਦੀਪ	دياديب
ਦਰਮੀਨ੍ਦੇਰ	درميندير
ਦਰ੍ਪ੍ਰਿਤ	دربريت
ਦਲਜੋਧ	دلجوده
ਦਲਬੀਨਦੇਰ	دلبيندير
ਦਲਬੀਨ੍ਦੇਰ੍ਜਿਤ	دلبينديرجيت
ਦਲਰਾਜ	دلراج
ਦਲੇਰ	دلير
ਦਵੀਨ੍ਦੇਰ	دويندير
ਦਿਦਾਰ	ديدار
ਦਿਨਤੇਕ	دينتيك
ਦਿਪਲੀਨ	ديبلين
ਦਿਲਜੋਤ	ديلجوت
ਦਿਲਨਿਤ	ديلنيت
ਦਿਲਪ੍ਰਿਤ	ديلبريت
ਦਿਲਮਿਤ	ديلميت
ਦਿਲਰਿਤ	ديلريت
ਦਿਲਸ਼ਾਨ	ديلشان
ਦਿਲਸ਼ੇਰ	ديلشير
ਦਿਵ੍ਯਜ੍ਯੋਤ	ديويجيوت
ਦੀਲਜੀਤ	ديلجيت
ਦੀਲਬਾਘ	ديلباجه
ਦੀਲ੍ਜਿਤ	ديلجيت
ਦੀਵ੍ਯਜੋਤ	ديويجوت
ਦੇਵਜੀਤ	ديوجيت
ਦੇਵਪ੍ਰਿਤ	ديوبريت
ਦੇਵਾਤ੍ਮਾ	ديواتما
ਦੇਵੀਨ੍ਦੇਰ	ديويندير
ਧਰਮਜ੍ਯੋਤ	دهرمجيوت
ਧਰਮਪਾਲ	دهرمبال
ਧਰਮਪ੍ਰੀਤ	دهرمبريت
ਧਰਮਲੀਨ	دهرملين
ਧੀਅਨ੍ਜੋਗ	دهيانجوج
ਨਕ੍ਸ਼ਤ੍ਰਾ	نكشترا
ਨਮ੍ਰੀਤਾਬੀਰ	نمريتابير
ਨਯਨਦੀਪ	نينديب
ਨਰਿਨ੍ਦਰ	نريندر
ਨਰੇਨ੍ਦ੍ਰ	نريندر
ਨਵਜੀਤ	نوجيت
ਨਵਜੀਵਨ	نوجيون
ਨਵਦੀਪ	نوديب
ਨਵਬੀਰ	نوبير
ਨਵਮਿਤ	نوميت
ਨਵ੍ਜੀਨ੍ਦੇਰ	نوجيندير
ਨਾਗਂਦਰ	ناجندر
ਨਾਨਕੀ	نانكي
ਨਾਨਵੀਰ	نانوير
ਨਾਨ੍ਦਾਨਜਿਤ	ناندانجيت
ਨਾਨ੍ਦਾਨਪ੍ਰਿਤ	ناندانبريت
ਨਾਮਜੀਵ	نامجيو
ਨਾਮਜੋਗ	نامجوج
ਨਾਮਜੋਤ	نامجوت
ਨਾਮਜੋਧ	نامجوده
ਨਾਮਧਾਰ	نامدهار
ਨਾਮਧਿਯਨ	نامدهيين
ਨਾਮਧਿਰ	نامدهير
ਨਾਮਨੀਰ੍ਮਾਲ	نامنيرمال
ਨਾਮਨੀਵਾਸ	نامنيواس
ਨਾਮਪ੍ਰਿਤ	نامبريت
ਨਾਮਪ੍ਰੇਮ	نامبريم
ਨਾਮਭਾਗਤ	نامبهاجت
ਨਾਮਵਿਚਾਰ	نامويتشار
ਨਾਮਸ਼ਰਣ	نامشرن
ਨਾਮਾਂਡੋਲ਼	ناماندول
ਨਾਮਾਹਾਰ	ناماهار
ਨਾਮੁਤ੍ਤਮ	ناموتتم
ਨਾਮ੍ਰਾਤਨ	نامراتن
ਨਾਮ੍ਰਿਤਾ	نامريتا
ਨਾਮ੍ਰੀਤਾਜੋਤ	نامريتاجوت
ਨਾਮ੍ਰੀਤਾਦੀਪ	نامريتاديب
ਨਾਮ੍ਰੀਤਾਪ੍ਰਿਤ	نامريتابريت
ਨਾਰ	نار
ਨਾਰਂਜਨ	نارنجن
ਨਾਰੀਤਪਲ	ناريتبل
ਨਾਰੀਨਦੇਰਦੀਪ	نارينديرديب
ਨਾਰੈਨ	ناراين
ਨਾਵਿਨਜਿਤ	ناوينجيت
ਨਾਵ੍ਕੀਰਣ	ناوكيرن
ਨਾਵ੍ਕੀਰਨਜੋਤ	ناوكيرنجوت
ਨਾਵ੍ਪ੍ਰਿਤ	ناوبريت
ਨਿਮਾਈ	نيماي
ਨਿਰਂਜਨ	نيرنجن
ਨਿਰਂਜਨਾ	نيرنجنا
ਨਿਰ੍ਮਲਜੀਤ	نيرملجيت
ਨਿਲਾਮਜੋਤ	نيلامجوت
ਨਿਲਾਮਪੁਲ	نيلامبول
ਨਿਲਾਮਪ੍ਰਿਤ	نيلامبريت
ਨਿਲਾਮਬੇਰ	نيلامبير
ਨਿਸ਼ਾ	نيشا
ਨਿਹ੍ਚਾਲਤੇਕ	نيهتشالتيك
ਨਿਹ੍ਚਾਲਮਿਤ	نيهتشالميت
ਨੀਤਨਾਮ	نيتنام
ਨੀਨਦੇਰ੍ਬੀਰ	نينديربير
ਨੀਮਮਾਂਪ੍ਰਿਤ	نيممانبريت
ਨੀਮਮਾਂਰ੍ਦੀਪ	نيممانرديب
ਨੀਮ੍ਮਾਂਰਤਾ	نيممانرتا
ਨੀਮ੍ਰਤ	نيمرت
ਨੀਰਮਾਂਲਦੀਪ	نيرمانلديب
ਨੀਰਮਾਂਲਬੀਰ	نيرمانلبير
ਨੀਰਮੋਲ	نيرمول
ਨੀਰਵੈਰ	نيرواير
ਨੀਰ੍ਭਾਉ	نيربهاو
ਨੀਰ੍ਮਾਂਲਕਾਰਾਮ	نيرمانلكارام
ਨੀਰ੍ਮਾਂਲਜੀਵ	نيرمانلجيو
ਨੀਰ੍ਮਾਂਲਜੋਤ	نيرمانلجوت
ਨੀਰ੍ਮਾਂਲਤੇਕ	نيرمانلتيك
ਨੀਰ੍ਮਾਂਲਧਾਰਾਮ	نيرمانلدهارام
ਨੀਰ੍ਮਾਂਲਪ੍ਰਿਤ	نيرمانلبريت
ਨੀਸ਼ਾਨ੍ਦੀਪ	نيشانديب
ਨੀਹ੍ਚਾਲ੍ਪ੍ਰੇਮ	نيهتشالبريم
ਨੂਰਦੇਵ	نورديو
ਨੂਰਨਿਤ	نورنيت
ਨੂਰਪ੍ਰਿਤ	نوربريت
ਨੇਕਨਾਮ	نيكنام
ਨੇਕੀਨਦੇਰ	نيكيندير
ਨੇਕ੍ਦੀਪ	نيكديب
ਨੇਕ੍ਪਾਲ	نيكبال
ਨੇਹ੍ਚਾਲਪ੍ਰਿਤ	نيهتشالبريت
ਨੈਨਤਾਰ	ناينتار
ਨੈਨਦੀਪ	ناينديب
ਨੈਨੀਨਦੇਰ	ناينيندير
ਨੋਉਲਖ	نوولكه
ਨੌਹਨੀਹਲ	ناوهنيهل
ਨ੍ਰੀਪਜੋਤ	نريبجوت
ਪਤਵਂਤ	بتونت
ਪਤਵੀਰ	بتوير
ਪਦਾਮਜਿਤ	بدامجيت
ਪਦਾਮਪ੍ਰੇਮ	بدامبريم
ਪਦ੍ਮਸ਼੍ਰੀ	بدمشري
ਪਰਤਾਪ ; ਪਰਤਾਪ	برتاب ; برتاب
ਪਰਤਾਪੀ	برتابي
ਪਰਦੀਪ	برديب
ਪਰਬੀਨ	بربين
ਪਰਮਕਮਲ਼	برمكمل
ਪਰਮਕਿਰਤ	برمكيرت
ਪਰਮਗੁਨ	برمجون
ਪਰਮਜਾਪ	برمجاب
ਪਰਮਜੀਤ ; ਪਰਮਜੀਤ	برمجيت ; برمجيت
ਪਰਮਜੁਗਤ	برمجوجت
ਪਰਮਜੋਗ	برمجوج
ਪਰਮਜੋਧ	برمجوده
ਪਰਮਠਾਕਰ	برمطهاكر
ਪਰਮਤੇਕ	برمتيك
ਪਰਮਦੀਪ	برمديب
ਪਰਮਧਾਰਾਮ	برمدهارام
ਪਰਮਧਿਰ	برمدهير
ਪਰਮਪਾਲ	برمبال
ਪਰਮਪ੍ਰੇਮ	برمبريم
ਪਰਮਬੋਧ	برمبوده
ਪਰਮਯੋਗ	برميوج
ਪਰਮਰਂਗ	برمرنج
ਪਰਮਲੀਨ	برملين
ਪਰਮਸ਼ਾਂਤ	برمشانت
ਪਰਮਸਿਤਾਲ	برمسيتال
ਪਰਮਸੁਖ	برمسوكه
ਪਰਮਸੇਵਕ	برمسيوك
ਪਰਮਾਧਾਰ	برمادهار
ਪਰਮਾਰ੍ਥ	برمارته
ਪਰਮਿਂਦਰ	برميندر
ਪਰਮੀਤ	برميت
ਪਰਮ੍ਦਯਾ	برمديا
ਪਰਸਂਜੀਤ	برسنجيت
ਪਰਸ਼ੋਤਮ	برشوتم
ਪਰਾਮਨੀਵਾਸ	برامنيواس
ਪਰੀਦਰ੍ਸ਼ਨ	بريدرشن
ਪਰ੍ਗਤ	برجت
ਪਰ੍ਵੀਨ੍ਦੇਰ	برويندير
ਪਲਬੀਨਦੇਰ	بلبيندير
ਪਲਵੀਨ੍ਦੇਰ੍ਪਾਲ	بلوينديربال
ਪਵਾਨਜੋਤ	بوانجوت
ਪਵਾਨਦੀਪ	بوانديب
ਪਵਾਨਪ੍ਰਿਤ	بوانبريت
ਪਵਾਨਵੀਰ	بوانوير
ਪਵੀਤ	بويت
ਪਾਰਂਗਤ	بارنجت
ਪੁਨੀਤ	بونيت
ਪੁਨੀਤਪਾਲ	بونيتبال
ਪੁਰਾਨਪ੍ਰੇਮ	بورانبريم
ਪੁਰਾਨ੍ਜੀਤ	بورانجيت
ਪੁਸ਼ਪ੍ਰਿਤ	بوشبريت
ਪੁਸ਼੍ਪਿਤਾ	بوشبيتا
ਪੂਰਨਜੀਤ	بورنجيت
ਪ੍ਰਗਿਤ	برجيت
ਪ੍ਰਜਨਾ	برجنا
ਪ੍ਰਣਿਤ	برنيت
ਪ੍ਰਨੀਤਾ	برنيتا
ਪ੍ਰਫੂਲਦੀਪ	بربهولديب
ਪ੍ਰਭਕੀਰਤ	بربهكيرت
ਪ੍ਰਭਕੀਰ੍ਪਾਲ	بربهكيربال
ਪ੍ਰਭਗੀਤ	بربهجيت
ਪ੍ਰਭਚਰਣ	بربهتشرن
ਪ੍ਰਭਚੇਤਨ	بربهتشيتن
ਪ੍ਰਭਜਿਤ	بربهجيت
ਪ੍ਰਭਜੀਤ	بربهجيت
ਪ੍ਰਭਜੀਵਨ	بربهجيون
ਪ੍ਰਭਜੋਗ	بربهجوج
ਪ੍ਰਭਜੋਤੇ	بربهجوتي
ਪ੍ਰਭਜੋਧ	بربهجوده
ਪ੍ਰਭਤਿਰਥ	بربهتيرته
ਪ੍ਰਭਦਾਸ	بربهداس
ਪ੍ਰਭਧਿਯਨ	بربهدهيين
ਪ੍ਰਭਧਿਰਾਜ	بربهدهيراج
ਪ੍ਰਭਨਾਮ	بربهنام
ਪ੍ਰਭਨੂਰ	بربهنور
ਪ੍ਰਭਪਰ੍ਵਾਨ	بربهبروان
ਪ੍ਰਭਬੋਧ	بربهبوده
ਪ੍ਰਭਮਿਤ	بربهميت
ਪ੍ਰਭਮੇਹਾਰ	بربهميهار
ਪ੍ਰਭਲੀਨ	بربهلين
ਪ੍ਰਭਵਿਚਾਰ	بربهويتشار
ਪ੍ਰਭਸਂਗਤ	بربهسنجت
ਪ੍ਰਭਸਿਤਾਲ	بربهسيتال
ਪ੍ਰਭਾਤਕੀਰਣ	بربهاتكيرن
ਪ੍ਰਭ੍ਰਮਣ	بربهرمن
ਪ੍ਰਭ੍ਰਾਤਨ	بربهراتن
ਪ੍ਰਭ੍ਰੂਪ	بربهروب
ਪ੍ਰਸ਼ਾਰਨਬੀਰ	برشارنبير
ਪ੍ਰਿਤਮੋਹਨ	بريتموهن
ਪ੍ਰਿਤੀਨ੍ਦੇਰ	بريتيندير
ਪ੍ਰਿਤ੍ਵੀਰ	بريتوير
ਪ੍ਰੀਤਪਾਲ	بريتبال
ਪ੍ਰੀਤਮ੍ਹਾਰੀ	بريتمهاري
ਪ੍ਰੀਤਾਮਜਿਤ	بريتامجيت
ਪ੍ਰੀਥਾਮ੍ਦੀਪ	بريتهامديب
ਪ੍ਰੀਥੀਪਾਲ	بريتهيبال
ਪ੍ਰੀਥ੍ਵੀਪਾਲ	بريتهويبال
ਪ੍ਰੇਮਜਿਤ	بريمجيت
ਪ੍ਰੇਮਤੇਕ	بريمتيك
ਪ੍ਰੇਮਪਾਲ	بريمبال
ਪ੍ਰੇਮਬਂਸ	بريمبنس
ਪ੍ਰੇਮਭਾਗਤ	بريمبهاجت
ਪ੍ਰੇਮਰਂਗ	بريمرنج
ਪ੍ਰੇਮਰਮਣ	بريمرمن
ਪ੍ਰੇਮਰਸ	بريمرس
ਪ੍ਰੇਮਲੀਨ	بريملين
ਪ੍ਰੇਮਵਾਂਤ	بريموانت
ਪ੍ਰੇਮਸੀਰੀ	بريمسيري
ਪ੍ਰੇਮਸੁਖ	بريمسوكه
ਪ੍ਰੇਮ੍ਵੀਰ	بريموير
ਫਕੀਰ	بهكير
ਫਤੇਹਕਾਰਾਮ	بهتيهكارام
ਫਤੇਹਪ੍ਰਿਤ	بهتيهبريت
ਫਤੇਹਬੀਰ	بهتيهبير
ਫਤੇਹ੍ਵਂਤ	بهتيهونت
ਫਾਜਲ	بهاجل
ਫੁਲਵਂਤ	بهولونت
ਫੋਜੀਨਦੇਰ	بهوجيندير
ਬਂਸਮਿਤ	بنسميت
ਬਕ੍ਸ਼ੀ	بكشي
ਬਚਾਨਬੀਰ	بتشانبير
ਬਚੀਨ੍ਤ	بتشينت
ਬਨੀਤ	بنيت
ਬਨੀਨਦੇਰ	بنيندير
ਬਰਿਨ੍ਦ੍ਰ	بريندر
ਬਰੀਨ੍ਦੇਰ	بريندير
ਬਲਤੇਜ	بلتيج
ਬਲਦੀਪ	بلديب
ਬਲਦੇਵ	بلديو
ਬਲਮੋਹਨ	بلموهن
ਬਲਰਾਜ	بلراج
ਬਲਵਿਂਦਰ	بلويندر
ਬਲੀਨਦੇਰ	بليندير
ਬਲੀਹਾਰ	بليهار
ਬਲ੍ਵਿਨ੍ਦ੍ਰ	بلويندر
ਬਲ੍ਵੀਨ੍ਦੇਰ	بلويندير
ਬਹਾਦਰ	بهادر
ਬਾਲਮਿਤ	بالميت
ਬਿਸ਼ਨਪਾਲ	بيشنبال
ਬਿਸ੍ਮੀਤ	بيسميت
ਬੀਨਦੇਰ	بيندير
ਬੀਨਾ	بينا
ਬੀਬੀਨਾਨਾਕੀ	بيبيناناكي
ਬੀਮਾਂਲਜੋਤ	بيمانلجوت
ਬੀਰੀਨਦਾਰ	بيريندار
ਬੀਸਮਾਧ	بيسماده
ਬੀਸ਼੍ਮਿਤ	بيشميت
ਬੁਜੀ	بوجي
ਬੁਧ੍ਪ੍ਰਿਤ	بودهبريت
ਬੁਧ੍ਰੂਪ	بودهروب
ਬੇਂਤ	بينت
ਬੇਨ੍ਨੀ	بينني
ਬੇਬੇ	بيبي
ਬੈਰਾਗੀ	بايراجي
ਬ੍ਰਹਮਜੋਤ	برهمجوت
ਬ੍ਰਹਾਮਲੀਨ	برهاملين
ਬ੍ਰਹਾਮ੍ਜੀਤ	برهامجيت
ਬ੍ਰਹ੍ਮਲੀਨ	برهملين
ਬ੍ਰਹ੍ਮਵੀਰ	برهموير
ਬ੍ਰਿਜੇਂਦਰ	بريجيندر
ਬ੍ਰੀਜੋਧ	بريجوده
ਭਗਤ	بهجت
ਭਗਵਾਨ	بهجوان
ਭਜਨਿਕ	بهجنيك
ਭਰਪੂਰ	بهربور
ਭਾਘਵੀਨ੍ਦੇਰ	بهاجهويندير
ਭਾਜ੍ਨਾਮ	بهاجنام
ਭਾਜ੍ਨਿਤ	بهاجنيت
ਭਾਵਜਿਤ	بهاوجيت
ਭਾਵਜੀਨ੍ਦੇਰ	بهاوجيندير
ਭਾਵਨਦੀਪ	بهاونديب
ਭਾਵਨੀਤ	بهاونيت
ਭਾਵਪਾਲ	بهاوبال
ਭਾਵਪ੍ਰੇਮ	بهاوبريم
ਭਾਵਲੀਨ	بهاولين
ਭੀਨਦੇਰ੍ਪਾਲ	بهينديربال
ਭੁਪੀਨ੍ਦੇਰ	بهوبيندير
ਮਂਗਲਾ	منجلا
ਮਂਤੇਕ	منتيك
ਮਜਾਲ	مجال
ਮਣਿਪਾਲ	منيبال
ਮਧੁਪ੍ਰਿਤ	مدهوبريت
ਮਧੁਰਬੀਨ	مدهوربين
ਮਧੁਵਂਤ	مدهوونت
ਮਨਵਂਤ	منونت
ਮਰਦੁਲਾ	مردولا
ਮਸ੍ਤਪ੍ਰੇਮ	مستبريم
ਮਸ੍ਤਾਨ	مستان
ਮਸ੍ਤੁਕ	مستوك
ਮਸ੍ਤ੍ਵੀਰ	مستوير
ਮਹਨਬੀਰ	مهنبير
ਮਹਾਜਿਤ	مهاجيت
ਮਹਾਨਗਿਯਨ	مهانجيين
ਮਹਾਨਗੀਤ	مهانجيت
ਮਹਾਨਗੁਨ	مهانجون
ਮਹਾਨਜਿਤ	مهانجيت
ਮਹਾਨਜੀਵਨ	مهانجيون
ਮਹਾਨਜੋਤ	مهانجوت
ਮਹਾਨਤੇਕ	مهانتيك
ਮਹਾਨਤ੍ਰੀਪਾਤ	مهانتريبات
ਮਹਾਨਦੀਪ	مهانديب
ਮਹਾਨਪਾਲ	مهانبال
ਮਹਾਨਪ੍ਰੇਮ	مهانبريم
ਮਹਾਨਭਗਤ	مهانبهجت
ਮਹਿਨਦੇਰ੍ਪ੍ਰਿਤ	مهينديربريت
ਮਹੀਨਗਾ	مهينجا
ਮਹੀਨਦੇਰ੍ਪਾਲ	مهينديربال
ਮਹੇਕਪ੍ਰਿਤ	مهيكبريت
ਮਹੇਨਦੇਰ	مهيندير
ਮਹੇਰਬਾਨੀ	مهيرباني
ਮਹੇਸ਼ੀਨਦੇਰ	مهيشيندير
ਮਾਂਨਕਰਣ	ماننكرن
ਮਾਂਨਗਲ੍ਪ੍ਰਿਤ	ماننجلبريت
ਮਾਂਨਵਾਨ੍ਤ੍ਬੀਰ	ماننوانتبير
ਮਾਂਨਸੀਰਤ	ماننسيرت
ਮਾਂਨਾਵੀਨਦੇਰ	مانناويندير
ਮਾਂਨਾਸਪ੍ਰੇਮ	مانناسبريم
ਮਾਂਨੀਨਦੇਰ੍ਬੀਰ	ماننينديربير
ਮਾਂਨੋਹਾਰਜੋਤ	ماننوهارجوت
ਮਾਂਨੋਹਾਰਦੀਪ	ماننوهارديب
ਮਾਂਨੋਹਾਰ੍ਜੀਤ	ماننوهارجيت
ਮਾਂਨੋਹਾਰ੍ਪਲ	ماننوهاربل
ਮਾਂਨ੍ਗਲ੍ਜੀਤ	ماننجلجيت
ਮਾਂਨ੍ਗਲ੍ਪ੍ਰੇਮ	ماننجلبريم
ਮਾਂਨ੍ਸ਼ਿਤਾਲ	ماننشيتال
ਮਾਦਨਬੀਰ	مادنبير
ਮਾਦਾਨਕੀਰ੍ਪਾਲ	مادانكيربال
ਮਾਦਾਨਪਾਲ	مادانبال
ਮਾਨਤੇਜ	مانتيج
ਮਾਨਦੇਵ	مانديو
ਮਾਨਪੁਲ	مانبول
ਮਾਨਬੀਰ	مانبير
ਮਾਨਰਿਤ	مانريت
ਮਾਨਾਸਦੀਪ	ماناسديب
ਮਾਨ੍ਕੀਰਣ	مانكيرن
ਮਾਨ੍ਗਲ੍ਜੋਤ	مانجلجوت
ਮਾਨ੍ਪ੍ਰੀਯਾ	مانبرييا
ਮਾਯ੍ਰਾਯ	مايراي
ਮਿਤ੍ਰਾ	ميترا
ਮਿਤ੍ਰਾਜ	ميتراج
ਮੀਰਾ	ميرا
ਮੁਕੁਂਦਾ	موكوندا
ਮੁਕੁਨਦ੍ਪ੍ਰਿਤ	موكوندبريت
ਮੁਖ੍ਤਯਾਰ	موكهتيار
ਮੁਦ੍ਰਾ	مودرا
ਮੁਨਦੀਪ	مونديب
ਮੁਨਲੇਨੇ	مونليني
ਮੇਸ਼	ميش
ਮੇਹਰ	ميهر
ਮੇਹਾਰਤੇਕ	ميهارتيك
ਮੇਹਾਰਪਲ	ميهاربل
ਮੇਹਾਰਪ੍ਰਿਤ	ميهاربريت
ਮੇਹਾਰਭੂਪ	ميهاربهوب
ਮੇਹਾਰਮਿਤ	ميهارميت
ਮੇਹੇਰ	ميهير
ਮੇਹੇਰਬਾਨੀ	ميهيرباني
ਮੋਨੀਨ੍ਦੇਰ	مونيندير
ਮੋਹਨਤੇਕ	موهنتيك
ਮੋਹਨਮਿਤ	موهنميت
ਮੋਹਨਲੀਨ	موهنلين
ਮੋਹਨਵਂਤ	موهنونت
ਮੋਹਨਵੀਰ	موهنوير
ਮੋਹਿਨ੍ਦੇਰਪਾਲ	موهينديربال
ਮੋਹੇਨਪਲ	موهينبل
ਮੋਹੇਨਪ੍ਰਿਤ	موهينبريت
ਯਕਿਨ	يكين
ਯਸ਼ਜੋਤ	يشجوت
ਯਸ਼ਨੂਰ	يشنور
ਯਸ਼ਪਾਲ	يشبال
ਯਸ਼ਵਂਤ	يشونت
ਯਸ਼੍ਦੀਪ	يشديب
ਯਾਤੀਨਪਾਲ	ياتينبال
ਯਾਦਲੀਨ	يادلين
ਯਾਦਵੀਰ	يادوير
ਯਾਦ੍ਬੀਰ	يادبير
ਯਾਸ੍ਮੀਨੇ	ياسميني
ਯੁਵਰਾਨੀ	يووراني
ਯੋਗੇਸ਼ਪਾਲ	يوجيشبال
ਰਂਗ ਰਮਨ	رنج رمن
ਰਂਗਜੋਤ	رنججوت
ਰਂਗਪ੍ਰਿਤ	رنجبريت
ਰਂਗਾਤਮ	رنجاتم
ਰਂਗੀਵਨ	رنجيون
ਰਂਜੀਤ	رنجيت
ਰਘੁਜਿਤ	رجهوجيت
ਰਘੁਬਂਸ	رجهوبنس
ਰਚਨਜਿਤ	رتشنجيت
ਰਚਨਜੋਤ	رتشنجوت
ਰਚ੍ਪੀਨਦੇਰ੍ਜਿਤ	رتشبينديرجيت
ਰਜੀਨਦਾਰ	رجيندار
ਰਣਦੀਪ	رنديب
ਰਣਬੀਰ	رنبير
ਰਤਨ੍ਕਾਰਾਮ	رتنكارام
ਰਤ੍ਤਾਨਜੋਤ	رتتانجوت
ਰਤ੍ਤਾਨਦੀਪ	رتتانديب
ਰਨਗ੍ਰਤ੍ਤੀ	رنجرتتي
ਰਨਪ੍ਰਿਤ	رنبريت
ਰਪੀਨਦੇਰ	ربيندير
ਰਮਚੇਤਨ	رمتشيتن
ਰਮਣੀਕ	رمنيك
ਰਮਨਜਿਤ	رمنجيت
ਰਮਨਦੀਪ	رمنديب
ਰਮਨਿਤ	رمنيت
ਰਮਨੀਵਾਸ	رمنيواس
ਰਮਲੀਨ	رملين
ਰਮਾਂਨਜੋਤ	رماننجوت
ਰਮਾਂਨਰੂਪ	رماننروب
ਰਮਾਂਨਸੁਖ	رماننسوكه
ਰਮਿਤ	رميت
ਰਮਿਨਾਜੀਤ	رميناجيت
ਰਮੀਨਦੇਰ੍ਜਿਤ	رمينديرجيت
ਰਮੀਨਦੇਰ੍ਪਾਲ	رمينديربال
ਰਮੀਨਦੇਰ੍ਪ੍ਰਿਤ	رمينديربريت
ਰਮੀਨਦੇਰ੍ਬੀਰ	رمينديربير
ਰਮੇਸ਼ਪਲ	رميشبل
ਰਮੇਸ਼ਮਿਤ	رميشميت
ਰਵਜੋਤ	روجوت
ਰਵਨੀਤ	رونيت
ਰਵਿਨ੍ਦਰ	رويندر
ਰਵਿਰਾਜ	رويراج
ਰਵੀਦੀਪ	رويديب
ਰਵੀਨਦੇਰ੍ਦੀਪ	روينديرديب
ਰਵੀਨਦੇਰ੍ਮਿਤ	روينديرميت
ਰਸਂਜਿਤ	رسنجيت
ਰਸਂਜੋਤ	رسنجوت
ਰਸਂਮਿਤ	رسنميت
ਰਸਗੁਨ	رسجون
ਰਸਜੋਤ	رسجوت
ਰਸਧਾਰਮ	رسدهارم
ਰਸਨਂਦ	رسنند
ਰਸਪ੍ਰਿਤ	رسبريت
ਰਸਬੀਰ	رسبير
ਰਸਭਾਗਤ	رسبهاجت
ਰਸਮ	رسم
ਰਸਮ੍ਰਿਤ	رسمريت
ਰਸਲੀਨ	رسلين
ਰਸਵਂਤ	رسونت
ਰਸ਼ਾਨ੍ਪ੍ਰਿਤ	رشانبريت
ਰਸੁਤ੍ਤਮ	رسوتتم
ਰਹੁਲਜੀਤ	رهولجيت
ਰਹੁਲਦੀਪ	رهولديب
ਰਾਖਨਾਂ	راكهنان
ਰਾਖਬੀਰ	راكهبير
ਰਾਜਕਿਰਣ	راجكيرن
ਰਾਜਦੀਪ	راجديب
ਰਾਜਨਾਰੀਨ੍ਦ	راجناريند
ਰਾਜਪਰਾਮ	راجبرام
ਰਾਜਪਾਲ	راجبال
ਰਾਜਪ੍ਰਤਾਪ	راجبرتاب
ਰਾਜਮਂਦਰ	راجمندر
ਰਾਜਮਿਤ	راجميت
ਰਾਜਸ਼ਰਣ	راجشرن
ਰਾਜਸੁਖ	راجسوكه
ਰਾਜਾਨਜਿਤ	راجانجيت
ਰਾਜਾਨਮਿਤ	راجانميت
ਰਾਜਾਨ੍ਦੀਪ	راجانديب
ਰਾਤਾਨਗੀਤ	راتانجيت
ਰਾਤਾਨਚੇਤਨ	راتانتشيتن
ਰਾਤਾਨਜੀਵਨ	راتانجيون
ਰਾਤਾਨਪ੍ਰਿਤ	راتانبريت
ਰਾਤਾਨਮਿਤ	راتانميت
ਰਾਤਾਨਵਂਤ	راتانونت
ਰਾਤਾਨਾਤਮ	راتاناتم
ਰਾਮਦਾਸ	رامداس
ਰਾਮਪਾਲ	رامبال
ਰਾਮਰਂਗ	رامرنج
ਰਾਮਰਤ੍ਤਨ	رامرتتن
ਰਾਮਸੁਖ	رامسوكه
ਰਾਸਰਮਣ	راسرمن
ਰਾਸ਼੍ਪਲ	راشبل
ਰਾਸ਼੍ਮੀਨਦੇਰ	راشميندير
ਰਿਧਿਮਾ	ريدهيما
ਰੀਜਕ	ريجك
ਰੀਤੀਨਦੇਰ	ريتيندير
ਰੀਪਨ੍ਜੋਤ	ريبنجوت
ਰੀਪੁਦਮ	ريبودم
ਰੂਂਗ / ਰਂਗ	رونج / رنج
ਰੂਪਦੀਪ	روبديب
ਰੂਪਦੇਵ	روبديو
ਰੂਪਵਂਤ	روبونت
ਰੇਗੇਨਦਰ	ريجيندر
ਰੋਸ਼ਨਦੀਪ	روشنديب
ਰੌਸ਼ਾਨਪ੍ਰੇਮ	راوشانبريم
ਰੌਸ਼ਾਨਬੀਰ	راوشانبير
ਲਕ੍ਸ਼੍ਮੀ	لكشمي
ਲਖਪ੍ਰਿਤ	لكهبريت
ਲਖਮਿਤ	لكهميت
ਲਖਰੂਪ	لكهروب
ਲਖਵੀਰ	لكهوير
ਲਵੇਨਿਤ	لوينيت
ਲਾਜਵਂਤ	لاجونت
ਲਾਵਪ੍ਰਿਤ	لاوبريت
ਲਾਵਿਨਦੀਪ	لاوينديب
ਲੀਵਗੀਆਨ	ليوجيآن
ਲੀਵਚਿਤ	ليوتشيت
ਲੀਵਚੇਤ	ليوتشيت
ਲੀਵਜੋਤ	ليوجوت
ਲੀਵਨਾਮ	ليونام
ਲੀਵਸ਼ਰਣ	ليوشرن
ਲੀਵਾਵਤਰ	ليواوتر
ਲੋਕਪਾਲ	لوكبال
ਲੋਕਪ੍ਰਿਤ	لوكبريت
ਲੋਕਰੂਪ	لوكروب
ਲੋਕ੍ਪ੍ਰੇਮ	لوكبريم
ਲੋਵਪ੍ਰੇਮ	لووبريم
ਲੋਵੇਦੀਪ	لوويديب
ਵਰੀਨਦੇਰ੍ਪਾਲ	ورينديربال
ਵਰੁਨਜਿਤ	ورونجيت
ਵਰੁਨਦੀਪ	ورونديب
ਵਸਂਤਪ੍ਰਿਤ	وسنتبريت
ਵਸੁਂਧਰਾ	وسوندهرا
ਵਾਦਭਾਗ	وادبهاج
ਵਾਮਾਂਨਜੀਤ	واماننجيت
ਵਾਰੀਨਦੇਰ	واريندير
ਵਾਸੀਮਬੀਰ	واسيمبير
ਵਾਹੀਦਪ੍ਰਿਤ	واهيدبريت
ਵਾਹੇਗੁਰੁ	واهيجورو
ਵਿਕ੍ਰਮਜੀਤ	ويكرمجيت
ਵਿਕ੍ਰਮਜੋਤ	ويكرمجوت
ਵਿਚਾਰ੍ਚੇਤਨ	ويتشارتشيتن
ਵਿਚਾਰ੍ਦੀਪ	ويتشارديب
ਵਿਚਾਰ੍ਲੀਨ	ويتشارلين
ਵਿਜਯਪ੍ਰਤਾਪ	ويجيبرتاب
ਵਿਜਯਪ੍ਰਿਤ	ويجيبريت
ਵਿਜੇਂਦਰ	ويجيندر
ਵਿਨਾਯਦੀਪ	وينايديب
ਵਿਨਾਯਪੁਲ	وينايبول
ਵਿਨਾਯ੍ਬਿਰ	وينايبير
ਵਿਮਾਂਲਜਿਤ	ويمانلجيت
ਵਿਮਾਂਲਜੋਤ	ويمانلجوت
ਵਿਮਾਂਲਪ੍ਰੇਮ	ويمانلبريم
ਵਿਰੀਨਦਾਰ ; ਵਿਰੀਨਦੇਰ	ويريندار ; ويريندير
ਵਿਰੀਨਦੇਰ	ويريندير
ਵਿਸਮਦ	ويسمد
ਵਿਸ਼ਾਲਦੀਪ	ويشالديب
ਵਿਸ਼ਾਲਪ੍ਰਿਤ	ويشالبريت
ਵਿਸ਼੍ਵਰ੍ਪ੍ਰਿਤ	ويشوربريت
ਵਿਸ਼੍ਵਾਤਮ	ويشواتم
ਵਿਸਾਹ	ويساه
ਵੀਜਯਮਿਤ	ويجيميت
ਵੀਰ	وير
ਵੀਰ /ਵੀਰ	وير /وير
ਵੀਰਪਾਲ	ويربال
ਵੀਵੇਕ੍ਬੀਰ	ويويكبير
ਵੀਸ੍ਰਮਣ	ويسرمن
ਵੇਰਾਜ	ويراج
ਵੈਭਵ	وايبهو
ਸਂਗਜਾਪ	سنججاب
ਸਂਗਤਪ੍ਰਿਤ	سنجتبريت
ਸਂਗਤਰੂਪ	سنجتروب
ਸਂਗਤ੍ਰਸ	سنجترس
ਸਂਗੀਤਾ	سنجيتا
ਸਂਗ੍ਰਾਮ	سنجرام
ਸਂਜੀਤ	سنجيت
ਸਂਜੋਗ	سنجوج
ਸਂਤਕੀਰੀਨ	سنتكيرين
ਸਂਤਪ੍ਰਕਾਸ਼	سنتبركاش
ਸਂਤਪ੍ਰੇਮ	سنتبريم
ਸਂਤਬੀਰ	سنتبير
ਸਂਤੋਖਜੀਤ	سنتوكهجيت
ਸਂਤੋਖਜੋਤ	سنتوكهجوت
ਸਂਤੋਖਪ੍ਰਿਤ	سنتوكهبريت
ਸਂਤੋਖਬੀਰ	سنتوكهبير
ਸਂਦੀਪ	سنديب
ਸਗਲਜੋਤ	سجلجوت
ਸਚਕਿਰਤ	ستشكيرت
ਸਚਜੋਗ	ستشجوج
ਸਚਪਾਲ	ستشبال
ਸਚਪ੍ਰਧਾਨ	ستشبردهان
ਸਚਭਾਗਤ	ستشبهاجت
ਸਚਮਾਨ	ستشمان
ਸਚਰੂਪ	ستشروب
ਸਚਵੀਰ	ستشوير
ਸਚਸੁਖ	ستشسوكه
ਸਚਸੇਵਕ	ستشسيوك
ਸਚਾਮ੍ਰਿਤ	ستشامريت
ਸਚ੍ਦੀਪ	ستشديب
ਸਜੀਨਦੇਰ	سجيندير
ਸਤਕਿਰਤ	ستكيرت
ਸਤਕੀਰਤ	ستكيرت
ਸਤਕੀਰ੍ਤਨ	ستكيرتن
ਸਤਗੁਨ	ستجون
ਸਤਗੁਰ	ستجور
ਸਤਜੋਤ	ستجوت
ਸਤਨਾਮ	ستنام
ਸਤਪਾਲ	ستبال
ਸਤਪ੍ਰਕਾਸ਼	ستبركاش
ਸਤਪ੍ਰਿਤ	ستبريت
ਸਤਪ੍ਰੇਮ	ستبريم
ਸਤਬਚਨ	ستبتشن
ਸਤਮਿਤ	ستميت
ਸਤਰਜਿਤ	سترجيت
ਸਤਰਾਜ	ستراج
ਸਤਲੀਨ	ستلين
ਸਤਵਂਤ	ستونت
ਸਤਸਂਗਤ	ستسنجت
ਸਤਸਂਤੋਖ	ستسنتوكه
ਸਤਸਰਂਗ	ستسرنج
ਸਤਸੁਖ	ستسوكه
ਸਤੀਨਦੇਰ੍ਜਿਤ	ستينديرجيت
ਸਤ੍ਯਜਿਤ	ستيجيت
ਸਤ੍ਯਪ੍ਰੇਮ	ستيبريم
ਸਥਿਨ੍ਦਰ	ستهيندر
ਸਦਜੀਵਨ	سدجيون
ਸਦਸੁਖ	سدسوكه
ਸਨਮੁਖ	سنموكه
ਸਨਾਨਤਨ	سنانتن
ਸਪਨਦੀਪ	سبنديب
ਸਪਾਹੀ	سباهي
ਸਬੂਰੀ	سبوري
ਸਭਾਜੀਤ	سبهاجيت
ਸਮਰਜੀਤ	سمرجيت
ਸਮਰਣ	سمرن
ਸਮਰਵੀਰ	سمروير
ਸਮਰ੍ਥ	سمرته
ਸਮਾਂਰਬੀਰ	سمانربير
ਸਮਾਂਰ੍ਜੋਤ	سمانرجوت
ਸਮਾਈ	سماي
ਸਮੀਨਦੀਪ	سمينديب
ਸਮੀਰ	سمير
ਸਰਦਾਰ	سردار
ਸਰਨਦਾਯਲ	سرندايل
ਸਰਨਦੀਪ	سرنديب
ਸਰਨਾਗਤ	سرناجت
ਸਰਬਜੀਤ / ਸਰਬਜੀਤ	سربجيت / سربجيت
ਸਰਬਨੀਵਾਸ	سربنيواس
ਸਰਬਪ੍ਰਿਤ	سرببريت
ਸਰਬਸੁਖ	سربسوكه
ਸਰਬੁਤ੍ਤਮ	سربوتتم
ਸਰਬ੍ਗਿਆਨ	سربجيآن
ਸਰਬ੍ਜਿਤ	سربجيت
ਸਰਬ੍ਦਾਯਲ	سربدايل
ਸਰਬ੍ਦੀਪ	سربديب
ਸਰਬ੍ਦੇਵ	سربديو
ਸਰਬ੍ਧਾਰਾਮ	سربدهارام
ਸਰਲਜਿਤ	سرلجيت
ਸਰਲਬੀਰ	سرلبير
ਸਰਾਬ੍ਰਜ	سرابرج
ਸਰੂਪ	سروب
ਸਰੂਰ	سرور
ਸਰ੍ਜਿਤ	سرجيت
ਸਰ੍ਮੀਨਦੇਰ	سرميندير
ਸਵਾਨਪ੍ਰਿਤ	سوانبريت
ਸਵਾਰਜਦੀਪ	سوارجديب
ਸਵਾਰਜਬੀਰ	سوارجبير
ਸਵਾਰਨਜੋਤ	سوارنجوت
ਸਵਾਰਨਪ੍ਰਿਤ	سوارنبريت
ਸਵੀਤੀਨਦੇਰ	سويتيندير
ਸਵੀਤੋਜ	سويتوج
ਸਵੀਨਦੇਰ	سويندير
ਸਹੀਲਮਿਤ	سهيلميت
ਸ਼ਯ੍ਮ੍ਸੁਨ੍ਦਾਰ	شيمسوندار
ਸ਼ਰਨਪਾਲ	شرنبال
ਸ਼ਰਨਬੀਰ	شرنبير
ਸ਼ਰਨ੍ਜੀਤ੍ਕੌਰ	شرنجيتكاور
ਸ਼ਾਂਤਚਿਤ	شانتتشيت
ਸ਼ਾਂਤਦੀਪ	شانتديب
ਸ਼ਾਂਤਪ੍ਰਕਾਸ਼	شانتبركاش
ਸ਼ਾਂਤਪ੍ਰਿਤ	شانتبريت
ਸ਼ਾਂਤਬੀਰ	شانتبير
ਸ਼ਾਂਤਲੀਨ	شانتلين
ਸ਼ਾਨਤ੍ਨੀਵਾਸ	شانتنيواس
ਸ਼ਾਬਦਚੇਤ	شابدتشيت
ਸ਼ਾਬਦਤੇਕ	شابدتيك
ਸ਼ਾਬਦ੍ਰਾਸ	شابدراس
ਸ਼ਾਬਾਦ੍ਦੀਪ	شابادديب
ਸ਼ਾਲੀਨ	شالين
ਸ਼ਾਸ਼ੀਪ੍ਰਿਤ	شاشيبريت
ਸ਼ਿਵਚਰਣ	شيوتشرن
ਸ਼ਿਵ੍ਚਾਰਨ੍ਜੀਤ	شيوتشارنجيت
ਸ਼ੁਕਾਰਿਯਨ	شوكاريين
ਸ਼ੁਭਦੀਪ	شوبهديب
ਸ਼ੂਰਵੀਰ	شوروير
ਸ਼ੇਰ	شير
ਸ਼ੇਰਪੁਲ	شيربول
ਸ਼ੇਰਬਹਾਦੁਰ	شيربهادور
ਸ਼ੇਹ੍ਬਾਝ	شيهباجه
ਸਾਕਰਥ	ساكرته
ਸਾਖ	ساكه
ਸਾਗਰ	ساجر
ਸਾਜ	ساج
ਸਾਤਪੁਲ	ساتبول
ਸਾਧਨਾਹ	سادهناه
ਸਾਧਿਕਾ	سادهيكا
ਸਾਬਰ	سابر
ਸਾਰ	سار
ਸਿਂਦਾ	سيندا
ਸਿਓਪਰਿਤ	سياوبريت
ਸਿਤਾਲਜੀਤ	سيتالجيت
ਸਿਤਾਲਜੋਤ	سيتالجوت
ਸਿਮਰਨ	سيمرن
ਸੀਖਲ	سيكهل
ਸੀਮਾਂਰ੍ਜਿਤ	سيمانرجيت
ਸੀਮਾਂਰ੍ਨਾਮ	سيمانرنام
ਸੀਮਾਂਰ੍ਪ੍ਰਿਤ	سيمانربريت
ਸੀਮਾਂਰ੍ਲੀਨ	سيمانرلين
ਸੀਮ੍ਰਤ	سيمرت
ਸੀਮ੍ਰਨਪਾਲ	سيمرنبال
ਸੀਮ੍ਰਨਪ੍ਰਿਤ	سيمرنبريت
ਸੀਮ੍ਰਨ੍ਕੌਰ	سيمرنكاور
ਸੀਮ੍ਰਨ੍ਜੀਤ	سيمرنجيت
ਸੀਮ੍ਰੀਤਾ	سيمريتا
ਸੀਰਤ	سيرت
ਸੀਰੀਪ੍ਰੀਤਮ	سيريبريتم
ਸੀਰੀਵੇਦ੍ਯਾ	سيريويديا
ਸੀਰੀਸੀਮ੍ਰਣ	سيريسيمرن
ਸੀਰੀਸੇਵਾ	سيريسيوا
ਸੁਖਚੈਨ	سوكهتشاين
ਸੁਖਜੀਵਨ	سوكهجيون
ਸੁਖਜੋਤ	سوكهجوت
ਸੁਖਜੋਧ	سوكهجوده
ਸੁਖਦਾਯਲ	سوكهدايل
ਸੁਖਦੀਪ	سوكهديب
ਸੁਖਦੇਵ	سوكهديو
ਸੁਖਬੀਰ	سوكهبير
ਸੁਖਮਾਂ	سوكهمان
ਸੁਖਰੂਪ	سوكهروب
ਸੁਖਸਿਤਾਲ	سوكهسيتال
ਸੁਖਸੀਮ੍ਰਣ	سوكهسيمرن
ਸੁਖਾਨਂਦ	سوكهانند
ਸੁਖਿਤ	سوكهيت
ਸੁਖੀਨ	سوكهين
ਸੁਖੀਨ੍ਦੇਰ	سوكهيندير
ਸੁਖ੍ਚਾਰਨ੍ਜੀਤ	سوكهتشارنجيت
ਸੁਖ੍ਜਿਤ	سوكهجيت
ਸੁਚਦੀਪ	سوتشديب
ਸੁਚਦੇਵ	سوتشديو
ਸੁਚਮ	سوتشم
ਸੁਜਨਰੂਪ	سوجنروب
ਸੁਜਨ੍ਬੀਰ	سوجنبير
ਸੁਜ੍ਜਨ	سوججن
ਸੁਧਬੁਧ	سودهبوده
ਸੁਧਸੁਰਤ	سودهسورت
ਸੁਭਪ੍ਰਿਤ	سوبهبريت
ਸੁਹੇਜਦੀਪ	سوهيجديب
ਸੇਵਾਕਪ੍ਰਿਤ	سيواكبريت
ਸੇਵਾਕਪ੍ਰੇਮ	سيواكبريم
ਸੇਵਾਕਰਣ	سيواكرن
ਸੇਵਾਪ੍ਰੀਤ	سيوابريت
ਸੇਹਜ	سيهج
ਸੇਹੇਜਬੀਰ	سيهيجبير
ਸੈਲੇਸ਼ਦੀਪ	سايليشديب
ਸੈਹਜ	سايهج
ਸੈਹਾਜਨੀਵਾਸ	سايهاجنيواس
ਸੈਹਾਜਲੀਨ	سايهاجلين
ਸੈਹਾਜਾਧਾਰ	سايهاجادهار
ਸੋਚੀ	سوتشي
ਸੋਨਹਨ	سونهن
ਸੋਭਾਵਂਤ	سوبهاونت
ਸੋਹੀਨਦੇਰ	سوهيندير
ਸੋਹੁਨ	سوهون
ਸ੍ਵਰ੍ਨ	سورن
ਹਕਾਮਪ੍ਰਿਤ	هكامبريت
ਹਨ੍ਸ੍ਪਾਲ	هنسبال
ਹਰਕਾਨ੍ਵਾਲ	هركانوال
ਹਰਕੀਰਣ	هركيرن
ਹਰਗੀਤ	هرجيت
ਹਰਗੁਰ੍ਮਿਤ (ਮਿਤ )	هرجورميت (ميت )
ਹਰਗੋਬੀਨ੍ਦ	هرجوبيند
ਹਰਚਰਣ	هرتشرن
ਹਰਜਪ	هرجب
ਹਰਜੀ	هرجي
ਹਰਜੀਤ	هرجيت
ਹਰਜੀਨ੍ਦੇਰ	هرجيندير
ਹਰਜੀਵ	هرجيو
ਹਰਜੁਗਤ	هرجوجت
ਹਰਜੋਗ	هرجوج
ਹਰਜੋਧ	هرجوده
ਹਰਜ੍ਯੋਤ	هرجيوت
ਹਰਤਿਰਥ	هرتيرته
ਹਰਤੇਜ੍ਪਾਲ	هرتيجبال
ਹਰਦਯਾਲ	هرديال
ਹਰਦਾਸ	هرداس
ਹਰਦਿਪਾ	هرديبا
ਹਰਦੀਪ	هرديب
ਹਰਧਨ	هردهن
ਹਰਨਾਮ	هرنام
ਹਰਨਾਰਾਯਣ	هرناراين
ਹਰਨਿਤ	هرنيت
ਹਰਨੀਰ੍ਮਲ	هرنيرمل
ਹਰਨੀਹਲ	هرنيهل
ਹਰਪਰ੍ਸਨ੍ਨ	هربرسنن
ਹਰਪਾਲ	هربال
ਹਰਪ੍ਰੇਮ੍ਜੀਤ	هربريمجيت
ਹਰਬਿਂਦਰ	هربيندر
ਹਰਬਿਰ	هربير
ਹਰਭਗਤ	هربهجت
ਹਰਮਨਾਦ	هرمناد
ਹਰਮਾਂਨ੍ਦੇਰ	هرمانندير
ਹਰਮੀਤ	هرميت
ਹਰਮੀਲਨ	هرميلن
ਹਰਮੂਰਤ	هرمورت
ਹਰਰਾਈ	هرراي
ਹਰਰੂਪ	هرروب
ਹਰਵਂਤ	هرونت
ਹਰਵਿਨ	هروين
ਹਰਸ਼ਰਣ	هرشرن
ਹਰਸਿਤਾਲ	هرسيتال
ਹਰਸੀਮ੍ਰਣ	هرسيمرن
ਹਰਸੀਮ੍ਰਨ੍ਜੋਤ	هرسيمرنجوت
ਹਰਸੀਮ੍ਰਿਤ	هرسيمريت
ਹਰਸੁਖ	هرسوكه
ਹਰਾਨੂਪ	هرانوب
ਹਰਾਮ੍ਰੀਤ	هرامريت
ਹਰਿਕੀਰ੍ਤਨ	هريكيرتن
ਹਰਿਦਰ੍ਸ਼ਨ	هريدرشن
ਹਰਿਨਾਰਾਯਣ	هريناراين
ਹਰਿਪ੍ਰੀਤ	هريبريت
ਹਰੀਅਮ੍ਰਿਤ	هريامريت
ਹਰੀਸਰੂਪ	هريسروب
ਹਰੀਸੀਮਾਂਰਣ	هريسيمانرن
ਹਰ੍ਕਾਰਾਨ੍ਜੀਤ	هركارانجيت
ਹਰ੍ਕੀਰਨ੍ਜੀਤ	هركيرنجيت
ਹਰ੍ਕੀਰਪਾਲ	هركيربال
ਹਰ੍ਜਸ	هرجس
ਹਰ੍ਤੇਇਜ	هرتييج
ਹਰ੍ਨੀਝ	هرنيجه
ਹਰ੍ਬਂਸ	هربنس
ਹਰ੍ਮਾਂਨਜਿਤ	هرماننجيت
ਹਰ੍ਮਾਂਨਪਾਲ	هرماننبال
ਹਰ੍ਮੀਨ੍ਦੇਰ	هرميندير
ਹਰ੍ਮੇਂਦ੍ਰ	هرميندر
ਹਰ੍ਸ਼ਰ੍ਧਾ	هرشردها
ਹਰ੍ਸ਼ਵਰ੍ਧਨ	هرشوردهن
ਹਰ੍ਸ਼ਾਗੁਨ	هرشاجون
ਹਰ੍ਸਿਰਤ	هرسيرت
ਹਸਨ	هسن
ਹਾਰਭਾਗ	هاربهاج
ਹਿਤੀਨਦੇਰ	هيتيندير
ਹਿਤੇਨਦੇਰ	هيتيندير
ਹਿਮ੍ਮਤ	هيممت
ਹਿਰੀਸ਼	هيريش
ਹੁਅਲੀਨਾ	هوالينا
ਹੁਕੁਮਪਰਿਤ	هوكومبريت
ਹੂਜਓਏ	هوجاوي
ਹੇਤ	هيت
ਹੇਤਬੀਰ	هيتبير
ਹੇਮੀਨਦੇਰ	هيميندير
ਹੇਯ੍ਮਾਂਨ੍ਪ੍ਰਿਤ	هييماننبريت
ਹੇਰਹੋ	هيرهو
