ሀብታምነት	hābǝtāmǝnnat
ሀቻምና	hāččāmǝnā
ሀች	hāčč
ሁለ	hulla
ሁለመና	hullamanā
ሁለተ	hulatta
ሁለቴ	hulatte
ሁለት	hulatt
ሁሉ	hullu
ሁሉም	hullum
ሁሌ	hulle
ሁል	hull
ሁልጊዜ	hullǝgize
ሁነኛ	hunaññā
ሁከተኛ	hukataññā
ሂስና	hisǝnnā
ሃያኛ	hāyāññā
ሃይማኖተኛ	hāyǝmānotaññā
ህላዌ	hǝllāwe
ህልውና	hǝllǝwǝnā
ህክምና	hǝkkǝmǝnnā
ሆሳዕና	hossāʿǝnā
ሆነለት	honallat
ሆነበት	honabbat
ሆኖም	honomm
ሆጃ	hoǧǧā
ለመለመ	lamallama
ለመሰሰ	lamassasa
ለመነ	lammana
ለመዘገ	lamazzaga
ለመደ	lammada
ለመጠ	lammaṭa
ለመጥ	lammaṭṭ
ለማ	lammā
ለማመደ	lamāmmada
ለማኝ	lammāñ
ለማኝነት	lammāñǝnnat
ለማዳ	lammādā
ለማዳነት	lammādānnat
ለማጣ	lammāṭā
ለምነት	lamǝnnat
ለሰለሰ	lasallasa
ለሰሰ	lassasa
ለሰነ	lassana
ለሱ	lassu
ለሳኝ	lassāñ
ለስ	lass
ለስላሳ	lasǝlāssā
ለስላሳነት	lasǝlāssānnat
ለሸለሸ	lašallaša
ለቀለቀ	laqallaqa
ለቀመ	laqqama
ለቀም	laqamm
ለቀስተኛ	laqqasǝtaññā
ለቀቀ	laqqaqa
ለቀቅ	laqqaq
ለቃቀመ	laqāqqama
ለቅለቅ	laqǝlaqq
ለቅላቂ	laqǝllāqi
ለበለበ	laballaba
ለበሰ	labassa
ለበቀ	labbaqa
ለበበ	labbaba
ለበደ	labbada
ለበጠ	labbaṭa
ለባቃ	labbāqqā
ለባበሰ	labābbasa
ለብ	labb
ለብታ	labbǝtā
ለብቻ	labbǝččā
ለተመ	lattama
ለካ	lakkā
ለኮሰ	lakkosa
ለኮፈ	lakkofa
ለወሰ	lawassa
ለወጠ	lawwaṭa
ለዋሳ	lawwāssā
ለዘበ	lazzaba
ለዘብተኛ	lazzabǝtaññā
ለዛ	lazzā
ለዛው	lazzāw
ለየ	layya
ለየብቻ	layyabǝččā
ለያየ	layāyya
ለይስሙላ	layǝsǝmullā
ለጅ	laǧǧ
ለገመ	laggama
ለገሰ	laggasa
ለጋ	laggā
ለጋስ	laggās
ለጋስነት	laggāsǝnnat
ለግላጋ	lagǝlāggā
ለጎን	lagonn
ለጎደ	laggoda
ለጐመ	laggʷama
ለጠለጠ	laṭallaṭa
ለጫካ	lač̣ākkā
ለፈለፈ	lafallafa
ለፈፈ	laffafa
ለፋ	laffā
ሊቅነት	liqǝnnat
ላላ	lāllā
ላምባ	lāmǝbbā
ላሸ	lāšša
ላሸቀ	lāššaqa
ላቂያ	lāqqiyā
ላቅ	lāqq
ላቆጠ	lāqqoṭa
ላከከ	lākkaka
ላይኛ	lāyǝññā
ላጲስ	lāṗṗis
ሌብነት	lebǝnnat
ሌጣነት	leṭānnat
ልመና	lǝmmanā
ልማደኛ	lǝmādaññā
ልምምድ	lǝmǝmmǝd
ልምጥ	lǝmmǝṭṭ
ልምጭ	lǝmmǝč̣
ልሳነ	lǝssāna
ልሳን	lǝssān
ልስላሴ	lǝsǝllāsse
ልስን	lǝssǝn
ልቃሚ	lǝqqāmi
ልቃቂ	lǝqqāqi
ልቃቂት	lǝqqāqit
ልቅ	lǝqq
ልቅም	lǝqqǝm
ልቅቅ	lǝqǝqq
ልቅነት	lǝqqǝnnat
ልበ	lǝbba
ልቡ	lǝbbu
ልቡና	lǝbbunā
ልባም	lǝbbām
ልባሽ	lǝbbāš
ልባዊ	lǝbbāwi
ልብ	lǝbb
ልብስ	lǝbbǝs
ልብቅ	lǝbbǝq
ልብዳት	lǝbbǝdāt
ልብድ	lǝbbǝd
ልብጥ	lǝbbǝṭ
ልኩን	lǝkkun
ልክ	lǝkk
ልዋጭ	lǝwwāč̣
ልውውጥ	lǝwǝwwǝṭ
ልዕልና	lǝʿǝlǝnnā
ልዝብ	lǝzzǝb
ልዩ	lǝyyu
ልዩነት	lǝyyunnat
ልጃገረድነት	lǝǧāgaradǝnnat
ልጅነት	lǝǧǝnnat
ልጉም	lǝggum
ልግመኛ	lǝgǝmaññā
ልግስና	lǝggǝsǝnnā
ልጥፋት	llǝṭṭǝfāt
ልጨኛ	lǝč̣č̣aññā
ልፈፋ	lǝffafā
ልፊያ	lǝffiyā
ልፋጫም	lǝffāč̣ām
ልፋጭ	lǝffāč̣
ሎሌነት	lolennat
ሎቲ	lotti
ሐማል	ḥāmmāl
ሐማልነት	ḥāmmālǝnnat
ሐሜተኛ	ḥāmetaññā
ሐሜት	ḥāmmet
ሐሰተኛ	ḥāssataññā
ሐሰት	ḥāssat
ሐሳብ	ḥāssāb
ሐሳዌ	ḥāssāwe
ሐቀኛ	ḥāqqaññā
ሐቀኛነት	ḥāqqaññānnat
ሐቅ	ḥāqq
ሐተተኛ	ḥātataññā
ሐች	ḥāčč
ሐካይ	ḥākkāy
ሐኬተኛ	ḥāketaññā
ሐኬተኝነት	ḥāketaññǝnnat
ሐዋላ	ḥāwwālā
ሐዋርያነት	ḥāwārǝyānnat
ሐዘንተኛ	ḥāzanǝtaññā
ሐዲስ	ḥāddis
ሑር	ḥurr
ሑርነት	ḥurrǝnnat
ሕመምተኛ	ḥǝmamǝttañā
ሕቅ	ḥǝqq
ሕቅታ	ḥǝqqǝtā
ሕክምና	ḥǝkkǝmǝnnā
ሕያውነት	ḥǝyāwǝnnat
ሕገ	ḥǝgga
ሕጋዊ	ḥǝggāwi
ሕጋዊነት	ḥǝggāwinnat
ሕግ	ḥǝgg
ሕጓ	ḥǝggʷā
ሕፃንነት	ḥǝḍānnǝnnat
መሀንዲስነት	mahānǝdisǝnnat
መሀከለኛ	mahākkalaññā
መሀከል	mahākkal
መሃይም	mahāyyǝm
መሃይምነት	mahāyyǝmǝnnat
መለለ	mallala
መለማመጃ	mallamāmaǧā
መለሰ	mallasa
መለቃለቂያ	mallaqālaqiyā
መለኮትነት	malakotǝnnat
መለወጫ	mallawač̣č̣ā
መለዮ	mallayyo
መለጠ	mallaṭa
መላ	mallā
መላሽ	mallāš
መላክተኛ	malākǝtaññā
መላጣነት	malāṭānnat
መልመጃ	mallǝmaǧā
መልሶ	mallǝso
መልቲነት	malǝtinnat
መልእክተኛ	malǝʾǝkǝtaññā
መልከኛ	malǝkaññā
መሐለቅ	maḥāllaq
መሐላ	maḥāllā
መመሪያ	mammariyā
መመነኛ	mamannañā
መመዘኛ	mamazzañā
መመዝገቢያ	mammazǝgabiyā
መመጻደቅ	mammaṣādaq
መማለጃ	mammālaǧā
መምህርነት	mamǝhǝrǝnnat
መሠሪ	maśarri
መሠሪነት	maśarrinnat
መሠዊያ	maśawwiyā
መሠውር	maśawwǝr
መሣሪያ	maśśāriyā
መሥዋዕትነት	maśǝwāʿǝtǝnnat
መረመረ	marammara
መረማመጃ	marramāmaǧā
መረረ	marrara
መረረው	marraraw
መረቀ	marraqa
መረቀዘ	maraqqaza
መረባ	marabbā
መረተ	marrata
መረነ	marrana
መረዋ	marawwā
መረዘ	marraza
መረጃ	marraǧā
መረገ	marraga
መረገጫ	marragač̣ā
መረጋገጫ	marragāgač̣ā
መረጠ	marraṭa
መሪነት	marinnat
መራ	marrā
መራራነት	marrārānat
መራር	marrār
መራርነት	marrārǝnnat
መራቂ	marrāqi
መራቢያ	marrābiyā
መራዥ	marrāž
መራገጫ	marrāgač̣ā
መራጭነት	marāč̣ǝnnat
መር	marr
መርከበኛ	marǝkabaññā
መርዘኛ	marǝzaññā
መሰለ	massala
መሰብሰቢያ	massabǝsabiyā
መሰነ	massana
መሰናዘሪያ	massanāzariyā
መሰናዶ	massanādo
መሰከረ	masakkarra
መሰከነ	masakkana
መሰኪያ	masakkiyā
መሰደጃ	massadaǧā
መሰገ	massaga
መሰጠ	massaṭa
መሳ	massā
መሳለሚያ	massālamiyā
መሳለቂያ	massālaqiyā
መሳጭ	massāč̣
መሳፍቻ	massāfǝččā
መስቀልኛ	masǝqalǝññā
መስቀልያ	masǝqalǝyyā
መስተአምር	masǝtaʾāmmǝr
መስካሪነት	masǝkārinnat
መስኮብኛ	masǝkobǝññā
መስፈሪያ	massǝfariyā
መሸ	mašša
መሸለቻ	mašallačā
መሸሸጊያ	maššašagiyā
መሸቀጫ	mašaqqač̣ā
መሸበቢያ	mašabbabiyā
መሸተ	maššata
መሸተኛ	mašataññā
መሸኛ	mašaññā
መሸገ	maššaga
መሸጋሸጊያ	maššagāšagiyā
መሸፈቻ	mašaffačā
መሸፈኛ	mašaffañā
መሻገሪያ	maššāgariyā
መቀለጃ	maqallaǧā
መቀመጫ	maqqamač̣ā
መቀቀያ	maqaqqayā
መቀነት	maqannat
መቀነቻ	maqannačā
መቀየሻ	maqayyašā
መቀጣጫ	maqqaṭāč̣ā
መቀጫ	maqqač̣ā
መቀጮ	maqqač̣o
መቃጠሪያ	maqqāṭariyā
መቆያ	maqoyyā
መቆጣጠሪያ	maqqoṭāṭariyā
መቆፈሪያ	maqoffariyā
መቋቋሚያ	maqqʷāqʷāmiyā
መቍጠሪያ	maqqʷiṭariyā
መበለት	maballat
መበላት	mabbalāt
መበየጃ	mabayyaǧā
መበያ	mabbayā
መበደሪያ	mabbadariyā
መተላለፊያ	mattalālafiyā
መተማመኛ	mattamāmañā
መተረ	mattara
መተረቻ	matarračā
መተረክያ	matarrakǝyā
መተተኛ	matataññā
መተኛ	mataññā
መተከዣ	matakkažā
መተከያ	mattakayā
መተዳደሪያ	mattadādariyā
መታ	mmatā
መታመኛ	mattāmañā
መታሠሪያ	mattāśariyā
መታረቂያ	mattāraqiyā
መታሰቢያ	mattāsabiyā
መታሻ	mattāšā
መታተረ	matāttara
መታታ	matāttā
መታወቂያ	mattāwaqiyā
መታጠቂያ	mattāṭaqiyā
መታጠቢያ	mattāṭabiyā
መታጠፊያ	mattāṭafiyā
መታጫ	mattāč̣ā
መትረየስ	matǝrayyas
መቶኛ	matoññā
መቼም	maččem
መቼውንም	maččewǝnǝm
መነመነ	manammana
መነሣት	mannaśāt
መነሻ	mannašā
መነሾ	mannašo
መነቀረ	manaqqara
መነቃቀረ	manaqāqqara
መነተፈ	manattafa
መነቸከ	manaččaka
መነነ	mannana
መነኰሰ	manakkʷasa
መነዘረ	manazzara
መነዛዘረ	manazāzzara
መነገገ	managgaga
መነጥር	manaṭṭǝr
መነጽር	manaṣṣǝr
መና	mannā
መናኛ	manāññā
መናኝ	mannāñ
መናገሻ	mannāgašā
መናፈሻ	mannāfašā
መንማና	manǝmānnā
መንቃራ	manǝqārrā
መንቻካ	manǝčākkā
መንደረኛ	manǝdaraññā
መንደርተኛ	manǝdarǝtaññā
መንገደኛ	manǝgadaññā
መንጠቆ	manǝṭaqqo
መንጫራ	manǝč̣ārrā
መንጫቃ	manǝč̣č̣āqqā
መንፈሳዊነት	manǝfasāwinnat
መኖ	manno
መኝታ	maññǝtā
መከለሻ	makallašā
መከላከያ	makkalākayā
መከማቻ	makkamāčā
መከረ	makkara
መከረኛ	makarrañā
መከተ	makkata
መከነ	makkana
መከናነቢያ	makkanānabiyā
መከዳ	makkaddā
መከፈኛ	makaffañā
መካች	makkāč
መካን	makkān
መካንነት	makkānǝnnat
መካከለኛ	makākkalaññā
መካከል	makākkal
መካከረ	makākkara
መኰንን	makʷannǝn
መወሰኛ	mawassaññā
መዋጮ	mawwāč̣o
መዐተኛ	maʿātaññā
መዘመዘ	mazammaza
መዘምራን	mazammǝrān
መዘምር	mazammǝr
መዘበረ	mazabbara
መዘባበቻ	mazzabābačā
መዘነ	mazzana
መዘክር	mazakkǝr
መዘውር	mazawwǝr
መዘዘኛ	mazazaññā
መዘገበ	mazaggaba
መዛኝ	mazzāññ
መደለዣ	madallažā
መደለያ	maddalayā
መደመደ	madammada
መደረቢያ	madarrabiyā
መደቆሻ	madaqqošā
መደበ	maddaba
መደበኛ	madabaññā
መደብ	maddab
መደብር	madabbǝr
መደደ	madadda
መደገፊያ	maddagafiyā
መድሃኒተኛ	madǝhānitaññā
መድጎሚያ	madǝggomiyā
መድፈኛ	madǝfaññā
መጀመሪያ	maǧammariyā
መገለ	maggala
መገመገ	magammaga
መገበ	maggaba
መገነዣ	magannažā
መገጣጠሚያ	maggaṭāṭamiyā
መጋረጃ	maggāraǧā
መጋቢ	maggābi
መጋቢት	maggābit
መጋዞ	maggāzo
መጋዣ	magāžžā
መጎናጠፊያ	maggonāṭafiyā
መጎናጸፊ	maggonāṣafi
መጓጓዣ	maggʷāgʷāžā
መጠመጠ	maṭammaṭa
መጠነኛ	maṭanaññā
መጠወተ	maṭawwata
መጠይቅ	maṭayyǝq
መጥቼ	maṭǝčče
መጨመጨ	mač̣ammač̣a
መጫኛ	mač̣āññā
መጸወተ	maṣawwata
መፈተኛ	mafattañā
መፈናፈኛ	maffanāfañā
መፈክር	mafakkǝr
ሙሀቻ	muhāččā
ሙላጭ	mullāč̣
ሙልል	mulǝll
ሙረዳ	murradā
ሙሽሪት	mušǝrrit
ሙሽራ	muššǝrā
ሙትቻ	mutǝččā
ሙከራ	mukkarā
ሙክት	mukkǝt
ሙክክ	mukǝkk
ሙዋለጠ	muwāllaṭa
ሙዋሙዋ	muwāmmuwā
ሙዋርተኛ	muwārǝtaññā
ሙዋሸሸ	muwāššaša
ሙዋጠጠ	muwāṭṭaṭa
ሙዚቀኛ	muziqaññā
ሙዝዝ	muzǝzz
ሙያሌ	muyyāle
ሙያተኛ	muyātaññā
ሙዳ	muddā
ሙጃ	muǧǧā
ሙጃማ	muǧǧāmmā
ሙጅር	muǧǧǝr
ሙግት	muggǝt
ሙግግ	mugǝgg
ሙጥኝ	muṭṭǝññ
ሚሊዮን	milliyon
ሚዳቋ	midāqqʷā
ማለለ	māllala
ማለቢያ	mālabbiyā
ማለደ	māllada
ማለገ	māllaga
ማላ	māllā
ማላጋነት	mālāgānnat
ማሕሌተኛ	māḥǝletaññā
ማመላለሻ	māmmalālašā
ማመሻ	māmmašā
ማሚቴ	māmmite
ማሚቶ	māmmito
ማማሰያ	māmmāsayā
ማምረቻና	māmǝračānnā
ማሞ	māmmo
ማሞኛ	māmoññā
ማሟያ	māmmʷāyā
ማረረ	mārrara
ማረከ	mārraka
ማረገኛ	māragaññā
ማራቢያ	mārrābiyā
ማራገቢያ	mārrāgabiyā
ማሰሻ	māssašā
ማሰፊያ	māssafiyā
ማሳመኛ	māsāmmañā
ማሳተሚያ	māsāttamiyā
ማስረጃ	māsǝraǧǧā
ማስቀመጫ	māsǝqammač̣ā
ማስወረድ	māsǝwarrad
ማስጠሎ	māsǝṭallo
ማሸጊያ	māššagiyā
ማሻሻያ	māššāšāyā
ማሽላ	māšǝllā
ማሾለቂያ	māšollaqiyā
ማቀቀ	māqqaqa
ማቋረጫ	māqqʷārač̣ā
ማተሚያ	māttamiyā
ማኅበረተኛ	māḫǝbarataññā
ማኅበርተኛ	māḫǝbarǝtaññā
ማኅበርተኝነት	māḫǝbarǝtaññǝnnat
ማነቃቂያ	mānnaqāqiyā
ማናበቢያ	mānnābabiyā
ማን	mānn
ማንም	mānǝmm
ማንኛውም	mānnǝññāwǝm
ማእድ	māʾǝdd
ማከፋፈያ	mākkafāfayā
ማካፈል	mākkāfal
ማክሰኞ	mākǝsañño
ማዋሐጃ	māwwāḥāǧā
ማዕረገኛ	māʿǝragaññā
ማዕድ	māʿǝdd
ማዕድን	māʿǝddǝn
ማይክሮስኮፕ	māyǝkǝrosǝkopp
ማደያ	māddayā
ማዳመጫ	māddāmač̣ā
ማድጋ	mādǝggā
ማገረ	māggara
ማገደ	māggada
ማገጃ	māggaǧā
ማገጠ	māggaṭa
ማጋጣነት	māgāṭānnat
ማጋጭነት	māgāč̣ǝnnat
ማግሰኞ	māgǝsañño
ማፈኛ	māffañā
ሜዳማ	medāmmā
ምላሰኛ	mǝlāsaññā
ምላሰኝነት	mǝlāsaññǝnnat
ምላሽ	mǝllāš
ምልስ	mǝllǝs
ምልክት	mǝlǝkkǝt
ምረቃ	mǝrraqā
ምረት	mǝrrat
ምሩቅ	mǝrruq
ምሪት	mǝrrit
ምራጭ	mǝrrāč̣
ምሬት	mǝrret
ምር	mǝrr
ምርምር	mǝrǝmmǝr
ምርር	mǝrǝrr
ምርቃት	mǝrrǝqāt
ምርኮኛ	mǝrǝkoññā
ምርጊት	mǝrǝgitt
ምሰሶ	mǝsasso
ምሳሌ	mǝssāle
ምሳር	mǝssār
ምስ	mǝss
ምስሪት	mǝssǝrit
ምስራች	mǝsǝrāčč
ምስኪንነት	mǝsǝkinǝnnat
ምስክር	mǝsǝkkǝr
ምስግ	mǝssǝg
ምስጢረኛ	mǝsǝṭiraññā
ምስፍና	mǝsǝfǝnnā
ምሽት	mǝššǝt
ምሽግ	mǝššǝg
ምቀኛ	mǝqqaññā
ምቀኝነት	mǝqqaññǝnnat
ምትክ	mǝtǝkk
ምቹ	mǝčču
ምቹነት	mǝččunnat
ምች	mǝčč
ምቾት	mǝččot
ምነና	mǝnnanā
ምናኔ	mǝnnāne
ምንም	mǝnǝmm
ምንኛ	mǝnǝññā
ምንኩስና	mǝnǝkusǝnnā
ምንደኛ	mǝnǝdaññā
ምንጅላት	mǝnǝǧǝllāt
ምንጠራ	mǝnǝṭṭarā
ምኞት	mǝññot
ምክትል	mǝkǝttǝl
ምደባ	mǝddabā
ምድጃ	mǝdǝǧǧā
ምጥዋተኛ	mǝṭǝwātaññā
ሞለለ	mollala
ሞለሞለ	molammola
ሞለጨ	mollač̣a
ሞለፈጠ	molaffaṭa
ሞላ	mollā
ሞላላ	molāllā
ሞላላነት	molāllānnat
ሞላጫ	mollāč̣č̣ā
ሞልሟላ	molǝmmʷāllā
ሞልቃቃ	molǝqāqqā
ሞረሞረ	morammora
ሞረደ	morrada
ሞረድ	morrad
ሞሸለቀ	mošallaqa
ሞሸረ	moššara
ሞሽላቃ	mošǝlāqqā
ሞቀሞቀ	moqammoqa
ሞቀኝ	moqaññ
ሞቃት	moqqāt
ሞቅሟቃ	moqǝmʷāqqā
ሞነተፈ	monattafa
ሞከረ	mokkara
ሞከተ	mokkata
ሞከከ	mokkaka
ሞካሪ	mokkāri
ሞካች	mokkāč
ሞዘዘ	mozzaza
ሞዛዛነት	mozāzānnat
ሞያተኛ	moyātaññā
ሞጀረ	moǧǧara
ሞገተ	moggata
ሞገደኛ	mogaddaññā
ሞገገ	moggaga
ሞጋች	moggāč
ሞጨለፈ	moč̣allafa
ሞጨሞጨ	moč̣ammoč̣a
ሟለጠ	mʷāllaṭa
ሟሟ	mʷāmmʷā
ሟሸሸ	mʷāššaša
ሟከከ	mʷākkaka
ሟጠጠ	mʷāṭṭaṭa
ሠለሰ	śallasa
ሠለጠ	śallaṭa
ሠላጤ	śallāṭe
ሠመረ	śammara
ሠረሠረ	śaraśśara
ሠረገ	śarraga
ሠራ	śarrā
ሠራተኛ	śarrātaññā
ሠራው	śarrāw
ሠራጊ	śarrāgi
ሠቀሠቀ	śaqaśśaqa
ሠቀቀ	śaqqaqa
ሠናይ	śannāy
ሠወረ	śawwara
ሠወርዋራ	śawarǝwārrā
ሠዊ	śawwi
ሠዋ	śawwā
ሠዋራ	śawwārrā
ሠዓሊነት	śaʿālinnat
ሠየመ	śayyama
ሠያሚ	śayyāmi
ሠገረ	śaggara
ሠጋ	śaggā
ሠጋር	śaggār
ሣሣ	śāśśā
ሣርማ	śārǝmmā
ሥሉስ	śǝllus
ሥሉጥ	śǝlluṭ
ሥላሴ	śǝllāse
ሥልጣኔ	śǝllǝṭṭāne
ሥሡ	śǝśśu
ሥሥት	śǝśśǝt
ሥሥነት	śǝśǝnnat
ሥርቻ	śǝrǝččā
ሥቅቅ	śǝqǝqq
ሥያሜ	śǝyyāme
ሦስተኛ	śosǝtaññā
ረመጠ	rammaṭa
ረሰረሰ	rasarrasa
ረሳ	rassā
ረቀቀ	raqqaqa
ረቂቅነት	raqiqǝnnat
ረበረበ	rabarraba
ረበሸ	rabbaša
ረበበ	rabbaba
ረባ	rabbā
ረባዳ	rabbāddā
ረብሸኛ	rabǝšaññā
ረታ	rattā
ረኅብተኛ	raḫǝbǝtaññā
ረከሰ	rakkasa
ረካ	rakkā
ረኸጥነት	raḵaṭǝnnat
ረዘመ	razzama
ረዘረዘ	razarraza
ረዘቀ	razzaqa
ረዥም	ražžǝm
ረዳ	raddā
ረዳት	raddāt
ረጅም	raǧǧǝm
ረገመ	raggama
ረገበ	raggaba
ረገብ	ragabb
ረገጠ	raggaṭa
ረገፈ	raggafa
ረጋ	raggā
ረጋገጠ	ragāggaṭa
ረፈረፈ	rafarrafa
ረፈደ	raffada
ረፋድ	raffād
ሩሩ	rurru
ሩስኛ	rusǝññā
ራራ	rārrā
ራብተኛ	rābǝtaññā
ርሚጦ	rǝmmiṭo
ርቀት	rǝqqat
ርችት	rǝččǝt
ርካሽ	rǝkkāš
ርክክብ	rǝkǝkkǝb
ርዝራዥ	rǝzǝrrāž
ርጋጭ	rǝggāč̣
ርጋፊ	rǝggāfi
ሮሮ	rorro
ሰለለ	sallala
ሰለመ	sallama
ሰለሰለ	salassala
ሰለቀ	sallaqa
ሰለቀጠ	salaqqaṭa
ሰለበ	sallaba
ሰለተ	sallata
ሰለቸ	salačča
ሰላ	sallā
ሰላላ	sallālā
ሰላማዊነት	salāmāwinnat
ሰላች	sallāč
ሰላይ	sallāy
ሰልካካ	salǝkākkā
ሰልፈኛ	salǝfaññā
ሰመመ	sammama
ሰመጠ	sammaṭa
ሰማ	sammā
ሰማዕትነት	samāʿǝtǝnnat
ሰምና	samǝnnā
ሰሞንኛ	samonǝññā
ሰረረ	sarrara
ሰረሰረ	sarassara
ሰረቀ	sarraqa
ሰረዘ	sarraza
ሰረገላ	saragallā
ሰረጎደ	saraggoda
ሰራረዘ	sarārraza
ሰሰነ	sassana
ሰቀለ	saqqala
ሰቀቀ	saqqaqa
ሰቀቀኝ	saqqaqaññ
ሰቀዘ	saqqaza
ሰቅ	saqq
ሰበረ	sabbara
ሰበሰበ	sabassaba
ሰበቀ	sabbaqa
ሰበበኛ	sababaññā
ሰበከ	sabbaka
ሰባ	sabbā
ሰባሰበ	sabāssaba
ሰባበረ	sabābbara
ሰባተኛ	sabāttaññā
ሰባት	sabātt
ሰባኛ	sabāññā
ሰብሳባ	sabǝsābbā
ሰተረ	sattara
ሰተት	satatt
ሰታራ	sattārā
ሰነቀ	sannaqa
ሰነቀረ	sanaqqara
ሰነበተ	sanabbata
ሰነበጠ	sanabbaṭa
ሰነኘ	sanañña
ሰነከለ	sanakkala
ሰነዘረ	sanazzara
ሰነገ	sannaga
ሰነፈ	sannafa
ሰነፈጠ	sanaffaṭa
ሰኔና	sanennā
ሰንከሎ	sanǝkallo
ሰንካላ	sanǝkāllā
ሰኞ	sañño
ሰከረ	sakkara
ሰከሰከ	sakassaka
ሰከነ	sakkana
ሰካ	sakkā
ሰካራም	sakkārām
ሰውነቱ	sawǝnnatu
ሰውነቱን	sawǝnnatun
ሰውነት	sawǝnnat
ሰውየው	sawǝyyaw
ሰውየውን	sawǝyyawǝn
ሰውዬ	sawǝyye
ሰየመ	sayyama
ሰየፈ	sayyafa
ሰያፊ	sayyāfi
ሰያፍ	sayyāf
ሰይፈኛ	sayǝfaññā
ሰደበ	saddaba
ሰደደ	saddada
ሰገሰገ	sagassaga
ሰገነት	sagannat
ሰገደ	saggada
ሰገገ	saggaga
ሰጉዳት	sagguddāt
ሰጐደ	saggʷada
ሰጓዳ	sagʷāddā
ሰጠ	saṭṭa
ሰጠመ	saṭṭama
ሰፈረ	saffara
ሰፈረተኛ	safarataññā
ሰፈርተኛ	safarǝtaññā
ሰፈነ	saffana
ሰፈፈ	saffafa
ሰፊ	ssafi
ሰፊው	saffiw
ሰፋ	saffā
ሰፍሳፋ	safǝsāffā
ሱረት	surrat
ሱሪ	surri
ሱሰኛ	susaññā
ሱካር	sukkār
ሱፋጭ	suffāč̣
ሲል	sill
ሲቀድ	siqadd
ሳሌ	sālle
ሳሎን	sāllon
ሳማ	sāmmā
ሳምንታዊ	sāmmǝnǝtāwi
ሳምንት	sāmmǝnǝt
ሳቂታ	sāqqittā
ሳቅ	sāqq
ሳቢያ	sābbiyā
ሳንባማ	sānǝbāmmā
ሳይንሰኛ	sāyǝnǝsaññā
ሳዱላ	sādullā
ሴረኛ	seraññā
ሴሰነ	sessana
ሴሰኛ	sesaññā
ሴሰኛነት	sesaññānnat
ሴሰኝነት	sesaññǝnnat
ሴተኛ	setaññā
ሴትነት	setǝnnat
ስለላ	sǝllalā
ስለሱ	sǝlassu
ስለዚህ	sǝlazzih
ስለዚያ	sǝlazziyā
ስሌት	sǝllet
ስልም	sǝllǝm
ስልምልም	sǝlǝmǝlǝmm
ስልሳኛ	sǝlǝsāññā
ስልቅ	sǝllǝq
ስልቻ	sǝllǝččā
ስልከኛ	sǝlǝkaññā
ስመኛ	sǝmaññā
ስሜት	sǝmmet
ስምም	sǝmǝmm
ስምምነት	sǝmǝmǝnnat
ስምንተኛ	sǝmǝnǝtaññā
ስምንት	sǝmmǝnǝt
ስሞተኛ	sǝmotaññā
ስረዛ	sǝrrazā
ስሪያ	sǝrriyā
ስርቅ	sǝrrǝq
ስርቅታ	sǝrrǝqǝtā
ስርዝ	sǝrrǝz
ስቅላት	sǝqqǝlāt
ስቅቅ	sǝqqǝq
ስባሪ	sǝbbāri
ስብራት	sǝbbǝrāt
ስብስብ	sǝbǝsǝbb
ስተተኛ	sǝtataññā
ስትር	sǝttǝr
ስንባጭ	sǝnǝbbāč̣
ስንተኛ	sǝnǝtaññā
ስንኝ	sǝnǝññ
ስንግ	sǝnnǝg
ስንጣሪ	sǝnnǝṭṭāri
ስንፍና	sǝnǝfǝnnā
ስኳር	sǝkkʷār
ስውር	sǝwwǝr
ስያሜ	sǝyyāme
ስደተኛ	sǝddataññā
ስደት	sǝddat
ስድ	sǝdd
ስድሳኛ	sǝdǝsāññā
ስድስተኛ	sǝddǝsǝtaññā
ስድስት	sǝddǝsǝt
ስጋጃ	sǝgāǧǧā
ስግስግ	sǝgǝsǝgg
ስፋፊ	sǝffāfi
ስፍስፍ	sǝfǝsǝff
ስፖርተኛ	sǝporǝtaññā
ሶመሶመ	somassomma
ሶምሶማ	somǝssomā
ሸለለ	šallala
ሸለመ	šallama
ሸለሸለ	šalaššala
ሸለቀቀ	šalaqqaqa
ሸለብ	šallabb
ሸለተ	šallata
ሸለገ	šallaga
ሸላለመ	šalāllama
ሸላሚ	šallāmi
ሸላች	šallāč
ሸላይ	šallāy
ሸመቀ	šammaqa
ሸመቀቀ	šamaqqaqa
ሸመተ	šammata
ሸመታ	šammatā
ሸመደደ	šamaddada
ሸመድማዳ	šamadǝmāddā
ሸመገለ	šamaggala
ሸማቂ	šammāqi
ሸማች	šammāč
ሸማኔ	šammāne
ሸሜኔ	šammene
ሸምቀቆ	šamǝqaqqo
ሸምቃቃ	šamǝqāqqā
ሸምበቆ	šamǝbaqqo
ሸረሞጠ	šarammoṭa
ሸረሸረ	šaraššara
ሸረኛ	šarrañā
ሸረኝነት	šaraññǝnnat
ሸረከተ	šarakkata
ሸረካከተ	šarakākkata
ሸረደደ	šaraddada
ሸረፈ	šarrafa
ሸራረፈ	šarārrafa
ሸር	šarr
ሸሻጊ	šaššāgi
ሸቀለ	šaqqala
ሸቀሸቀ	šaqaššaqa
ሸቀበ	šaqqaba
ሸቀጠ	šaqqaṭa
ሸቃቢ	šaqqābi
ሸቃይ	šaqqāy
ሸቃጭ	šaqqāč̣
ሸበለለ	šaballala
ሸበሸበ	šabaššaba
ሸበበ	šabbaba
ሸበተ	šabbata
ሸበቶ	šabbato
ሸብ	šabb
ሸብራቃ	šabǝrāqqā
ሸተተ	šattata
ሸተተው	šattataw
ሸተት	šatatt
ሸተትያ	šatatǝyyā
ሸነሸነ	šanaššana
ሸነቀረ	šannaqqara
ሸነቀጠ	šanaqqaṭa
ሸነቆረ	šanaqqora
ሸነቆጠ	šanaqqoṭa
ሸነተረ	šanattara
ሸነታተረ	šanatāttara
ሸነከፈ	šanakkafa
ሸነደረ	šanaddara
ሸነገለ	šanaggala
ሸነጠ	šannaṭa
ሸና	šannā
ሸንበቆ	šanǝbaqqo
ሸንተረርማ	šanǝtararǝmmā
ሸንከሎ	šanǝkallo
ሸንካፋ	šanǝkkāfā
ሸንዳራ	šanǝdārrā
ሸኘ	šañña
ሸኚ	šaññi
ሸከሸከ	šakaššaka
ሸከፈ	šakkafa
ሸካፋ	šakkāfā
ሸኮተ	šakkota
ሸውራራ	šawǝrrārā
ሸውሻዋ	šawǝšāwwā
ሸየኛ	šayaññā
ሸጐረ	šaggʷara
ሸጐጠ	šaggʷaṭa
ሸጠኝ	šaṭaññ
ሸፈተ	šaffata
ሸፈነ	šaffana
ሸፈጠ	šaffaṭa
ሸፈፈ	šaffafa
ሸፋጭ	šaffāč̣
ሸፋፈነ	šafāffana
ሸፍጠኛ	šafǝṭaññā
ሹሩባ	šurrubbā
ሹራብ	šurrāb
ሹርቤ	šurǝbbe
ሹካ	šukkā
ሹክ	šukk
ሹክክ	šukǝkk
ሺህኛ	šihǝññā
ሻምበል	šāmǝball
ሻቀለ	šāqqala
ሻንቅላ	šānǝqǝllā
ሻኛ	šāññā
ሻከረ	šākkara
ሻከር	šākarr
ሻገተ	šāggata
ሻግያ	šāgǝyyā
ሻፈደ	šāffada
ሽለላ	šǝllalā
ሽልማት	šǝllǝmāt
ሽልም	šǝllǝm
ሽልት	šǝllǝt
ሽልግ	šǝllǝg
ሽልጦ	šǝllǝṭo
ሽመቃ	šǝmmaqā
ሽሚያ	šǝmmiyā
ሽማግሌ	šǝmāgǝlle
ሽምብራ	šǝmǝbǝrrā
ሽምግልና	šǝmǝgǝllǝnā
ሽር	šǝrr
ሽርሙጥና	šǝrǝmuṭǝnnā
ሽርሽር	šǝrrǝšǝrr
ሽርክና	šǝrǝkǝnnā
ሽርጥ	šǝrrǝṭ
ሽርፋት	šǝrrǝfāt
ሽሽት	šǝššǝt
ሽሽግ	šǝššǝg
ሽቀላ	šǝqqalā
ሽቀባ	šǝqqabā
ሽቅብ	šǝqqǝb
ሽብልቅ	šǝbǝllǝq
ሽብር	šǝbbǝr
ሽቱ	šǝttu
ሽታ	šǝttā
ሽታው	šǝttāw
ሽቶ	šǝtto
ሽንፍላ	šǝnǝfǝllā
ሽክ	šǝkk
ሽክና	šǝkkǝnā
ሽክፍ	šǝkkǝf
ሽኮኮ	šǝkokko
ሽው	šǝww
ሽውታ	šǝwwǝtā
ሽያጭ	šǝyyāč̣
ሽጉር	šǝggur
ሽጉጥ	šǝgguṭṭ
ሽፋች	šǝffāč
ሽፍ	šǝff
ሽፍታ	šǝffǝtā
ሽፍትነት	šǝfǝtǝnnat
ሽፍን	šǝffǝn
ሾለከ	šollakka
ሾላካ	šollākā
ሾከከ	šokkaka
ሾጥ	šoṭṭ
ቀለለ	qallala
ቀለል	qalall
ቀለመ	qallama
ቀለሰ	qallasa
ቀለበ	qallaba
ቀለበሰ	qalabbasa
ቀለብ	qallab
ቀለብላባ	qalabǝllābā
ቀለብተኛ	qallabǝtaññā
ቀለደ	qallada
ቀለጠ	qallaṭa
ቀላ	qallā
ቀላለሰ	qalāllasa
ቀላለደ	qalāllada
ቀላል	qallāl
ቀላመደ	qalāmmada
ቀላማጅነት	qalāmāǧǧǝnnat
ቀላቢ	qallābi
ቀላወጠ	qalāwwaṭa
ቀላጅ	qallāǧ
ቀልማዳ	qalǝmāddā
ቀልቃላ	qalǝqāllā
ቀልደኛ	qalǝdaññā
ቀልጠፍ	qalǝṭaff
ቀልጣፋ	qalǝṭāffā
ቀመለ	qammala
ቀመመ	qammama
ቀመሰ	qammasa
ቀመስ	qammas
ቀመቀመ	qamaqqama
ቀማ	qammā
ቀማመሰ	qamāmmasa
ቀማሚ	qammāmi
ቀማኛ	qammāññā
ቀሠረ	qaśśara
ቀሠፈ	qaśśafa
ቀረ	qarra
ቀረረ	qarrara
ቀረሽ	qarraš
ቀረቀረ	qaraqqara
ቀረቀበ	qaraqqaba
ቀረበ	qarraba
ቀረና	qarannā
ቀረደደ	qaraddada
ቀረጠ	qarraṭa
ቀረጸ	qarraṣa
ቀረፈ	qarrafa
ቀራረመ	qarārrama
ቀራረፈ	qarārrafa
ቀር	qarr
ቀርፋፋ	qarǝfāffā
ቀሰመ	qassama
ቀሰረ	qassara
ቀሰሰ	qassasa
ቀሰስተኛ	qasasǝtaññā
ቀሰስተኛነት	qasasǝtaññānnat
ቀሰቀሰ	qasaqqasa
ቀሰተ	qassata
ቀሳሰመ	qasāssama
ቀሳፈተ	qasāffata
ቀስ	qass
ቀስተኛ	qasǝtaññā
ቀስታ	qassǝtā
ቀቀለ	qaqqala
ቀቃይ	qaqqāy
ቀበሌኛ	qabaleññā
ቀበቀበ	qabaqqaba
ቀበተተ	qabattata
ቀበቶ	qabatto
ቀበኛ	qabaññā
ቀበዝባዛ	qabazǝbāzzā
ቀበጠ	qabbaṭa
ቀባ	qabbā
ቀባባ	qabābbā
ቀባጀረ	qabāǧǧara
ቀብራራ	qabǝrārrā
ቀብቃባ	qabǝqābbā
ቀተረ	qattara
ቀነሰ	qannasa
ቀነቀነ	qanaqqana
ቀነበረ	qanabbara
ቀነተ	qannata
ቀነዘረ	qanazzara
ቀነደበ	qanaddaba
ቀነፈ	qannafa
ቀና	qannā
ቀናተኛ	qannātaññā
ቀናነሰ	qanānnasa
ቀን	qann
ቀንደኛ	qanǝdaññā
ቀኖና	qannonā
ቀኛዝማች	qaññāzǝmāč
ቀኝ	qaññ
ቀውላላ	qawǝlāllā
ቀዘቀዘ	qazaqqaza
ቀዘቀዘው	qazaqqazaw
ቀዘነ	qazzana
ቀዘዘ	qazzaza
ቀዘፈ	qazzafa
ቀዝቃዛ	qazǝqāzzā
ቀዥቃዣ	qažǝqāžžā
ቀየሠ	qayyaśa
ቀየረ	qayyara
ቀየደ	qayyada
ቀየጠ	qayyaṭa
ቀያሽ	qayyāš
ቀያቴ	qayyāte
ቀያየረ	qayāyyara
ቀያየጠ	qayāyyaṭa
ቀይ	qayy
ቀደመ	qaddama
ቀደምትነት	qaddamǝtǝnnat
ቀደሰ	qaddasa
ቀደደ	qaddada
ቀዳሚነት	qadāminnat
ቀዳሽ	qaddāš
ቀዶ	qaddo
ቀጠቀጠ	qaṭaqqaṭa
ቀጣፊነት	qaṭāfinnat
ቀጨቀጨ	qač̣aqqač̣a
ቀፈረረ	qafarrara
ቀፈቀፈ	qafaqqafa
ቀፈደደ	qafaddada
ቀፈፈ	qaffafa
ቀፍራራ	qafǝrrārā
ቁለላ	qullalā
ቁሌት	qullet
ቁልም	qulǝmm
ቁልፍ	qullǝff
ቁማርተኛ	qumārǝtaññā
ቁማጭ	qummāč̣
ቁምጥ	qummǝṭṭ
ቁምጥና	qumǝṭǝnnā
ቁራሽ	qurrāš
ቁራኛ	qurāññā
ቁራጭ	qurrāč̣
ቁር	qurr
ቁርጥምጥም	qurǝṭǝmǝṭǝmm
ቁስለኛ	qusǝlaññā
ቁቅ	quqq
ቁና	qunnā
ቁንን	qunnǝn
ቁንጅና	qunǝǧǝnnā
ቁጥር	quṭṭǝr
ቁፈራ	quffarā
ቁፋሪ	quffāri
ቁፋሮ	quffāro
ቁፍር	quffǝr
ቂመኛ	qimaññā
ቂጥኝ	qiṭǝññ
ቃልቻ	qāllǝččā
ቃረመ	qārrama
ቃሬ	qārre
ቃበዘ	qābbaza
ቃተተ	qāttata
ቃኘ	qāñña
ቃዠ	qāžža
ቄንጠኛ	qenǝṭaññā
ቅሌተኛ	qǝlletaññā
ቅሌታም	qǝlletām
ቅሌት	qǝllet
ቅልሽስሽ	qǝlǝšǝsǝšš
ቅልቅል	qǝlǝqqǝl
ቅልብ	qǝllǝb
ቅልጥ	qǝllǝṭṭ
ቅልጥፍና	qǝlǝṭǝfǝnnā
ቅልጥፍጥፍ	qǝlǝṭǝffǝṭǝf
ቅመማ	qǝmmamā
ቅሚያ	qǝmmiyā
ቅምምጦሽ	qǝmǝmmǝṭoš
ቅምብቻ	qǝmǝbǝččā
ቅምጥ	qǝmmǝṭ
ቅሥር	qǝśśǝr
ቅሪላ	qǝrillā
ቅሪት	qǝrrit
ቅራሪ	qǝrrāri
ቅራፊ	qǝrrāfi
ቅሬታ	qǝrretā
ቅር	qǝrr
ቅርጥፍ	qǝrǝṭǝff
ቅርፊት	qǝrǝfitt
ቅርፍፍ	qǝrǝfǝff
ቅስት	qǝssǝt
ቅስና	qǝssǝnnā
ቅቅል	qǝqqǝl
ቅበላ	qǝbbalā
ቅባቅዱስ	qǝbāqǝddus
ቅብብል	qǝbǝbbǝl
ቅብብሎሽ	qǝbǝbbǝloš
ቅነሳ	qǝnnasā
ቅናሽ	qǝnnāš
ቅንብር	qǝnǝbbǝr
ቅንነት	qǝnǝnnat
ቅንዝረኛ	qǝnǝzǝraññā
ቅንዲላ	qǝnǝdillā
ቅንፍ	qǝnnǝf
ቅኝ	qǝññ
ቅኝት	qǝññǝt
ቅዝቃዜ	qǝzǝqqāze
ቅዝዝ	qǝzzǝz
ቅዥቅዥ	qǝžǝqǝžž
ቅየሣ	qǝyyaśā
ቅያሜ	qǝyyāme
ቅያሪ	qǝyyāri
ቅይድ	qǝyyǝd
ቅይጥ	qǝyyǝṭ
ቅዱሳን	qǝddusān
ቅዱስ	qǝddus
ቅዱስነት	qǝddusǝnnat
ቅዳሴ	qǝddāse
ቅዳጅ	qǝddāǧ
ቅድ	qǝdd
ቅድም	qǝddǝm
ቅድሳት	qǝddǝsāt
ቅድስተ	qǝddǝsǝta
ቅድስት	qǝddǝsǝt
ቅድስና	qǝddǝsǝnā
ቅጅ	qǝǧǧ
ቅጠልያ	qǝṭalǝyyā
ቅጥረኛ	qǝṭǝraññā
ቅጥቃጤ	qǝṭǝqqāṭe
ቅፍር	qǝfǝrr
ቅፍርር	qǝfǝrǝrr
ቆለለ	qollala
ቆለመመ	qolammama
ቆለኛ	qollaññā
ቆላ	qollā
ቆሌ	qolle
ቆልማማ	qolǝmāmmā
ቆልቋላ	qolǝqʷāllā
ቆመጠ	qommaṭa
ቆም	qomm
ቆራረሰ	qorārrasa
ቆራጥ	qorrāṭ
ቆርቆሮ	qorǝqorro
ቆርጦኝ	qorǝṭoññ
ቆሸሸ	qoššaša
ቆሽማዳ	qošǝmāddā
ቆነጀ	qonaǧǧa
ቆነጣጠረ	qonaṭṭāṭṭara
ቆየ	qoyya
ቆይታ	qoyyǝtā
ቆጠቆጠ	qoṭaqqoṭa
ቆጶስ	qoṗṗos
ቆፈረ	qoffara
ቆፈነነ	qofannana
ቆፋሪ	qoffāri
ቆፋፈረ	qofāffara
ቈለመመ	qʷalammama
ቈለቈለ	qʷalaqqʷala
ቈለፈ	qʷallafa
ቈላለፈ	qʷalāllafa
ቈላፋ	qʷallāffā
ቈላፍ	qʷallāf
ቈረመደ	qʷarammada
ቈረሰ	qʷarrasa
ቈረቈረ	qʷaraqqʷara
ቈረቈሰ	qʷaraqqʷasa
ቈረበ	qʷarraba
ቈረጠ	qʷarraṭa
ቈረፈደ	qʷaraffada
ቈራ	qʷarrā
ቈራረጠ	qʷarārraṭa
ቈራጥ	qʷarrāṭ
ቈርማዳ	qʷarǝmāddā
ቈርቈዘ	qʷarǝqqʷaza
ቈርቋዛ	qʷarǝqqʷāzā
ቈርፋዳ	qʷarǝfāddā
ቈሰለ	qʷassala
ቈሰቈሰ	qʷasaqqʷasa
ቈነሰ	qʷannasa
ቈነነ	qʷannana
ቈነደደ	qʷanaddada
ቈነጐለ	qʷanaggʷala
ቈንቋና	qʷanǝqʷānnā
ቋመጠ	qʷāmmaṭa
ቋቅ	qʷāqq
ቋቅታ	qʷāqqǝttā
ቋቍቻ	qʷāqqʷiččā
ቋያ	qʷāyyā
ቋጥኝ	qʷāṭṭǝññ
ቍልጭ	qʷillǝč̣č̣
ቍራጭ	qʷirrāč̣
ቍርጥ	qʷirrǝṭ
ቍስለ	qʷisǝlla
በለቀጠ	balaqqaṭa
በለተ	ballata
በለኝ	balaññ
በለዘ	ballaza
በለገ	ballaga
በለጠ	ballaṭa
በሉጥ	balluṭ
በሊታ	ballitā
በላ	ballā
በሌለበት	balellabat
በል	ball
በመጀመሪያው	bamaǧammariyāw
በሞላ	bamollā
በረሃማ	barahāmmā
በረረ	barrara
በረቀ	barraqa
በረቀሰ	baraqqasa
በረቃቀሰ	baraqāqqasa
በረበረ	barabbara
በረታ	barattā
በረኛ	barraññā
በረከተ	barakkata
በረኸኛ	baraḵaññā
በረዘ	barraza
በረደ	barrada
በረደኝ	barradaññ
በረገደ	baraggada
በረገገ	baraggaga
በረጋገደ	baragāggada
በራ	barrā
በራረዘ	barārraza
በራዥ	barrāž
በራድ	barrād
በራፍ	barrāf
በር	barr
በርበሬ	barǝbarre
በርካታ	barǝkāttā
በርዳማ	barǝdāmmā
በርጩማ	barǝč̣ummā
በሰለ	bassala
በሰበሰ	basabbasa
በሰፊው	basaffiw
በሳ	bassā
በሳል	bassāl
በስባሳ	basǝbāssā
በሶ	basso
በሸቀ	baššaqa
በሸቀጠ	bašaqqaṭa
በሽተኛ	baššǝtaññā
በሽታ	baššǝtā
በቀለ	baqqala
በቀለኛ	baqalaññā
በቀል	baqqal
በቀስ	baqass
በቀስታ	baqassǝtā
በቀተ	baqqata
በቀደም	baqaddam
በቃ	baqqā
በቃኝ	baqqāñ
በቅበቃ	baqǝbaqqā
በቆሎ	baqqollo
በቈልት	baqqʷalǝt
በቡጢ	babuṭṭi
በተለይ	batalayy
በተረፈ	batarrafa
በተነ	battana
በተጨማሪ	batač̣ammāri
በታተነ	batāttana
በትር	battǝr
በነነ	bannana
በአጋጣሚ	baʾāgāṭṭāmi
በከለ	bakkala
በከተ	bakkata
በኩል	bakkul
በካይ	bakkāy
በወዘ	bawwaza
በዘበዘ	bazabbaza
በዚህ	bazzih
በዚህም	bazihǝmm
በዚያ	bazziyā
በዛ	bazzā
በየሰዓቱ	bayyasaʿātu
በየቀኑ	bayyaqanu
በየተራ	bayyatarā
በየነ	bayyana
በየወቅቱ	bayyawaqǝtu
በየዓመቱ	bayyaʿāmatu
በየደ	bayyada
በየጊዜው	bayyagizew
በየግል	bayyagǝll
በየፊናው	bayyafināw
በያለበት	bayyāllabbat
በያኝ	bayyāññ
በያጅ	bayyāǧ
በደለ	baddala
በደለኛ	badalaññā
በደል	baddal
በደዊ	badawwi
በዱላ	badullā
በዳ	baddā
በዳይ	baddāy
በድጋሚ	badǝggāmi
በጀ	baǧǧa
በጅምር	baǧǝmmǝr
በገነ	baggana
በገዛ	bagazzā
በግላጭ	bagǝllāč̣
በግል	bagǝll
በግምት	bagǝmmǝt
በግድ	bagǝdd
በጐ	baggʷa
በጐነት	baggʷannat
በጠቅላላ	baṭaqǝlāllā
በጠቅላላው	baṭaqǝlāllāw
በጠበጠ	baṭabbaṭa
በጡጫ	baṭuč̣č̣ā
በጥሞና	baṭǝmmonā
በጥያቄ	baṭǝyyāqe
በጥፊ	baṭǝffi
በጭራሽ	bač̣ǝrrāš
በጭካኔ	bač̣ǝkkāne
በጭፍን	bač̣ǝffǝn
ቡላ	bullā
ቡልቅ	bullǝqq
ቡልቅታ	bullǝqǝtā
ቡረቃ	burraqā
ቡራቡሬ	burrāburre
ቡራኬ	burrāke
ቡሬ	burre
ቡሬማ	burremmā
ቡቃያ	buqāyyā
ቡቡ	bubbu
ቡትርፍ	butǝrǝff
ቡችላ	buččǝllā
ቡና	bunnā
ቡናማ	bunnāmmā
ቡናኝ	bunnāñ
ቡን	bunn
ቡንኝ	bunnǝññ
ቡዳነት	budānnat
ቡድስ	buddǝs
ቡድነት	budǝnnat
ቡግ	bugg
ቡፍ	buff
ቢሆንም	bihonǝmm
ቢላዋ	billāwā
ቢላዎ	billāwo
ቢል	bill
ቢልቢላ	bilǝbillā
ቢራቢሮ	birrābirro
ቢዘገይም	bizagayyǝm
ባለሥልጣኖች	bālaśǝlǝṭānočč
ባለሳምንት	bālasāmmǝnǝt
ባለስድስት	bālasǝddǝsǝt
ባለብር	bālabǝrr
ባለእጅ	bālaʾǝǧǧ
ባለጅ	bālaǧǧ
ባለገ	bāllaga
ባለጉዳይ	bālaguddāy
ባለጌነት	bālagennat
ባለጠጋ	bālaṭaggā
ባለጥግ	bālaṭǝgg
ባለፀጋ	bālaḍaggā
ባላ	bāllā
ባላባት	bālābbāt
ባላባትነት	bālābbātǝnnat
ባላንጣነት	bālānǝṭānnat
ባልትና	bālǝtǝnnā
ባልና	bālǝnnā
ባልንጀርነት	bālǝnǝǧarǝnnat
ባልጩት	bālǝč̣utt
ባረቀ	bārraqa
ባረከ	bārraka
ባርማሽላ	bārǝmāšǝllā
ባርነት	bārǝnnat
ባሻ	bāššā
ባባ	bābbā
ባነነ	bānnana
ባንድነት	bānǝdǝnnat
ባኞ	bāñño
ባከነ	bākkana
ባዘቀ	bāzzaqa
ባዘተ	bāzzata
ቤተኛ	betaññā
ቤዛ	bezzā
ብላታ	bǝlāttā
ብላቴና	bǝlāttenā
ብላቴን	bǝlātten
ብላጊ	bǝllāgi
ብልሃተኛ	bǝlǝhātaññā
ብልሹ	bǝlǝššu
ብልት	bǝllǝt
ብልኮ	bǝllǝkko
ብልዝ	bǝllǝzz
ብልግ	bǝllǝgg
ብልግና	bǝlǝgǝnnā
ብልጥግና	bǝlǝṭǝggǝnnā
ብልጫ	bǝllǝč̣ā
ብልጭ	bǝllǝč̣
ብልጭታ	bǝllǝč̣ǝtā
ብልፅግና	bǝlǝḍǝggǝnnā
ብሎት	bǝllot
ብሔረተኛ	bǝḥerataññā
ብሕትውና	bǝḥǝtǝwǝnnā
ብረድስት	bǝraddǝsǝt
ብራ	bǝrrā
ብራቢሮ	bǝrābirro
ብራና	bǝrānnā
ብራኳ	bǝrākkʷā
ብር	bǝrr
ብርሌ	bǝrǝlle
ብርቅስቅስ	bǝrǝqǝsǝqqǝs
ብርኩማ	bǝrǝkummā
ብርካቴ	bǝrǝkkāte
ብርግድ	bǝrǝgǝdd
ብርጭቆ	bǝrǝč̣ǝqqo
ብስባሽ	bǝsǝbbāš
ብስጭትጭት	bǝsǝč̣ǝtǝč̣č̣ǝt
ብቁነት	bǝqqunnat
ብቅ	bǝqq
ብቡ	bǝbbu
ብብት	bǝbbǝt
ብትቶ	bǝtǝtto
ብትቷም	bǝtǝttʷām
ብትን	bǝttǝn
ብቸኛ	bǝččaññā
ብቸኝነት	bǝččaññǝnnat
ብቻ	bǝččā
ብናኝ	bǝnnāññ
ብኩርና	bǝkurǝnnā
ብኩንነት	bǝkunǝnnat
ብካች	bǝkkāč
ብክል	bǝkkǝl
ብክት	bǝkkǝt
ብው	bǝww
ብየዳ	bǝyyaddā
ብያኔ	bǝyyāne
ብዬ	bǝyye
ብይ	bǝyy
ብይን	bǝyyǝn
ብይድ	bǝyyǝd
ብድር	bǝddǝr
ብድግ	bǝdǝgg
ብጥብጥ	bǝṭǝbbǝṭ
ቦሎቄ	bolloqe
ቦረቀ	borraqa
ቦረቦረ	borabbora
ቦራቂ	borrāqi
ቦርቃቃ	borǝqāqqā
ቦቃማ	boqāmmā
ቦተረፈ	botarrafa
ቦታ	bottā
ቦነነ	bonnana
ቦከቦከ	bokabboka
ቦካ	bokkā
ቦዘነ	bozzana
ቦዘንተኛ	bozanǝtaññā
ቦደሰ	boddasa
ቦግ	bogg
ቦግታ	boggǝtā
ቦጨቅ	boč̣č̣aq
ቦጫጨረ	boč̣č̣āč̣ara
ቦጭ	boč̣č̣
ቧገተ	bʷāggata
ተለመ	tallama
ተለመለመ	talamallama
ተለመሰሰ	talamassasa
ተለመነ	talammana
ተለመዘገ	talamazzaga
ተለመደ	talammada
ተለመጠ	talammaṭa
ተለማመነ	talamāmmana
ተለማመደ	talamāmmada
ተለማመጠ	talamāmmaṭa
ተለማኝ	talammāñ
ተለማጅ	talammāǧ
ተለማጭ	talammāč̣
ተለሰነ	talassana
ተለሳለሰ	talasāllasa
ተለቀ	tallaqa
ተለቀለቀ	talaqallaqa
ተለቀመ	talaqqama
ተለቀቀ	tallaqqaqa
ተለቃለቀ	talaqāllaqa
ተለበለበ	talaballaba
ተለበቀ	talabbaqa
ተለበበ	talabbaba
ተለበደ	talabbada
ተለበጠ	talabbaṭa
ተለባቂ	talabbāqi
ተለባበሰ	talabābbasa
ተለተለ	talattala
ተለተመ	talattama
ተለወጠ	talawwaṭa
ተለዋወጠ	talawāwwaṭa
ተለዋጭ	talawwāč̣
ተለየ	talayya
ተለያየ	talayāyya
ተለጠለጠ	talaṭallaṭa
ተለፈፈ	talaffafa
ተለፋለፈ	talafāllafa
ተለፋላፊ	talafāllāfi
ተላ	tallā
ተላለቀ	talāllaqa
ተላለፈ	talāllafa
ተላላኪነት	talālākinnat
ተላላፊ	talāllāfi
ተላመደ	talāmmada
ተላመጠ	talāmmaṭa
ተላቀሰ	talāqqasa
ተላቀቀ	talāqqaqa
ተላከከ	talākkaka
ተላወሰ	talāwassa
ተላፋ	talāffā
ተልከስከሰ	talǝkasǝkkasa
ተልከፈከፈ	talǝkafakkafa
ተልካሳ	talǝkāssā
ተልፈሰፈሰ	talǝfasaffasa
ተመለሰ	tamallasa
ተመለከ	tamallaka
ተመለከተ	tamalakkata
ተመለጠ	tamallaṭa
ተመላለሰ	tamalāllasa
ተመላለጠ	tamalāllaṭa
ተመላሽ	tamallāš
ተመላኪ	tamallāki
ተመመ	tammama
ተመሠረተ	tamaśśarata
ተመሠጠ	tammaśśaṭa
ተመሥጦ	tamaśśǝṭo
ተመረመረ	tamarammara
ተመረረ	tamarrara
ተመረቀ	tamarraqa
ተመረኰዘ	tamarakkʷaza
ተመረዘ	tamarraza
ተመረገ	tamarraga
ተመረጠ	tamarraṭa
ተመራ	tamarrā
ተመራመረ	tamarāmmara
ተመራቂ	tamarrāqi
ተመራጭ	tamarrāč̣
ተመራጭነት	tamarrāč̣ǝnnat
ተመሰለ	tamassala
ተመሰቃቀለ	tamasaqāqqala
ተመሰከረ	tamasakkara
ተመሰገነ	tamasaggana
ተመሰጠ	tamassaṭa
ተመሳቀለ	tamasāqqala
ተመሳከረ	tamasākkara
ተመተመ	tamattama
ተመተረ	tamattara
ተመታ	tamattā
ተመቸ	tamačča
ተመቻቸ	tamačāčča
ተመነ	tammana
ተመነቃቀረ	tamanaqāqqara
ተመነተፈ	tamanattafa
ተመነዘረ	tamanazzara
ተመናቀረ	tamanāqqara
ተመኘ	tamañña
ተመከረ	tamakkara
ተመከተ	tamakkata
ተመካ	tamakkā
ተመካከረ	tamakākkara
ተመዘመዘ	tamazammaza
ተመዘበረ	tamazabbara
ተመዘነ	tamazzana
ተመዘዘ	tamazzaza
ተመዘገበ	tamazaggaba
ተመዛዘነ	tamazāzzana
ተመደበ	tamaddaba
ተመገበ	tamaggaba
ተመጋቢ	tamaggābbi
ተመጠወተ	tamaṭawwata
ተመጻደቀ	tamaṣāddaqa
ተማለደ	tamāllada
ተማመነ	tamāmmana
ተማማ	tamāmmā
ተማረረ	tamārrara
ተማረከ	tamārraka
ተማረዘ	tamārraza
ተማራ	tamārrā
ተማሰለ	tamāssala
ተማታ	tamāttā
ተማከረ	tamākkara
ተማዘዘ	tamāzzaza
ተማገረ	tamāggara
ተማገደ	tamāggada
ተምቦጫቦጨ	tamǝboč̣ābboč̣a
ተምታታ	tamǝtāttā
ተምነሸነሸ	tamǝnašannaša
ተምዘአዘገ	tamǝzaʾāzzaga
ተምዘገዘገ	tamǝzagazzaga
ተሞለጨ	tamollač̣a
ተሞላ	tamollā
ተሞላቀቀ	tamolāqqaqa
ተሞላፈጠ	tamolāffaṭa
ተሞረደ	tamorrada
ተሞሸለቀ	tamošallaqa
ተሞሸረ	tamoššara
ተሞከረ	tamokkara
ተሞከተ	tamokkata
ተሞካከረ	tamokākkara
ተሞክሮ	tamokkǝro
ተሞጀረ	tamoǧǧara
ተሞገሰ	tamoggasa
ተሞጋሽ	tamoggāš
ተሞጋገሰ	tamogāggasa
ተሞጨለፈ	tamoč̣allafa
ተሟላ	tamʷāllā
ተሟሸ	tamʷāšša
ተሟከረ	tamʷākkara
ተሟገተ	tamʷāggata
ተሟጋች	tamʷāggāč
ተሠረሠረ	taśaraśśara
ተሠረገ	taśarraga
ተሠቀሠቀ	taśaqaśśaqa
ተሠወረ	taśawwara
ተሠዋሪ	taśawwāri
ተሠየመ	taśayyama
ተሣሠረ	taśāśśara
ተረማመደ	taramāmmada
ተረሳ	tarassā
ተረሳሳ	tarasāssā
ተረበ	tarraba
ተረበረበ	tarabarraba
ተረበኛ	tarabaññā
ተረባረበ	tarabārraba
ተረተ	tarrata
ተረተረ	tarattara
ተረታ	tarattā
ተረኛ	taraññā
ተረከበ	tarakkaba
ተረከከ	tarakkaka
ተረካቢ	tarakkābi
ተረካከበ	tarakākkaba
ተረኰሰ	tarakkʷasa
ተረዳ	taraddā
ተረዳዳ	taradāddā
ተረገመ	taraggama
ተረገረገ	taragarraga
ተረገዘ	taraggaza
ተረገጠ	taraggaṭa
ተረጋጋ	taragāggā
ተረጐመ	taraggʷama
ተረፈ	tarrafa
ተራመደ	tarāmmada
ተራረመ	tarārrama
ተራረደ	tarārrada
ተራራማ	tarārāmmā
ተራቀቀ	tarāqqaqa
ተራቢ	tarrābi
ተራባ	tarābbā
ተራች	tarrāč
ተራኪ	tarrāki
ተራኰተ	tarākkʷata
ተራገመ	tarāggama
ተራገጠ	tarāggaṭa
ተራገፈ	tarāggafa
ተርመሰመሰ	tarǝmasammasa
ተርመጠመጠ	tarǝmaṭammaṭa
ተርበተበተ	tarǝbatabbata
ተርበደበደ	tarǝbadabbada
ተርከፈከፈ	tarǝkafakkafa
ተርካካ	tarǝkākkā
ተርገበገበ	tarǝgabaggaba
ተሰለለ	tasallala
ተሰለቀ	tasallaqa
ተሰለበ	tasallaba
ተሰለቸ	tasalačča
ተሰለቻቸ	tasalačāčča
ተሰለፈ	tasallafa
ተሰላቸ	tasalāčča
ተሰላፊ	tasallāfi
ተሰሚነት	tasaminnat
ተሰማ	tasammā
ተሰማማ	tasamāmmā
ተሰረረ	tasarrara
ተሰረሰረ	tasarassara
ተሰረቀ	tasarraqa
ተሰረነቀ	tasarannaqa
ተሰረዘ	tasarraza
ተሰረጐደ	tasaraggʷadda
ተሰራረቀ	tasarārraqa
ተሰቀለ	tasaqqala
ተሰቀቀ	tasaqqaqa
ተሰቃየ	tasaqāyya
ተሰቃይ	tasaqqāy
ተሰበረ	tasabbara
ተሰበሰበ	tasabassaba
ተሰበከ	tasabbaka
ተሰባሪ	tasabbāri
ተሰባበረ	tasabābbara
ተሰተረ	tasattara
ተሰነቀ	tasannaqa
ተሰነቀረ	tasanaqqara
ተሰነቀረብኝ	tasanaqqarabǝññ
ተሰነባበተ	tasanabābbata
ተሰነከለ	tasanakkala
ተሰነዳዳ	tasanadāddā
ተሰነገ	tasannaga
ተሰናበተ	tasanābbata
ተሰናከለ	tasanākkala
ተሰናዘረ	tasanāzzara
ተሰናዳ	tasanāddā
ተሰኘ	tasañña
ተሰካ	tasakkā
ተሰወጠ	tasawwaṭa
ተሰየፈ	tasayyafa
ተሰደበ	tasaddaba
ተሰደደ	tasaddada
ተሰዳደበ	tasadāddaba
ተሰገሰገ	tasagassaga
ተሳለመ	tasāllama
ተሳለቀ	tasāllaqa
ተሳረረ	tassārrara
ተሳረቀ	tasārraqa
ተሳሰበ	tasāssaba
ተሳቀቀ	tasāqqaqa
ተሳበበ	tasābbaba
ተሳተፈ	tasāttafa
ተሳከረ	tasākkara
ተሳካ	tasākkā
ተሳደበ	tasāddaba
ተሳደደ	tasāddada
ተስለመለመ	tasǝlamallama
ተስለከለከ	tasǝlakallaka
ተስማማ	tasǝmāmmā
ተስገበገበ	tasǝgabaggaba
ተስፋፋ	tasǝfāffā
ተሸለመ	tašallama
ተሸለቀቀ	tašalaqqaqa
ተሸለተ	tašallata
ተሸላለመ	tašalāllama
ተሸላሚ	tašallāmi
ተሸመቀቀ	tašamaqqaqa
ተሸመተ	tašammata
ተሸማቀቀ	tašamāqqaqa
ተሸረሸረ	tašaraššara
ተሸረከተ	tašarakkata
ተሸረካከተ	tašarakākkata
ተሸረፈ	tašarrafa
ተሸራረፈ	tašarārrafa
ተሸራፊ	tašarrāfi
ተሸሸገ	tašaššaga
ተሸቀበ	tašaqqaba
ተሸበረ	tašabbara
ተሸበበ	tašabbaba
ተሸነሸነ	tašanaššana
ተሸነተረ	tašanattara
ተሸናነፈ	tašanānnafa
ተሸናፊ	tašannāfi
ተሸኘ	tašañña
ተሸከመ	tašakkama
ተሸከሸከ	tašakaššaka
ተሸካሚ	tašakkāmi
ተሸካከመ	tašakākkama
ተሸጋሸገ	taššagāššaga
ተሸጋገረ	tašagāggara
ተሸጐረ	tašaggʷara
ተሸጐጠ	tašaggʷaṭa
ተሸፈነ	tašaffana
ተሸፋፈነ	tašafāffana
ተሹለከለከ	tašulakallaka
ተሻማ	tašāmmā
ተሻረከ	tašārraka
ተሻሸ	tašāšša
ተሻኰተ	tašākkʷata
ተሻገረ	tašāggara
ተሽመደመደ	tašǝmadammada
ተሽቀዳደመ	tašǝqadāddama
ተሽቆጠቆጠ	tašǝqoṭaqqoṭa
ተሽበለበለ	tašǝbalabbala
ተሽከረከረ	tašǝkarakkara
ተሽኮረመመ	tašǝkorammama
ተቀለሰ	taqallasa
ተቀለበ	taqallaba
ተቀለበሰ	taqalabbasa
ተቀላ	taqallā
ተቀላለደ	taqalāllada
ተቀላቀለ	taqalāqqala
ተቀላቢ	taqallābi
ተቀመለ	taqammala
ተቀመመ	taqammama
ተቀመሰ	taqammasa
ተቀመጠ	taqammaṭa
ተቀማ	taqammā
ተቀማጭ	taqammāč̣
ተቀረቀረ	taqaraqqara
ተቀረቀበ	taqaraqqaba
ተቀረደደ	taqaraddada
ተቀረጠ	taqarraṭa
ተቀረጸ	taqarraṣa
ተቀረፈ	taqarrafa
ተቀራረፈ	taqarārrafa
ተቀሰመ	taqassama
ተቀሰረ	taqassara
ተቀሰቀሰ	taqasaqqasa
ተቀሰተ	taqassata
ተቀቀለ	taqaqqala
ተቀበለ	taqabbala
ተቀበረ	taqabbara
ተቀበቀበ	taqabaqqaba
ተቀበተተ	taqabattata
ተቀባ	taqabbā
ተቀባበለ	taqabābbala
ተቀባይ	taqabbāy
ተቀተረ	taqattara
ተቀነሰ	taqannasa
ተቀነባበረ	taqqanabābbara
ተቀነፈ	taqannafa
ተቀናሽ	taqannāš
ተቀናቀነ	taqanāqqana
ተቀናቃኝ	taqanāqāññ
ተቀናበረ	taqanābbara
ተቀናነሰ	taqanānnasa
ተቀናና	taqannānā
ተቀኘ	taqañña
ተቀዘፈ	taqazzafa
ተቀዛቀዘ	taqazāqqaza
ተቀየመ	taqayyama
ተቀየሠ	taqayyaśa
ተቀየረ	taqayyara
ተቀየደ	taqayyada
ተቀየጠ	taqayyaṭa
ተቀደመ	taqaddama
ተቀደሰ	taqaddasa
ተቀደደ	taqaddada
ተቀዳ	taqaddā
ተቀዳሚ	taqaddāmi
ተቀዳደመ	taqadāddama
ተቀዳደደ	taqadāddada
ተቀዳጀ	taqadāǧǧa
ተቀጠቀጠ	taqaṭaqqaṭa
ተቀፈረረ	taqafarrara
ተቀፈቀፈ	taqafaqqafa
ተቀፈደደ	taqafaddada
ተቀፈፈ	taqaffafa
ተቁለጨለጨ	taqulač̣allač̣č̣a
ተቁነጠነጠ	taqunaṭannaṭa
ተቃለለ	taqāllala
ተቃለደ	taqāllada
ተቃመሰ	taqāmmasa
ተቃማ	taqāmmā
ተቃረመ	taqārrama
ተቃረበ	taqārraba
ተቃረነ	taqārrana
ተቃቀፈ	taqāqqafa
ተቃባ	taqābbā
ተቃና	taqānnā
ተቃኘ	taqāñña
ተቃወመ	taqāwwama
ተቃወሰ	taqāwwasa
ተቅለሰለሰ	taqǝlasallasa
ተቅለበለበ	taqǝlaballaba
ተቅለጠለጠ	taqǝlaṭallaṭa
ተቅበዘበዘ	taqǝbazabbaza
ተቅነዘነዘ	taqǝnazannaza
ተቆለለ	taqollala
ተቆላ	taqollā
ተቆረሰ	taqorrasa
ተቆረቆረ	taqoraqqora
ተቆረጠ	taqorraṭa
ተቆራረሰ	taqorārrasa
ተቆራኘ	taqorāñña
ተቆፈረ	taqoffara
ተቈለመመ	taqʷalammama
ተቈለፈ	taqʷallafa
ተቈረቈረ	taqʷaraqqʷara
ተቈረጠ	taqʷarraṭa
ተቈራ	taqʷarrā
ተቈራመደ	taqʷarāmmada
ተቈራረጠ	taqʷarārraṭa
ተቈራቈሰ	taqʷarāqqʷasa
ተቈራጭ	taqʷarrāč̣
ተቈሰቈሰ	taqʷasaqqʷasa
ተቈነነ	taqʷannana
ተቈነደደ	taqʷanaddada
ተቈናኝ	taqʷannāññ
ተቋለፈ	taqʷāllafa
ተቋላ	taqʷāllā
ተቋረጠ	taqʷārraṭa
ተቋራጭ	taqʷārrāč̣
ተበለቀጠ	tabalaqqaṭa
ተበለጠ	taballaṭa
ተበላ	taballā
ተበላለጠ	tabalāllaṭa
ተበላሸ	tabalāšša
ተበላቀጠ	tabalāqqaṭa
ተበረቀሰ	tabaraqqasa
ተበረቃቀሰ	tabaraqāqqasa
ተበረበረ	tabarabbara
ተበረዘ	tabarraza
ተበረጋገደ	tabaragāggada
ተበራከተ	tabarākkata
ተበሳ	tabassā
ተበሳሳ	tabasāssā
ተበሳበሰ	tabasābbasa
ተበሻቀጠ	tabašāqqaṭa
ተበቀለ	tabaqqala
ተበቃይ	tabaqqāy
ተበተበ	tabattaba
ተበታተነ	tabatāttana
ተበከለ	tabakkala
ተበካከለ	tabakākkala
ተበዘበዘ	tabazabbaza
ተበየነ	tabayyana
ተበየደ	tabayyada
ተበያጅ	tabayyāǧ
ተበደለ	tabaddala
ተበደረ	tabaddara
ተበዳ	tabaddā
ተበዳሪ	tabaddāri
ተበዳይ	tabaddāy
ተበዳደረ	tabadāddara
ተበጀ	tabaǧǧa
ተበጃጀ	tabaǧāǧǧa
ተበገረ	tabaggara
ተበጠበጠ	tabaṭabbaṭa
ተበጣበጠ	tabaṭābbaṭa
ተባ	tabbā
ተባላ	tabāllā
ተባረረ	tabārrara
ተባረከ	tabārraka
ተባረደ	tabārrada
ተባሸቀ	tabāššaqa
ተባቃ	tabāqqā
ተባበረ	tabābbara
ተባዛ	tabāzzā
ተብለጠለጠ	tabǝlaṭallaṭa
ተብለጨለጨ	tabǝlač̣allač̣a
ተብላላ	tabǝlāllā
ተብረቀረቀ	tabǝraqarraqa
ተብረከረከ	tabǝrakarraka
ተብራራ	tabǝrārrā
ተብሰለሰለ	tabǝsalassala
ተብታባ	tabǝtābbā
ተብከነከነ	tabǝkanakkana
ተቦረቦረ	taborabbora
ተቦተረፈ	tabotarrafa
ተቦካ	tabokkā
ተቦደሰ	taboddasa
ተቧደነ	tabʷāddana
ተተለተለ	tatalattala
ተተመተመ	tatamattama
ተተመነ	tatammana
ተተረማመሰ	tataramāmmasa
ተተረተረ	tatarattara
ተተረከ	tatarraka
ተተረከከ	tatarakkaka
ተተረኰሰ	tatarakkʷasa
ተተረጐመ	tataraggʷama
ተተራመሰ	tatarāmmasa
ተተበተበ	tatabattaba
ተተቸ	tatačča
ተተነተነ	tatanattana
ተተናኮለ	tatanākkola
ተተከለ	tatakkala
ተተካ	tatakkā
ተተካይ	tatakkāy
ተተኰሰ	tatakkʷasa
ተታለለ	tatāllala
ተታኰሰ	tatākkʷasa
ተታፋ	tatāffā
ተትረፈረፈ	tatǝrafarrafa
ተቸ	tačča
ተቸለሰ	tačallasa
ተቸበቸበ	tačabaččaba
ተቸነከረ	tačanakkara
ተቸከለ	tačakkala
ተቸገረ	tačaggara
ተቸፈቸፈ	tačafaččafa
ተቸፈገ	tačaffaga
ተቺ	tačči
ተቻኰለ	tačākkʷala
ተነሣ	tanaśśā
ተነሣሣ	tanaśśāśśā
ተነሰነሰ	tanasannasa
ተነሳ	tannasā
ተነቀለ	tanaqqala
ተነቀሰ	tanaqqasa
ተነቀነቀ	tanaqannaqa
ተነቀፈ	tanaqqafa
ተነቃቀፈ	tanaqāqqafa
ተነቃቃ	tanaqāqqā
ተነቃነቀ	tanaqānnaqa
ተነበበ	tanabbaba
ተነበየ	tanabbaya
ተነባበረ	tanabābbara
ተነባቢ	tanabbābi
ተነተነ	tanattana
ተነተገ	tanattaga
ተነታረከ	tanatārraka
ተነነ	tannana
ተነከረ	tanakkara
ተነከሰ	tanakkasa
ተነካ	tanakkā
ተነካከሰ	tanakākkasa
ተነካካ	tanakākkā
ተነኰሰ	tanakkʷasa
ተነኰተ	tanakkʷata
ተነዘነዘ	tanazannaza
ተነዛ	tanazzā
ተነዛነዘ	tanazānnaza
ተነደፈ	tanaddafa
ተነዳ	tanaddā
ተነዳደፈ	tanadāddafa
ተነገተ	tanaggata
ተነጋገረ	tanagāggara
ተነጋገደ	tanagāggada
ተነጐረ	tanaggʷara
ተነጫነጨ	tanač̣ānnač̣a
ተነፈሰ	tanaffasa
ተነፈገ	tanaffaga
ተነፋ	tanaffā
ተነፋረቀ	tanafārraqa
ተነፋነፈ	tanafānnafa
ተነፋፈሰ	tanafāffasa
ተነፋፈቀ	tanafāffaqa
ተነፋፈገ	tanafāffaga
ተነፋፋ	tanafāffā
ተናበበ	tanābbaba
ተናባቢ	tanābbābi
ተናነቀ	tanānnaqa
ተናነቀው	tanānnaqaw
ተናኘ	tanāñña
ተናከሰ	tanākkasa
ተናዘዘ	tanāzzaza
ተናደደ	tanāddada
ተናገሠ	tanāggaśa
ተናገረ	tanāggara
ተናጋ	tanāggā
ተናፈሰ	tanāffasa
ተናፈቀ	tanāffaqa
ተናፈጠ	tanāffaṭa
ተናፋ	tanāffā
ተን	tann
ተንሠቀሠቀ	tanǝśaqaśśaqa
ተንሰቀሰቀ	tanǝsaqassaqa
ተንሰፈሰፈ	tanǝsafassafa
ተንሳፈፈ	tanǝsāffafa
ተንሶለሶለ	tanǝsolassola
ተንሸረሸረ	tanǝšaraššara
ተንሸራተተ	tanǝšarāttata
ተንሸዋረረ	tanǝšawārrara
ተንሻተተ	tanǝšāttata
ተንቀለቀለ	tanǝqalaqqala
ተንቀረበበ	tanǝqarabbaba
ተንቀረፈፈ	tanǝqaraffaffa
ተንቀሳቀሰ	tanǝqasāqqasa
ተንቀበቀበ	tanǝqabaqqaba
ተንቀበደደ	tanǝqabaddada
ተንቀባረረ	tanǝqabārrara
ተንቀባደደ	tanǝqabāddada
ተንቀዋለለ	tanǝqawāllala
ተንቀዠቀዠ	tanǝqažaqqaža
ተንቀጠቀጠ	tanǝqaṭaqqaṭa
ተንቀፈደደ	tanǝqafaddada
ተንበለበለ	tanǝbalabbala
ተንበረከከ	tanǝbarakkaka
ተንበሸበሸ	tanǝbaššabbaša
ተንቦለቦለ	tanǝbolabbola
ተንቦረቀቀ	tanǝboraqqaqa
ተንቦራቀቀ	tanǝborāqqaqa
ተንቦገቦገ	tanǝbogabboga
ተንቦጨቦጨ	tanǝboč̣abboč̣a
ተንቦጫበጨ	tanǝboč̣ābbač̣a
ተንቦጫቦጨ	tanǝboč̣ābboč̣a
ተንተረከከ	tanǝtarakkaka
ተንተባተበ	tanǝtabāttaba
ተንተከተከ	tanǝtakattaka
ተንቶሰቶሰ	tanǝtosattosa
ተንቻቻ	tanǝčāččā
ተንከላወሰ	tanǝkalāwwasa
ተንከረፈፈ	tanǝkaraffafa
ተንከራተተ	tanǝkarāttata
ተንከባለለ	tanǝkabāllala
ተንከባከበ	tanǝkabākkaba
ተንከተከተ	tanǝkatakkata
ተንከታከተ	tanǝkatākkata
ተንከዋተተ	tanǝkawāttata
ተንከፈረረ	tanǝkafarrara
ተንኮለኛ	tanǝkolaññā
ተንኳኳ	tanǝkʷākkʷā
ተንኳፈፈ	tanǝkʷāffafa
ተንዘረፈጠ	tanǝzaraffaṭa
ተንዘረፈፈ	tanǝzaraffafa
ተንዘራፈጠ	tanǝzarāffaṭa
ተንዘፈዘፈ	tanǝzaffazafa
ተንዛዛ	tanǝzāzzā
ተንዠረገገ	tanǝžaraggaga
ተንዠቀዠቀ	tanǝžaqažžaqa
ተንዠባረረ	tanǝžabārrara
ተንዣበበ	tanǝžābbaba
ተንደላቀቀ	tanǝdalāqqaqa
ተንደረበበ	tanǝdarabbaba
ተንደረከከ	tanǝdarakkaka
ተንደረደረ	tanǝdaraddara
ተንደቀደቀ	tanǝdaqaddaqa
ተንደበደበ	tanǝdabaddaba
ተንደባለለ	tanǝdabāllala
ተንደባደበ	tanǝdabāddaba
ተንደከደ	tanǝdakkada
ተንደፋደፈ	tanǝdafāddafa
ተንዶለዶለ	tanǝdoladdola
ተንጀላጀለ	tanǝǧalāǧǧala
ተንጀረገገ	tanǝǧaraggaga
ተንገላታ	tanǝgalāttā
ተንገላወደ	tanǝgalāwwada
ተንገላጀጀ	tanǝgalāǧǧaǧa
ተንገረገበ	tanǝgaraggaba
ተንገሸገሸ	tanǝgašaggaša
ተንገበገበ	tanǝgabaggaba
ተንገዋለለ	tanǝgawāllala
ተንገደገደ	tanǝgadaggada
ተንገዳገደ	tanǝgadāggada
ተንገጫገጨ	tanǝgač̣āggač̣a
ተንገፈገፈ	tanǝgafaggafa
ተንጋለለ	tanǝgāllala
ተንጋደደ	tanǝgāddada
ተንጋጋ	tanǝgāggā
ተንጎራደደ	tanǝgorāddada
ተንጐራደደ	tanǝgʷarāddada
ተንጓለለ	tanǝgʷāllala
ተንጓደደ	tanǝgʷāddada
ተንጠረበበ	tanǝṭarabbaba
ተንጠረዘዘ	tanǝṭarazzaza
ተንጠራራ	tanǝṭarrārā
ተንጠራወዘ	tanǝṭarāwwaza
ተንጣለለ	tanǝṭāllala
ተንጸባረቀ	tanǝṣabārraqa
ተንፈላሰሰ	tanǝfalāssasa
ተንፈራገጠ	tanǝfarāggaṭa
ተንፈራፈረ	tanǝfarāffara
ተንፈስ	tanǝfass
ተንፈቀፈቀ	tanǝfaqaffaqa
ተንፋነፈ	tanǝfānnafa
ተንፏቀቀ	tanǝfʷāqqaqa
ተንፏፏ	tanǝfʷāffʷā
ተኛ	taññā
ተኛት	taññāt
ተኝቶ	taññǝto
ተኝቷል	taññǝtʷāl
ተአምረኛ	taʾāmmǝraññā
ተአምራታዊ	taʾāmmǝrātāwi
ተአምር	taʾāmmǝr
ተከለ	takkala
ተከለለ	takallala
ተከለሰ	takallasa
ተከለበሰ	takalabbasa
ተከለከለ	takalakkala
ተከላከለ	takalākkala
ተከመቻቸ	takamačāčča
ተከመከመ	takamakkama
ተከማቸ	takammāča
ተከሠተ	takaśśata
ተከረበተ	takarabbata
ተከረተፈ	takarattafa
ተከረከመ	takarakkama
ተከራከረ	takarākkara
ተከራየ	takarāyya
ተከሰሰ	takassasa
ተከሰከሰ	takasakkasa
ተከሳሽ	takassāš
ተከሳከሰ	takasākkasa
ተከበረ	takabbara
ተከበበ	takabbaba
ተከባበረ	takabābbara
ተከተለ	takattala
ተከተለበ	takatallaba
ተከተል	takattal
ተከተረ	takattara
ተከተበ	takattaba
ተከተተ	takattata
ተከተከ	takattaka
ተከተከተ	takatakkata
ተከተፈ	takattafa
ተከታተለ	takatāttala
ተከታከተ	takatākkata
ተከታይ	takattāy
ተከነ	takkana
ተከናነበ	takanānnaba
ተከናወነ	takanāwwana
ተከካ	takakkā
ተከዘ	takkaza
ተከደነ	takaddana
ተከፈለ	takaffala
ተከፈተ	takaffata
ተከፈነ	takaffana
ተከፈከፈ	takafakkafa
ተከፈፈ	takaffafa
ተከፋ	takaffā
ተከፋች	takaffāč
ተከፋይ	takaffāy
ተከፋፈለ	takafāffala
ተከፋፈተ	takafāffata
ተኩረፈረፈ	takurafarrafa
ተኩራራ	takurārrā
ተኩስ	takkus
ተኩነሰነሰ	takunasannasa
ተካ	takkā
ተካለለ	takāllala
ተካለሰ	takāllasa
ተካረረ	takārrara
ተካሰሰ	takāssasa
ተካበደ	takābbada
ተካከለ	takkākkala
ተካዥ	takkāž
ተካፈለ	takāffala
ተካፈተ	takāffata
ተክለፈለፈ	takǝlafallafa
ተክበሰበሰ	takǝbasabbasa
ተኮላሸ	takolāšša
ተኮማተረ	takomāttara
ተኮረተመ	takorattama
ተኮረጀ	takorraǧa
ተኮረፈ	takorrafa
ተኮራመተ	takorāmmata
ተኮራፊ	takorrāfi
ተኮሳተረ	takosāttara
ተኮተኮተ	takotakkota
ተኮፈሰ	takoffasa
ተኮፋሽ	takoffāš
ተኰላተፈ	takʷalāttafa
ተኰረተመ	takʷarattama
ተኰረታተመ	takʷaratāttama
ተኰሰ	takkʷasa
ተኰሳተረ	takʷasāttara
ተኰነነ	takʷannana
ተኳረፈ	takʷārrafa
ተኳሽ	takkʷāš
ተኳሽነት	takʷāšǝnnat
ተኳኰሰ	takʷākkʷasa
ተወለደ	tawallada
ተወለጋገደ	tawalagāggada
ተወላመመ	tawalāmmama
ተወላከፈ	tawalākkafa
ተወላጅ	tawallāǧ
ተወላገደ	tawalāggada
ተወረረ	tawarrara
ተወረሰ	tawarrasa
ተወረወረ	tawarawwara
ተወረደ	tawarrada
ተወራ	tawarrā
ተወራረሰ	tawarārrasa
ተወራረደ	tawarārrada
ተወራሽ	tawarrāš
ተወራወረ	tawarāwwara
ተወራጅ	tawarrāǧ
ተወሰነ	tawassana
ተወሰወሰ	tawasawwasa
ተወሰደ	tawassada
ተወሳ	tawassā
ተወቀሰ	tawaqqasa
ተወቀጠ	tawaqqaṭa
ተወቃ	tawaqqā
ተወቃቀሰ	tawaqāqqasa
ተወተፈ	tawattafa
ተወነባበደ	tawanabābbada
ተወነጃጀለ	tawanaǧāǧǧala
ተወናበደ	tawanābbada
ተወናፈለ	tawanāffala
ተወንጀለ	tawanǝǧǧala
ተወከለ	tawakkala
ተወካይ	tawakkāy
ተወዘፈ	tawazzafa
ተወዛወዘ	tawazāwwaza
ተወደደ	tawaddada
ተወዳደረ	tawadāddara
ተወዳጀ	tawadāǧǧa
ተወዳጅ	tawaddāǧ
ተወገረ	tawaggara
ተወገደ	tawaggada
ተወጋ	tawaggā
ተወጫመደ	tawač̣āmmada
ተዋለደ	tawāllada
ተዋልቀ	tawāllǝqa
ተዋረደ	tawārrada
ተዋሰነ	tawāssana
ተዋቀረ	tawāqqara
ተዋቀሰ	tawāqqasa
ተዋከበ	tawākkaba
ተዋወቀ	tawāwwaqa
ተዋደቀ	tawāddaqa
ተዋደደ	tawāddada
ተዋጋ	tawāggā
ተውለበለበ	tawǝlaballaba
ተውረገረገ	tawǝragarraga
ተውተረተረ	tawǝtarattara
ተውተበተበ	tawǝtabattaba
ተውተፈተፈ	tawǝtafattafa
ተዘለለ	tazallala
ተዘለቀ	tazallaqa
ተዘመዘመ	tazamazzama
ተዘረረ	tazarrara
ተዘረነቀ	tazarranaqa
ተዘረከተ	tazarakkata
ተዘረካከተ	tazarakākkata
ተዘረዘረ	tazarazzara
ተዘረገፈ	tazaraggafa
ተዘረጋ	tazaraggā
ተዘረፈ	tazarrafa
ተዘረፈጠ	tazaraffaṭa
ተዘራ	tazarrā
ተዘራረፈ	tazarārrafa
ተዘቀዘቀ	tazaqazzaqa
ተዘበራረቀ	tazabarārraqa
ተዘባረቀ	tazabārraqa
ተዘባበተ	tazabābbata
ተዘባነነ	tazabānnana
ተዘነቀ	tazannaqa
ተዘነተረ	tazanattara
ተዘነጋ	tazanaggā
ተዘነጋጋ	tazanagāggā
ተዘናከተ	tazanākkata
ተዘናጋ	tazanāggā
ተዘናፈለ	tazanāffala
ተዘከረ	tazakkara
ተዘከዘከ	tazakazzaka
ተዘካሪ	tazakkāri
ተዘወተረ	tazawattara
ተዘዋወረ	tazawāwwara
ተዘያየረ	tazayāyyara
ተዘገረረ	tazagarrara
ተዘገጃጀ	tazagaǧāǧǧa
ተዘጋ	tazzaggā
ተዘጋጀ	tazagāǧǧa
ተዘፈቀ	tazaffaqa
ተዘፈዘፈ	tazafazzafa
ተዛለለ	tazāllala
ተዛለፈ	tazāllafa
ተዛመተ	tazāmmata
ተዛመደ	tazāmmada
ተዛባ	tazzābbā
ተዛነቀ	tazānnaqa
ተዛነፈ	tazānnafa
ተዛና	tazānnā
ተዛናና	tazānānnā
ተዛወረ	tazāwwara
ተዛዘበ	tazāzzaba
ተዛዘነ	tazāzzana
ተዛፈቀ	tazāffaqa
ተዝለገለገ	tazǝlagallaga
ተዝለፈለፈ	tazǝlafallafa
ተዝረበረበ	tazǝrabarraba
ተዝረከረከ	tazǝrakarraka
ተዝረጠረጠ	tazǝraṭarraṭa
ተዝረፈረፈ	tazǝrafarrafa
ተዝናና	tazǝnānnā
ተዝጎረጎረ	tazǝgoraggora
ተዝጐረጐረ	tazǝgʷaraggʷara
ተዠለጠ	tažallaṭa
ተዥጎረገረ	tažǝgoraggara
ተዥጎደጎደ	tažǝgodaggoda
ተያየ	tayāyya
ተደለለ	tadallala
ተደለቀ	taddallaqa
ተደለደለ	tadaladdala
ተደላደለ	tadalāddala
ተደመመ	tadammama
ተደመረ	tadammara
ተደመሰሰ	tadamassasa
ተደመደመ	tadamaddama
ተደመጠ	tadammaṭa
ተደማመጠ	tadamāmmaṭa
ተደማሪ	tadammāri
ተደማጭ	tadammāč̣
ተደረሰ	tadarrasa
ተደረሰመ	tadarassama
ተደረበ	tadarraba
ተደረተ	tadarrata
ተደረደረ	tadaraddara
ተደረገ	tadarraga
ተደረገመ	tadaraggama
ተደራረበ	tadarārraba
ተደራረገ	tadarārraga
ተደራቢ	tadarrābi
ተደራደረ	tadarāddara
ተደራጀ	tadarāǧǧa
ተደራጊ	tadarrāgi
ተደሰተ	tadassata
ተደሳች	tadassāč
ተደቀነ	tadaqqana
ተደቆሰ	tadaqqosa
ተደበለለ	tadaballala
ተደበለቀ	tadaballaqa
ተደበላለቀ	tadabalāllaqa
ተደበቀ	tadabbaqa
ተደበደበ	tadabaddaba
ተደባለቀ	tadabāllaqa
ተደባበቀ	tadabābbaqa
ተደባደበ	tadabāddaba
ተደነቀ	tadannaqa
ተደነቀረ	tadanaqqara
ተደነቀረብኝ	tadanaqqarabǝññ
ተደናቀፈ	tadanāqqafa
ተደናቂ	tadannāqi
ተደናበረ	tadanābbara
ተደናበዘ	tadanābbaza
ተደናገረ	tadannāggara
ተደናገጠ	tadanāggaṭa
ተደከመ	tadakkama
ተደወለ	tadawwala
ተደገመ	tadaggama
ተደገሰ	tadaggasa
ተደገነ	tadaggana
ተደገፈ	tadaggafa
ተደጋገመ	tadagāggama
ተደጋገፈ	tadagāggafa
ተደጎመ	tadaggoma
ተደፈረ	tadaffara
ተደፈቀ	tadaffaqa
ተደፈነ	tadaffana
ተደፋ	tadaffā
ተደፋፈረ	tadafāffara
ተዳመረ	tadāmmara
ተዳመጠ	tadāmmaṭa
ተዳረሰ	tadārrasa
ተዳረቀ	tadārraqa
ተዳረገ	tadārraga
ተዳራ	tadārrā
ተዳቀለ	tadāqqala
ተዳቀቀ	tadāqqaqa
ተዳበለ	tadābbala
ተዳነቀ	tadānnaqa
ተዳኘ	tadāñña
ተዳከመ	tadākkama
ተዳደረ	tadāddara
ተዳፈረ	tadāffara
ተዳፈቀ	tadāffaqa
ተዳፈነ	tadāffana
ተዳፋ	tadāffā
ተድረቀረቀ	tadǝraqarraqa
ተድበለበለ	tadǝbalabbala
ተድበሰበሰ	tadǝbasabbasa
ተድቦለቦለ	tadǝbolabbola
ተድፈነፈነ	tadǝfanaffana
ተጀመረ	taǧammara
ተጀነነ	taǧannana
ተገለለ	tagallala
ተገለማመጠ	tagalamāmmaṭa
ተገለበጠ	tagalabbaṭa
ተገለባበጠ	tagalabābbaṭa
ተገለጠ	tagallaṭa
ተገለፈፈ	tagalaffafa
ተገላመጠ	tagalāmmaṭa
ተገላበጠ	tagalābbaṭa
ተገላገለ	tagalāggala
ተገመሰ	tagammasa
ተገመተ	tagammata
ተገመደለ	tagamaddala
ተገመገመ	tagamaggama
ተገረመ	tagarrama
ተገረዘ	tagarraza
ተገረፈ	tagarrafa
ተገራ	tagarrā
ተገሰሰ	tagassasa
ተገሸለጠ	tagašallaṭa
ተገሸረ	tagaššara
ተገበያየ	tagabayāyya
ተገቢ	tagabbi
ተገባደደ	tagabāddada
ተገታ	tagattā
ተገታተረ	tagatāttara
ተገነዘበ	taganazzaba
ተገነጣጠለ	taganaṭāṭṭala
ተገናኘ	taganāñña
ተገናዘበ	taganāzzaba
ተገኘ	tagañña
ተገዘተ	tagazzata
ተገዛ	tagazzā
ተገዛዛ	tagazzāzzā
ተገደለ	tagaddala
ተገደደ	tagaddada
ተገፈፈ	tagaffafa
ተገፋ	tagaffā
ተገፋተረ	tagafāttara
ተገፋፋ	tagafāffā
ተጉመጠመጠ	tagumaṭammaṭa
ተጉረበረበ	tagurabarraba
ተጋ	taggā
ተጋለጠ	tagāllaṭa
ተጋመሰ	tagāmmasa
ተጋማ	tagāmmā
ተጋረደ	tagārrada
ተጋረጠ	tagārraṭa
ተጋራ	tagārrā
ተጋበዘ	tagābbaza
ተጋባ	tagābbā
ተጋተረ	tagāttara
ተጋነነ	tagānnana
ተጋዘ	tagāzza
ተጋዛ	tagāzzā
ተጋደለ	tagāddala
ተጋገረ	tagāggara
ተጋገዘ	tagāggaza
ተጋፈጠ	tagāffaṭa
ተጋፋ	tagāffā
ተግ	tagg
ተግማማ	tagǝmāmmā
ተግባባ	tagǝbābbā
ተግተለተለ	tagǝtalattala
ተግተረተረ	tagǝtarattara
ተግደረደረ	tagǝdaraddara
ተግፈለፈለ	tagǝfalaffala
ተጎማለለ	tagomāllala
ተጎማዘዘ	tagomāzzaza
ተጎራበተ	tagorābbata
ተጎዳ	tagoddā
ተጎዳኘ	tagodāñña
ተጐለተ	tagʷallata
ተጐላመመ	tagʷalāmmama
ተጐላደፈ	tagʷalāddafa
ተጐሳቈለ	tagʷasāqqʷala
ተጐተተ	tagʷattata
ተጐታች	tagʷattāč
ተጐነጐነ	tagʷanaggʷana
ተጐናዘለ	tagʷanāzzala
ተጓተተ	tagʷāttata
ተጓደለ	tagʷāddala
ተጓደደ	tagʷāddada
ተጕመጠመጠ	tagʷǝmaṭammaṭa
ተጠለለ	taṭallala
ተጠለፈ	taṭallafa
ተጠላ	taṭallā
ተጠላላፊ	taṭalāllāfi
ተጠመቀ	taṭammaqa
ተጠመዘዘ	taṭamazzaza
ተጠመደ	taṭammada
ተጠማ	taṭammā
ተጠማዘዘ	taṭamāzzaza
ተጠረመሰ	taṭarammasa
ተጠረቃቀመ	taṭaraqāqqama
ተጠራ	taṭarrā
ተጠራቀመ	taṭarāqqama
ተጠቀመ	taṭaqqama
ተጠቃ	taṭaqqā
ተጠቃለለ	taṭaqāllala
ተጠቃሚ	taṭaqqāmi
ተጠቃሽ	taṭaqqāš
ተጠቃቀሰ	taṭaqāqqasa
ተጠቆመ	taṭaqqoma
ተጠበቀ	taṭabbaqa
ተጠበበ	taṭabbaba
ተጠባበቀ	taṭabābbaqa
ተጠነቀቀ	taṭanaqqaqa
ተጠና	taṭannā
ተጠናቀቀ	taṭanāqqaqa
ተጠናቆለ	taṭanāqqola
ተጠናበሰ	taṭanābbasa
ተጠናከረ	taṭanākkara
ተጠናወተ	taṭanāwwata
ተጠየቀ	taṭayyaqa
ተጠየቅ	taṭayyaq
ተጠየፈ	taṭayyafa
ተጠያቂ	taṭayyāqi
ተጠያየቀ	taṭayāyyaqa
ተጠያፊ	taṭayyāfi
ተጠጋ	taṭaggā
ተጠጋገነ	taṭagāggana
ተጠጋጋ	taṭagāggā
ተጠፋፋ	taṭafāffā
ተጣላ	taṭṭālā
ተጣመመ	taṭāmmama
ተጣመረ	taṭāmmara
ተጣመደ	taṭāmmada
ተጣረረ	taṭārrara
ተጣራ	taṭārrā
ተጣበቀ	taṭābbaqa
ተጣበበ	taṭābbaba
ተጣባ	taṭābbā
ተጣደፈ	taṭāddafa
ተጣዳ	taṭāddā
ተጣፋ	taṭāffā
ተጥለቀለቀ	taṭǝlaqallaqa
ተጥመለመለ	taṭǝmalammala
ተጥመሰመሰ	taṭǝmasammasa
ተጥመዘመዘ	taṭǝmazammaza
ተጥናና	taṭǝnānnā
ተጧጧፈ	taṭʷāṭṭʷāfa
ተጨለጠ	tač̣allaṭa
ተጨመላለቀ	tač̣amalāllaqa
ተጨመረ	tač̣č̣ammara
ተጨመቀ	tač̣ammaqa
ተጨመታተረ	tač̣amatāttara
ተጨማለቀ	tač̣amāllaqa
ተጨማሪ	tač̣ammāri
ተጨማተረ	tač̣amāttara
ተጨማደደ	tač̣amāddada
ተጨረሰ	tač̣č̣arrasa
ተጨራመመ	tač̣arāmmama
ተጨራመተ	tač̣arāmmata
ተጨራመደ	tač̣arāmmada
ተጨቆነ	tač̣aqqona
ተጨቋኝ	tač̣aqqʷāñ
ተጨበተ	tač̣abbata
ተጨበጨበለት	tač̣abač̣č̣aballat
ተጨባበጠ	tač̣abābbaṭa
ተጨባበጡ	tač̣abābbaṭu
ተጨባጭ	tač̣abbāč̣
ተጨነቀ	tač̣annaqa
ተጨናነቀ	tač̣anānnaqa
ተጨናገፈ	tač̣anāggafa
ተጨናጎለ	tač̣anāggola
ተጨካከነ	tač̣akākkana
ተጨዋወተ	tač̣awāwwata
ተጨፈለቀ	tač̣afallaqa
ተጨፋጨፈ	tač̣afāč̣č̣affa
ተጨፋፈቀ	tač̣afāffaqa
ተጫማ	tač̣āmmā
ተጫረሰ	tač̣č̣ārrasa
ተጫወተ	tač̣āwwata
ተጫወተበት	tač̣āwwatabbat
ተጫፈረ	tač̣āffara
ተጭበረበረ	tač̣ǝbarabbara
ተጸለየ	taṣallaya
ተጸናወተ	taṣanāwwata
ተጸየፈ	taṣayyafa
ተጸዳዳ	taṣadāddā
ተጻረረ	taṣārrara
ተጽናና	taṣǝnānnā
ተፀነሰ	taḍannasa
ተፈለቀቀ	tafalaqqaqa
ተፈለገ	tafallaga
ተፈለጠ	tafallaṭa
ተፈለፈለ	tafalaffala
ተፈላ	tafallā
ተፈላለገ	tafalāllaga
ተፈላሰፈ	tafalāssafa
ተፈላጊ	tafallāgi
ተፈላጭ	tafallāč̣
ተፈረመ	tafarrama
ተፈረከሰ	tafarakkasa
ተፈረደ	tafarrada
ተፈረፈረ	tafaraffara
ተፈራ	tafarrā
ተፈራረመ	tafarārrama
ተፈራራ	tafarārrā
ተፈቃቀረ	tafaqāqqara
ተፈቃቀደ	tafaqāqqada
ተፈተለ	tafattala
ተፈተለከ	tafatallaka
ተፈተሸ	tafattaša
ተፈተነ	tafattana
ተፈተገ	tafattaga
ተፈታ	tafattā
ተፈታተሸ	tafatāttaša
ተፈታተነ	tafattātana
ተፈታኝ	tafattāñ
ተፈነቀለ	tafanaqqala
ተፈነቸረ	tafanaččara
ተፈነከተ	tafanakkata
ተፈነገለ	tafanaggala
ተፈናቀለ	tafanāqqala
ተፈናከተ	tafanākkata
ተፈናፈነ	tafanāffana
ተፈወሰ	tafawwasa
ተፈጀ	tafaǧǧa
ተፈገፈገ	tafagaffaga
ተፈጋፈገ	tafagāffaga
ተፋ	taffā
ተፋለመ	tafāllama
ተፋለሰ	tafāllasa
ተፋረሰ	tafārrasa
ተፋረደ	tafārrada
ተፋሰሰ	tafāssasa
ተፋቀረ	tafāqqara
ተፋተገ	tafāttaga
ተፋታ	tafāttā
ተፋዘዘ	tafāzzaza
ተፋጀ	tafāǧǧa
ተፋፈነ	tafāffana
ተፋፈገ	tafāffaga
ተፌ	taffe
ተፍ	taff
ተፍለቀለቀ	tafǝlaqallaqa
ተፍለከለከ	tafǝlakallaka
ተፍረቀረቀ	tafǝraqarraqa
ተፍረከረከ	tafǝrakarraka
ተፍረጠረጠ	tafǝraṭarraṭa
ተፍታታ	tafǝtāttā
ተፎካከረ	tafokākkara
ቱር	turr
ቱስ	tuss
ቱሽ	tušš
ቱባ	tubbā
ቱቦ	tubbo
ቱታ	tuttā
ቱግ	tugg
ቱፋሕ	tuffāḥ
ታለበ	tāllaba
ታለፈ	tāllafa
ታላቅ	tāllāq
ታመመ	tāmmama
ታመሰ	tāmmasa
ታመቀ	tāmmaqa
ታመነ	tāmmana
ታማ	tāmmā
ታማኝ	tāmmāñ
ታምረኛ	tāmmǝraññā
ታምራታዊ	tāmmǝrātāwi
ታምር	tāmmǝr
ታሠሠ	tāśśaśa
ታሠረ	tāśśara
ታረመ	tārrama
ታረሰ	tārrasa
ታረቀ	tārraqa
ታረዘ	tārraza
ታረደ	tārrada
ታሪከኛ	tārikaññā
ታሰበ	tāssaba
ታስቦ	tāssǝbo
ታሸ	tāšša
ታሸመ	tāššama
ታሸገ	tāššaga
ታቀደ	tāqqada
ታቀፈ	tāqqafa
ታበለ	tābbala
ታበየ	tābbaya
ታተመ	tāttama
ታተረ	tāttara
ታተተ	tāttata
ታታ	tāttā
ታነቀ	tānnaqa
ታነጠ	tānnaṭa
ታናሽ	tānnāš
ታንከኛ	tānǝkaññā
ታኘከ	tāññaka
ታከለ	tākkala
ታከመ	tākkama
ታከተ	tākkata
ታከከ	tākkaka
ታካሚ	tākkāmi
ታወረ	tāwwara
ታወሰው	tāwwasaw
ታወቀ	tāwwaqa
ታወከ	tāwwaka
ታዘለ	tāzzala
ታዘበ	tāzzaba
ታዘዘ	tāzzaza
ታዛቢ	tāzzābi
ታዛዥ	tāzzāž
ታየ	tāyya
ታደለ	tāddala
ታደመ	tāddama
ታደገ	tāddaga
ታዲያሳ	tādiyāssā
ታዲያስ	tādiyāss
ታዳጊ	tāddāgi
ታጀለ	tāǧǧala
ታጀበ	tāǧǧaba
ታገለ	tāggala
ታገሠ	tāggaśa
ታገደ	tāggada
ታጋሽ	tāggāš
ታጐረ	tāggʷara
ታፈረ	tāffara
ታፈነ	tāffana
ታፈገ	tāffaga
ታፋሪ	tāffāri
ቴሌስኮፕ	telesǝkopp
ቴፕ	tepp
ትሉግሉግ	tǝlugǝlugg
ትላንትና	tǝlānǝtǝnnā
ትልቅ	tǝllǝq
ትልቅነት	tǝllǝqǝnnat
ትሕትና	tǝḥǝtǝnnā
ትምቡሽ	tǝmǝbušš
ትምትም	tǝmǝtǝmm
ትምክህተኛ	tǝmǝkǝhǝtaññā
ትራፊ	tǝrrāfi
ትር	tǝrr
ትርምስ	tǝrǝmmǝs
ትርታ	tǝrrǝtā
ትርክክ	tǝrǝkǝkk
ትርኳሽ	tǝrǝkkʷāš
ትሻለህ	tǝšāllah
ትቢተኛ	tǝbitaññā
ትቢያ	tǝbbiyā
ትብብር	tǝbǝbbǝr
ትብትብ	tǝbǝtǝbb
ትችት	tǝččǝt
ትናንትና	tǝnānǝtǝnnā
ትናጋ	tǝnnāgā
ትንሽ	tǝnnǝš
ትንቢተኛ	tǝnǝbitaññā
ትንኝ	tǝnǝññ
ትንፋሽ	tǝnǝffāš
ትእቢተኛ	tǝʾǝbitaññā
ትእግሥተኛ	tǝʾǝgǝśǝtaññā
ትከሻ	tǝkaššā
ትከሻማ	tǝkaššāmmā
ትከሻም	tǝkaššām
ትኩሳት	tǝkkusāt
ትኩስ	tǝkkus
ትካዜ	tǝkkāze
ትክ	tǝkk
ትክለኛ	tǝkǝlaññā
ትክል	tǝkkǝl
ትክት	tǝkkǝt
ትክዝ	tǝkkǝzz
ትውልድ	tǝwǝlǝdd
ትዕይንት	tǝʿǝyyǝnǝt
ትዝ	tǝzz
ትዝብት	tǝzzǝbǝt
ትዝታ	tǝzzǝtā
ትይዩ	tǝyǝyyu
ትግሥተኛ	tǝgǝśǝtaññā
ትግርኛ	tǝgǝrǝññā
ትግያ	tǝgǝyyā
ትጥቅና	tǝṭǝqǝnnā
ቶስቷሳ	tosǝtʷāssā
ቸለል	čalall
ቸለሰ	čallasa
ቸል	čall
ቸልተኛ	čallǝtaññā
ቸልታ	čallǝtā
ቸረቸመ	čaraččama
ቸረቸረ	čaraččara
ቸርቻማ	čarǝčāmmā
ቸርነት	čarǝnnat
ቸሰሰ	čassasa
ቸበቸበ	čabaččaba
ቸብቸቦ	čabǝčabbo
ቸነከረ	čanakkara
ቸከለ	čakkala
ቸኰለ	čakkʷala
ቸኳይ	čakkʷāy
ቸገረ	čaggara
ቸፈቸፈ	čafaččafa
ቸፈገ	čaffaga
ቸፍግ	čaffǝgg
ችላ	čǝllā
ችስ	čǝss
ችቦ	čǝbbo
ችኩል	čǝkkul
ችክ	čǝkk
ችክል	čǝkkǝll
ችኮ	čǝkko
ችኰላ	čǝkkʷalā
ችግረኛ	čǝggǝraññā
ችግር	čǝggǝr
ችግኝ	čǝggǝñ
ችፍ	čǝff
ችፍርግ	čǝfǝrǝgg
ችፍቻፊ	čǝfǝččāfi
ችፍግ	čǝffǝg
ኅሊና	ḫǝllinā
ኅብረተሰብአዊነት	ḫǝbǝratasabǝʾāwinnat
ኅያል	ḫǝyyāl
ኅይለኛ	ḫǝyǝlaññā
ኅይለኝነት	ḫǝyǝlaññǝnnat
ኅዳግ	ḫǝddāg
ኅጢአተኛ	ḫǝṭiʾātaññā
ኅጢአተኝነት	ḫǝṭiʾātaññǝnnat
ኋለኛ	ḫʷālaññā
ነሣ	naśśā
ነረተ	narrata
ነሰረ	nassara
ነሰነሰ	nasannasa
ነሳነሰ	nasānnasa
ነሸጠ	naššaṭa
ነቀለ	naqqala
ነቀሰ	naqqasa
ነቀዘ	naqqaza
ነቃ	naqqā
ነቃቀለ	naqāqqala
ነቃቀዘ	naqāqqaza
ነቃቀፈ	naqāqqafa
ነቃቃ	naqāqqā
ነቈጠ	naqqʷaṭa
ነበረ	nabbara
ነበር	nabbar
ነበበ	nabbaba
ነበዘ	nabbaza
ነቢይ	nabiyy
ነባር	nabbār
ነብርማ	nabǝrǝmmā
ነቦጨ	nabboč̣č̣a
ነተረከ	natarraka
ነተበ	nattaba
ነኁላላ	naḫulāllā
ነኈለለ	naḫʷallala
ነኝ	naññ
ነከረ	nakkara
ነከሰ	nakkasa
ነከስ	nakass
ነከተ	nakkata
ነካ	nakkā
ነካከሰ	nakākkasa
ነካካ	nakākkā
ነክ	nakk
ነኰተ	nakkʷata
ነውረኛ	nawǝraññā
ነዘረ	nazzara
ነዘነዘ	nazannaza
ነዛ	nazzā
ነዝናዛ	nazǝnāzzā
ነደለ	naddala
ነደደ	naddada
ነደፈ	naddafa
ነዳ	naddā
ነዳደለ	nadāddala
ነዳደፈ	nadāddafa
ነገሠ	naggaśa
ነገረ	naggara
ነገረኛ	nagaraññā
ነገረኝ	naggaraññ
ነገረው	naggaraw
ነገደ	naggada
ነጋ	naggā
ነጋዴ	naggāde
ነጋድራስ	naggādǝrās
ነጋገረ	nagāggara
ነጋገደ	nagāggada
ነጋጋ	nagāggā
ነጐረ	naggʷara
ነጻነት	naṣānnat
ነፈለለ	nafallala
ነፈረ	naffara
ነፈረቀ	nafarraqa
ነፈሰ	naffasa
ነፈሰበት	naffasabbat
ነፈነፈ	nafannafa
ነፈገ	naffaga
ነፊ	naffi
ነፋ	naffā
ነፋሻ	naffāššā
ነፋፈሰ	nafāffasa
ነፋፋ	nafāffā
ነፍላላ	nafǝlāllā
ነፍራቃ	nafǝrāqqā
ነፍናፋ	nafǝnāffā
ነፍጠኛ	nafǝṭaññā
ናሙና	nāmmunā
ናቸው	nāččaw
ናችሁ	nāččǝhu
ናኘ	nāñña
ናወዘ	nāwwaza
ናዋዥ	nāwwāž
ናፈቀ	nāffaqa
ንስሐ	nǝssǝḥā
ንቃሽ	nǝqqāš
ንቃይ	nǝqqāy
ንቅል	nǝqqǝl
ንቅሳታም	nǝqqǝsātām
ንቅሳት	nǝqqǝsāt
ንቅናቄ	nǝqǝnnāqe
ንብብር	nǝbǝbbǝr
ንብዝ	nǝbbǝz
ንብዝብዝ	nǝbǝzǝbǝzz
ንትርክ	nǝtǝrrǝk
ንክሳት	nǝkkǝsāt
ንክስ	nǝkkǝs
ንክኪት	nǝkǝkkit
ንክክ	nǝkǝkk
ንኳቸ	nǝkkʷāča
ንዝራት	nǝzzǝrāt
ንዴተኛ	nǝdetaññā
ንዴታም	nǝddetām
ንዴት	nǝddet
ንገዳ	nǝggadā
ንግር	nǝggǝr
ንግርተኛ	nǝggǝrǝtaññā
ንግርት	nǝggǝrǝt
ንግግር	nǝgǝggǝr
ንጹሕነት	nǝṣuḥǝnnat
ንጽሕና	nǝṣǝḥǝnnā
ንፊት	nǝffit
ንፋሽ	nǝffāš
አሁኑኑ	āhunnunu
አሁንም	āhunǝmm
አሁንስ	āhunǝss
አህያ	āhǝyyā
አለ	ālla
አለሁ	āllahu
አለለ	āllala
አለል	ālall
አለሎ	ālallo
አለመ	āllama
አለመለመ	ālamallama
አለመደ	ālammada
አለመጠ	ālammaṭa
አለማ	ālammā
አለማለም	āllamāllam
አለማመነ	āllamāmmana
አለማመደ	āllamāmmada
አለሳለስ	āllasālas
አለቀ	āllaqa
አለቀለቀ	ālaqallaqa
አለቀመ	ālaqqama
አለቀሰ	ālaqqasa
አለቃለቀ	āllaqāllaqa
አለቃቀሰ	ālaqāqqasa
አለቅነት	ālaqǝnnat
አለበ	āllaba
አለበለዚያ	ālaballazziyā
አለበሰ	āllabbasa
አለበት	āllabat
አለባበሰ	ālabābbasa
አለብኝ	āllabbǝññ
አለኝታ	āllaññǝtā
አለከለከ	ālakallaka
አለው	āllaw
አለዘበ	ālazzaba
አለያየ	āllayyāya
አለጎመ	ālaggoma
አለጐመ	ālaggʷama
አለጠ	āllaṭa
አለጠለጠ	ālaṭallaṭa
አለፈ	āllafa
አለፈበት	āllafabbat
አለፋ	ālaffā
አለፋጨቀ	āllafāč̣č̣aqa
አላላ	ālāllā
አላላም	āllālām
አላላከ	āllālāka
አላመነ	āllāmmana
አላመደ	āllāmada
አላመጠ	āllāmmaṭa
አላሚ	āllāmi
አላማኝ	āllāmāñ
አላሰነ	āllāssana
አላሸ	ālāšša
አላሸቀ	ālāššaqa
አላቀመ	āllāqqama
አላቀሰ	āllāqqasa
አላቀቀ	āllāqqaqa
አላቃሽ	āllāqāš
አላቆጠ	ālāqqoṭa
አላጋ	āllāggā
አላጋጭ	āllāgāč̣
አላፊነት	ālāfinnat
አልቃሻ	ālǝqāššā
አልባሌ	ālǝbbāle
አልባነት	ālǝbānnat
አልከሰከሰ	ālǝkasakkasa
አልኮሰኮሰ	ālǝkosakkosa
አልገባኝም	ālǝgabbāññǝm
አልጐመጐመ	ālǝgʷamaggʷama
አልጨረሰም	ālǝč̣arrasam
አልጫ	āllǝč̣č̣ā
አልፈሰፈሰ	ālǝfasaffasa
አሎሎ	ālollo
አመለመለ	āmalammala
አመለኛ	āmalaññā
አመለከ	āmallaka
አመለከተ	āmalakkata
አመለጠ	āmallaṭa
አመለጠው	āmallaṭaw
አመላለስ	āmmalāllas
አመላላሽ	āmmalāllāš
አመመ	āmmama
አመሠራረት	āmmaśarārat
አመረረ	āmarrara
አመረቀዘ	āmaraqqaza
አመረተ	āmarrata
አመራ	āmarrā
አመራመረ	āmmarāmmara
አመራመር	āmmarāmar
አመራማሪ	āmmarāmāri
አመራር	āmmarār
አመሰ	āmmasa
አመሰቃቀለ	āmmasaqāqqala
አመሰቃቃይ	āmmasaqāqāy
አመሰኳ	āmasakkʷā
አመሰገነ	āmasaggana
አመሰጋገነ	āmasagāggana
አመሳሰል	āmmasāsal
አመሳቀለ	āmmasāqqala
አመሳከረ	āmmasākkara
አመሳካሪ	āmmasākāri
አመሸ	āmmašša
አመሸህ	āmaššah
አመቀ	āmmaqa
አመቸ	āmačča
አመቺ	āmačči
አመቻቸ	āmmačāčča
አመነ	āmmana
አመነመነ	āmanammana
አመነቃቀረ	āmmanaqāqqara
አመነታ	āmanattā
አመነታታ	āmanatāttā
አመነቸከ	āmanaččaka
አመነኰሰ	āmanakkʷasa
አመነዘረ	āmanazzara
አመነጫጨቀ	āmmanač̣āč̣č̣aqqa
አመናቀረ	āmmanāqqara
አመናጨቀ	āmmanāč̣č̣aqa
አመከነ	āmakkana
አመካኘ	āmmakāña
አመዘነ	āmazzana
አመዛዘነ	āmmazāzzana
አመዛዛኝ	āmmazāzāñ
አመገ	āmmaga
አመገለ	āmmaggala
አመጋገብ	āmmagāgab
አመጣጠነ	āmmaṭāṭṭana
አመጻደቀ	āmmaṣāddaqa
አማ	āmmā
አማለደ	āmmālada
አማላጅ	āmmālāǧ
አማላጅነት	āmmālāǧǝnnat
አማመመ	āmāmmama
አማረረ	āmmārrara
አማረዘ	āmmārraza
አማረገ	āmmārraga
አማረጠ	āmmārraṭa
አማሪኛው	āmāriññāw
አማራሪ	āmmārāri
አማራጭ	āmmārāč̣
አማርኛ	āmārǝññā
አማሰለ	āmmāssala
አማሸ	āmmāšša
አማሺ	āmmāši
አማሽ	āmmāš
አማተበ	āmmāttaba
አማታ	āmmātā
አማች	āmmāč
አማከረ	āmākkara
አማካሪ	āmmākāri
አማካኝ	āmmākāñ
አማገረ	āmmāggara
አማገጠ	āmāggaṭa
አማጣ	āmmāṭā
አማጭ	āmmāč̣
አሜተኛ	āmetaññā
አምሳኛ	āmǝsāññā
አምሳያ	āmǝsāyyā
አምስተኛ	āmmǝsǝtaññā
አምስት	āmmǝsǝt
አምበል	āmǝball
አምቡላ	āmǝbullā
አምባረቀ	āmǝbārraqa
አምባሻ	āmǝbāššā
አምባጋሮኛ	āmǝbāgāroññā
አምቦልክ	āmǝbolǝkk
አምቦረቀቀ	āmǝboraqqaqa
አምቦጨቦጨ	āmǝboč̣abboč̣a
አምቧቧ	āmǝbʷābbʷā
አምታታ	āmǝtāttā
አምነሸነሸ	āmǝnašannaša
አምዘገዘገ	āmǝzagazzaga
አሞለጨ	āmollač̣a
አሞላ	āmollā
አሞላላ	āmmolāllā
አሞላቀቀ	āmolāqqaqa
አሞቀሞቀ	āmoqammoqa
አሞኘ	āmoñña
አሞካከረ	āmmokākkara
አሞገሰ	āmoggasa
አሞጋሽ	āmoggāš
አሞጋገሰ	āmogāggasa
አሞጠሞጠ	āmoṭammoṭa
አሟላ	āmmʷāllā
አሟሟቀ	āmmʷāmʷāqa
አሟሟቂ	āmmʷāmʷāqi
አሟረተ	āmʷārrata
አሟሸ	āmʷāšša
አሟከረ	āmmʷākkara
አሟገተ	āmmʷāggata
አሟጋች	āmmʷāgāč
አሠለሰ	āśallasa
አሠልጣኝ	āśalǝṭāññ
አሠመረ	āśammara
አሠማመረ	āśamāmmara
አሠሠ	āśśaśa
አሠረ	āśśara
አሠዋ	āśśawwā
አሠየመ	āśayyama
አሠገረ	āśaggara
አሠጋ	āśaggā
አሠጋገር	āśśagāgar
አሣሣ	āśāśśā
አሣረኛ	āśāraññā
አረመ	ārrama
አረመኔነት	āramanennat
አረሰ	ārrasa
አረሳሳ	ārasāssā
አረቀ	ārraqa
አረቀቀ	āraqqaqa
አረበደ	ārrabbada
አረባ	ārabbā
አረባጅ	ārabbāǧ
አረከሰ	ārakkasa
አረካ	ārakkā
አረካከበ	ārrakākkaba
አረካካቢ	ārrakākābi
አረዘመ	ārazzama
አረደ	ārrada
አረዳ	āraddā
አረጀ	āraǧǧa
አረገረገ	āragarraga
አረገበ	āraggaba
አረገዘ	āraggaza
አረገደ	āraggada
አረገፈ	āraggafa
አረጋ	āraggā
አረጋገጠ	ārragāggaṭa
አረጋገፈ	ārragāggafa
አረጋጋ	ārragāggā
አረጠ	ārraṭa
አረጠረጠ	āraṭarraṭa
አረፈደ	āraffada
አረፋፈደ	āraffāfada
አራ	ārrā
አራመደ	ārrāmmada
አራሙቻ	ārrāmuččā
አራሚ	ārrāmi
አራረሰ	ārārrasa
አራራ	ārārrā
አራራቀ	ārrārāqa
አራቈተ	ārrāqʷata
አራባ	ārrābā
አራተኛ	ārāttaññā
አራት	ārātt
አራገበ	ārrāggaba
አራገፈ	ārrāggafa
አራጋፊ	ārrāggāfi
አርመጠመጠ	ārǝmaṭammaṭa
አርበተበተ	ārǝbatabbata
አርበኛ	ārǝbaññā
አርበኛነት	ārǝbaññānat
አርበኝነት	ārǝbaññǝnnat
አርበደበደ	ārǝbadabbada
አርባኛ	ārǝbāññā
አርነት	ārǝnnat
አርአያነት	ārǝʾāyānnat
አርከፈከፈ	ārǝkafakkafa
አርገበገበ	ārǝgabaggaba
አርጩሜ	ārǝč̣umme
አሯሯጠ	ārrʷārʷāṭa
አሰለለ	āssallala
አሰለመ	āsallama
አሰለሰለ	āsalassala
አሰለበ	āssalaba
አሰለቸ	āsalačča
አሰለፈ	āsallafa
አሰላ	āsallā
አሰላሰለ	āssalāssala
አሰላይ	āssallāy
አሰላፊ	āssallāfi
አሰማ	āssammā
አሰረ	āssara
አሰረቀ	āssaraqa
አሰረዘ	āssarraza
አሰራጨ	āssarāč̣a
አሰሰ	āssasa
አሰሳ	āssasā
አሰቀለ	āssaqqala
አሰቀቀ	āssaqqaqa
አሰቃቂ	āssaqqāqi
አሰቃየ	āssaqāyya
አሰበ	āssaba
አሰበረ	āssabbara
አሰበከ	āsabbaka
አሰበጣጠረ	āssabaṭāṭṭara
አሰባ	āsabbā
አሰባሰበ	āssabāssaba
አሰባጠረ	āssabāṭṭara
አሰት	āssat
አሰነቀ	āssannaqa
አሰነበተ	āsanabbata
አሰነካከለ	āssanakākkala
አሰነዳዳ	āssanadāddā
አሰነጠቀ	āssanaṭṭaqa
አሰነፈ	āsannafa
አሰናበተ	āssanābbata
አሰናከለ	āssanākkala
አሰናካይ	āssanākāy
አሰናዳ	āssanāddā
አሰናጅ	āssanāǧ
አሰኘ	āssañña
አሰኘው	āssaññaw
አሰከረ	āsakkara
አሰከነ	āsakkana
አሰካ	āssakkā
አሰየፈ	āssayyafa
አሰደበ	āssaddaba
አሰዳቢ	āsaddābi
አሰገደ	āssagadda
አሰገገ	āsaggaga
አሰጠ	āssaṭṭa
አሰፈረ	āssaffara
አሰፈሰፈ	āsafassafa
አሰፈፈ	āsaffafa
አሰፋ	āssaffā
አሳለ	āssāla
አሳለበ	āsāllaba
አሳለፈ	āsāllafa
አሳመ	āssāma
አሳመመ	āsāmmama
አሳመሰ	āsāmmasa
አሳመቀ	āsāmmaqa
አሳመነ	āsāmmana
አሳማኝ	āsāmmāñ
አሳሠረ	āsāśśara
አሳረመ	āsārrama
አሳረረ	āssārrara
አሳረሰ	āsārrasa
አሳረደ	āsārrada
አሳረፈ	āsārrafa
አሳራ	āsārrā
አሳራሪ	āssārāri
አሳራሽ	āsārrāš
አሳሰበ	āsāssaba
አሳሳመ	āssāsāma
አሳሳቀ	āssāsāqa
አሳሳበ	āssāsāba
አሳሳቢ	āsāssābi
አሳሳተ	āssāsāta
አሳሳች	āssāsāč
አሳሸ	āsāšša
አሳሸገ	āsāššaga
አሳቀ	āssāqa
አሳቀለ	āssāqqala
አሳቀቀ	āssāqqaqa
አሳቀደ	āsāqqada
አሳቀፈ	āsāqqafa
አሳበ	āssāba
አሳበረ	āssābbara
አሳበቀ	āssābbaqa
አሳበበ	āssābbaba
አሳበደ	āsābbada
አሳበጠ	āsābbaṭa
አሳቢ	āssābi
አሳባሪ	āssābāri
አሳባቂ	āssābāqi
አሳብ	āssāb
አሳተ	āssāta
አሳተመ	āsāttama
አሳተፈ	āssāttafa
አሳታሚ	āsāttāmi
አሳቻ	āssāččā
አሳች	āssāč
አሳነሰ	āsānnasa
አሳነቀ	āsānnaqa
አሳነጠ	āsānnaṭa
አሳነፈ	āssānnafa
አሳከለ	āsākkala
አሳከመ	āsākkama
አሳከረ	āssākkara
አሳከተ	āsākkata
አሳከከ	āsākkaka
አሳካ	āssākkā
አሳካሚ	āsākkāmi
አሳወቀ	āsāwwaqa
አሳዘነ	āsāzzana
አሳዘዘ	āsāzzaza
አሳዛኝ	āsāzzāññ
አሳየ	āsāyya
አሳደለ	āsāddala
አሳደደ	āssāddada
አሳደገ	āsāddaga
አሳደፈ	āsāddafa
አሳዳጅ	āssādāǧ
አሳዳጊ	āsāddāgi
አሳጀለ	āsāǧǧala
አሳጀበ	āsāǧǧaba
አሳገደ	āsāggada
አሳጣ	āssāṭṭā
አሳጪ	āssāč̣i
አሳፈረ	āssāffara
አሳፈሰ	āsāffasa
አሳፈነ	āsāffana
አሳፋሪ	āssāfāri
አስለመነ	āsǝlammana
አስለመደ	āsǝlammada
አስለማ	āsǝlammā
አስለማጅ	āsǝlammāǧ
አስለሰነ	āsǝlassana
አስለቀለቀ	āsǝlaqallaqa
አስለቀመ	āsǝlaqqama
አስለቀሰ	āsǝlaqqasa
አስለቀቀ	āsǝlaqqaqa
አስለቃሽ	āsǝlaqqāš
አስለበለበ	āsǝlaballaba
አስለበሰ	āsǝlabbasa
አስለበበ	āsǝlabbaba
አስለበደ	āsǝlabbada
አስለበጠ	āsǝlabbaṭa
አስለጎመ	āsǝlaggoma
አስለፈለፈ	āsǝlafallafa
አስለፈፈ	āsǝlaffafa
አስለፋ	āsǝlaffā
አስመለሰ	āsǝmallasa
አስመለከተ	āsǝmalakkata
አስመለጠ	āsǝmallaṭa
አስመሠረተ	āsǝmaśśarata
አስመረመረ	āsǝmarammara
አስመረረ	āsǝmarrara
አስመረቀ	āsǝmarraqa
አስመረዘ	āsǝmarraza
አስመረገ	āsǝmarraga
አስመረጠ	āsǝmarraṭa
አስመራ	āsǝmarrā
አስመሰለ	āsǝmassala
አስመሰከረ	āsǝmasakkara
አስመሰገነ	āsǝmasaggana
አስመሳይ	āsǝmassāy
አስመሸ	āsǝmašša
አስመሸገ	āsǝmaššaga
አስመተረ	āsǝmattara
አስመታ	āsǝmattā
አስመነታ	āsǝmanattā
አስመነነ	āsǝmannana
አስመነኰሰ	āsǝmanakkʷasa
አስመነዘረ	āsǝmanazzara
አስመኘ	āsǝmañña
አስመከረ	āsǝmakkara
አስመዘነ	āsǝmazzana
አስመዘዘ	āsǝmazzaza
አስመዘገበ	āsǝmazaggaba
አስመደበ	āsǝmaddaba
አስመገበ	āsǝmaggaba
አስመጠወተ	āsǝmaṭawwata
አስማማ	āsǝmāmmā
አስማተኛ	āsǝmātaññā
አስማገረ	āsǝmāggara
አስሞላ	āsǝmollā
አስሞረደ	āsǝmorrada
አስሞከተ	āsǝmokkata
አስሞገተ	āsǝmoggata
አስሞጨለፈ	āsǝmoč̣allafa
አስረረ	āssǝrrara
አስረሳ	āsǝrassā
አስረቀቀ	āsǝraqqaqa
አስረበረበ	āsǝrabarraba
አስረከበ	āsǝrakkaba
አስረካቢ	āsǝrakkābi
አስረዳ	āsǝraddā
አስረጀ	āsǝraǧǧa
አስረገመ	āsǝraggama
አስረገዘ	āsǝraggaza
አስረገጠ	āsǝraggaṭa
አስረገፈ	āsǝraggafa
አስረፈደ	āsǝraffada
አስቀለሰ	āsǝqallasa
አስቀለበሰ	āsǝqalabbasa
አስቀለጠ	āsǝqallaṭa
አስቀመለ	āsǝqammala
አስቀመመ	āsǝqammama
አስቀመሰ	āsǝqammasa
አስቀመቀመ	āsǝqamaqqama
አስቀመጠ	āsǝqammaṭa
አስቀማ	āsǝqammā
አስቀሠፈ	āsǝqaśśafa
አስቀረ	āsǝqarra
አስቀረደደ	āsǝqaraddada
አስቀረጠ	āsǝqarraṭa
አስቀረጸ	āsǝqarraṣa
አስቀረፈ	āsǝqarrafa
አስቀሰተ	āsǝqassata
አስቀሳፈተ	āsǝqasāffata
አስቀቀለ	āsǝqaqqala
አስቀበለ	āsǝqabbala
አስቀበረ	āsǝqabbara
አስቀበቀበ	āsǝqabaqqaba
አስቀባ	āsǝqabbā
አስቀነሰ	āsǝqannasa
አስቀና	āsǝqannā
አስቀዘነ	āsǝqazzana
አስቀዘፈ	āsǝqazzafa
አስቀየመ	āsǝqayyama
አስቀየሠ	āsǝqayyaśa
አስቀየደ	āsǝqayyada
አስቀየጠ	āsǝqayyaṭa
አስቀያሚ	āsǝqayyāmi
አስቀደመ	āsǝqaddama
አስቀደሰ	āsǝqaddasa
አስቀደደ	āsǝqaddada
አስቀዳ	āsǝqaddā
አስቀዳሽ	āsǝqaddāš
አስቀድሞ	āsǝqaddǝmo
አስቀጠቀጠ	āsǝqaṭaqqaṭa
አስቀፈቀፈ	āsǝqafaqqafa
አስቀፈደደ	āsǝqafaddada
አስቂኝ	āssǝqiññ
አስቃረመ	āsǝqārrama
አስቆለለ	āsǝqollala
አስቆለፈ	āsǝqollafa
አስቆላ	āsǝqollā
አስቆረሰ	āsǝqorrasa
አስቆየ	āsǝqoyya
አስቆፈረ	āsǝqoffara
አስቈለመመ	āsǝqʷalammama
አስቈረቈረ	āsǝqʷaraqqʷara
አስቈረበ	āsǝqʷarraba
አስቈረጠ	āsǝqʷarraṭa
አስቈራ	āsǝqʷarrā
አስበላ	āsǝballā
አስበረቀሰ	āsǝbaraqqasa
አስበረበረ	āsǝbarabbara
አስበረዘ	āsǝbarraza
አስበረደ	āsǝbarrada
አስበረገገ	āsǝbaraggaga
አስበራ	āsǝbarrā
አስበሰለ	āsǝbassala
አስበተነ	āsǝbattana
አስበከለ	āsǝbakkala
አስበዘበዘ	āsǝbazabbaza
አስበየነ	āsǝbayyana
አስበየደ	āsǝbayyada
አስበደለ	āsǝbaddala
አስበዳ	āsǝbaddā
አስበጂ	āsǝbaǧǧi
አስበጠበጠ	āsǝbaṭabbaṭa
አስባረከ	āsǝbārraka
አስተለተለ	āsǝtalattala
አስተላለቀ	āsǝtalāllaqa
አስተላለፈ	āsǝtalāllafa
አስተመተመ	āsǝtamattama
አስተማመነ	āsǝtamāmmana
አስተማረ	āsǝtammāra
አስተሣሠረ	āsǝtaśāśśara
አስተረተረ	āsǝtarattara
አስተረጐመ	āsǝtaraggʷama
አስተራረሰ	āsǝtarārrasa
አስተሳሰበ	āsǝtasāssaba
አስተሻሸ	āsǝtašāšša
አስተባበለ	āsǝtabābbala
አስተባበረ	āsǝtabābbara
አስተቸ	āsǝtačča
አስተነተነ	āsǝtanattana
አስተነፈሰ	āsǝtanaffasa
አስተናበረ	āsǝtanābbara
አስተናገደ	āsǝtanāggada
አስተኛ	āsǝttañā
አስተከዘ	āsǝtakkaza
አስተካከለ	āsǝtakākkala
አስተኰሰ	āsǝtakkʷasa
አስተዋወቀ	āsǝtawāwwaqa
አስተዛዘበ	āsǝtazāzzaba
አስተያየ	āsǝtayāyya
አስተዳደረ	āsǝtadāddara
አስተጋባ	āsǝtagābbā
አስተፋ	āsǝtaffā
አስታረቀ	āsǝtārraqa
አስታቀፈ	āsǝtāqqafa
አስታከከ	āsǝtākkaka
አስታወሰ	āsǝtāwwasa
አስታወቀ	āsǝtāwwaqa
አስታገሠ	āsǝtāggaśa
አስታጐለ	āsǝtāggʷala
አስቸረቸረ	āsǝččaraččara
አስቸነከረ	āsǝčanakkara
አስቸከለ	āsǝčakkala
አስቸኰለ	āsǝčakkʷala
አስቸኳይ	āsǝčakkʷāy
አስቸገረ	āsǝčaggara
አስቸጋሪ	āsǝčaggāri
አስነሣ	āsǝnnaśā
አስነረተ	āsǝnarrata
አስነሰነሰ	āsǝnasannasa
አስነሺ	āsǝnašši
አስነቀለ	āsǝnaqqala
አስነቀሰ	āsǝnaqqasa
አስነቀፈ	āsǝnaqqafa
አስነቃፊ	āsǝnaqqāfi
አስነበበ	āsǝnabbaba
አስነከረ	āsǝnakkara
አስነከሰ	āsǝnakkasa
አስነካ	āsǝnakkā
አስነወረ	āsǝnawwara
አስነዋሪ	āsǝnawwāri
አስነደለ	āsǝnaddala
አስነደፈ	āsǝnaddafa
አስነዳ	āsǝnaddā
አስነገረ	āsǝnaggara
አስነገተ	āsǝnaggata
አስነገደ	āsǝnaggada
አስነጋ	āsǝnaggā
አስነጐረ	āsǝnaggʷara
አስነፈሰ	āsǝnaffasa
አስነፋ	āsǝnaffā
አስከለለ	āsǝkallala
አስከለበሰ	āsǝkalabbasa
አስከለከለ	āsǝkalakkala
አስከመረ	āsǝkammara
አስከረተፈ	āsǝkarattafa
አስከረከመ	āsǝkarakkama
አስከሰለ	āsǝkassala
አስከሰሰ	āsǝkassasa
አስከሰከሰ	āsǝkasakkasa
አስከበረ	āsǝkabbara
አስከበበ	āsǝkabbaba
አስከባሪ	āsǝkabbāri
አስከተለ	āsǝkattala
አስከተረ	āsǝkattara
አስከተበ	āsǝkattaba
አስከተተ	āsǝkattata
አስከተከተ	āsǝkatakkata
አስከነዳ	āsǝkannadā
አስከደነ	āsǝkaddana
አስከዳ	āsǝkaddā
አስከፈለ	āsǝkaffala
አስከፈነ	āsǝkaffana
አስከፈከፈ	āsǝkafakkafa
አስከፈፈ	āsǝkaffafa
አስከፊ	āsǝkaffi
አስከፋ	āsǝkaffā
አስካካ	āsǝkākkā
አስኮላሸ	āsǝkolāšša
አስኮረጀ	āsǝkorraǧa
አስኮረፈ	āsǝkorrafa
አስኮበለለ	āsǝkoballala
አስኮተኮተ	āsǝkotakkota
አስኰነነ	āsǝkʷannana
አስኰናኝ	āsǝkʷannāñ
አስወለቀ	āsǝwallaqa
አስወለደ	āsǝwallada
አስወረረ	āsǝwarrara
አስወረወረ	āsǝwarawwara
አስወረደ	āsǝwarrada
አስወራ	āsǝwarrā
አስወሰነ	āsǝwassana
አስወሰደ	āsǝwassada
አስወቀረ	āsǝwaqqara
አስወቀጠ	āsǝwaqqaṭa
አስወቃ	āsǝwaqqā
አስወተፈ	āsǝwattafa
አስወነጀለ	āsǝwanaǧǧala
አስወደደ	āsǝwaddada
አስወገረ	āsǝwaggara
አስወገደ	āsǝwaggada
አስወጋ	āsǝwaggā
አስዋኘ	āsǝwāñña
አስደለደለ	āsǝdaladdala
አስደመረ	āsǝdammara
አስደመሰሰ	āsǝdamassasa
አስደረተ	āsǝdarrata
አስደረደረ	āsǝdaraddara
አስደረገ	āsǝdarraga
አስደራጊ	āsǝdarrāgi
አስደሰተ	āsǝdassata
አስደሳች	āsǝdassāč
አስደቀቀ	āsǝdaqqaqa
አስደበለቀ	āsǝdaballaqa
አስደበቀ	āsǝdabbaqa
አስደባለቀ	āsǝdabāllaqa
አስደነሰ	āsǝdannasa
አስደነቀ	āsǝdannaqa
አስደነበረ	āsǝdanabbara
አስደነገጠ	āsǝdanaggaṭa
አስደናቂ	āsǝdannāqi
አስደወለ	āsǝdawwala
አስደገመ	āsǝdaggama
አስደገሰ	āsǝdaggasa
አስደገደገ	āsǝdagaddaga
አስደፈረ	āsǝdaffara
አስደፈቀ	āsǝdaffaqa
አስደፈነ	āsǝdaffana
አስደፈጠ	āsǝdaffaṭa
አስጀመረ	āsǝǧammara
አስገለበጠ	āsǝgalabbaṭa
አስገመሰ	āsǝgammasa
አስገመተ	āsǝgammata
አስገመገመ	āsǝgamaggama
አስገረመ	āsǝgarrama
አስገረዘ	āsǝgarraza
አስገራ	āsǝgarrā
አስገራሚ	āsǝgarrāmi
አስገባ	āsǝgabbā
አስገነዘበ	āsǝganazzaba
አስገኘ	āsǝgañña
አስገዘተ	āsǝgazzata
አስገደለ	āsǝgaddala
አስገደደ	āsǝgaddada
አስገደፈ	āsǝgaddafa
አስጎመጀ	āsǝgomaǧǧa
አስጐበኘ	āsǝgʷabañña
አስጐነበሰ	āsǝgʷanabbasa
አስጠለለ	āsǝṭallala
አስጠላ	āsǝṭallā
አስጠመደ	āsǝṭammada
አስጠማ	āsǝṭammā
አስጠራ	āsǝṭarrā
አስጠቃ	āsǝṭaqqā
አስጠነቀቀ	āsǝṭanaqqaqa
አስጠና	āsǝṭannā
አስጠኚ	āsǝṭaññi
አስጠየፈ	āsǝṭayyafa
አስጠያፊ	āsǝṭayyāfi
አስጠይ	āsǝṭayy
አስጠገነ	āsǝṭaggana
አስጠጋ	āsǝṭaggā
አስጨመረ	āsǝč̣ammara
አስጨመቀ	āsǝč̣ammaqa
አስጨበጨበ	āsǝč̣abač̣č̣aba
አስጨነቀ	āsǝč̣annaqa
አስጨናቂ	āsǝč̣annāqi
አስጨፈለቀ	āsǝč̣afallaqa
አስጨፈረ	āsǝč̣affara
አስጸየፈ	āsǝṣṣayyafa
አስጸያፊ	āsǝṣṣayyāfi
አስፈለገ	āsǝfallaga
አስፈለገኝ	āsǝfallagaññ
አስፈለፈለ	āsǝfalaffala
አስፈላ	āsǝfallā
አስፈረመ	āsǝfarrama
አስፈረደ	āsǝffarada
አስፈሪ	āsǝfarri
አስፈራ	āsǝfarrā
አስፈራራ	āsǝfarārrā
አስፈሳ	āsǝfassā
አስፈሳው	āsǝfassāw
አስፈቀደ	āsǝfaqqada
አስፈተሸ	āsǝfattaša
አስፈተነ	āsǝfattana
አስፈተገ	āsǝfattaga
አስፈታ	āsǝfattā
አስፈጀ	āsǝfaǧǧa
አስፋፋ	āsǝfāffā
አሶመሰመ	āsomassama
አሸ	āšša
አሸለለ	āššallala
አሸለመ	āšallama
አሸለቀቀ	āššalaqqaqa
አሸለበ	āšallaba
አሸለተ	āššallata
አሸመ	āššama
አሸመተ	āšammata
አሸመገለ	āšamaggala
አሸመጠጠ	āššamaṭṭaṭa
አሸረሞጠ	āšarammoṭa
አሸረጠ	āšarraṭa
አሸረፈ	āšarrafa
አሸሸ	āššaša
አሸሸገ	āššaššaga
አሸቀለ	āššaqqala
አሸቀበ	āšaqqaba
አሸበረ	āššabbara
አሸበረቀ	āšabarraqa
አሸበሸበ	āšabaššaba
አሸበበ	āššabbaba
አሸበተ	āšabbata
አሸባሪ	āššabbāri
አሸተተ	āšattata
አሸነሸነ	āššanaššana
አሸነፈ	āššannafa
አሸና	āššannā
አሸናፊ	āššannāfi
አሸኘ	āššañña
አሸኛኘት	āššañāñat
አሸከመ	āššakkama
አሸካሸከ	āššakāššaka
አሸዋማ	āšawāmmā
አሸዋነት	āšawānnat
አሸገ	āššaga
አሸጋሸገ	āššagāššaga
አሸጋገረ	āššagāggara
አሸጠ	āššaṭa
አሸፈተ	āšaffata
አሸፈነ	āššaffana
አሻለ	āššāla
አሻማ	āššāmmā
አሻረ	āššāra
አሻረከ	āššārraka
አሻሸ	āšāšša
አሻሻለ	āššāšāla
አሻሻጠ	āššāšāṭa
አሻሻጭ	āššāšāč̣
አሻቀበ	āšāqqaba
አሻንጉሊት	āšānǝgullit
አሻከረ	āšākkara
አሻገረ	āšāggara
አሻገተ	āšāggata
አሻፈረኝ	āšāffarañ
አሻፈደ	āšāffada
አሽሙረኛ	āšǝmuraññā
አሽሟጣጭነት	āšǝmʷāṭāč̣ǝnnat
አሽቀዳደመ	āšǝqadāddama
አሽቆጠቆጠ	āšǝqoṭaqqoṭa
አሽበለበለ	āšǝbalabbala
አሽታ	āššǝtā
አሽከረከረ	āšǝkarakkara
አሽከርነት	āšǝkarǝnnat
አሽካካ	āšǝkkākā
አሽኮረመመ	āšǝkorammama
አሾለቀ	āšollaqa
አሾለከ	āšollaka
አሾላቂ	āšollāqi
አሾመ	āššoma
አሾከሾከ	āšokaššoka
አቀለለ	āqallala
አቀለመ	āqallama
አቀለጠ	āqallaṭa
አቀላ	āqallā
አቀላል	āqqalāl
አቀላቀለ	āqqalāqqala
አቀላጠፈ	āqqalāṭṭafa
አቀመሰ	āqammasa
አቀማመጥ	āqqamāmaṭ
አቀማጠለ	āqqamāṭṭala
አቀረረ	āqarrara
አቀረቀረ	āqaraqqara
አቀረበ	āqarraba
አቀረና	āqarannā
አቀረጣጠፈ	āqqaraṭāṭṭafa
አቀራረበ	āqqarārraba
አቀሰሰ	āqassasa
አቀበለ	āqabbala
አቀበጠ	āqabbaṭa
አቀባበለ	āqqabābbala
አቀባበረ	āqqabābbara
አቀባባይ	āqqabābāy
አቀባይ	āqabbāy
አቀነቀነ	āqanaqqana
አቀነበጠ	āqanabbaṭa
አቀነባበረ	āqqanabābbara
አቀነባባሪ	āqqanabābbāri
አቀና	āqannā
አቀናበረ	āqqanābbara
አቀናበር	āqqanābbar
አቀናባሪ	āqqanābāri
አቀናነሰ	āqqanānnasa
አቀዘቀዘ	āqazaqqaza
አቀዛቀዘ	āqqazāqaza
አቀያየረ	āqqayāyyara
አቀያየደ	āqayāyyada
አቀያየጠ	āqqayāyyaṭa
አቀዳጀ	āqadāǧǧa
አቀጣጠረ	āqqaṭāṭara
አቀጣጠነ	āqqaṭāṭana
አቀፈ	āqqafa
አቀፍ	āqqaf
አቁለጨለጨ	āqulač̣allač̣a
አቁላላ	āqulāllā
አቁነጠነጠ	āqunaṭannaṭa
አቃለለ	āqqāllala
አቃመሰ	āqāmmasa
አቃረበ	āqqāraba
አቃራመ	āqqārrāma
አቃሰተ	āqāssata
አቃበረ	āqqābbara
አቃባ	āqqābbā
አቃነሰ	āqqānnasa
አቃና	āqqānnā
አቃወሰ	āqāwwasa
አቃዋሽ	āqqāwāš
አቃዠ	āqāžža
አቃጠለ	āqqāṭṭala
አቃጠረ	āqqāṭara
አቃጠፈ	āqqāṭṭafa
አቃጣሪ	āqqāṭāri
አቅለሸለሸ	āqǝlašallaša
አቅለበለበ	āqǝlaballaba
አቅማማ	āqǝmāmmā
አቅራቢያ	āqǝrābbiyā
አቅበዘበዘ	āqǝbazabbaza
አቅነዘነዘ	āqǝnazannaza
አቅጣጫ	āqǝṭāč̣č̣ā
አቆለቆለ	āqolaqqola
አቆላለፈ	āqqolāllafa
አቆላመጠ	āqqolāmmaṭa
አቆራኘ	āqqorāñña
አቆሸሸ	āqoššaša
አቆነጀ	āqonaǧǧa
አቆየ	āqoyya
አቆጠቆጠ	āqoṭaqqoṭa
አቈለቈለ	āqʷalaqqʷala
አቈላለፈ	āqʷalāllafa
አቈረቈዘ	āqʷaraqqʷaza
አቈረበ	āqʷarraba
አቈረፈደ	āqʷaraffada
አቈራመደ	āqqʷarāmmada
አቈራረጠ	āqqʷarārraṭa
አቈሰለ	āqʷassala
አቈሳሰለ	āqʷasāssala
አቈነሰ	āqʷannasa
አቈጣጠረ	āqqʷaṭāṭṭara
አቋለፈ	āqqʷāllafa
አቋመጠ	āqʷāmmaṭa
አቋረጠ	āqqʷārraṭa
አቋራጭ	āqqʷārāč̣
አቋቋመ	āqqʷāqʷāma
አቋቋሚ	āqqʷāqʷāmi
አቋቋም	āqqʷāqʷām
አቋፈረ	āqqʷāffara
አበለ	ābbala
አበለዘ	āballaza
አበለጠ	āballaṭa
አበላ	āballā
አበላለጠ	ābalāllaṭa
አበላሸ	ābalāšša
አበል	āball
አበረ	ābbara
አበረረ	ābarrara
አበረታ	ābarattā
አበረከተ	ābarakkata
አበረደ	ābarrada
አበረገገ	ābaraggaga
አበራ	ābarrā
አበራከተ	ābbarākkata
አበራየ	ābarāyya
አበር	ābbar
አበሰ	ābbasa
አበሰለ	ābassala
አበሰረ	ābassara
አበሰበሰ	ābasabbasa
አበሳጨ	ābbasāč̣č̣a
አበሸቀ	ābaššaqa
አበሸቀጠ	ābbašaqqaṭa
አበሻቀጠ	ābbašāqqaṭa
አበቀለ	ābaqqala
አበቃ	ābaqqā
አበቃቃ	ābbaqāqqā
አበበ	ābbaba
አበባማ	ābabāmmā
አበታተነ	ābbatāttana
አበከተ	ābakkata
አበካከነ	ābakākkana
አበዛ	ābazzā
አበደረ	ābaddara
አበዳሪ	ābaddāri
አበጀ	ābaǧǧa
አበጃጀ	ābaǧāǧǧa
አበገነ	ābaggana
አበጠ	ābbaṭa
አበጣበጠ	ābbaṭābbaṭa
አበጣባጭ	ābbaṭābāč̣
አባ	ābbā
አባለገ	ābāllaga
አባለጠ	ābāllaṭa
አባላ	ābāllā
አባልነት	ābālǝnnat
አባረረ	ābbārrara
አባረቀ	ābārraqa
አባራ	ābārrā
አባራሪ	ābbārāri
አባቃ	ābāqqā
አባበለ	ābābbala
አባበጠ	ābābbaṭa
አባባ	ābbābbā
አባባለ	ābbābāla
አባባል	ābbābāl
አባባሰ	ābbābāsa
አባቴ	ābbāte
አባት	ābbāt
አባነነ	ābānnana
አባከነ	ābākkana
አባካኝ	ābākāññ
አባወራ	ābbāwarrā
አባዛ	ābāzzā
አባዥ	ābbāž
አባዬ	ābbāye
አባይ	ābbāy
አባይነት	ābāyǝnnat
አባዳ	ābbādā
አባጨጓሬ	ābbāč̣aggʷārre
አብላላ	ābǝllālā
አብረቀረቀ	ābǝraqarraqa
አብረከረከ	ābǝrakarraka
አብራራ	ābǝrārrā
አብሰለሰለ	ābǝsalassala
አብቃቃ	ābǝqāqqā
አብነት	ābǝnnat
አብዛኛው	ābǝzāññāw
አብዛኛውን	ābǝzāññāwǝn
አቦ	ābbo
አቦነነ	ābonnana
አቦካ	ābokkā
አቦዘነ	ābozzana
አቧለተ	ābʷāllata
አቧራማ	ābʷārrāmā
አቧደነ	ābbʷāddana
አተላ	ātallā
አተመ	āttama
አተመተመ	ātamattama
አተረማመሰ	āttaramāmmasa
አተረፈ	ātarrafa
አተራመሰ	āttarāmmasa
አተራማሽ	āttarāmāš
አተራረፈ	ātarārrafa
አተራተረ	āttarāttara
አተበ	āttaba
አተተ	āttata
አተኛኘት	āttañāñat
አተኛኝ	āttañāñ
አተከነ	ātakkana
አተኮረ	ātakkora
አተኰሰ	ātakkʷasa
አታለለ	āttālala
አታላይ	āttālāy
አታሚ	āttāmi
አታቢ	āttābi
አታች	āttāč
አታከለ	āttākkala
አታከተ	ātākkata
አታገለ	āttāggala
አታጋይ	āttāgāy
አትራ	āttǝrā
አትክልተኛ	ātǝkǝlǝttañā
አትጠራጠር	āttǝṭṭarāṭar
አቶሰቶሰ	ātosattosa
አቶፈቶፈ	ātofattofa
አቸነፈ	āččannafa
አቻ	āččā
አቻምና	āččāmǝnā
አቻቻለ	āččāčāla
አቻኳይ	āččākʷāy
አነሣ	ānaśśā
አነሣሣ	ānnaśāśśā
አነሣሽ	ānnaśāš
አነሰ	ānnasa
አነሰረ	ānassara
አነስተኛ	ānasǝtaññā
አነቀ	ānnaqa
አነቀዘ	ānaqqaza
አነቀፈ	ānaqqafa
አነቃ	ānaqqā
አነቃቂ	ānnaqāqi
አነቃቃ	ānnaqāqqā
አነቃነቀ	ānnaqānnaqa
አነቃናቂ	ānnaqānāqi
አነቈረ	ānaqqʷara
አነበበ	ānabbaba
አነበነበ	ānabannaba
አነበዘ	ānabbaza
አነባ	ānabbā
አነባበረ	ānnabābbara
አነባበሮ	ānnabābaro
አነባበበ	ānabābbaba
አነታረከ	ānnatārraka
አነኈለለ	ānaḫʷallala
አነከሰ	ānakkasa
አነከተ	ānakkata
አነካከሰ	ānakākkasa
አነካኪ	ānnakāki
አነካካ	ānnakākkā
አነኰረ	ānakkʷara
አነኰተ	ānakkʷata
አነኳኰተ	ānakʷākkʷata
አነወረ	ānawwara
አነዘረ	ānazzara
አነደደ	ānaddada
አነዳድ	ānnadād
አነገሠ	ānaggaśa
አነገበ	ānaggaba
አነገተ	ānaggata
አነጋ	ānaggā
አነጋገር	ānnagāgar
አነጋጋ	ānagāggā
አነጋጋሪ	ānnagāgāri
አነጐረ	ānaggʷara
አነጐተ	ānaggʷata
አነጐድ	ānaggʷad
አነጠ	ānnaṭa
አነጠነጠ	ānaṭannaṭa
አነጣጠለ	ānnaṭāṭṭala
አነጣጠረ	ānnaṭāṭṭara
አነጣጣሪ	ānnaṭāṭāri
አነጫነጨ	ānač̣ānnač̣a
አነጻጸረ	ānnaṣāṣṣara
አነፈረ	ānaffara
አነፈረቀ	ānafarraqa
አነፈሰ	ānaffasa
አነፈነ	ānnafana
አነፈነፈ	ānafannafa
አነፋረቀ	ānnafārraqa
አነፋፈሰ	ānafāffasa
አናረ	ānnāra
አናቀለ	ānnāqqala
አናበበ	ānnābbaba
አናባቢ	ānnābābi
አናከሰ	ānnākkasa
አናኪ	ānnāki
አናካ	ānnākkā
አናዘዘ	ānnāzzaza
አናዛዥ	ānnāzāž
አናደደ	ānnāddada
አናደፈ	ānnāddafa
አናዳ	ānnāddā
አናዳጅ	ānnādāǧ
አናገሠ	ānnāggaśa
አናገረ	ānnāggara
አናጊ	ānnāgi
አናጋ	ānnāggā
አናጋሪ	ānnāgāri
አናጋሽ	ānnāgāš
አናጠቀ	ānnāṭṭaqa
አናጠበ	ānnāṭṭaba
አናጠፈ	ānnāṭafa
አናጢነት	ānāṭinnat
አናፈሰ	ānnāffasa
አናፋ	ānāffā
አንሰፈሰፈ	ānǝsafassafa
አንሸረሸረ	ānǝšaraššara
አንሸዋረረ	ānǝšawārrara
አንሻተተ	ānǝšāttata
አንሻፈፈ	ānǝšāffafa
አንሾካሾከ	ānǝšokāšokka
አንሿከከ	ānǝšʷākkaka
አንሿካኪ	ānǝšʷākkāki
አንቀለቀለ	ānǝqalaqqala
አንቀላፋ	ānǝqalāffā
አንቀረበበ	ānǝqarabbaba
አንቀረፈፈ	ānǝqaraffafa
አንቀሰቀሰ	ānǝqasaqqasa
አንቀሳቀሰ	ānǝqasāqqasa
አንቀባረረ	ānǝqabārrara
አንቀዋለለ	ānǝqawāllala
አንቀጠቀጠ	ānǝqaṭaqqaṭa
አንቃረረ	ānǝqārrara
አንቆረቆረ	ānǝqoraqqora
አንቋሸሸ	ānǝqʷāššaša
አንበለበለ	ānǝbalabbala
አንበረከከ	ānǝbarakkaka
አንበሳ	ānǝbassā
አንበሸበሸ	ānǝbašabbaša
አንቦራቀቀ	ānǝborāqqaqa
አንቦገቦገ	ānǝbogabboga
አንቦጨቦጨ	ānǝboč̣č̣abboč̣a
አንቦጫቦጨ	ānǝboč̣č̣ābboč̣a
አንተላከሰ	ānǝtalākkasa
አንተረከከ	ānǝtarakkaka
አንተከተከ	ānǝtakattaka
አንተገተገ	ānǝtagattaga
አንቺዬ	ānǝčiyye
አንከረፈፈ	ānǝkaraffafa
አንከራተተ	ānǝkarāttata
አንከበከበ	ānǝkabakkaba
አንከባለለ	ānǝkabāllala
አንከባከበ	ānǝkabākkaba
አንከተከተ	ānǝkatakkata
አንከታከተ	ānǝkatākkata
አንከፈረረ	ānǝkafarrara
አንካላ	ānǝkāllā
አንካሳ	ānǝkāssā
አንካሴ	ānǝkāsse
አንኳሰሰ	ānǝkʷāssasa
አንኳኳ	ānǝkʷākkʷā
አንዘላዘለ	ānǝzalāzzala
አንዘረፈጠ	ānǝzaraffaṭa
አንዘረፈፈ	ānǝzaraffafa
አንዘፈዘፈ	ānǝzafazzafa
አንዛረጠ	ānǝzārraṭa
አንዛዛ	ānǝzāzzā
አንዠቀዘቀ	ānǝžaqazzaqa
አንዠቀዠቀ	ānǝžaqažžaqa
አንዣበበ	ānǝžābbaba
አንዣባቢ	ānǝžābbābi
አንደላቀቀ	ānǝdalāqqaqa
አንደረበበ	ānǝdarabbaba
አንደቀደቀ	ānǝdaqaddaqa
አንደበደበ	ānǝdabaddaba
አንደባለለ	ānǝdabāllala
አንደኛ	ānǝdaññā
አንደፋደፈ	ānǝdafāddafa
አንዳች	ānǝdāčč
አንድም	ānǝdǝmm
አንድነት	ānǝdǝnnat
አንጀረገገ	ānǝǧaraggaga
አንጀተ	ānǝǧǧata
አንገላታ	ānǝgalāttā
አንገረገበ	ānǝgaraggaba
አንገራገረ	ānǝgarāggara
አንገሸገሸ	ānǝgašaggaša
አንገበገበ	ānǝgabaggaba
አንገዋለለ	ānǝgawāllala
አንገደገደ	ānǝgadaggada
አንገዳገደ	ānǝgadāggada
አንገጫገጨ	ānǝgač̣āggač̣a
አንገፈገፈ	ānǝgafaggafa
አንጋለለ	ānǝgāllala
አንጋሬ	ānǝgārre
አንጋደደ	ānǝgāddada
አንጋጋ	ānǝgāggā
አንጋፋ	ānǝgāffā
አንግዋለለ	ānǝgǝwāllala
አንጐራደደ	ānǝgʷarāddada
አንጐራጐረ	ānǝgʷarāggʷara
አንጐደጐደ	ānǝgʷadaggʷada
አንጓለለ	ānǝgʷāllala
አንጕራጐረ	ānǝgʷǝrāggʷara
አንጠራራ	ānǝṭarrārā
አንጠራራኝ	ānǝṭarārāññ
አንጠራወዘ	ānǝṭarāwwaza
አንጥረኛ	ānǝṭǝraññā
አንጨረፈፈ	ānǝč̣araffafa
አንጸባረቀ	ānǝṣabārraqa
አንፈራገጠ	ānǝfarāggaṭa
አንፈራፈረ	ānǝfarāffara
አንፈቀፈቀ	ānǝfaqaffaqa
አንፏቀቀ	ānǝfʷāqqaqa
አንፏቃቂ	ānǝfʷāqqāqi
አኘከ	āññaka
አኢሉባቦር	āʾilubbābor
አከለ	ākkala
አከላከለ	ākkalākkala
አከል	ākkal
አከመ	ākkama
አከመቻቸ	ākamačāčča
አከማቸ	ākkamāčča
አከረመ	ākarrama
አከረረ	ākarrara
አከረፋ	ākaraffā
አከራካሪ	ākkarākāri
አከራየ	ākkarāyya
አከሰለ	ākassala
አከሰመ	ākassama
አከሰረ	ākassara
አከሰከሰ	ākasakkasa
አከሳ	ākassā
አከበረ	ākabbara
አከበደ	ākabbada
አከባበረ	ākabābbara
አከባበር	ākkabābar
አከተ	ākkata
አከተመ	ākattama
አከታተለ	ākkatāttala
አከነነ	ākannana
አከነፈ	ākannafa
አከናነበ	ākkanānnaba
አከናወ	ākkannāwa
አከናወነ	ākkanāwwana
አከከ	ākkaka
አከድዬ	ākkadǝyye
አከፈለ	ākaffala
አከፋ	ākaffā
አከፋፈለ	ākkafāffala
አከፋፋይ	ākkafāfāy
አካለለ	ākkālala
አካለሰ	ākkāllasa
አካመረ	ākkāmmara
አካሚ	ākkāmi
አካሰሰ	ākkāssasa
አካበበ	ākkābbaba
አካበተ	ākābbata
አካባቢ	ākkābābi
አካተተ	ākkāttata
አካቴ	ākkāte
አካከከ	ākākkaka
አካካሰ	ākkākāsa
አካደነ	ākkāddana
አካፈለ	ākkāffala
አካፋ	ākāffā
አካፋይ	ākkāfāy
አክ	ākk
አክለፈለፈ	ākǝlafallafa
አክታ	ākkǝtā
አኮላሸ	ākkolāšša
አኮመታተረ	ākkomatāttara
አኮማተረ	ākkomāttara
አኮረፈ	ākorrafa
አኮራ	ākorrā
አኮራመተ	ākkorāmmata
አኮሰመነ	ākosammana
አኮበለለ	ākoballala
አኰረተ	ākʷarrata
አኰሰሰ	ākʷassasa
አኰበኰበ	ākʷabakkʷaba
አኰቴት	ākkʷatet
አኳሁዋን	ākkʷāhuwān
አኳሰሰ	ākʷāssasa
አወለቀ	āwallaqa
አወለወለ	āwalawwala
አወለጋገደ	āwwalagāggada
አወላለቀ	āwalāllaqa
አወላመመ	āwwalāmmama
አወላከፈ	āwwalākkafa
አወላካፊ	āwwalākāfi
አወላወለ	āwwalāwwala
አወላገደ	āwwalāggada
አወረሰ	āwarrasa
አወረዛ	āwarazzā
አወረደ	āwarrada
አወራ	āwarrā
አወራረሰ	āwarārrasa
አወራረደ	āwarārrada
አወራጨ	āwwarāč̣a
አወሰለተ	āwasallata
አወሳ	āwassā
አወበቀ	āwabbaqa
አወናበደ	āwwanābbada
አወናባጅ	āwwanābbāǧ
አወናከረ	āwwanākkara
አወናፈለ	āwwanāffala
አወከ	āwwaka
አወካ	āwakkā
አወዛወዘ	āwwazāwwaza
አወደለ	āwaddala
አወደመ	āwaddama
አወደሰ	āwaddasa
አወዳደረ	āwwadāddara
አወዳዳሪ	āwwadādāri
አወጋ	āwaggā
አወጣ	āwaṭṭā
አወጣጣ	āwwaṭāṭṭā
አወፈረ	āwaffara
አዋለደ	āwwāllada
አዋላጅ	āwwālāǧ
አዋልደጌሻ	āwālǝdageššā
አዋሐደ	āwwāḥāda
አዋረደ	āwwārrada
አዋራ	āwwārā
አዋሰነ	āwwāssana
አዋሰደ	āwwāssada
አዋሳኝ	āwwāsāñ
አዋሸከ	āwwāššaka
አዋቀጠ	āwwāqqaṭa
አዋቃ	āwwāqqā
አዋኪ	āwwāki
አዋዋለ	āwwāwāla
አዋዋይ	āwwāwāy
አዋዛ	āwwāzzā
አዋየ	āwwāya
አዋደደ	āwwāddada
አዋጊ	āwwāgi
አዋጋ	āwwāggā
አዋጠረ	āwwāṭṭara
አዋጣ	āwwāṭṭā
አዋጪ	āwwāč̣i
አውለበለበ	āwǝlaballaba
አውላላ	āwǝlāllā
አውራጃ	āwǝrrāǧā
አውሬነት	āwǝrennat
አውሮፓ	āwǝroppā
አውሮፕላን	āwǝroppǝlān
አውተረተረ	āwǝtarattara
አውተፈተፈ	āwǝtafattafa
አውታታ	āwǝtāttā
አውደለደለ	āwǝdaladdala
አውድማ	āwǝdǝmmā
አውጫጭኝ	āwǝč̣āč̣č̣ǝññ
አዘለ	āzzala
አዘለለ	āzzalala
አዘለቀ	āzallaqa
አዘለፈ	āzzallafa
አዘመመ	āzammama
አዘመረ	āzammara
አዘመተ	āzammata
አዘረዘረ	āzzarazzara
አዘረገፈ	āzzaraggafa
አዘረጋ	āzzaragā
አዘረጋጋ	āzzaragāggā
አዘረጠ	āzarraṭa
አዘረጠጠ	āzzaraṭaṭa
አዘረፈ	āzzarrafa
አዘራ	āzzarā
አዘቀዘቀ	āzaqazzaqa
አዘቀጠ	āzaqqaṭa
አዘበራረቀ	āzzabarārraqa
አዘባረቀ	āzzabārraqa
አዘባነነ	āzzabānnana
አዘነ	āzzana
አዘነበ	āzannaba
አዘነበለ	āzanabbala
አዘነጋ	āzanaggā
አዘነጠለ	āzzanaṭṭala
አዘናከተ	āzzanākkata
አዘናጋ	āzzanāggā
አዘንተኛ	āzanǝtaññā
አዘከረ	āzakkara
አዘከዘከ	āzzakazzaka
አዘወረ	āzzawwara
አዘወተረ	āzawattara
አዘዘ	āzzaza
አዘገመ	āzaggama
አዘገነ	āzzaggana
አዘገየ	āzagayya
አዘገጀ	āzzagaǧǧa
አዘጋ	āzzaggā
አዘጋጀ	āzzagāǧǧa
አዘጋገመ	āzagāggama
አዘጠዘጠ	āzaṭazzaṭa
አዘፈቀ	āzaffaqa
አዘፈነ	āzzaffana
አዛለቀ	āzzāllaqa
አዛመተ	āzzāmmata
አዛመደ	āzzāmmada
አዛማች	āzzāmāč
አዛማጅ	āzzāmāǧ
አዛቀ	āzzāqa
አዛባ	āzzābbā
አዛነፈ	āzzānnafa
አዛወረ	āzzāwwara
አዛዘነ	āzāzzana
አዛዥ	āzzāž
አዛጋ	āzzāggā
አዛፈነ	āzzāffana
አዝለገለገ	āzǝlagallaga
አዝማሚያ	āzǝmāmmiyā
አዝረበረበ	āzǝrabbarraba
አዝረከረከ	āzǝrakarraka
አዝረጠረጠ	āzǝraṭarraṭa
አዝረፈረፈ	āzǝrafarrafa
አዝናና	āzǝnānnā
አዝጎረጎረ	āzǝgoragorra
አዞ	āzzo
አዠ	āžža
አዠለጠ	āžžallaṭa
አዥጎረጎረ	āžǝgoraggora
አዥጎደጎደ	āžǝgodaggoda
አዥጐረጐረ	āžǝgʷaraggʷara
አየ	āyya
አየለ	āyyala
አየር	āyyar
አየው	āyyaw
አያ	āyyā
አያሌ	āyyāle
አያያ	āyyāyyā
አያያዘ	āyyāyāza
አያያዝ	āyyāyāz
አይልም	āyǝlǝmm
አይቀርም	āyǝqarǝmm
አይደለም	āyǝdallam
አይገባኝም	āyǝgabāññǝm
አይጥማ	āyǝṭǝmmā
አደለ	āddala
አደለበ	ādallaba
አደላ	ādallā
አደላደለ	āddalāddala
አደላዳይ	āddalādāy
አደመ	āddama
አደመቀ	ādammaqa
አደመጠ	ādammaṭa
አደማ	ādammā
አደረ	āddara
አደረሰ	ādarrasa
አደረገ	āddarraga
አደረገው	ādarragaw
አደራ	ādarrā
አደራረግ	āddarārag
አደራደረ	āddarāddara
አደራጀ	ādarāǧǧa
አደራጅ	āddarāǧ
አደር	āddar
አደርክ	āddarǝk
አደሰ	āddasa
አደሸደሸ	ādašaddaša
አደቀቀ	ādaqqaqa
አደበ	āddaba
አደበነ	ādabbana
አደበዘዘ	ādabazzaza
አደባ	āddabā
አደባለቀ	ādabāllaqa
አደባባይ	āddabābāy
አደባየ	ādabāyya
አደብ	āddab
አደነ	āddana
አደነቀ	ādannaqa
አደነቆረ	ādanaqqora
አደነዘ	ādannaza
አደነዘዘ	ādanazzaza
አደነጋገረ	āddanagāggara
አደናቀፈ	āddanāqqafa
አደናበረ	āddanābbara
አደናባሪ	āddanābāri
አደናገረ	āddanāggara
አደናገጠ	āddanāggaṭa
አደናጋሪ	āddanāgāri
አደን	āddan
አደንጓሬ	ādanǝgʷārre
አደከመ	ādakkama
አደኸየ	ādaḵayya
አደዘደዘ	ādazaddaza
አደደበ	ādaddaba
አደገ	āddaga
አደገኛ	ādagaññā
አደገደ	ādaggada
አደግ	āddag
አደፈ	āddafa
አደፈረሰ	āddafarasa
አደፈጠ	ādaffaṭa
አደፋፈረ	āddafāffara
አዱኛ	ādduññā
አዲስ	āddis
አዳለጠ	ādāllaṭa
አዳላ	āddāllā
አዳመረ	āddāmmara
አዳመቀ	āddāmmaqa
አዳመጠ	āddāmmaṭa
አዳሚ	āddāmi
አዳማቂ	āddāmmāqi
አዳም	āddām
አዳምና	āddāmǝnnā
አዳረሰ	āddārrasa
አዳራሽ	āddārāš
አዳሽ	āddāš
አዳቀለ	āddāqqala
አዳቀቀ	āddāqqaqa
አዳበለ	āddābbala
አዳበረ	ādābbara
አዳባይ	āddābāy
አዳነቀ	ādānnaqa
አዳኝ	āddāñ
አዳከመ	āddākkama
አዳወረ	ādāwwara
አዳይ	āddāy
አዳደለ	ādāddala
አዳደሰ	ādāddasa
አዳገተ	ādāggata
አዳፈነ	ādāffana
አዳፋ	āddāffā
አዳፍኔ	āddāfǝne
አድሎኛ	ādǝloññā
አድመኛ	ādǝmaññā
አድረገ	ādǝrraga
አድራሻ	ādǝrāššā
አድበለበለ	ādǝbalabbala
አድበሰበሰ	ādǝbasabbasa
አድቦለቦለ	ādǝbolabbola
አድፈነፈነ	ādǝfanaffana
አድፋፋ	ādǝfāffā
አዶ	āddo
አዶለዶመ	ādoladdoma
አጀለ	āǧǧala
አጀበ	āǧǧaba
አጃ	āǧǧā
አጃቢ	āǧǧābi
አጃጃለ	āǧǧāǧāla
አጃገነ	āǧǧāgana
አጅሬ	āǧǧǝre
አገለለ	āgallala
አገለሞተ	āgalammota
አገለደመ	āgaladdama
አገለገለ	āgallagala
አገላበጠ	āggalābbaṭa
አገመ	āggama
አገማ	āgammā
አገሣ	āgaśśā
አገረሸ	āgarašša
አገረሸበት	āgaraššabbat
አገሸሸ	āgaššaša
አገባ	āgabbā
አገባብ	āggabāb
አገባት	āgabbāt
አገባደደ	āggabāddada
አገተ	āggata
አገነፋ	āganaffā
አገናኘ	āganāñña
አገናኝ	āgganāññ
አገናዘበ	āgganāzaba
አገናዛቢ	āgganāzābi
አገኘ	āgañña
አገዘ	āggaza
አገዝ	āggaz
አገደ	āggada
አገደመ	āgaddama
አገደፈ	āgaddafa
አገድ	āggad
አገገመ	āgaggama
አገጋሚ	āgaggāmi
አገጫጨ	āggač̣āč̣č̣a
አጋለጠ	āggāllaṭa
አጋመሰ	āggāmmasa
አጋሚ	āggāmi
አጋማሽ	āggāmāš
አጋሪ	āggāri
አጋራ	āggārā
አጋር	āggār
አጋሰሰ	āgāssasa
አጋሰስ	āgāssas
አጋበሰ	āgābbasa
አጋባ	āggābbā
አጋተረ	āggāttara
አጋነነ	āggānnana
አጋኖ	āggānno
አጋዛ	āggāzzā
አጋዥ	āggāž
አጋየ	āgāyya
አጋደለ	āgāddala
አጋደመ	āggāddama
አጋደደ	āggāddada
አጋጅ	āggāǧ
አጋጋለ	āggāgāla
አጋጋመ	āggāgāma
አጋጠመ	āggāṭṭama
አጋጣሚ	āggāṭāmi
አጋጨ	āggāč̣a
አጋፈረ	āggāfara
አጋፈጠ	āggāffaṭa
አጋፋሪ	āggāfāri
አግበሰበሰ	āgǝbasabbasa
አግተለተለ	āgǝtalattala
አግዶኝ	āgǝddoññ
አግጣጫ	āgǝṭāč̣č̣ā
አግፈለፈለ	āgǝfalaffala
አጎላመሰ	āgolāmmasa
አጎላማሽ	āggolāmāš
አጎመዘዘ	āgomazzaza
አጎረሰ	āgorrasa
አጎራበተ	āggorābbata
አጎት	āggot
አጎናጠፈ	āggonāṭṭafa
አጎደለ	āgoddala
አጎፈረ	āgoffara
አጐላ	āgʷallā
አጐረ	āggʷara
አጐረና	āgʷarannā
አጐራ	āgʷarrā
አጐሳቈለ	āgʷasāqqʷala
አጐበደደ	āgʷabaddada
አጐበጐበ	āgʷabaggʷaba
አጐበጠ	āgʷabbaṭa
አጐተነ	āgʷattana
አጐነቈለ	āgʷanaqqʷala
አጐነበሰ	āgʷanabbasa
አጐደጐደ	āgʷadaggʷada
አጓመጠ	āgʷāmmaṭa
አጓራ	āgʷārrā
አጓት	āggʷāt
አጓደደ	āggʷāddada
አጓጐለ	āgʷāggʷala
አጓጓዘ	āggʷāgʷāza
አጕመተመተ	āgʷǝmatammata
አጕረመረመ	āgʷǝramarrama
አጕረጠረጠ	āgʷǝraṭarraṭa
አጕተመተመ	āgʷǝtamattama
አጠለለ	āṭallala
አጠለቀ	āṭallaqa
አጠለቀው	āṭallaqaw
አጠመቀ	āṭammaqa
አጠማ	āṭammā
አጠረሰ	āṭarrasa
አጠረኝ	āṭṭaraññ
አጠራ	āṭarrā
አጠራቀመ	āṭṭarāqqama
አጠቀሰ	āṭaqqasa
አጠቃ	āṭaqqā
አጠቃለለ	āṭṭaqāllala
አጠቆረ	āṭaqqora
አጠበቀ	āṭabbaqa
አጠበበ	āṭabbaba
አጠባ	āṭabbā
አጠነባ	āṭanabbā
አጠነነ	āṭannana
አጠነከረ	āṭanakkara
አጠነፈፈ	āṭanaffafa
አጠና	āṭannā
አጠናቀረ	āṭṭanāqqara
አጠናቀቀ	āṭṭanāqqaqa
አጠናከረ	āṭṭanākkara
አጠናጋ	āṭanāggā
አጠየቀ	āṭayyaqa
አጠያየፈ	āṭṭayāyyafa
አጠገበ	āṭaggaba
አጠጋጋ	āṭṭagāggā
አጠፈፈ	āṭaffafa
አጠፋ	āṭaffā
አጣላ	āṭṭālā
አጣመመ	āṭāmmama
አጣመረ	āṭāmmara
አጣመደ	āṭāmmada
አጣራ	āṭṭārā
አጣቀሰ	āṭṭāqqasa
አጣበቀ	āṭṭābbaqa
አጣበበ	āṭṭābbaba
አጣብቂኝ	āṭṭābǝqiññ
አጣየቀ	āṭṭāyyaqa
አጣደፈ	āṭṭāddafa
አጣገበ	āṭṭāggaba
አጣፈረ	āṭṭāffara
አጣፈጠ	āṭāffaṭa
አጣፋ	āṭṭāffā
አጥለቀለቀ	āṭǝlaqallaqa
አጥላላ	āṭǝlāllā
አጥመለመለ	āṭǝmalammala
አጥመዘመዘ	āṭǝmazammaza
አጥበረበረ	āṭǝbarabbara
አጥናና	āṭǝnānnā
አጥወለወለ	āṭǝwalawwala
አጥፊና	āṭǝfinnā
አጨለመ	āč̣allama
አጨለገ	āč̣allaga
አጨማለቀ	āč̣č̣amāllaqa
አጨማተረ	āč̣č̣amāttara
አጨማደደ	āč̣č̣amāddada
አጨራመመ	āč̣č̣arāmmama
አጨራመደ	āč̣č̣arāmmada
አጨቀየ	āč̣aqayya
አጨባበጠ	āč̣č̣abābbaṭa
አጨነቆረ	āč̣anaqqora
አጨነጎለ	āč̣č̣anaggola
አጨናገፈ	āč̣č̣anāggafa
አጫረሰ	āč̣č̣ārrasa
አጫረተ	āč̣č̣ārrata
አጫወተ	āč̣č̣āwwata
አጭበረበረ	āč̣ǝbarabbara
አጸለየ	āṣṣallaya
አጸና	āṣannā
አጸየፈ	āṣṣayyafa
አጸያፊ	āṣṣayyāfi
አጸደቀ	āṣaddaqa
አጸዳ	āṣaddā
አጽናና	āṣǝnānnā
አፈለሰ	āfallasa
አፈለቀ	āfallaqa
አፈላ	āfallā
አፈረ	āffara
አፈረጠ	āfarraṭa
አፈረጠው	āfarraṭaw
አፈራ	āfarrā
አፈራረሰ	āfarārrasa
አፈሰ	āffasa
አፈሰሰ	āffassasa
አፈቀረ	āffaqqara
አፈተለከ	āfatallaka
አፈታበት	āfattābbat
አፈታተነ	āffatāttana
አፈነ	āffana
አፈነደደ	āfanaddada
አፈነዳ	āfanaddā
አፈነገጠ	āfanaggaṭa
አፈነፈነ	āfanaffana
አፈናቀለ	āffanāqqala
አፈናጠረ	āffanāṭṭara
አፈናጠጠ	āffanāṭṭaṭa
አፈኛ	āfaññā
አፈከፈ	āfakkafa
አፈካ	āfakkā
አፈዘዘ	āfazzaza
አፈገ	āffaga
አፈገመ	āfaggama
አፈገፈገ	āfagaffaga
አፈፈ	āffafa
አፈፍ	āfaff
አፋለመ	āffāllama
አፋለሰ	āffāllasa
አፋለገ	āffāllaga
አፋረደ	āffārada
አፋራም	āffārām
አፋር	āffār
አፋሰሰ	āffāssasa
አፋሸገ	āfāššaga
አፋቀረ	āffāqqara
አፋተለ	āffāttala
አፋተገ	āffāttaga
አፋታ	āffātā
አፋኝ	āffāñ
አፋዘዘ	āffāzzaza
አፋደሰ	āfāddasa
አፋጀ	āffāǧǧa
አፋጠነ	āffāṭṭana
አፋጠጠ	āffāṭṭaṭa
አፋጣኝ	āffāṭāñ
አፋጨ	āffāč̣č̣a
አፋፋመ	āffāfāma
አፍለቀለቀ	āfǝlaqallaqa
አፍለኛ	āfǝlaññā
አፍታታ	āfǝtāttā
አፍንጫማ	āfǝnǝč̣āmmā
አፍኖ	āffǝno
አፎካከረ	āffokākkara
አፓርትማ	āppārǝtǝmā
ኢትዮጲያ	itǝyoṗṗiyā
ኢትዮጲያዊ	itǝyoṗṗiyāwi
ኢትዮጵያዊት	itǝyoṗṗǝyāwit
ኢየሩሳሌም	iyyarusālem
ኢየሱሳዊ	iyyasusāwi
ኢየሱስ	iyyasus
ኢዮቤልዩ	iyyobelǝyu
ኢጣልያኛ	iṭālǝyāññā
ኤክዌተር	ekkǝwetar
እላቂ	ǝllāqi
እልም	ǝllǝm
እልቂት	ǝlǝqitt
እልቅ	ǝlǝqq
እልቅት	ǝllǝqǝt
እልቅና	ǝlǝqǝnnā
እልባት	ǝllǝbāt
እልከኛ	ǝllǝkaññā
እልክ	ǝllǝk
እልፊት	ǝlǝfitt
እልፍኝ	ǝlǝfǝññ
እመ	ǝmma
እመምተኛ	ǝmamǝtaññā
እመር	ǝmmar
እመቤታችን	ǝmmabetāččǝn
እመቤት	ǝmmabet
እመት	ǝmmat
እመጫት	ǝmmač̣āt
እማሆይ	ǝmmāhoy
እሜቴ	ǝmmete
እምር	ǝmmǝr
እምስ	ǝmmǝs
እምቢልተኛ	ǝmǝbilǝtaññā
እምቢተኛ	ǝmǝbitaññā
እምብዛም	ǝmǝbǝzāmm
እምቦሳ	ǝmǝbossā
እምዬ	ǝmmǝye
እሥረኛ	ǝśǝraññā
እሥራት	ǝśśǝrāt
እሥር	ǝśśǝr
እረኛ	ǝrraññā
እረኝነት	ǝrraññǝnnat
እራሪ	ǝrrāri
እራሽ	ǝrrāš
እርማት	ǝrrǝmāt
እርምጃ	ǝrǝmǝǧǧā
እርይ	ǝrrǝy
እርጅና	ǝrǝǧǝnnā
እርግዝና	ǝrǝgǝzǝnnā
እርግጠኛ	ǝrǝgǝṭaññā
እርግፍ	ǝrǝgǝff
እሮምታ	ǝrromǝtā
እሰይ	ǝssay
እሳ	ǝssā
እሳት	ǝssāt
እሳትና	ǝsātǝnnā
እሳቸው	ǝssāččaw
እስልምና	ǝsǝlǝmǝnnā
እስከነ	ǝsǝkanna
እስከናካቴው	ǝsǝkannākkātew
እስከዚህ	ǝsǝkazzih
እስከዚያ	ǝsǝkazziyā
እስፓንኛ	ǝsǝpānǝññā
እሸትነት	ǝšatǝnnat
እሹሩሩ	ǝššururu
እሺ	ǝšši
እሽ	ǝšš
እሽም	ǝššǝm
እሽሩሩ	ǝššǝruru
እሽቅድድም	ǝšǝqǝdǝddǝm
እሽግ	ǝššǝg
እቀጭታ	ǝqqač̣č̣ǝtā
እቅፍ	ǝqqǝf
እበት	ǝbbat
እቡይ	ǝbbuy
እባካችሁ	ǝbākkāččǝhu
እባክህ	ǝbākkǝh
እባክሽ	ǝbākkǝš
እባክዎን	ǝbākkǝwon
እባጭ	ǝbbāč̣
እብሪተኛ	ǝbǝritaññā
እብስ	ǝbbǝss
እቴዋ	ǝtewwā
እትማማች	ǝtǝmmāmāč
እትማማችነት	ǝtǝmmāmāčǝnnat
እትም	ǝttǝm
እትዬ	ǝtǝyye
እትፍ	ǝttǝf
እትፍታ	ǝttǝfǝtā
እችግር	ǝčǝggǝr
እነ	ǝnna
እነሆ	ǝnnaho
እነማን	ǝnnamānn
እነኋት	ǝnnaḫʷāt
እነኛ	ǝnnaññā
እነዚያ	ǝnnazziyā
እና	ǝnnā
እናት	ǝnnāt
እናትነት	ǝnnātǝnnat
እናትና	ǝnnātǝnnā
እንስሳነት	ǝnǝsǝsānnat
እንስትነት	ǝnǝsǝtǝnnat
እንቃቅላ	ǝnǝqāqǝllā
እንቅስቃሴ	ǝnǝqǝssǝqqāse
እንቅጥቃጤ	ǝnǝqǝṭǝqqāṭe
እንቆቅልሽ	ǝnǝqoqǝllǝš
እንቆቆ	ǝnǝqoqqo
እንብርክ	ǝnǝbǝrǝkk
እንትና	ǝnǝtǝnnā
እንትፍ	ǝnǝtǝff
እንቺ	ǝnǝčči
እንክርት	ǝnǝkǝrrǝt
እንክብል	ǝnǝkǝbǝll
እንክብካቤ	ǝnǝkǝbǝkkābe
እንኮኮ	ǝnǝkokko
እንደልብ	ǝnǝdalǝbb
እንደገና	ǝnǝdagganā
እንዲሁም	ǝnǝdihumm
እንጃለት	ǝnǝǧāllat
እንጃልህ	ǝnǝǧāllǝh
እንጃልሽ	ǝnǝǧāllǝš
እንጃልኝ	ǝnǝǧāllǝññ
እንጃባቱ	ǝnǝǧābbātu
እንጆሪ	ǝnǝǧorri
እንግሊዘኛ	ǝnǝgǝlizaññā
እንግልት	ǝnǝgǝlǝtt
እንግዲማ	ǝnǝgǝdimmā
እንግዲያስ	ǝnǝgǝdiyāss
እንጐቻ	ǝnǝgʷaččā
እንጕርጕሮ	ǝnǝgʷǝrǝggʷǝro
እንፍሌ	ǝnǝfǝlle
እኛ	ǝññā
እኝኝ	ǝññǝññ
እኩለ	ǝkkula
እኩሌታ	ǝkkuletā
እኩል	ǝkkul
እኩያ	ǝkkuyyā
እክላም	ǝkkǝlām
እክል	ǝkkǝl
እኮ	ǝkko
እውልኛ	ǝwǝllǝññā
እውነተኛ	ǝwǝnataññā
እውነተኛነት	ǝwǝnataññānnat
እውነትም	ǝwǝnatǝmm
እዚህ	ǝzzih
እዚያ	ǝzziyā
እየመጣ	ǝyyamaṭṭā
እየቅሉ	ǝyyaqǝlu
እየተጠና	ǝyataṭannā
እያንዳንዱ	ǝyyānǝdānǝdu
እያደር	ǝyyāddar
እደሳ	ǝddasā
እዳሪ	ǝddāri
እድለ	ǝddǝla
እድል	ǝddǝl
እድመኛ	ǝdǝmaññā
እድር	ǝddǝr
እድርተኛ	ǝddǝrǝtaññā
እጀ	ǝǧǧa
እጀታ	ǝǧǧatā
እጁን	ǝǧǧun
እጄ	ǝǧǧe
እጅ	ǝǧǧ
እጅብ	ǝǧǧǝb
እጅና	ǝǧǧǝnā
እጅጉን	ǝǧǧǝgun
እጅጌ	ǝǧǧǝge
እጅግ	ǝǧǝgg
እገዛ	ǝggazā
እገዳ	ǝggadā
እግረኛ	ǝgǝraññā
እግድ	ǝggǝd
እጥቤ	ǝṭṭǝbbe
እጭድ	ǝč̣č̣ǝd
እፉኝት	ǝfuññǝt
እፊያ	ǝffiyā
እፋሽ	ǝffāš
እፋፊ	ǝffāfi
እፍ	ǝff
እፍኝ	ǝffǝñ
እፍግ	ǝffǝg
እፍግፍግ	ǝfǝgǝfǝgg
እፎይ	ǝffoy
እፎይታ	ǝffoyǝtā
ከሁሉ	kahullu
ከለለ	kallala
ከለላ	kallalā
ከለሰ	kallasa
ከለበ	kallaba
ከለበሰ	kallabbasa
ከለቻ	kallaččā
ከለከለ	kalakkala
ከለፈ	kallafa
ከለፍላፋ	kalafǝlāffā
ከላሽ	kallāš
ከላባ	kallābā
ከል	kall
ከመረ	kammara
ከመቼ	kamačče
ከመቼውም	kamaččewǝmm
ከመከመ	kamakkama
ከማሪ	kammāri
ከሞላ	kamollā
ከሠተ	kaśśata
ከሠተለት	kaśśatallat
ከሠተበት	kaśśatabbat
ከረመ	karrama
ከረረ	karrara
ከረበተ	karabbata
ከረተፈ	karattafa
ከረከመ	karakkama
ከረከረ	karakkara
ከረደደ	karaddada
ከረፋ	karaffā
ከርታታ	karǝtāttā
ከርከሮ	karǝkarro
ከርዳዳ	karǝdāddā
ከርፋፋ	karǝffāfā
ከሰለ	kassala
ከሰልማ	kasalǝmmā
ከሰመ	kassama
ከሰረ	kassara
ከሰሰ	kassasa
ከሰበ	kassaba
ከሰከሰ	kasakkasa
ከሲታ	kassittā
ከሳ	kassā
ከሳራ	kassārā
ከሳይ	kassāy
ከሸነ	kaššana
ከሸፈ	kaššafa
ከበረ	kabbara
ከበርቴ	kabbarǝte
ከበሰ	kabbasa
ከበበ	kabbaba
ከበተ	kabbata
ከበደ	kabbada
ከባዳ	kabbādā
ከባድ	kabbād
ከተለበ	katallaba
ከተል	kattall
ከተመ	kattama
ከተረ	kattara
ከተበ	kattaba
ከተተ	kattata
ከተከተ	katakkata
ከተፈ	kattafa
ከት	katt
ከትቢያ	katǝbbiyā
ከቶ	katto
ከቶውንም	kattowǝnǝmm
ከቸረ	kaččara
ከቸቸ	kaččača
ከቻራ	kačārrā
ከች	kačč
ከነበለ	kanabbala
ከነቤተሰቡ	kannabetasabu
ከነተረ	kanattara
ከነነ	kannana
ከነአካቴው	kannaʾākkātew
ከነከነ	kanakkana
ከነዳ	kanaddā
ከነፈ	kannafa
ከንቱነት	kanǝtunnat
ከካ	kakkā
ከውታታ	kawǝtāttā
ከውካዋ	kawǝkāwwā
ከዚህ	kazzih
ከዚህም	kazzihǝm
ከዚያ	kazziyā
ከደነ	kaddana
ከዳ	kaddā
ከዳተኛ	kadātaññā
ከጀለ	kaǧǧala
ከፈለ	kaffala
ከፈተ	kaffata
ከፈነ	kaffana
ከፈከፈ	kafakkafa
ከፈፈ	kaffafa
ከፋ	kaffā
ከፋኝ	kaffāñ
ከፋፈለ	kafāffala
ከፋፈተ	kafāffata
ከፍ	kaff
ከፍራራ	kafǝrrārā
ከፍተኛ	kaffǝtaññā
ከፍታ	kaffǝtā
ኩሊነት	kulinnat
ኩልሽት	kulǝššǝt
ኩምትርትር	kumǝtǝrǝtǝrr
ኩረጃ	kurraǧā
ኩራተኛ	kurātaññā
ኩራዝ	kurrāz
ኩርምት	kurǝmǝtt
ኩርምትምት	kurǝmǝtǝmǝtt
ኩርትም	kurǝtǝmm
ኩርትምትም	kurǝtǝmǝtǝmm
ኩባያ	kubbāyyā
ኩብ	kubb
ኩብኩባ	kubǝkubbā
ኩይሳ	kuyyǝsā
ኩፍ	kuff
ኩፍኝ	kuffǝññ
ኪራየተኛ	kirāyataññā
ካባ	kābbā
ካቤላ	kābellā
ካቦ	kābbo
ካቻምና	kāččāmǝnā
ካች	kāčč
ካንዴላ	kānǝdellā
ካካ	kākkā
ካውያ	kāwǝyyā
ካደመ	kāddama
ካዳሚ	kāddāmi
ካፊያ	kāffiyā
ካፍያ	kāffǝyā
ካፒታሊዝም	kāppitālizǝm
ካፖርት	kāpporǝt
ኬላ	kellā
ክለሳ	kǝllasā
ክልል	kǝllǝl
ክልስ	kǝllǝs
ክልብሽ	kǝlǝbǝšš
ክልብሽታ	kǝllǝbǝšǝtā
ክመራ	kǝmmarā
ክምር	kǝmmǝr
ክምቹ	kǝmǝčču
ክምችት	kǝmǝččǝt
ክር	kǝrr
ክርስትና	kǝrǝsǝtǝnnā
ክርክም	kǝrǝkkǝm
ክርክር	kǝrǝkkǝr
ክርድ	kǝrǝdd
ክርፍፍ	kǝrǝfǝff
ክስ	kǝss
ክብ	kǝbb
ክብልል	kǝbǝlǝll
ክብርና	kǝbǝrǝnnā
ክብብ	kǝbǝbb
ክብነት	kǝbbǝnnat
ክት	kǝtt
ክትር	kǝttǝr
ክትባት	kǝttǝbāt
ክትትል	kǝtǝttǝl
ክትካች	kǝtǝkkāč
ክችች	kǝččǝč
ክንውን	kǝnǝwwǝn
ክካም	kǝkkām
ክክ	kǝkk
ክው	kǝww
ክውትት	kǝwǝtǝtt
ክጀላ	kǝǧǧalā
ክፉኛ	kǝfuññā
ክፋተኛ	kǝfātaññā
ክፋይ	kǝffāy
ክፍ	kǝff
ክፍት	kǝffǝt
ክፍያ	kǝfǝyyā
ኮምፓስ	komǝpāss
ኮረሸመ	koraššama
ኮረብታማ	korabǝtāmmā
ኮረጀ	korraǧa
ኮረጠ	korraṭa
ኮራ	korrā
ኮርማታ	korǝmāttā
ኮርቻ	korǝččā
ኮሰመነ	kosammana
ኮስማና	kosǝmānnā
ኮስታራ	kosǝtārrā
ኮሸሽ	košašš
ኮበለለ	koballala
ኮተኮተ	kotakkota
ኮቴ	kotte
ኮትቻ	kotǝččā
ኮዳ	koddā
ኮፈኮፈ	kofakkofa
ኰለለ	kʷallala
ኰለል	kʷallal
ኰላ	kʷallā
ኰልታፋ	kʷalǝtāffā
ኰልኰሎ	kʷalǝkʷallo
ኰመኰመ	kʷamakkʷama
ኰረተመ	kʷarattama
ኰረታተመ	kʷaratāttama
ኰረኰመ	kʷarakkʷama
ኰረኰረ	kʷarakkʷara
ኰረዳ	kʷaraddā
ኰረፈ	kʷarrafa
ኰረፌ	kʷarrafe
ኰሰሰ	kʷassasa
ኰሰተረ	kʷasattara
ኰሰኰሰ	kʷasakkʷasa
ኰሳሳ	kʷassāsā
ኰሳሳነት	kʷasāsānnat
ኰስታራ	kʷasǝtārrā
ኰስኳሳ	kʷasǝkʷāssā
ኰነነ	kʷannana
ኰናኝ	kʷannāñ
ኵርፈኛ	kʷǝrǝfaññā
ኵርፍተኛ	kʷǝrrǝfǝtaññā
ወለል	walall
ወለም	walamm
ወለቀ	wallaqa
ወለወለ	walawwala
ወለደ	wallada
ወለድ	wallad
ወለገደ	walaggada
ወለጋ	wallagā
ወላለቀ	walāllaqa
ወላለደ	walāllada
ወላወለ	walāwwala
ወላይታ	walāyǝttā
ወላይትኛ	walāyǝtǝññā
ወላድ	wallād
ወልማማ	walǝmmāmā
ወልካፋ	walǝkkāfā
ወልጋዳ	walǝgāddā
ወሎ	wallo
ወመቴ	wammate
ወረረ	warrara
ወረርሽኝ	wararǝšǝññ
ወረሰ	warrasa
ወረቦ	warabbo
ወረተኛ	warataññā
ወረክራካ	warakǝrākkā
ወረወረ	warawwara
ወረዛ	warazzā
ወረደ	warrada
ወረገኑ	warraganu
ወረፈ	warrafa
ወራረደ	warārrada
ወራዳ	warrāddā
ወራዳነት	warrāddānnat
ወራፊ	warrāfi
ወሬኛ	wareññā
ወርቃማ	warǝqāmmā
ወርድና	warǝdǝnnā
ወሮበላ	warroballā
ወሰለተ	wasallata
ወሰራ	wasarrā
ወሰነ	wassana
ወሰን	wassan
ወሰንተኛ	wasanǝtaññā
ወሰወሰ	wasawwasa
ወሰደ	wassada
ወሰደው	wassadaw
ወሰድ	wasadd
ወሳኝ	wassāñ
ወሳፍቻ	wassāfǝččā
ወስላታ	wasǝlāttā
ወስዋሳ	wasǝwāssā
ወሸለ	waššala
ወሸመ	waššama
ወሸቀ	waššaqa
ወሸከተ	wašakkata
ወሻቃ	waššāqqā
ወሽመላ	wašǝmallā
ወሽካታ	wašǝkāttā
ወቀረ	waqqara
ወቀሰ	waqqasa
ወቀሳ	waqassā
ወቀጠ	waqqaṭa
ወቃ	waqqā
ወበራ	wabarrā
ወበቀ	wabbaqa
ወባማ	wabāmmā
ወቦ	wabbo
ወተወተ	watawwata
ወተፈ	wattafa
ወተፍታፋ	watafǝtāffā
ወታደራዊ	wattāddarāwi
ወታደር	watāddar
ወታደርነት	watāddarǝnnat
ወታፋ	wattāffā
ወትዋታ	watǝwwātā
ወነበደ	wanabbada
ወነከረ	wanakkara
ወነወነ	wanawwana
ወነጀለ	wanaǧǧala
ወንድማማችነት	wanǝdǝmmāmāčǝnnat
ወንድም	wanǝdǝmm
ወንድነት	wanǝdǝnnat
ወንጀለኛ	wanǝǧalaññā
ወከለ	wakkala
ወከፍ	wakkaf
ወኪል	wakkil
ወካይ	wakkāy
ወዘተ	wazzata
ወዘተ\.	wazzata\.
ወዘወዘ	wazawwaza
ወዘፈ	wazzafa
ወዛ	wazzā
ወዛም	wazzām
ወዛደር	wazāddar
ወየበ	wayyaba
ወየው	wayyaw
ወያላ	wayyālā
ወይም	wayǝmm
ወይስ	wayǝss
ወይንማ	wayǝnǝmmā
ወዮ	wayyo
ወዮታ	wayyotā
ወደለ	waddala
ወደላ	wadallā
ወደመ	waddama
ወደረ	waddara
ወደረኛ	wadaraññā
ወደቀ	waddaqa
ወደዚህ	wadazzih
ወደዚያ	wadazziyā
ወደደ	waddada
ወደድ	waddad
ወደጎን	wadagonn
ወዲያልኝ	wadiyāllǝññ
ወዳድ	waddād
ወዳጅነት	wadāǧǝnnat
ወዶ	waddo
ወገረ	waggara
ወገኛ	wagaññā
ወገግ	wagagg
ወገግታ	waggagǝtā
ወጋ	waggā
ወጋጋ	wagāggā
ወጌሻ	wageššā
ወጣ	waṭṭā
ወጣራ	waṭṭārrā
ወጣትነት	waṭṭātǝnnat
ወጣች	waṭāčč
ወጥ	waṭṭ
ወጭማዳ	wač̣ǝmāddā
ወፈረ	waffara
ወፈር	wafarr
ወፈፈ	waffafa
ወፈፌ	wafaffe
ወፈፍተኛ	wafafǝtaññā
ወፋፈረ	wafāffara
ዋለለ	wāllala
ዋስትና	wāsǝtǝnnā
ዋሸ	wāšša
ዋሻ	wāššā
ዋተተ	wāttata
ዋነተኛ	wānataññā
ዋነኛ	wānnaññā
ዋና	wānnā
ዋኘ	wāñña
ዋዠ	wāžža
ዋጀ	wāǧǧa
ውሀማ	wǝhāmmā
ውለኛ	wǝlaññā
ውላቂ	wǝllāqi
ውላጅ	wǝllāǧ
ውል	wǝll
ውልቃት	wǝllǝqāt
ውልቅ	wǝllǝq
ውልብ	wǝllǝb
ውልታ	wǝllǝtā
ውልክፍክፍ	wǝlǝkǝfǝkǝff
ውራ	wǝrrā
ውራጅ	wǝrrāǧ
ውር	wǝrr
ውርር	wǝrrǝr
ውርርድ	wǝrǝrrǝd
ውርንጭላ	wǝrǝnǝč̣ǝllā
ውርጅብኝ	wǝrǝǧǝbbǝññ
ውሳኔ	wǝssāne
ውስልትና	wǝsǝlǝtǝnnā
ውሻ	wǝššā
ውሻነት	wǝššānnat
ውሽማ	wǝšǝmmā
ውቂያ	wǝqqiyā
ውቃጭ	wǝqqāč̣
ውቅራት	wǝqqǝrāt
ውትፍ	wǝttǝf
ውነተኛ	wǝnataññā
ውንብድና	wǝnǝbǝdǝnnā
ውንድቢ	wǝnǝdǝbbi
ውከላ	wǝkkalā
ውክልና	wǝkkǝlǝnnā
ውዝዋዜ	wǝzǝwwāze
ውዝፍ	wǝzzǝf
ውይባት	wǝyyǝbāt
ውደሳ	wǝddasā
ውዳሴ	wǝddāse
ውዳቂ	wǝddāqi
ውዴላ	wǝddellā
ውድ	wǝdd
ውድነት	wǝddǝnnat
ውድድር	wǝdǝddǝr
ውጊያ	wǝggiyā
ውፋሬ	wǝffāre
ዐልቅት	ʿālǝqqǝt
ዐመቀ	ʿāmmaqa
ዐመጠ	ʿāmmaṭa
ዐመጠኛ	ʿāmaṭaññā
ዐመፀ	ʿāmmaḍa
ዐመፀኛ	ʿāmaḍaññā
ዐሥረኛ	ʿāśǝraññā
ዐሥር	ʿāśśǝr
ዐረቀ	ʿārraqa
ዐረበ	ʿārraba
ዐረብኛ	ʿārabǝññā
ዐረገ	ʿārraga
ዐረፈ	ʿārrafa
ዐራቢ	ʿārrābi
ዐቀደ	ʿāqqada
ዐቃቢት	ʿāqqābit
ዐቃቤ	ʿāqqābe
ዐበደ	ʿābbada
ዐበድ	ʿābbad
ዐወቀ	ʿāwwaqa
ዐወደ	ʿāwwada
ዐወደኝ	ʿāwwadaññ
ዐውድማ	ʿāwǝdǝmmā
ዐየ	ʿāyya
ዐይናማ	ʿāyǝnāmmā
ዓለመኛ	ʿālamaññā
ዓለማዊነት	ʿālamāwinnat
ዕልል	ʿǝlǝll
ዕምቅ	ʿǝmmǝq
ዕሴት	ʿǝsset
ዕቀዳ	ʿǝqqadā
ዕቁብ	ʿǝqqub
ዕቃ	ʿǝqqā
ዕቅድ	ʿǝqqǝd
ዕውር	ʿǝwwǝr
ዕውቀተኛ	ʿǝwǝqataññā
ዕጮኛ	ʿǝč̣oññā
ዘለለ	zallala
ዘለል	zalall
ዘለም	zalamm
ዘለሰ	zallasa
ዘለሰኛ	zalasaññā
ዘለቀ	zallaqa
ዘለዘለ	zalazzala
ዘለግ	zalagg
ዘለግላጋ	zalagǝllāgā
ዘለፈ	zallafa
ዘላበደ	zalābbada
ዘላን	zallān
ዘልዛላ	zalǝzzālā
ዘልዛልነት	zalǝzāllǝnnat
ዘመመ	zammama
ዘመረ	zammara
ዘመተ	zammata
ዘመዘመ	zamazzama
ዘመዳሞች	zamadāmočč
ዘማ	zammā
ዘማዊ	zammāwi
ዘረረ	zarrara
ዘረነቀ	zarannaqa
ዘረኛ	zaraññā
ዘረከተ	zarakkata
ዘረክራካ	zarakǝrākkā
ዘረዘረ	zarazzara
ዘረገፈ	zaraggafa
ዘረጋ	zaraggā
ዘረፈ	zarrafa
ዘረፍራፋ	zarafǝrāffā
ዘራ	zarrā
ዘራሽ	zarrāš
ዘራፍ	zarrāf
ዘርካታ	zarǝkāttā
ዘርዛራ	zarǝzārrā
ዘርፋፋ	zarǝfāffā
ዘርፍና	zarǝfǝnnā
ዘቀዘቀ	zaqazzaqa
ዘቀጠ	zaqqaṭa
ዘቅዛቃ	zaqǝzāqqā
ዘበለለ	zaballala
ዘበራረቀ	zabarārraqa
ዘበተ	zabbata
ዘበነ	zabbana
ዘበናይነት	zabanāyǝnnat
ዘበኛ	zabaññā
ዘበዘበ	zabazzaba
ዘበጠ	zabbaṭa
ዘባ	zabbā
ዘባረቀ	zabārraqa
ዘብዛባ	zabǝzābbā
ዘብጥያ	zabǝṭǝyyā
ዘነመ	zannama
ዘነቀ	zannaqa
ዘነቆለ	zanaqqola
ዘነበ	zannaba
ዘነተረ	zanattara
ዘነነ	zannana
ዘነን	zanann
ዘነጋ	zanaggā
ዘነፈ	zannafa
ዘና	zannā
ዘናጭ	zannāč̣
ዘንባላ	zanǝbāllā
ዘንካታ	zanǝkāttā
ዘንፋላ	zanǝfāllā
ዘከረ	zakkara
ዘከዘከ	zakazzaka
ዘኬ	zakke
ዘክዛካ	zakǝzākkā
ዘወረ	zawwara
ዘወርዋራ	zawarǝwārrā
ዘዋራ	zawwārrā
ዘው	zaww
ዘየረ	zayyara
ዘየነ	zayyana
ዘየደ	zayyada
ዘያጅ	zayyāǧ
ዘዴኛ	zadeññā
ዘገምተኛ	zagamǝtaññā
ዘገረረ	zagarrara
ዘገበ	zaggaba
ዘገነ	zaggana
ዘገነነ	zagannana
ዘገየ	zagayya
ዘጋ	zaggā
ዘግየት	zagǝyatt
ዘጎርጓራ	zagorǝgʷārrā
ዘጎነ	zaggona
ዘጠነኛ	zaṭanaññā
ዘጠኝ	zaṭaññ
ዘፈቀ	zaffaqa
ዘፈነ	zaffana
ዘፈዘፈ	zafazzafa
ዘፍ	zaff
ዙጥ	zuṭṭ
ዚቀኛ	ziqaññā
ዛተለ	zāttala
ዛቻ	zāččā
ዛኒጋባ	zānigābbā
ዛዘነ	zāzzana
ዛጎልማ	zāgolǝmmā
ዜመኛ	zemaññā
ዜንጠኛ	zenǝṭaññā
ዝሊያ	zǝlliyā
ዝላይ	zǝllāy
ዝልል	zǝllǝl
ዝልስ	zǝllǝs
ዝመራ	zǝmmarā
ዝሙተኛ	zǝmmutaññā
ዝሙት	zǝmmut
ዝማሬ	zǝmmāre
ዝም	zǝmm
ዝምታ	zǝmmǝtā
ዝራጭ	zǝrrāč̣
ዝር	zǝrr
ዝርክርክ	zǝrǝkǝrǝkk
ዝርክት	zǝrǝkkǝtt
ዝርዛሪ	zǝrǝzzāri
ዝርዝር	zǝrǝzzǝr
ዝርያ	zǝrrǝyā
ዝርግነት	zǝrǝgǝnnat
ዝርግፍ	zǝrǝgǝff
ዝቀታ	zǝqqatā
ዝቃጭ	zǝqqāč̣
ዝቅ	zǝqq
ዝቅተኛ	zǝqqǝtaññā
ዝብዝብ	zǝbǝzzǝb
ዝተታም	zǝttatām
ዝተት	zǝttat
ዝነኛ	zǝnnaññā
ዝነጣ	zǝnnaṭā
ዝና	zǝnnā
ዝናር	zǝnnār
ዝናቢስ	zǝnnābis
ዝንባሌ	zǝnǝbbāle
ዝንጅብል	zǝnǝǧǝbǝll
ዝንፋት	zǝnnǝfāt
ዝክዝክ	zǝkǝzǝkk
ዝውውር	zǝwǝwwǝr
ዝየራ	zǝyyarā
ዝየና	zǝyyanā
ዝየዳ	zǝyyadā
ዝይ	zǝyy
ዝግ	zǝgg
ዝግተኛ	zǝggǝtaññā
ዝግታ	zǝggǝtā
ዝግጁ	zǝgǝǧǧu
ዝግጅት	zǝgǝǧǧǝt
ዠለጠ	žallaṭa
ዠረር	žararr
ዠረገገ	žaraggaga
ዠርጋዳ	žarǝgāddā
ዠርጋጋ	žarǝgāggā
ዠቀዠቀ	žaqažžaqa
ዠበደ	žabbada
ዠበድ	žabbad
ዠብረር	žabǝrarr
ዠብራራ	žabǝrārrā
ዥማት	žǝmmāt
ዥዋዥዌ	žǝwwāžǝwwe
ዥው	žǝww
ዦፌ	žoffe
የለለው	yalallaw
የለም	yallam
የለሽ	yallaš
የለኝም	yallaññǝm
የለውም	yallawǝm
የሌለ	yalella
የሌለው	yallellaw
የሐሰት	yaḥāssat
የሕግ	yaḥǝgg
የመረረ	yamarrara
የመሸኛ	yamašaññā
የሚመጣው	yammimaṭāw
የሚበቃ	yammibaqā
የሚዘለቅ	yamizzallaq
የሚያህል	yammiyāhǝl
የሚያመሰኳ	yammiyāmasakkʷā
የሚያሰለች	yammiyāsalačč
የሚያስቅ	yammiyāssǝq
የሚያስተኛ	yammiyāsǝtaññā
የሚያከራክር	yammiyākkarākkǝr
የሚጠልዝ	yammiṭallǝz
የማን	yamānn
የማዘጋጃ	yamāzzagāǧā
የማያከራክር	yammāyākkarākkǝr
የማያዛልቅ	yammāyāzzāllǝq
የማይሆን	yammāyǝhon
የማይለወጥ	yammāyǝllawwaṭ
የማይለው	yammāyǝlaw
የማይል	yammāyǝl
የማይረባ	yammāyǝrabā
የማይሻር	yammāyǝššār
የማይቀር	yammāyǝqar
የማይበቃ	yammāyǝbaqā
የማይበገር	yammāyǝbbaggar
የማይታጠፍ	yammāyǝtāṭṭaf
የማይጠዳው	yammāyǝṭadāw
የምሩን	yamǝrrun
የምር	yamǝrr
የምስራች	yamǝssǝrāčč
የረሳው	yarassāw
የረፋድ	yaraffād
የሩጫ	yaruč̣č̣ā
የርሱ	yarǝssu
የርሳቸው	yarǝsāččaw
የሰራ	yassarā
የሱ	yassu
የሳቸው	yassāččaw
የሸማኔ	yašammāne
የቀረ	yaqarra
የቀረች	yaqarrač
የቀረው	yaqarraw
የቆየ	yaqoyya
የቈላ	yaqʷallā
የበለጠ	yaballaṭa
የበላይነት	yabalāyǝnnat
የበቃ	yabaqqā
የባሰበት	yabāsabbat
የተለቀቀ	yatalaqqaqa
የተለያየ	yatalayāyya
የተሟላ	yatamʷāllā
የተሟጠጠ	yatamʷāṭṭaṭa
የተቀደሰ	yataqaddasa
የተንጠለጠለ	yatanǝṭalaṭṭala
የተወለደ	yatawwalada
የተወሰነ	yatawassana
የተዛባ	yatazābbā
የተጠላ	yataṭallā
የተጣላ	yataṭāllā
የተጣራ	yataṭārrā
የተጸውዖ	yataṣawwǝʿo
የታማ	yatāmmā
የትም	yatǝmm
የትና	yatǝnnā
የትኛው	yatǝññāw
የትየለሌ	yatǝyyalale
የነቃ	yanaqqā
የነጋዴዎች	yanaggādewočč
የናት	yannāt
የንስሐ	yanǝssǝḥā
የአህያ	yaʾāhǝyyā
የአየር	yaʾāyyar
የአጋጣሚ	yaʾāgāṭṭāmi
የእጅ	yaʾǝǧǧ
የከበረ	yakabbara
የካቲት	yakkātit
የክት	yakǝtt
የኮቴ	yakotte
የወረገኑ	yawarraganu
የወንድም	yawanǝdǝmm
የዋህ	yawwāh
የዋህነት	yawwāhǝnnat
የዝናር	yazǝnnār
የይ	yayy
የደምበኛ	yadamǝbaññā
የደራ	yadarrā
የደስደስ	yadasǝdass
የድመት	yadǝmmat
የገዛ	yagazzā
የጉበት	yagubbat
የጋማ	yagāmmā
የግሥ	yagǝśś
የጎልማሶች	yagolǝmāsočč
የጎደለበት	yagoddalabbat
የጠለቀ	yaṭallaqa
የጠረጴዛ	yaṭaraṗṗezā
የጥሪ	yaṭǝrri
የጥቅል	yaṭǝqqǝl
የጥያቄ	yaṭǝyyāqe
የጫማ	yač̣āmmā
የጭቅና	yač̣ǝqqǝnnā
የፈሰሰ	yafassasa
የፊታችን	yafitāččǝn
የፊጥኝ	yafiṭṭǝññ
ያለ	yālla
ያለውድ	yālawǝdd
ያለግምት	yālagǝmmǝt
ያልተሟላ	yālǝtamʷāllā
ያልተወሰነ	yālǝtawassana
ያልተገራ	yālǝtagarrā
ያልታሰበ	yālǝtāssaba
ያመዋል	yāmmawāl
ያም	yāmm
ያሳማ	yāssāmā
ያቻትና	yāččātǝnnā
ያች	yāčč
ያኔ	yānne
ያን	yānn
ያንማ	yānnǝmmā
ያንን	yānnǝn
ያኛው	yāññāw
ያውና	yāwǝnnā
ያውኮ	yāwǝkko
ያዝ	yāzz
ያደረ	yāddara
ያገለገለ	yāgalaggala
ያጎት	yāggot
ይህም	yǝhǝmm
ይህን	yǝhǝnn
ይህኛው	yǝhǝññāw
ይሉኝ	yǝluññ
ይሉኝታ	yǝluññǝtā
ይልቁንም	yǝlǝqunǝmm
ይልቁንስ	yǝlǝqunǝss
ይልቅስ	yǝlǝqǝss
ይስጠን	yǝsǝṭann
ይስጣኝ	yǝsǝṭāññ
ይስጥልኝ	yǝsǝṭǝlǝññ
ይሻላል	yǝššālāl
ይብላኝ	yǝbǝlāññ
ይውልህ	yǝwǝllǝh
ይግባኝ	yǝgǝbāññ
ደለለ	dallala
ደለቀ	dallaqa
ደለበ	dallaba
ደለኸ	dallaḵa
ደለዘ	dallaza
ደለደለ	daladdala
ደለፈሰ	dalaffasa
ደላ	dallā
ደላላ	dallālā
ደላይ	dallāy
ደልቃቃ	dalǝqāqqā
ደልዳላ	dalǝddālā
ደመመ	dammama
ደመረ	dammara
ደመሰሰ	damassasa
ደመቀ	dammaqa
ደመና	dammanā
ደመኛ	damaññā
ደመወዝተኛ	damawazǝtaññā
ደመደመ	damaddama
ደማ	dammā
ደማቃ	dammāqā
ደማቅ	dammāq
ደም	damm
ደምበኛ	damǝbaññā
ደሞ	dammo
ደረሰ	darrasa
ደረሰለት	darrasallat
ደረሰመ	darassama
ደረሰበት	darrasabat
ደረሰኝ	darrasaññ
ደረቀ	darraqa
ደረበ	darraba
ደረተ	darrata
ደረደረ	daraddara
ደረጀ	daraǧǧa
ደረገመ	daraggama
ደራ	darrā
ደራሲነት	darāsinnat
ደርሽ	darrǝšš
ደርበብ	darǝbabb
ደርባባ	darǝbābbā
ደርካካ	darǝkākkā
ደሰመ	dassama
ደሰሰ	dassasa
ደስ	dass
ደስተኛ	dassǝtaññā
ደስታ	dassǝtā
ደቀ	daqqa
ደቀለ	daqqala
ደቀመዝሙር	daqqamazǝmur
ደቀቀ	daqqaqa
ደቀነ	daqqana
ደቀደቀ	daqaddaqa
ደቃ	daqqā
ደቃቃ	daqqāqā
ደቃቅ	daqqāq
ደቅደቂት	daqǝdaqqit
ደቆሰ	daqqosa
ደቆስቋሳ	daqosǝqʷāssā
ደቋቆሰ	daqʷāqqosa
ደበለለ	daballala
ደበለቀ	daballaqa
ደበላለቀ	dabalāllaqa
ደበልባላ	dabalǝbāllā
ደበሰሰ	dabassasa
ደበስባሳ	dabasǝbāssā
ደበቀ	dabbaqa
ደበበ	dabbaba
ደበተ	dabbata
ደበነ	dabbana
ደበዘዘ	dabazzaza
ደበደበ	dabaddaba
ደባል	dabbāl
ደባቃ	dabbāqā
ደባበሰ	dabābbasa
ደባች	dabbāč
ደብሳሳ	dabǝsāssā
ደብዛዛ	dabǝzāzzā
ደብዳቤ	dabǝdābbe
ደቦለቦለ	dabolabbola
ደቦል	dabbol
ደቦልቧላ	dabolǝbʷāllā
ደኅንነት	daḫǝnǝnnat
ደነሰ	dannasa
ደነቀ	dannaqa
ደነቀረ	danaqqara
ደነቀፈ	danaqqafa
ደነቆለ	danaqqola
ደነቆረ	danaqqora
ደነበረ	danabbara
ደነበዘ	danabbaza
ደነባ	danabbā
ደነነ	dannana
ደነዘ	dannaza
ደነዘዘ	danazzaza
ደነደነ	danadanna
ደነገዘ	danaggaza
ደነገገ	danaggaga
ደነገጠ	danaggaṭa
ደነጎረ	danaggora
ደነፋ	danaffā
ደነፋፋ	danaffāfā
ደናማ	dannāmmā
ደናሽ	dannāš
ደን	dann
ደንቃፋ	danǝqāffā
ደንበኛ	danǝbaññā
ደንባራ	danǝbārrā
ደንባዛ	danǝbāzzā
ደንደሮ	danǝdarro
ደንደሳም	danǝddassām
ደንደስ	danǝdass
ደንዳና	danǝdānnā
ደንዳኔ	danǝdānne
ደንገሎ	danǝgallo
ደንጉላ	danǝgullā
ደንጋራ	danǝgārrā
ደንጋዛ	danǝgāzzā
ደከመ	dakkama
ደካማ	dakāmmā
ደኸየ	daḵayya
ደወለ	dawwala
ደዋይ	dawwāy
ደደረ	daddara
ደደቀ	daddaqa
ደደበ	daddaba
ደደብ	daddab
ደጀ	daǧǧa
ደጃች	daǧǧāč
ደጃፍ	daǧǧāf
ደጅ	daǧǧ
ደገመ	daggama
ደገሰ	daggasa
ደገነ	daggana
ደገኛ	dagaññā
ደገደገ	dagaddaga
ደገፈ	daggafa
ደጉሰ	daggusa
ደጋደግ	daggādagg
ደጋፊ	daggāfi
ደግ	dagg
ደግነቱ	daggǝnnatu
ደግነት	daggǝnnat
ደግዳጋ	dagǝdāggā
ደግፍ	daggǝf
ደጎመ	daggoma
ደጎባ	daggobā
ደፈረ	daffara
ደፈረሰ	dafarrasa
ደፈቀ	daffaqa
ደፈነ	daffana
ደፈንፋና	dafanǝfānnā
ደፈደፈ	dafaddafa
ደፋ	daffā
ደፋር	daffār
ደፍ	daff
ዱለቻ	dullaččā
ዱለኛ	dullaññā
ዱላ	dullā
ዱርዬ	durǝyye
ዱባ	dubbā
ዱቤ	dubbe
ዱብ	dubb
ዲካ	dikkā
ዳለቻ	dālaččā
ዳለጠ	dāllaṭa
ዳሌ	dālle
ዳመነ	dāmmana
ዳመና	dāmmanā
ዳመናማ	dāmannāmmā
ዳመናም	dāmmanām
ዳመጠ	dāmmaṭa
ዳረገ	dārraga
ዳርቻ	dārǝččā
ዳርና	dārǝnnā
ዳሰሰ	dāssasa
ዳሸቀ	dāššaqa
ዳበረ	dābbara
ዳበሰ	dābbasa
ዳበሳ	dābbasā
ዳባ	dābbā
ዳቦ	dābbo
ዳተኛ	dātaññā
ዳንሰኛ	dānǝsaññā
ዳንግሌ	dānǝgǝlle
ዳኘ	dāñña
ዳኛ	dāññā
ዳኝነት	dāññǝnnat
ዳከረ	dākkara
ዳክዬ	dākkǝyye
ዳዋ	dāwwā
ዳውላ	dāwǝllā
ዳግመኛ	dāgǝmaññā
ድህነት	dǝhǝnnat
ድለላ	dǝllalā
ድል	dǝll
ድልህ	dǝllǝh
ድልል	dǝllǝl
ድልኸ	dǝllǝḵa
ድልኽ	dǝllǝḵ
ድልዝ	dǝllǝz
ድልድል	dǝlǝddǝl
ድሎትኛ	dǝlotǝññā
ድመራ	dǝmmarā
ድመት	dǝmmat
ድማሪ	dǝmmāri
ድምር	dǝmmǝr
ድምበረተኛ	dǝmǝbarataññā
ድምቡሼ	dǝmǝbušše
ድሪያ	dǝrriyā
ድራሹ	dǝrrāšu
ድርቅ	dǝrrǝq
ድርቅና	dǝrǝqǝnnā
ድርብ	dǝrrǝb
ድርት	dǝrrǝt
ድርና	dǝrǝnnā
ድርድር	dǝrǝddǝr
ድርጁ	dǝrǝǧǧu
ድርጅት	dǝrǝǧǧǝt
ድርጊት	dǝrǝggit
ድርግም	dǝrǝgǝmm
ድቁስ	dǝqqus
ድቅን	dǝqqǝnn
ድበቃ	dǝbbaqā
ድበብ	dǝbabb
ድቡሽት	dǝbbušǝt
ድባኖ	dǝbbāno
ድብ	dǝbb
ድብልቅ	dǝbǝllǝq
ድብቅ	dǝbbǝq
ድብብቆሽ	dǝbǝbbǝqoš
ድብት	dǝbbǝt
ድብን	dǝbbǝnn
ድብኝት	dǝbǝññǝt
ድኅነት	dǝḫǝnnat
ድንቁርና	dǝnǝqurǝnnā
ድንቄም	dǝnǝqemm
ድንቅ	dǝnnǝq
ድንበረተኛ	dǝnǝbarataññā
ድንበርተኛ	dǝnǝbarǝtaññā
ድንቡሎ	dǝnǝbullo
ድንች	dǝnnǝčč
ድንክዬ	dǝnǝkǝyye
ድንገተኛ	dǝnǝgataññā
ድንጋጌ	dǝnǝggāge
ድንጋጤ	dǝnǝggāṭe
ድንግልና	dǝnǝgǝllǝnā
ድንግዝግዝ	dǝnǝgǝzǝgǝzz
ድኝ	dǝññ
ድኩላ	dǝkkulā
ድኽነት	dǝḵǝnnat
ድወላ	dǝwwalā
ድው	dǝww
ድውር	dǝwwǝr
ድውይ	dǝwwǝy
ድዳም	dǝddām
ድድ	dǝdd
ድድር	dǝddǝr
ድድቅ	dǝddǝq
ድገና	dǝgganā
ድጋሚ	dǝggāmi
ድግስ	dǝggǝs
ድግን	dǝggǝn
ድጎማ	dǝggomā
ድጕሳት	dǝggʷǝsāt
ዶለተ	dollata
ዶለዶመ	doladdoma
ዶልዷላ	dolǝdʷāllā
ዶልዷሌ	dolǝdʷālle
ዶልዷማ	dolǝdʷāmmā
ዶመኛ	domaññā
ዶኬ	dokke
ዶዮ	doyyo
ዶፈዶፈ	dofaddofa
ዶፍዷፋ	dofǝdʷāffā
ጀመረ	ǧammara
ጀምሮ	ǧammǝro
ጀረገገ	ǧaraggaga
ጀሶ	ǧasso
ጀበበ	ǧabbaba
ጀበደ	ǧabbada
ጀብደኛ	ǧabǝdaññā
ጀቦነ	ǧabbona
ጀገነ	ǧaggana
ጀግንነት	ǧagǝnǝnnat
ጂጌ	ǧigge
ጃኬት	ǧākket
ጃዊ	ǧāwwi
ጃውሳ	ǧāwwǝsā
ጃጀ	ǧāǧǧa
ጃፓናዊ	ǧāppānāwi
ጃፓን	ǧāppān
ጅላንጅል	ǧǝlānǝǧǧǝl
ጅልነት	ǧǝlǝnnat
ጅማታም	ǧǝmmātām
ጅማት	ǧǝmmāt
ጅምር	ǧǝmmǝr
ጅብ	ǧǝbb
ጅንን	ǧǝnnǝn
ጅዋጅዌ	ǧǝwwāǧǝwwe
ጅው	ǧǝww
ጆንያ	ǧonǝyyā
ጆፌ	ǧoffe
ጆፍጆፌ	ǧofǝǧoffe
ገሀነመ	gahānnama
ገሀነም	gahānnam
ገለል	galall
ገለልተኛ	galalǝtaññā
ገለልተኛነት	galalǝtaññānat
ገለማ	galammā
ገለሞተ	galammota
ገለበ	gallaba
ገለበጠ	galabbaṭa
ገለጀጀ	galaǧǧaǧa
ገለጠ	gallaṭa
ገለጸ	gallaṣa
ገለፈጠ	galaffaṭa
ገለፈፈ	galaffafa
ገላለጠ	galāllaṭa
ገላመጠ	galāmmaṭa
ገላገለ	galāggala
ገልዋዳ	galǝwāddā
ገመለ	gammala
ገመምተኛ	gamamǝtaññā
ገመሰ	gammasa
ገመተ	gammata
ገመደ	gammada
ገመደለ	gamaddala
ገመገመ	gamaggama
ገመጠ	gammaṭa
ገማ	gammā
ገማች	gammāč
ገምባሌ	gamǝbālle
ገሠሠ	gaśśaśa
ገሠጠ	gaśśaṭa
ገሠጸ	gaśśaṣa
ገረመ	garrama
ገረመመ	garammama
ገረረ	garrara
ገረዘ	garraza
ገረደፈ	garaddafa
ገረጀፈ	garaǧǧafa
ገረገረ	garaggara
ገረገደ	garragada
ገረፈ	garrafa
ገራ	garrā
ገራም	garrām
ገርበብ	garǝbabb
ገርባባ	garǝbābbā
ገርጃፋ	garǝǧāffā
ገርጋራ	garǝgārrā
ገሰረ	gassara
ገሰሰ	gassasa
ገሰገሰ	gasaggasa
ገሸለጠ	gašallaṭa
ገሸረ	gaššara
ገሸሽ	gašašš
ገበረ	gabbara
ገበየ	gabayya
ገበያተኛ	gabayātaññā
ገቢና	gabinnā
ገባ	gabbā
ገባር	gabbār
ገባች	gabāčč
ገባው	gabbāw
ገብ	gabb
ገብጋባ	gabǝggābā
ገተረ	gattara
ገተት	gattat
ገታ	gattā
ገታራ	gattārā
ገትጋታ	gatǝgāttā
ገቻ	gaččā
ገነባ	ganabbā
ገነተረ	ganattara
ገነት	gannat
ገነነ	gannana
ገነን	gannan
ገነዘ	gannaza
ገነደሰ	ganaddasa
ገነገነ	ganaggana
ገነፈለ	ganaffala
ገና	gannā
ገንባሌ	ganǝbālle
ገንታራ	ganǝtārrā
ገዘተ	gazzata
ገዘገዘ	gazaggaza
ገዘፈ	gazzafa
ገዛ	gazzā
ገዝጋዛ	gazǝgāzzā
ገደ	gadda
ገደለ	gaddala
ገደለው	gaddalaw
ገደላማ	gadalāmmā
ገደርዳራ	gadarǝdārrā
ገደበ	gaddaba
ገደገደ	gadaggada
ገደፈ	gaddafa
ገዳማ	gaddāmmā
ገዳም	gaddām
ገዳዳ	gaddādā
ገዴ	gadde
ገድ	gadd
ገድለኛ	gadǝlaññā
ገድጋዳ	gadǝgāddā
ገዶኝ	gaddoññ
ገገምተኛ	gagamǝtaññā
ገገረ	gaggara
ገጠገጠ	gaṭaggaṭa
ገጠጠ	gaṭṭaṭa
ገጨኸኝ	gač̣č̣aḵaññ
ገፈተረ	gafattara
ገፈገፈ	gafaggafa
ገፈፈ	gaffafa
ገፈፋ	gafaffā
ገፋ	gaffā
ገፋፋ	gafāffā
ጉልላት	gullǝlāt
ጉልማ	gulǝmmā
ጉልበተኛ	gulǝbataññā
ጉልተኛ	gulǝtaññā
ጉልቻ	gullǝčā
ጉማጅ	gummāǧ
ጉም	gumm
ጉረሮ	gurarro
ጉረኖ	guranno
ጉረኛ	guraññā
ጉራ	gurrā
ጉራሽ	gurrāš
ጉራቻ	gurrāččā
ጉራች	gurrāčč
ጉራጅ	gurrāǧ
ጉሬዛማ	gurezāmmā
ጉርምስና	gurǝmǝssǝnnā
ጉርብርብ	gurǝbǝrǝbb
ጉርብትና	gurǝbǝtǝnnā
ጉሮሮ	gurorro
ጉበት	gubbat
ጉበኛ	gubaññā
ጉብ	gubb
ጉብታ	gubbǝtā
ጉብዝና	gubǝzǝnnā
ጉቦ	gubbo
ጉቦኛ	gubboññā
ጉተታ	guttatā
ጉትቻ	gutǝččā
ጉትያ	gutǝyyā
ጉቶ	gutto
ጉያ	guyyā
ጉደኛ	gudaññā
ጉዳተኛ	gudātaññā
ጉዳዩ	guddāyu
ጉዳዬ	guddāye
ጉዳይ	guddāy
ጉድ	gudd
ጉድለት	guddǝlat
ጉዶ	guddo
ጉጉት	guggut
ጋለበ	gāllaba
ጋማ	gāmmā
ጋሜ	gāmme
ጋረደ	gārrada
ጋረጠ	gārraṭa
ጋራማ	gārāmmā
ጋሬ	gārre
ጋሸበ	gāššaba
ጋሻ	gāššā
ጋሼ	gāšše
ጋሽዬ	gāššǝye
ጋበዘ	gābbaza
ጋብቻ	gābǝččā
ጋንድያ	gānǝdǝyyā
ጋየ	gāyya
ጋገረ	gāggara
ጋጋ	gāggā
ጋጠኝ	gāṭaññ
ጌትነት	getǝnnat
ጌቶች	getočč
ጌጅ	geǧǧ
ጌጠኛ	geṭaññā
ግለሂስ	gǝllahis
ግለኛ	gǝllaññā
ግላዊ	gǝllāwi
ግላጭ	gǝllāč̣
ግል	gǝll
ግልሙትና	gǝlǝmutǝnnā
ግልባጭ	gǝllǝbbāč̣
ግልብነት	gǝlǝbǝnnat
ግልግል	gǝlǝggǝl
ግልፋፊ	gǝlǝffāfi
ግልፍ	gǝllǝff
ግልፍተኛ	gǝlǝfǝtaññā
ግልፍታም	gǝllǝfǝtām
ግማሽ	gǝmmāš
ግማደ	gǝmmāda
ግማጭ	gǝmmāč̣
ግም	gǝmm
ግምል	gǝmmǝl
ግምበኛ	gǝmǝbaññā
ግምት	gǝmmǝt
ግሣዊ	gǝśśāwi
ግሣጼ	gǝśśāṣe
ግሥ	gǝśś
ግሦች	gǝśśoč
ግረዛ	gǝrrazā
ግራኝ	gǝrāññ
ግራዋ	gǝrāwwā
ግር	gǝrr
ግርዛት	gǝrrǝzāt
ግርድና	gǝrǝdǝnnā
ግርድፍ	gǝrǝddǝf
ግርግር	gǝrrǝgǝrr
ግርፋት	gǝrrǝfāt
ግሳንግስ	gǝssānǝgǝs
ግስላ	gǝssǝlā
ግስጋሴ	gǝsǝggāse
ግሽር	gǝššǝr
ግቢ	gǝbbi
ግብርና	gǝbǝrǝnnā
ግብዝ	gǝbbǝz
ግብዝና	gǝbǝzǝnnā
ግብዣ	gǝbǝžžā
ግትር	gǝttǝr
ግትርትር	gǝtǝrǝtǝrr
ግትቻ	gǝtǝččā
ግንበኛ	gǝnǝbaññā
ግንኙነት	gǝnǝññunnat
ግንዛቤ	gǝnǝzzābe
ግንዲላ	gǝnǝdillā
ግኝት	gǝññǝt
ግዝት	gǝzzǝt
ግዞተኛ	gǝzotaññā
ግዥ	gǝžž
ግዳይ	gǝddāy
ግዳጅ	gǝddāǧ
ግዴ	gǝdde
ግዴታ	gǝddetā
ግድ	gǝdd
ግድብ	gǝddǝb
ግድያ	gǝdǝyyā
ግድግዳ	gǝdǝgǝddā
ግግ	gǝgg
ግግር	gǝggǝr
ግጥም	gǝṭṭǝmm
ግፈኛ	gǝfaññā
ግፊት	gǝffit
ግፊያ	gǝffiyā
ጎለመሰ	golammasa
ጎልማሳ	golǝmāssā
ጎመን	gomman
ጎመዘዘ	gomazzaza
ጎመደ	gommada
ጎመጀ	gomaǧǧa
ጎሚስታ	gommisǝtā
ጎማ	gommā
ጎማህ	gommāh
ጎማሬ	gommāre
ጎምላላ	gomǝlāllā
ጎምዛዛ	gomǝzzāzā
ጎረመሰ	gorammasa
ጎረሰ	gorrasa
ጎረበ	gorraba
ጎረደ	gorrada
ጎረደመ	goraddama
ጎራረደ	gorārrada
ጎርደድ	gorǝdadd
ጎሸመ	goššama
ጎሽ	gošš
ጎበበ	gobbaba
ጎበዘ	gobbaza
ጎታች	gottāč
ጎን	gonn
ጎንደርኛ	gonǝdarǝññā
ጎዘጎዘ	gozzaggoza
ጎዦ	gožžo
ጎደለ	goddala
ጎደል	goddal
ጎዳ	goddā
ጎዳኒሳ	godānissā
ጎጆ	goǧǧo
ጎጆና	goǧǧonā
ጎፈረ	goffara
ጎፈር	goffar
ጎፈነነ	gofannana
ጐለተ	gʷallata
ጐለጐለ	gʷalaggʷala
ጐላ	gʷallā
ጐልማማ	gʷalǝmāmmā
ጐልዳፋ	gʷalǝdāffā
ጐመራ	gʷamarrā
ጐረበጠ	gʷarabbaṭa
ጐረበጠኝ	gʷarabbaṭaññ
ጐረና	gʷarannā
ጐረጐረ	gʷaraggʷara
ጐረፈ	gʷarrafa
ጐርናና	gʷarǝnānnā
ጐርደድ	gʷarǝdadd
ጐርዳዳ	gʷarǝdāddā
ጐሰመ	gʷassama
ጐሰረ	gʷassara
ጐሰቈለ	gʷasaqqʷala
ጐሰጐሰ	gʷasaggʷasa
ጐስቋላ	gʷasǝqʷāllā
ጐበኘ	gʷabañña
ጐበጠ	gʷabbaṭa
ጐባን	gʷabbān
ጐተተ	gʷattata
ጐተጐተ	gʷataggʷata
ጐነቈለ	gʷanaqqʷala
ጐነጐነ	gʷanaggʷana
ጐነጠ	gʷannaṭa
ጐነፈ	gʷannafa
ጐንበስ	gʷanǝbass
ጐንዛላ	gʷanǝzāllā
ጐደሪ	gʷadarri
ጐደጐደ	gʷadaggʷada
ጐድጓዳ	gʷadǝgʷāddā
ጐጃሜ	gʷaǧǧāme
ጐጃም	gʷaǧǧām
ጐፈየ	gʷafayya
ጓሮኛ	gʷāroññā
ጓያ	gʷāyyā
ጓደኛ	gʷādaññā
ጓደኛሞች	gʷādaññāmoč
ጓደኝነት	gʷāddaññǝnnat
ጓድ	gʷādd
ጓጐለ	gʷāggʷala
ጓጐረ	gʷāggʷara
ጓጐጠ	gʷāggʷaṭa
ጓጓ	gʷāggʷā
ጓጓላ	gʷāggʷālā
ጕላይ	gʷǝllāy
ጕልት	gʷǝllǝt
ጕልቻ	gʷǝlǝččā
ጕሰማ	gʷǝssamā
ጕስቈላ	gʷǝsǝqʷallā
ጕብኝት	gʷǝbǝññǝt
ጕተታ	gʷǝttatā
ጕትት	gʷǝttǝt
ጕትቻ	gʷǝtǝččā
ጕነጣ	gʷǝnnaṭā
ጕዞኛ	gʷǝzoññā
ጕጕ	gʷǝggʷǝ
ጕፋያ	gʷǝfāyyā
ጠለለ	ṭallala
ጠለቀ	ṭallaqa
ጠለዘ	ṭallaza
ጠለፈ	ṭallafa
ጠላ	ṭallā
ጠል	ṭall
ጠመመ	ṭammama
ጠመረረ	ṭamarrara
ጠመሰሰ	ṭamassasa
ጠመቀ	ṭammaqa
ጠመዘዘ	ṭamazzaza
ጠመዝማዛ	ṭamazǝmāzzā
ጠመደ	ṭammada
ጠምባራ	ṭamǝbārrā
ጠምዛዛ	ṭamǝzāzzā
ጠምጣማ	ṭamǝṭāmmā
ጠረመሰ	ṭarammasa
ጠረረ	ṭarrara
ጠረሰ	ṭarrasa
ጠረቀመ	ṭaraqqama
ጠረበ	ṭarraba
ጠረነቀ	ṭarannaqa
ጠረዘ	ṭarraza
ጠረገ	ṭarraga
ጠረጴዛ	ṭaraṗṗezā
ጠራ	ṭarrā
ጠርባባ	ṭarǝbābbā
ጠርዛዛ	ṭarǝzāzzā
ጠሰቀ	ṭassaqa
ጠስቆ	ṭassǝqo
ጠቀለለ	ṭaqallala
ጠቀመ	ṭaqqama
ጠቀሰ	ṭaqqasa
ጠቀስ	ṭaqqas
ጠቅላላ	ṭaqǝllālā
ጠቅላላውን	ṭaqǝlāllāwǝn
ጠቆረ	ṭaqqora
ጠበልተኛ	ṭabalǝtaññā
ጠበሰ	ṭabbasa
ጠበሰቀ	ṭabassaqa
ጠበቀ	ṭabbaqa
ጠበበ	ṭabbaba
ጠበኛ	ṭabaññā
ጠበደለ	ṭabaddala
ጠባ	ṭabbā
ጠባቂ	ṭabbāqi
ጠባብ	ṭabbāb
ጠብ	ṭabb
ጠብታ	ṭabbǝtā
ጠቦት	ṭabbot
ጠነሰሰ	ṭanassasa
ጠነቀቀ	ṭanaqqaqa
ጠነቆለ	ṭanaqqola
ጠነበዘ	ṭanabbaza
ጠነባ	ṭanabbā
ጠነነ	ṭannana
ጠነነኝ	ṭannanaññ
ጠነዛ	ṭanazzā
ጠነፈፈ	ṭanaffafa
ጠና	ṭannā
ጠኔ	ṭanne
ጠኔያም	ṭanneyām
ጠንቀኛ	ṭanǝqaññā
ጠንቃቃ	ṭanǝqāqqā
ጠንባራ	ṭanǝbārrā
ጠንባሳ	ṭanǝbāssā
ጠንባዛ	ṭanǝbāzzā
ጠንካራ	ṭanǝkkārā
ጠወለገ	ṭawallaga
ጠውላጋ	ṭawǝlāggā
ጠየመ	ṭayyama
ጠየቀ	ṭayyaqa
ጠያር	ṭayyār
ጠያቂ	ṭayyāqi
ጠያፍ	ṭayyāf
ጠይም	ṭayyǝm
ጠደቀ	ṭaddaqa
ጠዳ	ṭaddā
ጠጅ	ṭaǧǧ
ጠገበ	ṭaggaba
ጠገነ	ṭaggana
ጠገገ	ṭaggaga
ጠጋ	ṭaggā
ጠጋቢስ	ṭaggābis
ጠጋኝ	ṭaggāñ
ጠጠተ	ṭaṭṭata
ጠጠተኝ	ṭaṭṭataññ
ጠጣ	ṭaṭṭā
ጠፈረ	ṭaffara
ጠፈረተኛ	ṭafarataññā
ጠፈጠፈው	ṭafaṭṭafaw
ጠፈፈ	ṭaffafa
ጠፋ	ṭaffā
ጠፍ	ṭaff
ጠፍጣፋ	ṭafǝṭāffā
ጡሌ	ṭulle
ጡል	ṭull
ጡረኛ	ṭuraññā
ጡርነት	ṭurǝnnat
ጡብ	ṭubb
ጡንቸኛ	ṭunǝčaññā
ጡንቻማ	ṭunǝčāmmā
ጡጥ	ṭuṭṭ
ጢም	ṭimm
ጢሰኛ	ṭisaññā
ጢቅ	ṭiqq
ጢቅታ	ṭiqqǝtā
ጢን	ṭinn
ጣሰሰ	ṭāssasa
ጣጠኛ	ṭāṭaññā
ጣፈጠ	ṭāffaṭa
ጣፊያ	ṭāffiyā
ጤነኛ	ṭenaññā
ጤናማ	ṭenāmmā
ጤናዳም	ṭenāddām
ጥለኛ	ṭǝlaññā
ጥላማ	ṭǝlāmmā
ጥላቻ	ṭǝlāččā
ጥልቅ	ṭǝllǝqq
ጥልቆ	ṭǝllǝqo
ጥማድ	ṭǝmmād
ጥምልምል	ṭǝmǝlǝmǝll
ጥምር	ṭǝmmǝr
ጥምዝ	ṭǝmǝzz
ጥምጥም	ṭǝmǝṭǝmm
ጥሞና	ṭǝmmonā
ጥሩምበኛ	ṭǝrumǝbaññā
ጥሪ	ṭǝrri
ጥራቢ	ṭǝrrābi
ጥራጊ	ṭǝrrāgi
ጥር	ṭǝrr
ጥርቃሚ	ṭǝrǝqqāmi
ጥርቃሞ	ṭǝrǝqqāmo
ጥርቅም	ṭǝrǝqqǝm
ጥርቅምአድርጎ	ṭǝrǝqǝmmǝʾādǝrǝgo
ጥርኝ	ṭǝrǝññ
ጥስቅ	ṭǝssǝq
ጥቁም	ṭǝqqum
ጥቃቅን	ṭǝqāqqǝn
ጥቅል	ṭǝqqǝl
ጥበቃ	ṭǝbbaqā
ጥበበኛ	ṭǝbabaññā
ጥበት	ṭǝbbat
ጥቢ	ṭǝbbi
ጥብቅ	ṭǝbbǝq
ጥብቅና	ṭǝbǝqǝnnā
ጥብቆ	ṭǝbbǝqo
ጥብኛ	ṭǝbbǝññā
ጥቦት	ṭǝbbot
ጥንቃቄ	ṭǝnǝqqāqe
ጥንካሬ	ṭǝnǝkkāre
ጥንዚዛ	ṭǝnǝzizzā
ጥየቃ	ṭǝyyaqā
ጥዩፍ	ṭǝyyuf
ጥያቄ	ṭǝyyāqe
ጥይት	ṭǝyyǝt
ጥይፍተኛ	ṭǝyyǝfǝtaññā
ጥጃ	ṭǝǧǧā
ጥገት	ṭǝggat
ጥገና	ṭǝgganā
ጥገኛ	ṭǝggaññā
ጥገኛነት	ṭǝggaññānnat
ጥጋበኛ	ṭǝgābaññā
ጥግ	ṭǝgg
ጥግን	ṭǝggǝn
ጥፊ	ṭǝffi
ጥፋተኛ	ṭǝfātaññā
ጦልጣሏ	ṭolǝṭāllʷā
ጦልጧላ	ṭolǝṭʷāllā
ጦመኛ	ṭomaññā
ጦረኛ	ṭoraññā
ጦርነት	ṭorǝnnat
ጦሰኛ	ṭosaññā
ጦስኝ	ṭosǝññ
ጦሽ	ṭošš
ጦቢያ	ṭobbiyā
ጨለመ	č̣allama
ጨለማ	č̣allamā
ጨለጠ	č̣allaṭa
ጨለፈ	č̣allafa
ጨላጭ	č̣allāč̣
ጨሌ	č̣alle
ጨመለቅ	č̣amallaq
ጨመረ	č̣ammara
ጨመቀ	č̣ammaqa
ጨመተ	č̣ammata
ጨመደደ	č̣amaddada
ጨምላቃ	č̣amǝlāqqā
ጨምባሳ	č̣amǝbāssā
ጨምታራ	č̣amǝtārrā
ጨምዳዳ	č̣amǝdāddā
ጨረሰ	č̣arrasa
ጨረታ	č̣arratā
ጨረገደ	č̣araggada
ጨረፈ	č̣arrafa
ጨርማማ	č̣arǝmāmmā
ጨርማታ	č̣arǝmāttā
ጨርማዳ	č̣arǝmāddā
ጨርሶ	č̣arrǝso
ጨርጫሳ	č̣arǝč̣āssā
ጨቀየ	č̣aqayya
ጨቅላነት	č̣aqǝlānnat
ጨቅጫቃ	č̣aqǝč̣āqqā
ጨቆነ	č̣aqqona
ጨቋኝ	č̣aqqʷāñ
ጨበጠ	č̣abbaṭa
ጨቦደ	č̣abboda
ጨነቀ	č̣annaqa
ጨነገፈ	č̣anaggafa
ጨንቋራ	č̣anǝqʷārrā
ጨንባሳ	č̣anǝbāssā
ጨከነ	č̣akkana
ጨካኝ	č̣akkāñ
ጨዋነት	č̣awānnat
ጨውናና	č̣awǝnānnā
ጨገገ	č̣aggaga
ጨጓራ	č̣aggʷārrā
ጨፈለቀ	č̣afallaqa
ጨፈረ	č̣affara
ጨፈነ	č̣affana
ጨፈገገ	č̣afaggaga
ጨፋሪ	č̣affāri
ጨፋና	č̣affānā
ጨፌ	č̣affe
ጨፍራራ	č̣afǝrārrā
ጨፍጋጋ	č̣afǝgāggā
ጩርር	č̣urǝrr
ጫማ	č̣āmmā
ጫር	č̣ārr
ጫና	č̣ānnā
ጫን	č̣ānn
ጫካ	č̣ākkā
ጫካማ	č̣ākāmmā
ጫጩት	č̣āč̣utt
ጫፍና	č̣āfǝnnā
ጭለማ	č̣ǝllamā
ጭላጭ	č̣ǝllāč̣
ጭልጥ	č̣ǝllǝṭṭ
ጭልፊት	č̣ǝlǝfitt
ጭማሪ	č̣ǝmmāri
ጭማቂ	č̣ǝmmāqi
ጭምር	č̣ǝmmǝr
ጭምት	č̣ǝmmǝt
ጭራሹ	č̣ǝrrāšu
ጭራሽ	č̣ǝrrāš
ጭር	č̣ǝrr
ጭርታ	č̣ǝrrǝtā
ጭቁን	č̣ǝqqun
ጭቃማ	č̣ǝqāmmā
ጭቅቅታም	č̣ǝqǝqqǝtām
ጭቅቅት	č̣ǝqǝqqǝt
ጭቅና	č̣ǝqǝnnā
ጭቆና	č̣ǝqqonā
ጭባጭ	č̣ǝbbāč̣
ጭብጥ	č̣ǝbbǝṭ
ጭብጦ	č̣ǝbbǝṭo
ጭቦ	č̣ǝbbo
ጭቦኛ	č̣ǝbboññā
ጭንቅላታም	č̣ǝnǝqǝllātām
ጭንቅላት	č̣ǝnǝqqǝlāt
ጭከና	č̣ǝkkanā
ጭካኔ	č̣ǝkkāne
ጭኮ	č̣ǝkko
ጭው	č̣ǝww
ጭውውት	č̣ǝwwǝwǝt
ጭፈራ	č̣ǝffarā
ጭፍን	č̣ǝffǝn
ጮሌ	č̣olle
ጮረረ	č̣orrara
ጮራ	č̣orrā
ጮቤ	č̣obbe
ጳጳሳት	ṗāṗṗāsāt
ጳጳስ	ṗāṗṗās
ጸለየ	ṣallaya
ጸሎተኛ	ṣalotaññā
ጸበረቀ	ṣabarraqa
ጸነነ	ṣannana
ጸና	ṣannā
ጸያፍ	ṣayyāf
ጸደቀ	ṣaddaqa
ጸዳ	ṣaddā
ጸጋ	ṣaggā
ጸጥ	ṣaṭṭ
ጸጥተኛ	ṣaṭṭǝtaññā
ጸጸተ	ṣaṣṣata
ጸጸተኛ	ṣaṣataññā
ጽላተ	ṣǝllāta
ጽላት	ṣǝllāt
ጽኑነት	ṣǝnunnat
ጽዋ	ṣǝwwā
ጽጌረዳ	ṣǝggeradā
ጾመኛ	ṣomaññā
ፀሐያማ	ḍaḥāyāmmā
ፈለሰ	fallasa
ፈለሰመ	falassama
ፈለሰፈ	falassafa
ፈለቀ	fallaqa
ፈለቀቀ	falaqqaqa
ፈለገ	fallaga
ፈለጠ	fallaṭa
ፈለፈለ	falaffala
ፈሊጠኛ	faliṭaññā
ፈላ	fallā
ፈላሻ	fallāšā
ፈላጊ	fallāgi
ፈልሳሳ	falǝssāsā
ፈረመ	farrama
ፈረሰ	farrasa
ፈረሰኛ	farasaññā
ፈረሱላ	farasullā
ፈረንሳይኛ	faranǝsāyǝññā
ፈረክራካ	farakǝrākkā
ፈረደ	farrada
ፈረደለት	farradalat
ፈረደበት	farradabbat
ፈረጠ	farraṭa
ፈረፈረ	faraffara
ፈሪነት	farinnat
ፈራ	farrā
ፈራሚ	farrāmi
ፈራረሰ	farārrasa
ፈርጣማ	farǝṭāmmā
ፈሰሰ	fassasa
ፈሰከ	fassaka
ፈሰፈሰ	fasaffasa
ፈሳ	fassā
ፈቀቅ	faqaqq
ፈቀደ	faqqada
ፈቀደው	faqqadaw
ፈቀፈቀ	faqaffaqa
ፈቃደኛ	faqādaññā
ፈቃደኛነት	faqādaññānnat
ፈተለ	fattala
ፈተሸ	fattaša
ፈተነ	fattana
ፈተገ	fattaga
ፈተፈተ	fataffata
ፈታ	fattā
ፈታሽ	fattāš
ፈታታ	fatāttā
ፈታኝ	fattāñ
ፈት	fatt
ፈትለክ	fatǝlakk
ፈነቀለ	fanaqqala
ፈነከተ	fanakkata
ፈነደቀ	fanaddaqa
ፈነዳ	fanaddā
ፈነገለ	fanaggala
ፈንዳዳ	fanǝdāddā
ፈንጋላ	fanǝgāllā
ፈንጠዝያ	fanǝṭazǝyyā
ፈንጣራ	fanǝṭārrā
ፈካ	fakkā
ፈወሰ	fawwasa
ፈዋሽ	fawwāš
ፈዘዘ	fazzaza
ፈዛዛ	fazāzzā
ፈየለ	fayyala
ፈየደ	fayyada
ፈጀ	faǧǧa
ፈጅ	faǧǧ
ፈገመ	faggama
ፈገገ	faggaga
ፈገፈገ	fagaffaga
ፈግጠው	faggǝṭaw
ፈጠመ	faṭṭama
ፈጠፈጠ	faṭaffaṭa
ፈጸመ	faṣṣama
ፈጻሚ	faṣṣāmi
ፉት	futt
ፉከራ	fukkarā
ፉክክር	fukǝkkǝr
ፉጉሎ	fugullo
ፊር	firr
ፊተኛው	fitaññāw
ፊትና	fitǝnnā
ፊን	finn
ፊኛ	fiññā
ፊጥኝ	fiṭṭǝññ
ፋነነ	fānnana
ፋንድያ	fānǝddǝyā
ፋኖ	fānno
ፋፋ	fāffā
ፌዘኛ	fezzaññā
ፍለጋ	fǝllagā
ፍላጎት	fǝllāgot
ፍልስፍና	fǝlǝsǝfǝnnā
ፍልቃቂ	fǝllǝqqāqi
ፍሥሐ	fǝśśǝḥā
ፍራሽ	fǝrrāš
ፍራቻ	fǝrāččā
ፍሬያማ	fǝreyāmmā
ፍርምባ	fǝrǝmǝbbā
ፍርስ	fǝrrǝs
ፍርጥ	fǝrrǝṭ
ፍርፋሪ	fǝrǝffāri
ፍሳሽ	fǝssāš
ፍስስ	fǝssǝs
ፍስክ	fǝssǝk
ፍቅረኛ	fǝqǝraññā
ፍቅፋቂ	fǝqǝffāqi
ፍተሻ	fǝttašā
ፍተጋ	fǝttagā
ፍትወተኛ	fǝtǝwataññā
ፍትግ	fǝttǝg
ፍች	fǝčč
ፍንካች	fǝnǝkkāč
ፍንክች	fǝnǝkǝčč
ፍንድቅ	fǝnǝddǝqq
ፍየል	fǝyyal
ፍዳ	fǝddā
ፍዳውን	fǝddāwǝn
ፍጅት	fǝǧǧǝt
ፍግም	fǝggǝmm
ፍግፋጊ	fǝgǝffāgi
ፍጥጥ	fǝṭǝṭṭ
ፍጹምነት	fǝṣṣumǝnnat
ፎሌ	folle
ፎልፏላ	folǝfʷāllā
ፎረሸ	forraša
ፎቀቅ	foqqaq
ፎነነ	fonnana
ፎከረ	fokkara
ፎከተ	fokkata
ፎከት	fokatt
ፓኮ	pākko
ፓፓዬ	pāppāye
ፕሮፓጋንዳ	pǝropāgānǝddā
ፖሊቲከኛ	politikaññā
ፖስተኛ	posǝtaññā
