# Baby names
അകര്ശാനാ	অকর্শানা
അക്ശൈനീഏ	অক্শৈনীএ
അഗജാ	অগজা
അചിംത	অচিংত
അചിത	অচিত
അച്ചിന്ദ്ര	অচ্চিন্দ্র
അഡ്യാദവൈതാ	অড্যাদবৈতা
അദഭുതഃ	অদভুতঃ
അദേന്യ	অদেন্য
അദേല	অদেল
അദ്രിതീ	অদ্রিতী
അദ്രീഥീ	অদ্রীথী
അദ്രീമാം	অদ্রীমাং
അദ്വൈയാ	অদ্বৈযা
അധര്ഷ	অধর্ষ
അധിപാ	অধিপা
അധീരതാ	অধীরতা
അധ്യുത	অধ্যুত
അനംതാമായാ	অনংতামাযা
അബരനാ	অবরনা
അബിനയ	অবিনয
അബിനാ	অবিনা
അബീനംദാ	অবীনংদা
അബീശാ	অবীশা
അഭയ	অভয
അഭയന	অভযন
അഭിഗ്ന്യാ	অভিগ্ন্যা
അഭിജീതാ	অভিজীতা
അഭിനിവേശ	অভিনিবেশ
അഭിമ	অভিম
അഭിമാനീ	অভিমানী
അഭിമോദാ	অভিমোদা
അഭിരാ	অভিরা
അഭിരാത	অভিরাত
അഭീരല	অভীরল
അഭീശ്രേയ	অভীশ্রেয
അഭീസുമത	অভীসুমত
അഭ്യപ്സീത	অভ্যপ্সীত
അഭ്യുദയാ	অভ্যুদযা
അമൃതാ	অমৃতা
അലകനംദാ	অলকনংদা
അലക്ഷാ	অলক্ষা
അല്കാ	অল্কা
അശവ	অশব
അശ്നേഇല	অশ্নেইল
ആകാശലീനാ	আকাশলীনা
ആകൃഥീ	আকৃথী
ആക്ഷ്യാ	আক্ষ্যা
ആചാര്യ	আচার্য
ആത്മയ	আত্ময
ആദി	আদি
ആദിമ	আদিম
ആദീവ	আদীব
ആധീരേന	আধীরেন
ആധ്യാ	আধ্যা
ആനംദീനീ	আনংদীনী
ആനീകാ	আনীকা
ആന്തീകാ	আন্তীকা
ആന്വീ	আন্বী
ആപ്ത	আপ্ত
ആപ്തി	আপ্তি
ആമാംനീ	আমাংনী
ആമിഷ	আমিষ
ആമുക്ഥാ	আমুক্থা
ആയുസ	আযুস
ആയോദ	আযোদ
ആരംഭീ	আরংভী
ആരതീ	আরতী
ആരസീ	আরসী
ആര്യ	আর্য
ആര്യക	আর্যক
ആര്യനാ	আর্যনা
ആര്യമാനീ	আর্যমানী
ആലേഃയാ	আলেঃযা
ആവംശ	আবংশ
ആവേശ	আবেশ
ആശകാ	আশকা
ആശിയാനാ	আশিযানা
ആശുതോഷ	আশুতোষ
ആശ്മീന	আশ্মীন
ആശ്വിത	আশ্বিত
ആസവ	আসব
ആസ്തിക	আস্তিক
ഇക്ശാനാ	ইক্শানা
ഇജയാ	ইজযা
ഇനീയന	ইনীযন
ഇനോദയ	ইনোদয
ഇന്ദരകാന്ത	ইন্দরকান্ত
ഇന്ദിവാരസ	ইন্দিবারস
ഇന്ദുശിതാലാ	ইন্দুশিতালা
ഇന്ദ്രജാ	ইন্দ্রজা
ഇന്ദ്രതന	ইন্দ্রতন
ഇന്ദ്രദയുമ്ന	ইন্দ্রদযুম্ন
ഇന്ദ്രവദന	ইন্দ্রবদন
ഇന്ദ്രാണീ	ইন্দ্রাণী
ഇബ്ബാനീ	ইব্বানী
ഇയുരേശ	ইযুরেশ
ഇയേനഗര	ইযেনগর
ഇരാജ	ইরাজ
ഇരിത	ইরিত
ഇരേശ	ইরেশ
ഇലിസാ	ইলিসা
ഇശിതാ	ইশিতা
ഇശ്വാര്യ	ইশ্বার্য
ഇഷ്ടാ	ইষ্টা
ഇഷ്ടി	ইষ্টি
ഇസാര	ইসার
ഇസ്ശും	ইস্শুং
ഈതന	ঈতন
ഈതികാ	ঈতিকা
ഈരേന്പ്രിത	ঈরেন্প্রিত
ഈര്ശീതാ	ঈর্শীতা
ഈലാക്കീയാ	ঈলাক্কীযা
ഈലികാ	ঈলিকা
ഈലേശാ	ঈলেশা
ഈശാര	ঈশার
ഈശിക	ঈশিক
ഈശ്വരദത്ത	ঈশ্বরদত্ত
ഈഹാ	ঈহা
ഉഗ്രസ്രവാസ	উগ্রস্রবাস
ഉജവണീ	উজবণী
ഉജേശാ	উজেশা
ഉജ്ജന	উজ্জন
ഉജ്ജവല	উজ্জবল
ഉജ്ജവാലാ	উজ্জবালা
ഉജ്ജ്വലാ /ഉജ്വലാ	উজ্জ্বলা /উজ্বলা
ഉജ്ജ്വാലാ	উজ্জ্বালা
ഉത്കര്ഷ	উত্কর্ষ
ഉത്കലാ	উত্কলা
ഉത്തര	উত্তর
ഉത്പര	উত্পর
ഉത്സര്ഗ	উত্সর্গ
ഉദയ കുമാര	উদয কুমার
ഉദരഥീ	উদরথী
ഉദാന്തികാ	উদান্তিকা
ഉദേയ	উদেয
ഉദ്ധാര	উদ্ধার
ഉദ്യത	উদ্যত
ഉദ്യമീ	উদ্যমী
ഉദ്യോത	উদ্যোত
ഉധവ	উধব
ഉപംഗ	উপংগ
ഉപദാ	উপদা
ഉപാധ്രീതീ	উপাধ্রীতী
ഉപ്പാസ	উপ্পাস
ഉമാ	উমা
ഉമേശ്വര	উমেশ্বর
ഉരിശിതാ	উরিশিতা
ഉര്ജാ	উর্জা
ഉര്ജീകാ	উর্জীকা
ഉര്ജീതാ	উর্জীতা
ഉര്ദാഹാവ	উর্দাহাব
ഉര്മികാ	উর্মিকা
ഉര്മിമാലാ	উর্মিমালা
ഉര്വീനാഥ	উর্বীনাথ
ഉല്പേശ	উল্পেশ
ഉശേന്യ	উশেন্য
ഉഷാശി	উষাশি
ഉഷ്മാ	উষ্মা
ഉസരീ	উসরী
ഊതരാ	ঊতরা
ഊര്വേശ	ঊর্বেশ
ഏകംശീ	একংশী
ഏകക്ഷരപരാ	একক্ষরপরা
ഏകതന	একতন
ഏകതാ	একতা
ഏകാംശ	একাংশ
ഏകാകാന്യ	একাকান্য
ഏകാനീ	একানী
ഏകാപര്നികാ	একাপর্নিকা
ഏകേസ്വാര	একেস্বার
ഏത്തന	এত্তন
ഏധിത	এধিত
ഏമാ	এমা
ഏലനാ	এলনা
ഏലാ	এলা
ഏലീലവേംദന	এলীলবেংদন
ഏലീലീ	এলীলী
ഓഈസീന	ওঈসীন
ഓജസ്വീ	ওজস্বী
ഓജാ	ওজা
ഓജീസ	ওজীস
ഓനിശ	ওনিশ
ഓമപ്രകാശ	ওমপ্রকাশ
ഓവീന	ওবীন
ഓവൈസ	ওবৈস
കംജ	কংজ
കംജന	কংজন
കംഠന	কংঠন
കംദര്പ	কংদর্প
കംപനാ	কংপনা
കകോന	ককোন
കതകീ	কতকী
കതേല്യ്ന	কতেল্য্ন
കനക	কনক
കനദ	কনদ
കനാകംഗീ	কনাকংগী
കനീജാ	কনীজা
കനീരാ	কনীরা
കനീസാ	কনীসা
കനുഷ	কনুষ
കന്വക	কন্বক
കന്ശീകാ	কন্শীকা
കപാലീന	কপালীন
കപിലാശ്വര	কপিলাশ্বর
കമലാപതി	কমলাপতি
കമലിനീ	কমলিনী
കമലേക്ഷണ	কমলেক্ষণ
കമ്നാ	কম্না
കരാലാ	করালা
കരീസമാം	করীসমাং
കരുനാസ്രീ	করুনাস্রী
കരുപ്പസമ്യ	করুপ্পসম্য
കര്ണ	কর্ণ
കര്തീഗാ	কর্তীগা
കര്മദീപ	কর্মদীপ
കര്മാശ	কর্মাশ
കലരനീ	কলরনী
കലശ	কলশ
കലാധര	কলাধর
കലാനിധി	কলানিধি
കലാപരണ	কলাপরণ
കലാപീന	কলাপীন
കലാപ്രിയാ	কলাপ্রিযা
കലൈസേലവീ	কলৈসেলবী
കവന	কবন
കവിപ  പ്രിയ	কবিপ  প্রিয
കവീനാഥ	কবীনাথ
കശ്തീ	কশ্তী
കാജല	কাজল
കാജീശ	কাজীশ
കാദമ്ബരീ	কাদম্বরী
കാധിരോലീ	কাধিরোলী
കാനീ	কানী
കാന്ജീരാ	কান্জীরা
കാന്തീ	কান্তী
കാമത	কামত
കാമിഷാ	কামিষা
കാമേശ	কামেশ
കാരുണ്യ പ്രകാശ	কারুণ্য প্রকাশ
കാരൂകാ	কারূকা
കാര്നിക	কার্নিক
കാലിക	কালিক
കാലിപദാ	কালিপদা
കാലിയാ	কালিযা
കാലീതാ	কালীতা
കാവ്യ ശ്രീ	কাব্য শ্রী
കിന്നേരാ	কিন্নেরা
കീഅനാ	কীঅনা
കീജല	কীজল
കീനാരീ	কীনারী
കീന്ചനാ	কীন্চনা
കേകലാ	কেকলা
കേതന	কেতন
കേനിഷാ	কেনিষা
കേളവ്യ	কেলব্য
കൈരവീ	কৈরবী
കൈലാശ	কৈলাশ
കോശേല	কোশেল
കൌശികാ	কৌশিকা
ഖഗേശ	খগেশ
ഖമീശ	খমীশ
ഖാതീരാവണ	খাতীরাবণ
ഖാത്വന്ഗീന	খাত্বন্গীন
ഖീലതീ	খীলতী
ഖുസീ	খুসী
ഗംഗാ	গংগা
ഗംദേശാ	গংদেশা
ഗംധാര	গংধার
ഗംധാരാ	গংধারা
ഗംധാലീ	গংধালী
ഗഗന	গগন
ഗജവദന	গজবদন
ഗജേന്ദ്ര	গজেন্দ্র
ഗണക	গণক
ഗണനാ പംഡിതന	গণনা পংডিতন
ഗണനാഥ	গণনাথ
ഗണ്യാ	গণ্যা
ഗതി	গতি
ഗനേസന	গনেসন
ഗന്ഗസീരുവന	গন্গসীরুবন
ഗയാലികാ	গযালিকা
ഗരിമാ	গরিমা
ഗരിഷ്ട	গরিষ্ট
ഗരുല	গরুল
ഗാഇശ	গাইশ
ഗാന്ഗമൈന്ദന	গান্গমৈন্দন
ഗാമിനീ	গামিনী
ഗായത്രീ	গাযত্রী
ഗായലേ	গাযলে
ഗിഅന	গিঅন
ഗിയാ	গিযা
ഗിരിവര	গিরিবর
ഗീതി	গীতি
ഗീതീശാ	গীতীশা
ഗുംജാ	গুংজা
ഗുനാജാ	গুনাজা
ഗുനാരത്നാ	গুনারত্না
ഗുനാശേകാര	গুনাশেকার
ഗുനീന	গুনীন
ഗുന്ജീതാ	গুন্জীতা
ഗുപ്തക	গুপ্তক
ഗുരദയാല	গুরদযাল
ഗുരദേവ	গুরদেব
ഗുരബാനീ	গুরবানী
ഗുരമാന	গুরমান
ഗുരുത്തമ	গুরুত্তম
ഗുര്നാന്ഡീശ	গুর্নান্ডীশ
ഗുലമോഹര	গুলমোহর
ഗുവീദ	গুবীদ
ഗൂംജീതാ	গূংজীতা
ഗൂഹാരീ	গূহারী
ഗേനേലിയാ	গেনেলিযা
ഗേശനാ	গেশনা
ഗോപാല	গোপাল
ഗോപീ നാഥ	গোপী নাথ
ഗോഭില	গোভিল
ഗോരഖ-നാഥ	গোরখ-নাথ
ഗൌരവീ	গৌরবী
ഗൌരീകാംത	গৌরীকাংত
ഗൌരീശ	গৌরীশ
ഗൌര്പ്രിയാ	গৌর্প্রিযা
ഗ്രീതേശ	গ্রীতেশ
ഗ്രീവാ	গ্রীবা
ഗ്രീശ്മീതാ	গ্রীশ্মীতা
ഗ്രീഷ്മ	গ্রীষ্ম
ഘടോതകത്ചാ	ঘটোতকত্চা
ചംചലാ	চংচলা
ചംദേര്ഭാന	চংদের্ভান
ചംദ്രകാംത	চংদ্রকাংত
ചംദ്രകാംതാ	চংদ্রকাংতা
ചംദ്രചുര	চংদ্রচুর
ചംദ്രപുശ്പാ	চংদ্রপুশ্পা
ചംദ്രപ്രകാശ	চংদ্রপ্রকাশ
ചംദ്രമതി	চংদ্রমতি
ചംദ്രലേഖാ	চংদ্রলেখা
ചംദ്രഹാസ	চংদ্রহাস
ചംദ്രാനന	চংদ্রানন
ചംദ്രാഭാ	চংদ্রাভা
ചംദ്രേശ	চংদ্রেশ
ചകേശ	চকেশ
ചകോര	চকোর
ചക്ഷസ	চক্ষস
ചതുര	চতুর
ചതുരാ	চতুরা
ചതുര്ഭുജാ	চতুর্ভুজা
ചതുര്വേദീ	চতুর্বেদী
ചത്രീയാ	চত্রীযা
ചന്ദ്രകേതു	চন্দ্রকেতু
ചരണ	চরণ
ചരന്യാ	চরন্যা
ചലാമാ	চলামা
ചാംദ	চাংদ
ചാനാസ്യാ	চানাস্যা
ചാനേ	চানে
ചാന്ദനികാ	চান্দনিকা
ചാരുന	চারুন
ചാരുവീ	চারুবী
ചാര്മീ	চার্মী
ചാര്വീ	চার্বী
ചാവ്രിക	চাব্রিক
ചിത്കലാ	চিত্কলা
ചിത്ത	চিত্ত
ചിത്തപ്രസാദ	চিত্তপ্রসাদ
ചിത്തരംജന	চিত্তরংজন
ചിത്തരംജനീ	চিত্তরংজনী
ചിത്രകുന്ധാലാ	চিত্রকুন্ধালা
ചിത്രകേതു	চিত্রকেতু
ചിത്രഗംധാ	চিত্রগংধা
ചിത്രബാനാ	চিত্রবানা
ചിത്രമാലാ	চিত্রমালা
ചിത്രര്ത	চিত্রর্ত
ചിത്രല	চিত্রল
ചിത്രലേഖാ	চিত্রলেখা
ചിത്രാദീപ	চিত্রাদীপ
ചിത്രീനീ	চিত্রীনী
ചിദംബര	চিদংবর
ചിദാനംദാ	চিদানংদা
ചിനാര	চিনার
ചിന്നാദുരാഈ	চিন্নাদুরাঈ
ചിമന	চিমন
ചീദാര്ത	চীদার্ত
ചീന്മയേ	চীন্মযে
ചീരുഷ	চীরুষ
ചേതന്ദീപ	চেতন্দীপ
ചേതള	চেতল
ചേഥാസാ	চেথাসা
ചേമ്മല	চেম্মল
ചേര്വിക	চের্বিক
ചേലന	চেলন
ചേലിയാഁ	চেলিযাഁ
ചൈതന്യാ	চৈতন্যা
ചൈത്രാ	চৈত্রা
ചൈരാവലീ	চৈরাবলী
ഛായാംക	ছাযাংক
ജക്ഷ	জক্ষ
ജക്ഷാനീ	জক্ষানী
ജഗതപ്രകാശ	জগতপ্রকাশ
ജഗദഗുരു	জগদগুরু
ജഗദമ്ബാ	জগদম্বা
ജഗനമോഹിനീ	জগনমোহিনী
ജഗന്മയീ	জগন্মযী
ജഗ്വീ	জগ্বী
ജഗ്വീര	জগ্বীর
ജജ്വാല്യാ	জজ্বাল্যা
ജടായു	জটাযু
ജനഹിതാ	জনহিতা
ജനാദേവ	জনাদেব
ജനാവ	জনাব
ജനിത	জনিত
ജമാംദാഗ്ന്യ മഹാദാര്പാ	জমাংদাগ্ন্য মহাদার্পা
ജമ്ബവതപ്രീതി	জম্ববতপ্রীতি
ജയംത	জযংত
ജയചംദ	জযচংদ
ജയപാല	জযপাল
ജയമാലാ	জযমালা
ജയശ്രീ	জযশ্রী
ജയാകീര്തന	জযাকীর্তন
ജയാകേതന	জযাকেতন
ജയാപാദമാം	জযাপাদমাং
ജയായ	জযায
ജയിത	জযিত
ജയേശ	জযেশ
ജലദ	জলদ
ജല്പേശ	জল্পেশ
ജശവംത	জশবংত
ജസീത്താ	জসীত্তা
ജസ്സീ	জস্সী
ജാനകീ	জানকী
ജാനകീദാസ	জানকীদাস
ജാനകീനാഥ	জানকীনাথ
ജാനകീഭൂഷണ	জানকীভূষণ
ജാനഹിതാ	জানহিতা
ജാപക	জাপক
ജായിത്രീ	জাযিত্রী
ജിനേശ്വര	জিনেশ্বর
ജിഹാന	জিহান
ജീതേശ	জীতেশ
ജീന്ദാല	জীন্দাল
ജീവനകലാ	জীবনকলা
ജീവനീ	জীবনী
ജീവന്തീനീ	জীবন্তীনী
ജുഷ്ടി	জুষ্টি
ജേനീശാ	জেনীশা
ജേര്ശീകാ	জের্শীকা
ജൈകാപിശ	জৈকাপিশ
ജൈചരണ	জৈচরণ
ജൈനീശ	জৈনীশ
ജൈപ്രകാശ	জৈপ্রকাশ
ജൈവംത	জৈবংত
ജൈസല	জৈসল
ജൈഹാസീനീ	জৈহাসীনী
ജോംഫീ	জোংফী
ജോശനീകാ	জোশনীকা
ജോശീതാ	জোশীতা
ജ്വാലാ	জ্বালা
ജ്ഹില	জ্হিল
ജ്ഹീണൂക	জ্হীণূক
ഝഹനവീ	ঝহনবী
ഝാനീശാ	ঝানীশা
ഝാരാ	ঝারা
ഝീയാ	ঝীযা
ഝേനീശാ	ঝেনীশা
ഝ്യാനനീ	ঝ্যাননী
ടീംകു	টীংকু
ഠുമരീ	ঠুমরী
തക്ശീ	তক্শী
തക്ശീല	তক্শীল
തജജ്ഞ	তজজ্ঞ
തനവീ	তনবী
തനിഷ്ക	তনিষ্ক
തനുംജാശ്രീ	তনুংজাশ্রী
തനുംശ്കാ	তনুংশ্কা
തനോജ	তনোজ
തപസ	তপস
തപസ്വിനീ	তপস্বিনী
തമില  സേല്വീ	তমিল  সেল্বী
തമിശ	তমিশ
തമോഘ്നാ	তমোঘ্না
തമോനഷ	তমোনষ
തരംജോത	তরংজোত
തരനീ	তরনী
തരലാ	তরলা
തരീനീ	তরীনী
തരുശ്രീ	তরুশ্রী
തരൂണീ	তরূণী
തവലീന :	তবলীন :
തവിഷാ	তবিষা
തസ്യ	তস্য
താക്ഷ്യാ	তাক্ষ্যা
താജേന്ദര	তাজেন্দর
താനാരുപീ	তানারুপী
താനിയാ	তানিযা
താന്വീഥാ	তান্বীথা
താപീ	তাপী
താരികാ	তারিকা
താരീനീ	তারীনী
താരൂശ	তারূশ
താലംക	তালংক
താലീന	তালীন
താലേശ	তালেশ
താവന	তাবন
താവീശാ	তাবীশা
തിതലീ	তিতলী
തിനാശ	তিনাশ
തിലക	তিলক
തീഈവ്യേശ	তীঈব্যেশ
തീര്ഥാ	তীর্থা
തീസ്ചാ	তীস্চা
തുത്തീ	তুত্তী
തുനാവാ	তুনাবা
തുന്ഗാര	তুন্গার
തുപമ	তুপম
തുരഗ	তুরগ
തുശീഥാ	তুশীথা
തൃപേശ	তৃপেশ
തേജസ	তেজস
തേജസ്വീ	তেজস্বী
തേജസ്വീന	তেজস্বীন
തേജേനദര	তেজেনদর
തേജോമയ	তেজোময
തോയേശ	তোযেশ
തോശീകാ	তোশীকা
തൌരുസ	তৌরুস
ത്രികായാ	ত্রিকাযা
ത്രിപുരസുംദരീ	ত্রিপুরসুংদরী
ത്രിഭുവന	ত্রিভুবন
ത്രിമാന	ত্রিমান
ത്രിമൂര്തി	ত্রিমূর্তি
ത്രിവേണീ	ত্রিবেণী
ത്രിശല	ত্রিশল
ത്രിശലാനാ	ত্রিশলানা
ത്രീഝ്യാ	ত্রীঝ্যা
ത്രീതിയാ	ত্রীতিযা
ത്രീനേശ	ত্রীনেশ
ത്രീപന	ত্রীপন
ത്രീപ്ത	ত্রীপ্ত
ത്രീവീദ	ত্রীবীদ
ത്വരിതാ	ত্বরিতা
ത്വീശീ	ত্বীশী
ത്വേസാ	ত্বেসা
ഥംസീ	থংসী
ഥനീരികാ	থনীরিকা
ഥാകാപ്പന്സ്വാമീ	থাকাপ্পন্স্বামী
ഥാരികാ	থারিকা
ഥാവനീ	থাবনী
ഥീരീശ്കാ	থীরীশ্কা
ഥുസീഥാ	থুসীথা
ഥ്രേശാ	থ্রেশা
ദംദാപാനീ	দংদাপানী
ദക്ഷാഹതാ	দক্ষাহতা
ദബീത	দবীত
ദബ്ന്ശും	দব্ন্শুং
ദയാദാ	দযাদা
ദയാനിതാ	দযানিতা
ദരഹാസ	দরহাস
ദര്ശ	দর্শ
ദര്ശക	দর্শক
ദര്ശികാ	দর্শিকা
ദര്ശീനീ	দর্শীনী
ദര്സീകാ	দর্সীকা
ദശാഗ്രീവാ ശീരോഹരാ	দশাগ্রীবা শীরোহরা
ദശാഗ്രീവാകുലാന്താകാ	দশাগ্রীবাকুলান্তাকা
ദശാനന	দশানন
ദഹാ	দহা
ദാനാസ്വീ	দানাস্বী
ദാനുംശ്രീ	দানুংশ্রী
ദാന്ദാകാരാന്യ പുന്യകൃതേ	দান্দাকারান্য পুন্যকৃতে
ദാരുല	দারুল
ദാഹക	দাহক
ദികീശംദ	দিকীশংদ
ദിഗീശാ	দিগীশা
ദിപംശീ	দিপংশী
ദിപശീകീ	দিপশীকী
ദിപേംദര	দিপেংদর
ദിപ്താ	দিপ্তা
ദിബസരീ	দিবসরী
ദിവീഥാ	দিবীথা
ദിവേനാ	দিবেনা
ദീതാ	দীতা
ദീനബംധു	দীনবংধু
ദീപഥീ	দীপথী
ദീപപ്രഭാ	দীপপ্রভা
ദീപമാലാ	দীপমালা
ദീപശിഖാ	দীপশিখা
ദീപാംജലി	দীপাংজলি
ദീപാശാ	দীপাশা
ദീപിത	দীপিত
ദീവാംശ	দীবাংশ
ദേജ	দেজ
ദേബജ്യോതീ	দেবজ্যোতী
ദേബദാത്താ	দেবদাত্তা
ദേബദ്രിതാ	দেবদ্রিতা
ദേബന്ശീ	দেবন্শী
ദേയ്വയാനാകാന്തന	দেয্বযানাকান্তন
ദേവഗര്ഭാ	দেবগর্ভা
ദേവജ്യോതി	দেবজ্যোতি
ദേവദാന	দেবদান
ദേവന്ദ്ര	দেবন্দ্র
ദേവമദാനാ	দেবমদানা
ദേവരാജ	দেবরাজ
ദേവശ്രീ	দেবশ্রী
ദേവാംഗനാ	দেবাংগনা
ദേവാംഗീ	দেবাংগী
ദേവാംശു	দেবাংশু
ദേവാദീത്യാ	দেবাদীত্যা
ദേവാനീ	দেবানী
ദേവാന്ശാ	দেবান্শা
ദേവാപ്രിയാ	দেবাপ্রিযা
ദേവാമനോഹാരീ	দেবামনোহারী
ദേവീന	দেবীন
ദേവീലാല	দেবীলাল
ദേവേന	দেবেন
ദേവേശീ	দেবেশী
ദേവ്യഹ്നാന	দেব্যহ্নান
ദേശാവംത	দেশাবংত
ദൈത്യാകുലാന്താകാ	দৈত্যাকুলান্তাকা
ദൈവ്യാ	দৈব্যা
ധക്ശീന്യ	ধক্শীন্য
ധനസുഖ	ধনসুখ
ധനാജീ	ধনাজী
ധനിഷ്ഠ	ধনিষ্ঠ
ധനു	ধনু
ധനുജാ	ধনুজা
ധനേശീ	ধনেশী
ധന്വികാ	ধন্বিকা
ധരമനിഷ്ഠ	ধরমনিষ্ঠ
ധരാമാം	ধরামাং
ധരാഹാസീനീ	ধরাহাসীনী
ധരീശ	ধরীশ
ധര്മ  ദുത്ത	ধর্ম  দুত্ত
ധര്മഅധ്യക്ഷ	ধর্মঅধ্যক্ষ
ധര്മദിത്യ	ধর্মদিত্য
ധര്മദേവ	ধর্মদেব
ധര്ശീതാ	ধর্শীতা
ധര്ശീനീ	ধর্শীনী
ധാമീനീ	ধামীনী
ധാരാനീ	ধারানী
ധിതി	ধিতি
ധിതീ	ধিতী
ധീപ്ത്ഹാ	ধীপ্ত্হা
ധീമാഹീ	ধীমাহী
ധീര്ഥാ	ধীর্থা
ധേയാംശീ	ধেযাংশী
ധൈര്യ്യാ	ধৈর্য্যা
ധ്യുഥീ	ধ্যুথী
ധ്രുമീ	ধ্রুমী
നംദക	নংদক
നംദു	নংদু
നക്ശ	নক্শ
നക്സത്രരാജാ	নক্সত্ররাজা
നഗമാനീ	নগমানী
നടവര	নটবর
നത്രീശാ	নত্রীশা
നദീപ	নদীপ
നഭാ	নভা
നഭോമാനീ	নভোমানী
നമന	নমন
നമനാ	নমনা
നയന	নযন
നരേന്ദ്രന	নরেন্দ্রন
നരേന്ദ്രനാഥ	নরেন্দ্রনাথ
നരേശ	নরেশ
നവനീത വിലീപ്തംഗാ	নবনীত বিলীপ্তংগা
നവമ	নবম
നവരംഗ	নবরংগ
നസീബ	নসীব
നാംബീ	নাংবী
നാഗനാഥ	নাগনাথ
നാഗപാല	নাগপাল
നാഗേശ്വരണ	নাগেশ্বরণ
നാഗൈഃ	নাগৈঃ
നാതാഭൈരവീ	নাতাভৈরবী
നാതിന	নাতিন
നാന്ധീനീ	নান্ধীনী
നാന്നാന	নান্নান
നാഭിതാ	নাভিতা
നാഭേംദു	নাভেংদু
നാമത	নামত
നായകീ	নাযকী
നായാനീ	নাযানী
നായാനീകാ	নাযানীকা
നാലിനികാംത	নালিনিকাংত
നാലീനേശയ	নালীনেশয
നാവീന്യ	নাবীন্য
നാവീല	নাবীল
നാവ്യാ ദുര്ഗാ	নাব্যা দুর্গা
നാവ്രീതാ	নাব্রীতা
നികാരാ	নিকারা
നിഖിതാ	নিখিতা
നിഖില	নিখিল
നിജു	নিজু
നിധി	নিধি
നിധിപാ	নিধিপা
നിപാ	নিপা
നിരംജനാ	নিরংজনা
നിരമഈ	নিরমঈ
നിരുപമാ	নিরুপমা
നിര്മളാ	নির্মলা
നിര്മിതി	নির্মিতি
നിലാശാ	নিলাশা
നിശാനഥീ	নিশানথী
നീഗീഥാ	নীগীথা
നീതു	নীতু
നീഥീകാ	নীথীকা
നീധാ	নীধা
നീധാര്സനാ	নীধার্সনা
നീമാംലന	নীমাংলন
നീരാലികാ	নীরালিকা
നീരൈമാംഥീ	নীরৈমাংথী
നീര്മുകതാ	নীর্মুকতা
നീല മാധവ	নীল মাধব
നീലംജന	নীলংজন
നീലക്ഷ	নীলক্ষ
നീല്ജാ	নীল্জা
നീശാലീ	নীশালী
നീശീതീ	নীশীতী
നീശ്മീഥാ	নীশ্মীথা
നീസ്ചീഥാ	নীস্চীথা
നീഹാ	নীহা
നേമീശാ	নেমীশা
നേയ്സാ	নেয্সা
നേരീശാ	নেরীশা
നൈജാ	নৈজা
നൈരീതീ	নৈরীতী
നൈവേധീ	নৈবেধী
നൌസദ	নৌসদ
പംകജന	পংকজন
പംചഭൂതാത്മികാ	পংচভূতাত্মিকা
പംഥീനീ	পংথীনী
പഝ്ഹേനീ	পঝ্হেনী
പത്താമ്ബരാപരീധാനാ	পত্তাম্বরাপরীধানা
പത്ര	পত্র
പന്ദാലാവാസന	পন্দালাবাসন
പമ്പാ	পম্পা
പമ്ഫാ	পম্ফা
പയാസ	পযাস
പയോധീ	পযোধী
പരംതാപാ	পরংতাপা
പരമാംത്മികാ	পরমাংত্মিকা
പരമാംന്ത്ര	পরমাংন্ত্র
പരമിലാ	পরমিলা
പരമേശ്വരീ	পরমেশ্বরী
പരമ്വാര്ദാന	পরম্বার্দান
പരവാനീ	পরবানী
പരവിംദര	পরবিংদর
പരാകാഷ	পরাকাষ
പരാവീ	পরাবী
പരിഹാ	পরিহা
പര്തീബന	পর্তীবন
പര്ലീ	পর্লী
പര്വ	পর্ব
പലാക്ഷ	পলাক্ষ
പലാശീനീ	পলাশীনী
പവന	পবন
പവനസുത	পবনসুত
പശുപതി	পশুপতি
പഹലാജ	পহলাজ
പാടലാ	পাটলা
പാന്ദുരംഗാ	পান্দুরংগা
പായല	পাযল
പാരു	পারু
പാര്ഥിക	পার্থিক
പാര്ഥീവീ	পার্থীবী
പാര്ഥോ	পার্থো
പാളവീ	পালবী
പാവകീ	পাবকী
പാവനാ	পাবনা
പാവാനാ	পাবানা
പാഹീ	পাহী
പിവാല	পিবাল
പൂജന	পূজন
പൂരതീ	পূরতী
പൂരികാ	পূরিকা
പൂര്വജാ	পূর্বজা
പൂര്വികാ	পূর্বিকা
പേഖമ	পেখম
പേത്ചീ	পেত্চী
പേരാരസീ	পেরারসী
പ്രകൃഥീ	প্রকৃথী
പ്രഗന്യാ	প্রগন্যা
പ്രഗ്യപരാമിതാ	প্রগ্যপরামিতা
പ്രജാനാ	প্রজানা
പ്രനാദാ	প্রনাদা
പ്രനീധാനാ	প্রনীধানা
പ്രബകരണ	প্রবকরণ
പ്രഭാകര	প্রভাকর
പ്രഭാകരന	প্রভাকরন
പ്രഭാത	প্রভাত
പ്രഭാവ	প্রভাব
പ്രാതീകാ	প্রাতীকা
ഫനീ	ফনী
ഫനീഭുഷണ	ফনীভুষণ
ഫാല്ഗുനീ	ফাল্গুনী
ഫൂലന	ফূলন
ഫ്രാന്ചീസ	ফ্রান্চীস
ബംദിശ	বংদিশ
ബംധൂല	বংধূল
ബംശീ	বংশী
ബംസീധര	বংসীধর
ബകുലാ	বকুলা
ബകൂല	বকূল
ബദ്രീ	বদ্রী
ബനജ	বনজ
ബനവാരീ	বনবারী
ബബന	ববন
ബബിശ	ববিশ
ബര്ഹന	বর্হন
ബലബീര	বলবীর
ബഹവാസ്യ	বহবাস্য
ബാബു	বাবু
ബാബുല	বাবুল
ബാല മുകുന്ദ	বাল মুকুন্দ
ബാലധി	বালধি
ബാലാമോഹന	বালামোহন
ബാലാരാജ	বালারাজ
ബാലാശംകര	বালাশংকর
ബാലു	বালু
ബാലേന്ദു	বালেন্দু
ബാസ്കാര	বাস্কার
ബിനീതാ	বিনীতা
ബീനും	বীনুং
ബീന്ദുശ്രീ	বীন্দুশ্রী
ബീന്നീകേര	বীন্নীকের
ബീപുല	বীপুল
ബീബീന	বীবীন
ബീരത	বীরত
ബീഹാന	বীহান
ബേനീതാ	বেনীতা
ബേനും	বেনুং
ബേലുരമീ	বেলুরমী
ബേല്ലീ	বেল্লী
ബൈവാവീ	বৈবাবী
ബൈസാഖീ	বৈসাখী
ബ്രീഥ്ഹീ	ব্রীথ্হী
ബ്ലേസ്സീ	ব্লেস্সী
ഭഗവാന	ভগবান
ഭദ്രക്ഷ	ভদ্রক্ষ
ഭദ്രനിധി	ভদ্রনিধি
ഭദ്രപ്രിയാ	ভদ্রপ্রিযা
ഭദ്രിക	ভদ্রিক
ഭദ്രീശാ	ভদ্রীশা
ഭവാനീ	ভবানী
ഭവ്യരാജ	ভব্যরাজ
ഭാഗവംതീ	ভাগবংতী
ഭാദരന	ভাদরন
ഭാനുമിത്ര	ভানুমিত্র
ഭാരഥീ	ভারথী
ഭാര്ഗവന	ভার্গবন
ഭാര്ഗവാ	ভার্গবা
ഭാര്ഘവീ	ভার্ঘবী
ഭാര്ദ്ദ്വാജ	ভার্দ্দ্বাজ
ഭാലേംദ്ര	ভালেংদ্র
ഭാവതീ	ভাবতী
ഭാവീഗുരും	ভাবীগুরুং
ഭാവ്യമ	ভাব্যম
ഭാശ്വീനീ	ভাশ্বীনী
ഭാസു	ভাসু
ഭാസ്കാരീ	ভাস্কারী
ഭാസ്കേര	ভাস্কের
ഭീമശംകര	ভীমশংকর
ഭൂദേവ	ভূদেব
ഭൂപത	ভূপত
ഭൂപാല	ভূপাল
ഭൂമാ	ভূমা
ഭൂമാം	ভূমাং
ഭേരേശ	ভেরেশ
ഭൈരവീ	ভৈরবী
മംഗലമ	মংগলম
മംഗേശ	মংগেশ
മംജു  പ്രസന്ന	মংজু  প্রসন্ন
മംജുനാഥ	মংজুনাথ
മംജുലാ	মংজুলা
മംത	মংত
മംതോഷ	মংতোষ
മംദിഥാ	মংদিথা
മംദിരാ	মংদিরা
മകാലീ	মকালী
മകുര	মকুর
മഗന	মগন
മണികാംത	মণিকাংত
മദുരാ	মদুরা
മധുനിഷാ	মধুনিষা
മധുമാംലീ	মধুমাংলী
മധുരിമാ	মধুরিমা
മധുവംതീ	মধুবংতী
മനജീത	মনজীত
മനപ	মনপ
മനസ്വിന	মনস্বিন
മനാല്പ	মনাল্প
മനീതാ	মনীতা
മനീഷ	মনীষ
മനോജ	মনোজ
മനോരനജനീ	মনোরনজনী
മനോരിഥാ	মনোরিথা
മന്നത	মন্নত
മന്മായീ	মন্মাযী
മല്ലികാ	মল্লিকা
മഹംത	মহংত
മഹാതപസ്വീ	মহাতপস্বী
മഹാദുര്ഗാ	মহাদুর্গা
മഹാദേവാ	মহাদেবা
മഹാദേവാദീപുജീതാ	মহাদেবাদীপুজীতা
മഹാന്തേശ	মহান্তেশ
മഹാബാലാ	মহাবালা
മഹാസ്വേതാ	মহাস্বেতা
മഹിപതി	মহিপতি
മഹിഷാസുരമര്ദിനീ	মহিষাসুরমর্দিনী
മഹീജിത	মহীজিত
മഹേംദ്രാ	মহেংদ্রা
മഹേശ	মহেশ
മഹേശനീ	মহেশনী
മഹേശീ	মহেশী
മാംതിക	মাংতিক
മാംനീമോഝ്ഹീ	মাংনীমোঝ্হী
മാംനുസരീ	মাংনুসরী
മാംന്ക്ഷ	মাংন্ক্ষ
മാംന്ഗീരീ	মাংন্গীরী
മാംന്താവ്യാഹ	মাংন্তাব্যাহ
മാംന്തീകാ	মাংন্তীকা
മാംന്ദീതാ	মাংন্দীতা
മാംലാമാംകാല മകാന	মাংলামাংকাল মকান
മാഇല	মাইল
മാനകാ	মানকা
മാനജ	মানজ
മാനശ	মানশ
മാനിക	মানিক
മാനീശീന	মানীশীন
മാനോരിത	মানোরিত
മാന്കന	মান্কন
മാന്ദാവിക	মান্দাবিক
മായാ	মাযা
മാര്ഗശീ	মার্গশী
മാര്ഗീ	মার্গী
മാര്തംദ	মার্তংদ
മാര്ഥീകാ	মার্থীকা
മാര്യ	মার্য
മാര്യാ	মার্যা
മാര്ഷാ	মার্ষা
മാലാര്കോഡീ	মালার্কোডী
മാലിനീ	মালিনী
മാല്ലേശാ	মাল্লেশা
മാസൂമ	মাসূম
മാസൂമീ	মাসূমী
മാഹിയാ	মাহিযা
മാഹിരാജ	মাহিরাজ
മാഹുലീ	মাহুলী
മിലീ	মিলী
മിഹീകാ	মিহীকা
മീനാ	মীনা
മേധ	মেধ
മേധീനീ	মেধীনী
മൈത്രായ	মৈত্রায
മൌലീശാ	মৌলীশা
മ്യ്ഥിലീ	ম্য্থিলী
യംശ	যংশ
യക്ഷ	যক্ষ
യജും	যজুং
യജുസ	যজুস
യജ്നേശ	যজ্নেশ
യഥാര്ഥ	যথার্থ
യദുനംദന	যদুনংদন
യശസ്വിനീ	যশস্বিনী
യശാശ്രീ	যশাশ্রী
യശ്ദീപ	যশ্দীপ
യശ്മിത	যশ্মিত
യശ്മിതാ	যশ্মিতা
യശ്വാര്ധാനാ	যশ্বার্ধানা
യശ്വീന	যশ্বীন
യശ്വീനീ	যশ্বীনী
യസ്വംഥ	যস্বংথ
യാക്സീനീ	যাক্সীনী
യാഗ്നാകായാ	যাগ্নাকাযা
യാഗ്നീഥാ	যাগ্নীথা
യാചന	যাচন
യാതീരാജു	যাতীরাজু
യാദവീ	যাদবী
യാദവേന്ദ്ര	যাদবেন্দ্র
യാന്തി	যান্তি
യാശ്രീഥാ	যাশ্রীথা
യാഷ്ക	যাষ্ক
യാസസ്വീ	যাসস্বী
യുഗന്തീകാ	যুগন্তীকা
യുഗപ	যুগপ
യുഗാന്ധര	যুগান্ধর
യുതി	যুতি
യുവംശ	যুবংশ
യുവനാഥ	যুবনাথ
യുവല	যুবল
യുവാഥീ	যুবাথী
യുവാന  സൂര്യ	যুবান  সূর্য
യുവ്നീക	যুব্নীক
യേര്രപ്പാ	যের্রপ্পা
യേശനാ	যেশনা
യേശാസ്വീനീ	যেশাস্বীনী
യേസസരീ	যেসসরী
യോഗദേവാ	যোগদেবা
യോഗരാജ	যোগরাজ
യോഗാനംദ	যোগানংদ
യോഗിത	যোগিত
യോഗിതാ	যোগিতা
യോഗിഥ	যোগিথ
യോഗേശ്വര	যোগেশ্বর
യോഗ്ദീപ	যোগ্দীপ
യോത്ശനാ	যোত্শনা
യോനേന്ദ്ര	যোনেন্দ্র
യോഹ്ശീനീ	যোহ্শীনী
യൌവാനീ	যৌবানী
രംഗനാഥ	রংগনাথ
രംജന	রংজন
രംജികാ	রংজিকা
രംജീവ	রংজীব
രഈര്ഥ	রঈর্থ
രക്ത	রক্ত
രക്തകമള	রক্তকমল
രക്ഷികാ	রক্ষিকা
രക്ഷിത	রক্ষিত
രഘവാ	রঘবা
രഘവേന്ദര	রঘবেন্দর
രഘുനാഥ	রঘুনাথ
രജത	রজত
രജനീശ	রজনীশ
രജനേശ	রজনেশ
രജീത	রজীত
രതന	রতন
രതാംജലി	রতাংজলি
രതീക	রতীক
രതുല	রতুল
രത്നാകര	রত্নাকর
രത്നാബലീ	রত্নাবলী
രഥനാ	রথনা
രന്യ	রন্য
രന്വിഥാ	রন্বিথা
രബേക	রবেক
രമാംസ്വമ്യ	রমাংস্বম্য
രമ്ബേശ	রম্বেশ
രയാന	রযান
രര്ശ്മീതാ	রর্শ্মীতা
രവി കാന്ത	রবি কান্ত
രവികാംത	রবিকাংত
രവിത	রবিত
രവീജാ	রবীজা
രവീനാ	রবীনা
രവ്യംകീ	রব্যংকী
രശീലാ	রশীলা
രസവംത	রসবংত
രസ്മീന	রস্মীন
രാഈ കുമാര	রাঈ কুমার
രാഖീ	রাখী
രാഗാവ	রাগাব
രാഗിനീ	রাগিনী
രാഗേശ	রাগেশ
രാഗ്വേദ	রাগ্বেদ
രാജക	রাজক
രാജകന്യാ	রাজকন্যা
രാജഗോപാല	রাজগোপাল
രാജയവര്ദന	রাজযবর্দন
രാജാ	রাজা
രാജാര്ശീ	রাজার্শী
രാജികാ	রাজিকা
രാജീവ	রাজীব
രാജേംദ്രമോഹന	রাজেংদ্রমোহন
രാജേശ്വര	রাজেশ্বর
രാജ്യശ്രീ	রাজ্যশ্রী
രാധാനീ	রাধানী
രാനീ	রানী
രാമ  കീന്കാര	রাম  কীন্কার
രാമഗോപാല	রামগোপাল
രാമചന്ദ്രന	রামচন্দ্রন
രാമനാരായണ	রামনারাযণ
രാമരാ	রামরা
രാമരാജ	রামরাজ
രാമാംസുഗ്രീവാ	রামাংসুগ্রীবা
രാമാനംദ	রামানংদ
രാമാനുജമ	রামানুজম
രാമോജീ	রামোজী
രാഹിത്യ	রাহিত্য
രാഹീന്യ	রাহীন্য
രാഹുലരാജ	রাহুলরাজ
രിദ്ധി	রিদ্ধি
രീചികാ	রীচিকা
രീതൂ	রীতূ
രീഥേകാ	রীথেকা
രീദേവ	রীদেব
രീധമാം	রীধমাং
രീഭ്യാ	রীভ্যা
രീശും	রীশুং
രീശ്മേഥാ	রীশ্মেথা
രേഖാ	রেখা
രേത്വിക	রেত্বিক
രേധാ	রেধা
രേനാ	রেনা
രേനേശ	রেনেশ
രേമാംനീകാ	রেমাংনীকা
രേമീ	রেমী
രേവാതീ	রেবাতী
രേവീഥാ	রেবীথা
രേശമീ	রেশমী
രേശ്വീന	রেশ্বীন
രേഹാംശീ	রেহাংশী
രേഹാനാ	রেহানা
രേഹേഈലാ	রেহেঈলা
രേഹ്നുഘാ	রেহ্নুঘা
രൈവത	রৈবত
രൈവതാ	রৈবতা
ലംഗീത	লংগীত
ലക്ഷ	লক্ষ
ലക്ഷാകീ	লক্ষাকী
ലക്ഷിതാ	লক্ষিতা
ലക്ഷ്മീകാനതമ	লক্ষ্মীকানতম
ലജ്ജാ	লজ্জা
ലജ്ജാകാ	লজ্জাকা
ലതാ	লতা
ലതേശ	লতেশ
ലവപാല	লবপাল
ലവലീന	লবলীন
ലഹരീ	লহরী
ലാക്ശേതാ	লাক্শেতা
ലാജവംതീ	লাজবংতী
ലാതീശ	লাতীশ
ലാനീബന	লানীবন
ലാഭാ	লাভা
ലാമ്ബോധാര	লাম্বোধার
ലാരീനാ	লারীনা
ലാര്മികാ	লার্মিকা
ലാര്രാജ	লার্রাজ
ലാര്ശന	লার্শন
ലാവനീ	লাবনী
ലാവിനാ	লাবিনা
ലീകേശ	লীকেশ
ലീത്സാ	লীত্সা
ലീനാശാ	লীনাশা
ലീനീത	লীনীত
ലീപാക്ഷീ	লীপাক্ষী
ലീപ്സീകാ	লীপ্সীকা
ലീമനാ	লীমনা
ലീലാമഈ	লীলামঈ
ലീശാംത	লীশাংত
ലുസിയാ	লুসিযা
ലേഈവീനാ	লেঈবীনা
ലേഖീശാ	লেখীশা
ലേമാര	লেমার
ലോകനേത്ര	লোকনেত্র
ലോകാജനാനീ	লোকাজনানী
ലോകാമാത്രീ	লোকামাত্রী
ലോകീഥാ	লোকীথা
ലോകേന്ദ്ര	লোকেন্দ্র
ലോഗീനീ	লোগীনী
ലോഗേശ്വരണ	লোগেশ্বরণ
ലോചനാ	লোচনা
ലോനാ	লোনা
ലോമാംകേശ	লোমাংকেশ
ലോഹിത	লোহিত
ലോഹിതാശ്വാ	লোহিতাশ্বা
ലൌക്യ	লৌক্য
വംദിതാ	বংদিতা
വംസികൃഷ്ണ	বংসিকৃষ্ণ
വനദ	বনদ
വനമാംഥീ	বনমাংথী
വനസ	বনস
വനിനാധ	বনিনাধ
വന്ജുല	বন্জুল
വപുസ	বপুস
വയദീശ	বযদীশ
വരലീ	বরলী
വരിന	বরিন
വരിയാസ	বরিযাস
വരുന	বরুন
വരുനികാ	বরুনিকা
വര്ണിത	বর্ণিত
വര്ധമാന	বর্ধমান
വര്ധാനീ	বর্ধানী
വര്ധീമൈനകാപുജീതാ	বর্ধীমৈনকাপুজীতা
വര്നീശാ	বর্নীশা
വര്ശനേയാ	বর্শনেযা
വര്ശീകാ	বর্শীকা
വര്ശീതാ	বর্শীতা
വര്ശീദ	বর্শীদ
വര്ഷനീ	বর্ষনী
വല്ലികാ	বল্লিকা
വസംതാ	বসংতা
വസംതീ	বসংতী
വസീസതാ	বসীসতা
വസുമിത്ര	বসুমিত্র
വസുസേന	বসুসেন
വാക്പതി	বাক্পতি
വാക്ഷു	বাক্ষু
വാച്യ	বাচ্য
വാജ്രക്ഷ	বাজ্রক্ষ
വാതത്മാജ	বাতত্মাজ
വാത്സല്യ	বাত্সল্য
വാദിവേലും	বাদিবেলুং
വാനര	বানর
വാന്ശുല	বান্শুল
വാമന	বামন
വാമാംക്ഷീ	বামাংক্ষী
വാമീല	বামীল
വാരനാ	বারনা
വാരുനീ	বারুনী
വാലാരമാംഥീ	বালারমাংথী
വാല്ല്മാംനാലന	বাল্ল্মাংনালন
വാശു	বাশু
വാസുമന	বাসুমন
വാഹിനീ	বাহিনী
വികീശാ	বিকীশা
വിക്ഷിത	বিক্ষিত
വിജയാലക്ഷ്മീ	বিজযালক্ষ্মী
വിജയാശാനഥീ	বিজযাশানথী
വിജീതാ	বিজীতা
വിദിശാ	বিদিশা
വിദ്യാ	বিদ্যা
വിദ്യുല	বিদ্যুল
വിധാഥരീ	বিধাথরী
വിന്ധുജാ	বিন্ধুজা
വിബാലീ	বিবালী
വിഭാവാ	বিভাবা
വിഭൂതി	বিভূতি
വിഭൂഷ	বিভূষ
വിയാമര്ശ	বিযামর্শ
വിരഗനാപതീ	বিরগনাপতী
വിരഭാദ്രപ്പാ	বিরভাদ্রপ্পা
വിരാജ	বিরাজ
വിലാശീനീ	বিলাশীনী
വീണാ	বীণা
വീണാധാരീ	বীণাধারী
വേക്രാംത	বেক্রাংত
വേഗ	বেগ
വേഗവാഹീനീ	বেগবাহীনী
വേഗീ	বেগী
വേണു	বেণু
വേത്ത്രീ	বেত্ত্রী
വേത്രിവാല	বেত্রিবাল
വേത്രീവേല	বেত্রীবেল
വേദകാര്തിക	বেদকার্তিক
വേദവല്ലീ	বেদবল্লী
വേദാ	বেদা
വേദാ ശ്രീ	বেদা শ্রী
വേധാംത	বেধাংত
വേന്കാത്രമണ	বেন্কাত্রমণ
വേന്തന	বেন্তন
വേന്നേലാ	বেন্নেলা
വേന്മതീ	বেন্মতী
വേലു	বেলু
വേഹംത	বেহংত
വൈകുംഠ	বৈকুংঠ
വൈജീനാഥ	বৈজীনাথ
വൈദത	বৈদত
വൈദേഹീ	বৈদেহী
വൈദ്യുംത	বৈদ্যুংত
വൈധേ	বৈধে
വൈധ്യാത	বৈধ্যাত
വൈരാഗ	বৈরাগ
വൈരോചന	বৈরোচন
വൈശാലീ	বৈশালী
വൈശ്വീ	বৈশ্বী
വൈഷ്ണവീ	বৈষ্ণবী
വൈസകാ	বৈসকা
സംക്രാംതി	সংক্রাংতি
സംഗമിത്ര	সংগমিত্র
സംഗമീധീരാ	সংগমীধীরা
സംചയ	সংচয
സംചീതീ	সংচীতী
സംജേനാ	সংজেনা
സംജോലീ	সংজোলী
സംതോക	সংতোক
സംദിപോന	সংদিপোন
സംദീപ	সংদীপ
സംദേശ	সংদেশ
സംധരാ	সংধরা
സംധ്യാ	সংধ্যা
സംബീതാ	সংবীতা
സംമീതാ	সংমীতা
സംയുക്ത	সংযুক্ত
സംവിധാ	সংবিধা
സംവീഥാ	সংবীথা
സംസ്കൃതി	সংস্কৃতি
സംഹിത	সংহিত
സക്ശീന്യാ	সক্শীন্যা
സഖ്യാ	সখ্যা
സഗന	সগন
സഗുനാ	সগুনা
സചിതാ	সচিতা
സചിദാനംദ വിഗ്രഹ	সচিদানংদ বিগ্রহ
സചേതന	সচেতন
സച്ചിദാനംദാ	সচ্চিদানংদা
സജീത	সজীত
സജീലീ	সজীলী
സദഗതി	সদগতি
സദഗുനാ	সদগুনা
സദാശിവ	সদাশিব
സദിശ	সদিশ
സപനാ	সপনা
സപുഷ്പാ	সপুষ্পা
സപ്താബീ	সপ্তাবী
സപ്തോര്ശീ	সপ্তোর্শী
സമജാ	সমজা
സമദര്ശീ	সমদর্শী
സമഭ്ദ്ധാ	সমভ্দ্ধা
സമരേശ	সমরেশ
സമാംദ്രിതാ	সমাংদ্রিতা
സമാംര്ധ	সমাংর্ধ
സമാജസ	সমাজস
സമാരാസ്യാ	সমারাস্যা
സമിക	সমিক
സമിരന	সমিরন
സമേംദ്ര	সমেংদ্র
സമേശ	সমেশ
സമ്പൂര്ണ	সম্পূর্ণ
സമ്പ്രഥ്യ	সম্প্রথ্য
സമ്പ്രീതീ	সম্প্রীতী
സമ്രാട	সম্রাট
സമ്രീധ	সম্রীধ
സരസംഗീ	সরসংগী
സലീജ	সলীজ
സഹര്സീതാ	সহর্সীতা
സഹശ്രദ	সহশ্রদ
സഹസ്ത്രജീത	সহস্ত্রজীত
സഹസ്ത്രബാഹു	সহস্ত্রবাহু
സഹീത	সহীত
സഹീരാമ	সহীরাম
സഹ്യ	সহ্য
സാംജ	সাংজ
സാഇ രാമ	সাই রাম
സാഈനാഥ	সাঈনাথ
സാചീ	সাচী
സാജന	সাজন
സാദ്രീശീ	সাদ্রীশী
സാദ്വിഥാ	সাদ্বিথা
സാധന	সাধন
സാധ്യാ	সাধ্যা
സാനിധ്യ	সানিধ্য
സാമംതാ	সামংতা
സാമ്ഭാ	সাম্ভা
സാരണീ	সারণী
സാരഥീ	সারথী
സാരികാ	সারিকা
സാലവീ	সালবী
സാലസാ	সালসা
സൈകത	সৈকত
സൈനീത്യ	সৈনীত্য
സൈന്ധന്യ	সৈন্ধন্য
സൈലീ	সৈলী
സൈഹാര്സന	সৈহার্সন
ഹംസമാലാ	হংসমালা
ഹംസാവാഥ്യ	হংসাবাথ্য
ഹനാര്വീന	হনার্বীন
ഹനീതാ	হনীতা
ഹനുപ	হনুপ
ഹനുമാന	হনুমান
ഹബീതാ	হবীতা
ഹമസാദീപികാ	হমসাদীপিকা
ഹമസാനംദീനീ	হমসানংদীনী
ഹമീര	হমীর
ഹരജീത	হরজীত
ഹരജീവന	হরজীবন
ഹരനാധ	হরনাধ
ഹരശും	হরশুং
ഹരികിശന	হরিকিশন
ഹരിഗംഗാ	হরিগংগা
ഹരിഗോപാല	হরিগোপাল
ഹരിദാസ	হরিদাস
ഹരിദ്വാര	হরিদ্বার
ഹരിപ്രീത	হরিপ্রীত
ഹരിമംതീ	হরিমংতী
ഹരീ	হরী
ഹരേശ്വര	হরেশ্বর
ഹര്മീന	হর্মীন
ഹര്ഷണ	হর্ষণ
ഹര്സികാ	হর্সিকা
ഹശ്മീതാ	হশ্মীতা
ഹസമുഖ	হসমুখ
ഹസീതാ	হসীতা
ഹസ്വീഥാ	হস্বীথা
ഹാര്ദീനീ	হার্দীনী
ഹാര്ശീനീ	হার্শীনী
ഹാലിക	হালিক
ഹിംഡോള	হিংডোল
ഹിംദോലാ	হিংদোলা
ഹിതാക്ഷീ	হিতাক্ষী
ഹിതീ	হিতী
ഹിഥീക്സാ	হিথীক্সা
ഹിമാംശു	হিমাংশু
ഹിമാക്ഷ	হিমাক্ষ
ഹിമാലയ	হিমালয
ഹിരംയക	হিরংযক
ഹിരവ	হিরব
ഹിരവാ	হিরবা
ഹിരുധായാ	হিরুধাযা
ഹിവാ	হিবা
ഹീരാനമാം	হীরানমাং
ഹീരാന്യാപ്രകാഈ	হীরান্যাপ্রকাঈ
ഹീര്നാക്ഷീ	হীর্নাক্ষী
ഹുവീശ്കാ	হুবীশ্কা
ഹൃദയനാഥ	হৃদযনাথ
ഹേഈദീ	হেঈদী
ഹേജല	হেজল
ഹേതാ	হেতা
ഹേതാശ	হেতাশ
ഹേത്ശ്രീ	হেত্শ্রী
ഹേഥാന്ശ്രീ	হেথান্শ্রী
ഹേനീത	হেনীত
ഹേനീല	হেনীল
ഹേമനാഥ	হেমনাথ
ഹേമലതാ	হেমলতা
ഹേമാ	হেমা
ഹേമാംദ്രികാ	হেমাংদ্রিকা
ഹേമാഗൌരീ	হেমাগৌরী
ഹേമാനംദ	হেমানংদ
ഹേമാലാ	হেমালা
ഹേമാവതീ	হেমাবতী
ഹേമാവാതിനംദന	হেমাবাতিনংদন
ഹേമേംദു	হেমেংদু
ഹേയന	হেযন
ഹേയാംശ	হেযাংশ
ഹേരീത	হেরীত
ഹേലീ	হেলী
ഹോന്നേശാ	হোন্নেশা
ഹോമാ	হোমা
ഹ്രീത്വിക	হ্রীত্বিক
ഹ്രീദാന്ക്ഷ	হ্রীদান্ক্ষ
ഹ്രീധാന	হ্রীধান
ഹ്രീശന	হ্রীশন
ഹ്രീശാംത	হ্রীশাংত
ഹ്രീഷിത	হ্রীষিত
ഹ്രുദയ	হ্রুদয
ഹ്രുശാല	হ্রুশাল
ഹ്രേയാംശ	হ্রেযাংশ
ഹ്ര്യ്ദയേശ	হ্র্য্দযেশ
#
#
# Territory names from CLDR
അസൻഷൻ ദ്വീപ്	অসন্ষন্ দ্বীপ্
അന്റോറ	অন্রোর
യുണൈറ്റഡ് അറബ് എമിറൈറ്റ്‌സ്	যুণৈর্রড্ অরব্ এমিরৈর্র্‌স্
അഫ്‌ഗാനിസ്ഥാൻ	অফ্‌গানিস্থান্
ആൻറിഗ്വയും ബർബുഡയും	আন্রিগ্বযুং বর্বুডযুং
ആൻഗ്വില്ല	আন্গ্বিল্ল
അൽബേനിയ	অল্বেনিয
അർമേനിയ	অর্মেনিয
അംഗോള	অংগোল
അൻറാർട്ടിക്ക	অন্রার্ট্টিক্ক
അർജൻറീന	অর্জন্রীন
അമേരിക്കൻ സമോവ	অমেরিক্কন্ সমোব
ഓസ്ട്രിയ	ওস্ট্রিয
ഓസ്‌ട്രേലിയ	ওস্‌ট্রেলিয
അറൂബ	অরূব
അലൻഡ് ദ്വീപുകൾ	অলন্ড্ দ্বীপুকল্
അസർബൈജാൻ	অসর্বৈজান্
ബോസ്നിയയും ഹെർസഗോവിനയും	বোস্নিযযুং হের্সগোবিনযুং
ബാർബഡോസ്	বার্বডোস্
ബംഗ്ലാദേശ്	বংগ্লাদেশ্
ബെൽജിയം	বেল্জিযং
ബുർക്കിനാ ഫാസോ	বুর্ক্কিনা ফাসো
ബൾഗേറിയ	বল্গেরিয
ബഹ്റിൻ	বহ্রিন্
ബറുണ്ടി	বরুণ্টি
ബെനിൻ	বেনিন্
സെന്റ് ബാർത്തലമി	সেন্র্ বার্ত্তলমি
ബർമുഡ	বর্মুড
ബ്രൂണൈ	ব্রূণৈ
ബൊളീവിയ	বোলীবিয
ബൊണെയ്ർ, സിന്റ് യുസ്റ്റേഷ്യസ്, സാബ എന്നിവ	বোণেয্র্, সিন্র্ যুস্র্রেষ্যস্, সাব এন্নিব
ബ്രസീൽ	ব্রসীল্
ബഹാമാസ്	বহামাস্
ഭൂട്ടാൻ	ভূট্টান্
ബൗവെട്ട് ദ്വീപ്	বৌবেট্ট্ দ্বীপ্
ബോട്സ്വാന	বোট্স্বান
ബെലറൂസ്	বেলরূস্
ബെലീസ്	বেলীস্
കാനഡ	কানড
കോക്കസ് (കീലിംഗ്) ദ്വീപുകൾ	কোক্কস্ (কীলিংগ্) দ্বীপুকল্
കോംഗോ - കിൻഷാസ	কোংগো - কিন্ষাস
കോംഗോ (DRC)	কোংগো (DRC)
സെൻട്രൽ ആഫ്രിക്കൻ റിപ്പബ്ലിക്	সেন্ট্রল্ আফ্রিক্কন্ রিপ্পব্লিক্
കോംഗോ - ബ്രാസവില്ലി	কোংগো - ব্রাসবিল্লি
കോംഗോ (റിപ്പബ്ലിക്ക്)	কোংগো (রিপ্পব্লিক্ক্)
സ്വിറ്റ്സർലാൻഡ്	স্বির্র্সর্লান্ড্
കോട്ട് ഡി വാർ	কোট্ট্ ডি বার্
ഐവറി കോസ്റ്റ്	ঐবরি কোস্র্র্
കുക്ക് ദ്വീപുകൾ	কুক্ক্ দ্বীপুকল্
ചിലി	চিলি
കാമറൂൺ	কামরূণ্
ചൈന	চৈন
കൊളംബിയ	কোলংবিয
ക്ലിപ്പെർട്ടൻ ദ്വീപ്	ক্লিপ্পের্ট্টন্ দ্বীপ্
കോസ്റ്ററിക്ക	কোস্র্ররিক্ক
ക്യൂബ	ক্যূব
കേപ്പ് വെർദെ	কেপ্প্ বের্দে
കുറാകാവോ	কুরাকাবো
ക്രിസ്മസ് ദ്വീപ്	ক্রিস্মস্ দ্বীপ্
സൈപ്രസ്	সৈপ্রস্
ചെക്ക് റിപ്പബ്ലിക്	চেক্ক্ রিপ্পব্লিক্
ജർമനി	জর্মনি
ഡീഗോ ഗ്രാഷ്യ	ডীগো গ্রাষ্য
ദിജിബൗട്ടി	দিজিবৌট্টি
ഡെൻമാർക്ക്	ডেন্মার্ক্ক্
ഡൊമിനിക്ക	ডোমিনিক্ক
ഡൊമിനിക്കൻ റിപ്പബ്ലിക്	ডোমিনিক্কন্ রিপ্পব্লিক্
അൾജീരിയ	অল্জীরিয
സെയൂത്ത ആൻഡ് മെലിയ	সেযূত্ত আন্ড্ মেলিয
ഇക്വഡോർ	ইক্বডোর্
എസ്റ്റോണിയ	এস্র্রোণিয
ഈജിപ്ത്	ঈজিপ্ত্
പശ്ചിമ സഹാറ	পশ্চিম সহার
എറിത്രിയ	এরিত্রিয
സ്‌പെയിൻ	স্‌পেযিন্
എത്യോപ്യ	এত্যোপ্য
യൂറോപ്യൻ യൂണിയൻ	যূরোপ্যন্ যূণিযন্
ഫിൻലാൻഡ്	ফিন্লান্ড্
ഫിജി	ফিজি
ഫാക്ക്‌ലാന്റ് ദ്വീപുകൾ	ফাক্ক্‌লান্র্ দ্বীপুকল্
ഫോക്ക്‌ലാൻഡ് ദ്വീപുകൾ (ഐലാസ് മാൽവിനാസ്)	ফোক্ক্‌লান্ড্ দ্বীপুকল্ (ঐলাস্ মাল্বিনাস্)
മൈക്രോനേഷ്യ	মৈক্রোনেষ্য
ഫറോ ദ്വീപുകൾ	ফরো দ্বীপুকল্
ഫ്രാൻസ്	ফ্রান্স্
ഗാബൺ	গাবণ্
യുണൈറ്റഡ് കിംഗ്ഡം	যুণৈর্রড্ কিংগ্ডং
ഗ്രനേഡ	গ্রনেড
ജോർജ്ജിയ	জোর্জ্জিয
ഫ്രഞ്ച് ഗയാന	ফ্রঞ্চ্ গযান
ഗേൺസി	গেণ্সি
ഘാന	ঘান
ജിബ്രാൾട്ടർ	জিব্রাল্ট্টর্
ഗ്രീൻലാൻറ്	গ্রীন্লান্র্
ഗാംബിയ	গাংবিয
ഗിനിയ	গিনিয
ഗ്വാഡലൂപ്പ്	গ্বাডলূপ্প্
ഇക്വറ്റോറിയൽ ഗിനിയ	ইক্বর্রোরিযল্ গিনিয
ഗ്രീസ്	গ্রীস্
ദക്ഷിണ ജോർജ്ജിയയും ദക്ഷിണ സാൻഡ്‌വിച്ച് ദ്വീപുകളും	দক্ষিণ জোর্জ্জিযযুং দক্ষিণ সান্ড্‌বিচ্চ্ দ্বীপুকলুং
ഗ്വാട്ടിമാല	গ্বাট্টিমাল
ഗ്വാം	গ্বাং
ഗിനിയ-ബിസൗ	গিনিয-বিসৌ
ഗയാന	গযান
ഹോങ്കോങ്ങ് (SAR) ചൈന	হোঙ্কোঙ্ঙ্ (SAR) চৈন
ഹോങ്കോങ്ങ്	হোঙ্কোঙ্ঙ্
ഹിയേർഡും മക്‌ഡൊണാൾഡ് ദ്വീപുകളും	হিযের্ডুং মক্‌ডোণাল্ড্ দ্বীপুকলুং
ഹോണ്ടുറാസ്	হোণ্টুরাস্
ക്രൊയേഷ്യ	ক্রোযেষ্য
ഹെയ്തി	হেয্তি
ഹംഗറി	হংগরি
കാനറി ദ്വീപുകൾ	কানরি দ্বীপুকল্
ഇന്തോനേഷ്യ	ইন্তোনেষ্য
അയർലാൻഡ്	অযর্লান্ড্
ഇസ്രായേൽ	ইস্রাযেল্
ഐൽ ഓഫ് മാൻ	ঐল্ ওফ্ মান্
ഇന്ത്യ	ইন্ত্য
ബ്രിട്ടീഷ് ഇന്ത്യൻ മഹാസമുദ്ര പ്രദേശം	ব্রিট্টীষ্ ইন্ত্যন্ মহাসমুদ্র প্রদেশং
ഇറാഖ്	ইরাখ্
ഇറാൻ	ইরান্
ഐസ്‌ലാന്റ്	ঐস্‌লান্র্
ഇറ്റലി	ইর্রলি
ജേഴ്സി	জেল্সি
ജമൈക്ക	জমৈক্ক
ജോർദ്ദാൻ	জোর্দ্দান্
ജപ്പാൻ	জপ্পান্
കെനിയ	কেনিয
കിർഗിസ്ഥാൻ	কির্গিস্থান্
കംബോഡിയ	কংবোডিয
കിരിബാട്ടി	কিরিবাট্টি
കോമൊറോസ്	কোমোরোস্
സെന്റ് കിറ്റ്‌സും നെവിസും	সেন্র্ কির্র্‌সুং নেবিসুং
ഉത്തരകൊറിയ	উত্তরকোরিয
ദക്ഷിണകൊറിയ	দক্ষিণকোরিয
കുവൈറ്റ്	কুবৈর্র্
കേമാൻ ദ്വീപുകൾ	কেমান্ দ্বীপুকল্
കസാഖിസ്ഥാൻ	কসাখিস্থান্
ലാവോസ്	লাবোস্
ലെബനൻ	লেবনন্
സെൻറ് ലൂസിയ	সেন্র্ লূসিয
ലിച്ചൺസ്റ്റൈൻ	লিচ্চণ্স্র্রৈন্
ശ്രീലങ്ക	শ্রীলঙ্ক
ലൈബീരിയ	লৈবীরিয
ലെസോതോ	লেসোতো
ലിത്വാനിയ	লিত্বানিয
ലക്സംബർഗ്	লক্সংবর্গ্
ലാറ്റ്വിയ	লার্র্বিয
ലിബിയ	লিবিয
മൊറോക്കൊ	মোরোক্কো
മൊണാക്കോ	মোণাক্কো
മൾഡോവ	মল্ডোব
മോണ്ടെനെഗ്രോ	মোণ্টেনেগ্রো
സെൻറ് മാർട്ടിൻ	সেন্র্ মার্ট্টিন্
മഡഗാസ്കർ	মডগাস্কর্
മാർഷൽ ദ്വീപുകൾ	মার্ষল্ দ্বীপুকল্
മാസിഡോണിയ	মাসিডোণিয
മാസിഡോണിയ (FYROM)	মাসিডোণিয (FYROM)
മാലി	মালি
മ്യാൻമാർ (ബർമ്മ)	ম্যান্মার্ (বর্ম্ম)
മംഗോളിയ	মংগোলিয
മക്കാവു (SAR) ചൈന	মক্কাবু (SAR) চৈন
മക്കാവു	মক্কাবু
ഉത്തര മറിയാനാ ദ്വീപുകൾ	উত্তর মরিযানা দ্বীপুকল্
മാർട്ടിനിക്ക്	মার্ট্টিনিক্ক্
മൗറിറ്റാനിയ	মৌরির্রানিয
മൊണ്ടെസരത്ത്	মোণ্টেসরত্ত্
മാൾട്ട	মাল্ট্ট
മൗറീഷ്യസ്	মৌরীষ্যস্
മാലിദ്വീപ്	মালিদ্বীপ্
മലാവി	মলাবি
മെക്സിക്കോ	মেক্সিক্কো
മലേഷ്യ	মলেষ্য
മൊസാംബിക്ക്	মোসাংবিক্ক্
നമീബിയ	নমীবিয
പുതിയ കാലിഡോണിയ	পুতিয কালিডোণিয
നൈജർ	নৈজর্
നോർഫോക് ദ്വീപ്	নোর্ফোক্ দ্বীপ্
നൈജീരിയ	নৈজীরিয
നിക്കരാഗ്വ	নিক্করাগ্ব
നെതർലാൻഡ്‌സ്	নেতর্লান্ড্‌স্
നോർവെ	নোর্বে
നേപ്പാൾ	নেপ্পাল্
നൗറു	নৌরু
ന്യൂയി	ন্যূযি
ന്യൂസിലാൻറ്	ন্যূসিলান্র্
ഒമാൻ	ওমান্
പനാമ	পনাম
പെറു	পেরু
ഫ്രഞ്ച് പോളിനേഷ്യ	ফ্রঞ্চ্ পোলিনেষ্য
പാപ്പുവ ന്യൂ ഗിനിയ	পাপ্পুব ন্যূ গিনিয
ഫിലിപ്പൈൻസ്	ফিলিপ্পৈন্স্
പാക്കിസ്ഥാൻ	পাক্কিস্থান্
പോളണ്ട്	পোলণ্ট্
സെന്റ് പിയറിയും മിക്കലണും	সেন্র্ পিযরিযুং মিক্কলণুং
പിറ്റ്‌കെയ്‌ൻ ദ്വീപുകൾ	পির্র্‌কেয্‌ন্ দ্বীপুকল্
പ്യൂർട്ടോ റിക്കോ	প্যূর্ট্টো রিক্কো
പാലസ്‌തീൻ പ്രദേശങ്ങൾ	পালস্‌তীন্ প্রদেশঙ্ঙল্
പലസ്‌തീൻ	পলস্‌তীন্
പോർച്ചുഗൽ	পোর্চ্চুগল্
പലാവു	পলাবু
പരാഗ്വേ	পরাগ্বে
ഖത്തർ	খত্তর্
ദ്വീപസമൂഹം	দ্বীপসমূহং
റീയൂണിയൻ	রীযূণিযন্
റൊമാനിയ	রোমানিয
സെർബിയ	সের্বিয
റഷ്യ	রষ্য
റുവാണ്ട	রুবাণ্ট
സൗദി അറേബ്യ	সৌদি অরেব্য
സോളമൻ ദ്വീപുകൾ	সোলমন্ দ্বীপুকল্
സെയ്‌ഷെൽസ്	সেয্‌ষেল্স্
സുഡാൻ	সুডান্
സ്വീഡൻ	স্বীডন্
സിംഗപ്പുർ	সিংগপ্পুর্
സെൻറ് ഹെലീന	সেন্র্ হেলীন
സ്ലോവേനിയ	স্লোবেনিয
സ്വാൽബാഡും ജാൻ മായേനും	স্বাল্বাডুং জান্ মাযেনুং
സ്ലോവാക്യ	স্লোবাক্য
സിയെറ ലിയോൺ	সিযের লিযোণ্
സാൻ മറിനോ	সান্ মরিনো
സെനഗൽ	সেনগল্
സോമാലിയ	সোমালিয
സുരിനെയിം	সুরিনেযিং
ദക്ഷിണ സുഡാൻ	দক্ষিণ সুডান্
സാവോ ടോമും പ്രിൻസിപെയും	সাবো টোমুং প্রিন্সিপেযুং
എൽ സാൽവദോർ	এল্ সাল্বদোর্
സിന്റ് മാർട്ടെൻ	সিন্র্ মার্ট্টেন্
സിറിയ	সিরিয
സ്വാസിലാൻറ്	স্বাসিলান্র্
ട്രസ്റ്റൻ ഡ കൂന	ট্রস্র্রন্ ড কূন
ടർക്ക്‌സും കെയ്‌ക്കോ ദ്വീപുകളും	টর্ক্ক্‌সুং কেয্‌ক্কো দ্বীপুকলুং
ഛാഡ്	ছাড্
ഫ്രഞ്ച് ദക്ഷിണ ഭൂപ്രദേശം	ফ্রঞ্চ্ দক্ষিণ ভূপ্রদেশং
ടോഗോ	টোগো
തായ്‌ലാൻഡ്	তায্‌লান্ড্
താജിക്കിസ്ഥാൻ	তাজিক্কিস্থান্
ടോക്കെലൂ	টোক্কেলূ
തിമോർ-ലെസ്റ്റെ	তিমোর্-লেস্র্রে
കിഴക്കൻ തിമോർ	কিলক্কন্ তিমোর্
തുർക്ക്മെനിസ്ഥാൻ	তুর্ক্ক্মেনিস্থান্
ടുണീഷ്യ	টুণীষ্য
ടോംഗ	টোংগ
തുർക്കി	তুর্ক্কি
ട്രിനിഡാഡും ടുബാഗോയും	ট্রিনিডাডুং টুবাগোযুং
ടുവാലു	টুবালু
തായ്‌വാൻ	তায্‌বান্
ടാൻസാനിയ	টান্সানিয
ഉക്രെയ്‌ൻ	উক্রেয্‌ন্
ഉഗാണ്ട	উগাণ্ট
അമേരിക്കൻ ഐക്യനാടുകൾ	অমেরিক্কন্ ঐক্যনাটুকল্
ഉറുഗ്വേ	উরুগ্বে
ഉസ്‌ബെക്കിസ്ഥാൻ	উস্‌বেক্কিস্থান্
വത്തിക്കാൻ	বত্তিক্কান্
സെന്റ് വിൻസെന്റും ഗ്രനെഡൈൻസും	সেন্র্ বিন্সেন্রুং গ্রনেডৈন্সুং
വെനിസ്വേല	বেনিস্বেল
ബ്രിട്ടീഷ് വെർജിൻ ദ്വീപുകൾ	ব্রিট্টীষ্ বের্জিন্ দ্বীপুকল্
വിയറ്റ്നാം	বিযর্র্নাং
വന്വാതു	বন্বাতু
വാലിസ് ആന്റ് ഫ്യൂച്യുന	বালিস্ আন্র্ ফ্যূচ্যুন
സമോവ	সমোব
കൊസോവൊ	কোসোবো
യെമൻ	যেমন্
മയോട്ടി	মযোট্টি
ദക്ഷിണാഫ്രിക്ക	দক্ষিণাফ্রিক্ক
സാംബിയ	সাংবিয
സിംബാബ്‌വേ	সিংবাব্‌বে
അജ്ഞാത പ്രദേശം	অজ্ঞাত প্রদেশং
#
#
# Miscellaneous
എഩ്ഩാൽ	এন়্ন়াল্
പതിറ്റുപ്പത്തു	পতির্রুপ্পত্তু
തമിഴ്	তমিল্
ആലപ്പുഴ	আলপ্পুল
ദുഃഖം	দুঃখং
ഊഃ	ঊঃ
ഗൌതമ	গৌতম
ഗൗതമ	গৌতম
ശിവോഽഹം	শিবোঽহং
നിൎവാണം	নির্বাণং
സൂര്യൻ	সূর্যন্
ഋഷി	ঋষি
൦൧൨൩൪൫൬൭൮൯	০১২৩৪৫৬৭৮৯
൰	১০
൱	১০০
൲	১০০০
