quarter → kwˈortər



forte-piano → fˌortepiˈɑno
galileo → gˌæləlˈeo
galilei → gˌæləlˈe
isolde → ˌɪsˈoldə
kamala → kˈɑmələ
kaposi's → kəpˈosiz
kuban → kubˈæn
l'vov → ləvˈov
laertes → leˈɛrtiz
listenership → lˈɪsənərʃˌɪp
malay → məlˈe
martinson → mˈɑrtənsən
melanocyte → məlˈænəsˌɑɪt
mende → mˈɛnde
modus → mˈodəs
operandi → ˌɑpərˈændi
moss → mɑs
ms-dos
nama → nˈɑmɑ
napierian → nepˈɪriən
navratilova → nˌævrətɪlˈovə
neruda → nɛrˈudə
para-aminosalicylic
paraphilia → pˌɛrəfˈɪliə
particulate → pɑrtˈɪkjəlɪt
phonemic → fənˈimɪk
preceptory → prɛsˈɛptəri
pressman → prˈɛsmən
reredos → rˈɛrɪdɑs
saarland → zˈɑrlɑnt
sahib → sɑhˈib
solvent → sˈɑlvənt
steadfast → stˈɛdfæst
steiner → stˈɑɪnər
steinmetz → stˈɑɪnmɛts
stendhal → stɛndˈɑl
stepfamily → stˈɛpfˌæmli
stereo → stˈɛriˌo
stereochemistry → stˌɛriokˈɛmɪstri
stereography → stˌɛriˈɑgrəfi
stereophonic → stˌɛriəfˈɑnɪk
stereoscopic → stˌɛriəskˈɑpɪk
stereotaxis → stˌɛriətˈæksɪs
stereotype → stˈɛriətˌɑɪp
stereotyped → stˈɛriətˌɑɪpt
steric → stˈɛrɪk
sunroof → sˈənrʊf
thereon → ðɛrˈɑn
thereupon → ðˈɛrəpˌɑn
turgor


aquifer → ˈɑkwəfər
aquilegia → ˌækwəlˈiʤə
aquiline → ˈækwəlˌɑɪn
aragonite → ərˈægənˌɑɪt
aram → ˈɛrəm
arbil → ˈɑrbɪl
arboreal → ɑrbˈoriəl
archɑɪsm → ˈɑrkiˌɪzəm
archdiocese → ɑrʧdˈɑɪəsis
archduke → ɑrʧdˈuk
archivist → ˈɑrkɑɪvɪst
archon → ˈɑrkɑn
arcturus → ɑrktˈʊrəs
arcuate → ˈɑrkjuet
arendt → ˈɑrənt
areopagite → ˌæriˈopəʤˌɑɪt
argentine → ˈɑrʤəntˌɑɪn
argive → ˈɑrʤɑɪv
argos → ˈɑrgos
argot → ˈɑrgo
arian → ˈɛriən
arianism → ˈɛriənˌɪzəm
arioso → ˌɑriˈozo
ariosto → ˌɑriˈosto
aristide → ˌɑrɪstˈid
aristocrat → ərˈɪstəkrˌæt
aristotelian → ˌərɪstətˈiliən
arius → ərˈɑɪəs
arjuna → ˈɑrʤənə
arkhangelsk → ɑrkˈɑŋɛlsk
armada → ɑrmˈɑdə
armature → ˈɑrməʧər
armenia → ɑrmˈiniə
armenian → ɑrmˈiniən
armorial → ɑrmˈoriəl
arpeggio → ɑrpˈɛʤo
arrhenius → ərˈeniəs
arrowroot → ˈærorˌut
artemisia → ˌɑrtəmˈɪʒə
artisan → ˈɑrtɪzən
arum → ˈɛrəm
aryan → ˈɛriən
asbestos → æsbˈɛstəs
asbestosis → ˌæsbɛstˈosɪs
ascorbate → əskˈorbet
ascot → ˈæskət
aseptic → esˈɛptɪk
ashanti → əʃˈɑnti
ashcroft → ˈæʃkrɑft
asiatic → ˌeʒiˈætɪk
asimov → ˈæzɪmˌɑv
asmodeus → ˌæzmədˈiəs
aspartame → ˈæspərtˌem
aspirant → ˈæspərənt
aspirin → ˈæsprɪn
assiduity → ˌæsɪʤˈuɪti
assisi → əsˈisi
associable → əsˈoʃəbəl
associate → əsˈosiˌet
association → əsˌosiˈeʃən
associationism → əsˌosiˈeʃənˌɪzəm
associative → əsˈosiˌetɪv
astatine → ˈæstətˌɑɪn
asthma → ˈæzmə
astoria → æstˈoriə
astrakhan → ɑstrɑkˈɑn
asturias → əstˈʊriəs
aswan → ˈæswɑn
asymptote → ˈæsɪmtˌot
atmospheric → ˌætməsfˈɛrɪk
atmospherics → ˌætməsfˈɛrɪks
atoll → ˈætɑl
atpase → ˌetpˈez
atresia → ətrˈiʒə
atropine → ˈætrəpˌɑɪn
atropos → ˈætrəpˌos
attaché → ˌætəʃˈe
attendee → ətˌɛndˈi
attitude → ˈætɪtˌud
aubusson → ˈobəsoŋ
auditorium → ˌodɪtˈoriəm
auditory → ˈɑdɪtˌori
audubon → ˈɑdəbən
augusta → əgˈəstə
auntie → ˈænti
auspices → ˈɑspɪsiz
austerlitz → ˈaʊtərlˌɪts
australasia → ˌɑstrəlˈeʒə
australopithecine → ɑstrˌelopˈɪθɪsˌɑɪn
austrasia → ostrˈeʒə
authoritarian → əθˌorɪtˈɛriən
authoritative → əθˈorɪtˌetɪv
authority → əθˈorɪti
autobahn → ˈaʊtobˌɑn
automaton → ətˈɑmətɑn
automobile → ˌɑtəməbˈil
autopsy → ˈɑtˌɑpsi
autostrada → ˈaʊtostrˈɑdə
auxiliary → ɑgzˈɪljəri
aversion → əvˈərʒən
aversive → əvˈərsɪv
aviation → ˌeviˈeʃən
aviator → ˈeviˌetər
avionics → ˌeviˈɑnɪks
avocado → ˌɑvəkˈɑdo
avogadro → ˌɑvogˈɑdro
ayahuasca → ˌɑɪəwˈɑskə
ayatollah → ˌɑɪətˈolə
aymara → ˌɑɪmɑrˈɑ
ayrshire → ˈɛrʃər
ayurveda → ˌɑɪərvˈedə
azerbɑɪjan → ˌɑzərbɑɪʤˈɑn
azerbɑɪjani → ˌɑzərbɑɪʤˈɑni
babirusa → bˌɑbərˈusə
babylon → bˈæbəlɑn
babylonia → bˌæbəlˈoniə
baccarat → bˌɑkərˈɑ
bacchanalia → bˌækənˈeliə
backcross → bˈækkrɑs
backdoor → bˈækdor
backlog → bˈæklɑg
backroom → bˈækrum
backwash → bˈækwɑʃ
backwater → bˈækwˌɑtər
badajoz → bˌɑðəhˈoz
badminton → bˈædmˌɪntən
bɑɪkal → bɑɪkˈɑl
bakhtin → bɑktˈin
balaclava → bˌɑləklˈɑvə
balaklava → bˌɑləklˈɑvə
balfour → bˈælfʊr
balinese → bˌɑlənˈiz
ballade → bəlˈɑd
ballroom → bˈolrum
balmoral → bælmˈorəl
baltimore → bˈoltəmˌor
balzac → bˈɑlzæk
bambino → bɑmbˈino
banality → bənˈælɪti
banco → bˈɑŋko
bancroft → bˈæŋkroft
bandwidth → bˈændwɪdθ
bangalore → bˌæŋgəlˈor
bangladesh → bˌɑŋglədˈɛʃ
bangor → bˈæŋgor
bangui → bɑŋgˈi
bankrupt → bˈæŋkrəpt
banneret → bˈænərɪt
barbados → bɑrbˈedˌos
barbarossa → bˌɑrbərˈosə
barbary → bˈɑrbəri
barbiturate → bɑrbˈɪʧərɪt
barents → bˈærənts
barite → bˈɛrɑɪt
barium → bˈɛriəm
baronetcy → bˈærənɪtsi
barrio → bˈɑriˌo
barroom → bˈɑrrum
barrymore → bˈærɪmˌor
bartók → bˈɑrtɑk
basal → bˈezəl
baseboard → bˈesbord
basically → bˈesɪkli
basil → bˈezəl
basildon → bˈezəldən
basilisk → bˈæzəlˌɪsk
basra → bˈɑsrə
bassoon → bəsˈun
bastion → bˈæsʧən
bataan → bətˈɑn
bathhouse → bˈæθhaʊs
bathmat → bˈæθmæt
bathos → bˈeθɑs
bathrobe → bˈæθrob
bathroom → bˈæθrum
bathsheba → bæθʃˈibə
bathtub → bˈæθtəb
batiste → bətˈist
baton → bətˈɑn
bayard → bˈeərd
bayeux → bɑɪjˈu
bayonet → bˈeənɛt
beatitude → biˈætɪtˌud
beatrix → bˈeətrˌɪks
beaumont → bˈomɑnt
because → bɪkˈəz
bechuanaland → bɛʧwˈɑnəlˌænd
bedclothes → bˈɛdkloðz
bedroom → bˈɛdrum
beetroot → bˈitrut
before → bɪfˈor
beforehand → bɪfˈorhˌænd
begone → bɪgˈɑn
begum → bˈegəm
behalf → bɪhˈæf
beldam → bˈɛldəm
belgrade → bˈɛlgred
bellerophon → bəlˈɛrəfən
belloc → bˈɛlɑk
bellows → bˈɛloz
belong → bɪlˈɑŋ
belonging → bɪlˈɑŋɪŋ
belorussia → bˌɛlorˈəʃə
belorussian → bˌɛlorˈəʃən
beloved → bɪlˈəvd
beltane → bˈɛlten
benares → bənˈɑrəz
benedictine → bˌɛnɪdˈɪktɑɪn
benefaction → bˌɛnəfˈækʃən
beneficiary → bˌɛnəfˈɪʃəri
bengal → bɛŋgˈəl
bengali → bɛŋgˈoli
benghazi → bɛŋgˈɑzi
benison → bˈɛnɪsən
benzimidazole → bˌɛnzəmɪdˈæzˌol
benzodiazepine → bˌɛnzodɑɪˈæzəpˌɑɪn
benzoyl → bˈɛnzoˌɪl
bequeath → bɪkwˈið
berchtesgaden → bˈɛrktəsgˌɑdən
bergen → bˈɛrgən
bering → bˈɛrɪŋ
berkeley → bˈərkli
berkshire → bˈərkʃər
berlioz → bˈɛrliˌoz
bernicia → bərnˈiʃə
bernini → bɛrnˈini
bernstein → bˈərnstɑɪn
berserk → bərzˈərk
bestial → bˈɛsʧəl
bestiality → bˌɛsʧiˈælɪti
bestiary → bˈɛsʧiˌɛri
beta → bˈetə
bethanechol → bɛθˈænɪkˌɑl
bethlehem → bˈɛθlɪhˌɛm
betroth → bɪtrˈoð
betrothal → bɪtrˈoðəl
betrothed → bɪtrˈoðd
bewhiskered → bɪwˈɪskərd
bhutan → butˈɑn
bhutanese → bˌutənˈiz
biafra → biˈɑfrə
bicarbonate → bɑɪkˈɑrbənˌɪt
bicycle → bˈɑɪsˌɪkəl
bidirectional → bˌɑɪdɪrˈɛkʃənəl
bifocal → bˈɑɪfokəl
bifurcate → bˈɑɪfərkˌet
bilbao → bɪlbˈaʊ
bilirubin → bˌɪlɪrˈubɪn
billabong → bˈɪləbˌɑŋ
billboard → bˈɪlbord
billingsgate → bˈɪlɪŋzgˌet
biloxi → bəlˈɑksi
binaural → bənˈorəl
binocular → bənˈɑkjələr
biodynamic → bˌɑɪodɪnˈæmɪk
biosensor → bˈɑɪosˌɛnsər
bipartisan → bɑɪpˈɑrtɪzən
biphenyl → bɑɪfˈinəl
bison → bˈɑɪsən
bitumen → bɪtˈumən
bituminous → bɪtˈumənəs
bivariate → bɑɪvˈɛriɪt
blackboard → blˈækbord
blackguard → blˈægərd
blackstone → blˈækston
blackwell → blˈæckwɛl
blancmange → bləmˈɑŋʤ
blavatsky → bləvˈɑtski
bloodbath → blˈədbæθ
bloomsbury → blˈumzbˌəri
boarder → bˈordər
boarding house → bˈordɪŋhˌaʊs
boardroom → bˈordrum
boardwalk → bˈordwok
boccaccio → bokˈɑʧo
boccioni → boʧˈoni
bochum → bˈokəm
bodhran → bˈorɑn
boeotia → biˈoʃə
bogeyman → bˈʊgimˌæn
bogtrotter → bˈɑgtrˌɑtər
bogwood → bˈɑgwʊd
bohrium → bˈoriəm
boise → bˈoizi
boisterous → bˈoistərəs
bokhara → bokˈɑrə
bolero → bolˈɛro
bolide → bˈolɑɪd
bolingbroke → bˈɑlɪŋbrˌʊk
bolivia → bəlˈɪviə
bologna → bəlˈoni
bolshevik → bˈolʃəvˌɪk
bolshevism → bˈolʃəvˌɪzəm
bombard → bɑmbˈɑrd
bongo → bˈɑŋgo
boniface → bˈɑnəfes
bonsɑɪ → bɑnsˈɑɪ
bookstore → bˈʊkstor
borage → bˈorɪʤ
borax → bˈoræks
boreal → bˈoriəl
boreas → bˈoriəs
boredom → bˈordəm
borehole → bˈorhol
borgia → bˈorʤə
boring → bˈorɪŋ
bornholm → bˈornholm
borodin → bˈorədˌin
boron → bˈorɑn
borrowing → bˈɑroɪŋ
boswell → bˈɑzwɛl
botha → bˈotə
bothwell → bˈɑθwɛl
boudin → budˈæŋ
boudoir → bˈudwɑr
bougɑɪnvillaea → bˌugənvˈɪljə
bougɑɪnvillea → bˌugənvˈɪljə
bouillon → bˈʊljən
boulevard → bˈʊləvˌɑrd
boulogne → bulˈonjə
boundary → bˈaʊndəri
bouquet → bukˈe
bournemouth → bˈornməθ
bovet → bovˈe
bovine → bˈovɑɪn
bowsprit → bˈaʊsprɪt
brabant → brəbˈænt
brachiopod → brˈækiəpˌɑd
brachiosaur → brˈækiəsˌor
bradbury → brˈædbˌəri
bradykinin → brˌædɪkˈɑɪnɪn
brahma → brˈɑmə
brɑɪnwash → brˈenwɑʃ
brɑɪnwashing → brˈenwˌɑʃɪŋ
brandeis → brˈændɑɪs
bratislava → brˌɑtɪslˈɑvə
bravura → brəvˈʊrə
breadboard → brˈɛdbord
breakwater → brˈekwˌɑtər
breccia → brˈɛʧə
breughel → brˈoigəl
breviary → brˈɛviˌɛri
brezhnev → brˈɛʒnɛf
briand → briˈɑŋ
bridegroom → brˈɑɪdgrum
bridgeport → brˈɪʤport
brindisi → brˈɪndɪzi
brioche → briˈoʃ
brisbane → brˈɪzbən
britannia → brɪtˈænjə
broadcloth → brˈodklɑθ
broadsword → brˈodsord
bronchi → brˈɑŋki
bronchitis → brɑŋkˈɑɪtɪs
bronchodilator → brˌɑŋkodɑɪlˈetər
broomstick → brˈumstɪk
brownsville → brˈaʊnzvɪl
brueghel → brˈoigəl
bubo → bˈubo
buchan → bˈəkən
bucharest → bˈukərˌɛst
buchenwald → bˈukənvˈɑld
buchman → bˈʊkmən
buckingham → bˈəkɪŋəm
buckwheat → bˈəkwit
budapest → bˈudəpˌɛst
buddhism → bˈudˌɪzəm
budgerigar → bˈəʤərigˌɑr
buffet → bəfˈe
bugger → bˈəgər
buggery → bˈəgəri
bukhara → bukˈɑrə
bukharin → bukˈɑrɪn
bukhoro → bukˈoro
bulawayo → bˌuləwˈeo
bulganin → bʊlgˈɑnɪn
bulgar → bˈəlgɑr
bulgaria → bəlgˈɛriə
bulgarian → bəlgˈɛriən
bulimia → bulˈimiə
bulldog → bˈʊldɑg
bulletin → bˈʊlɪtn
bullfrog → bˈʊlfrɑg
bulwark → bˈʊlwərk
bumpkin → bˈəmpkɪn
buoyancy → bˈoiənsi
burmese → bərmˈiz
burrito → bʊrˈito
burroughs → bˈəroz
bursar → bˈərsər
burundi → bʊrˈundi
busoni → buzˈoni
bustier → bustjˈe
butadiene → bjˌutədˈɑɪin
butanol → bjˈutənˌɑl
byblos → bˈɪblɑs
bygone → bˈɑɪgɑn
byzantine → bˈɪzəntˌɑɪn
byzantium → bɪzˈænʃəm
cabal → kəbˈɑl
caballero → kˌɑbɑjˈɛro
cabana → kəbˈænə
cabral → kəbrˈɑl
cadre → kˈɑdre
caecilian → səsˈɪljən
caesarea → sˌizərˈiə
caesura → sɪʒˈʊrə
caftan → kˈæftæn
café → kæfˈe
cɑɪsson → kˈesɑn
cɑɪus → kˈeəs
calamari → kˌɑləmˈɑri
calamine → kˈæləmˌɑɪn
calder → kˈɑldər
caldera → kɑldˈɛrə
caldwell → kˈɑldwɛl
caledonia → kˌælɪdˈonjə
calfskin → kˈæfskɪn
california → kˌælɪfˈornjə
caliphate → kˈælɪfˌet
callaghan → kˈæləhæn
calomel → kˈæləmˌɛl
caloric → kəlˈorɪk
calumet → kˈæljəmˌɛt
calvino → kɑlvˈino
camaraderie → kˌɑmərˈɑdəri
cameraman → kˈæmrəmˌæn
camomile → kˈæməmˌɑɪl
camorra → kəmˈorə
camouflage → kˈæməflˌɑʒ
campania → kɑmpˈɑnjɑ
campesino → kˌɑmpɪsˈino
campinas → kɑmpˈinəs
campo → kˈɑmpo
camus → kɑmˈu
canberra → kˈænbərə
cancún → kæŋkˈun
candelabra → kˌændlˈɑbrə
candelabrum → kˌændlˈɑbrəm
candidate → kˈændɪdˌet
cannot → kənˈɑt
canterbury → kˈæntərbˌɛri
cantilever → kˈæntlˌivər
canton → kˈæntɑn
cantonese → kˌæntənˈiz
cantonment → kæntˈonmənt
capercɑillie → kˌæpərkˈelji
capon → kˈepɑn
cappuccino → kˌæpəʧˈino
capriccio → kəprˈiʧo
capricious → kəprˈiʃəs
capstan → kˈæpstæn
capsule → kˈæpsəl
captor → kˈæptər
capuchin → kˈæpjəʧɪn
capybara → kˌæpəbˈɑrə
caramel → kˈɑrməl
caramelize → kˈɑrməlˌɑɪz
carbine → kˈɑrbɑɪn
carburetor → kˈɑrbərˌetər
carcassonne → kˌɑrkəsˈon
cardboard → kˈɑrdbord
cardin → kɑrdˈæŋ
cardiogenic → kˌɑrdioʤˈɛnɪk
cardiopulmonary → kˌɑrdiopˈʊlmənˌɛri
cardiorespiratory → kˌɑrdiorˈɛspərətˌori
careworn → kˈɛrworn
caricature → kˈærɪkəʧˌər
carina → kərˈinə
carling → kˈɑrlɪŋ
carlos → kˈɑrlos
carlovingian → kˌɑrləvˈɪnʤən
carmine → kˈɑrɑɪn
carnap → kˈɑrnæp
carnegie → kˈɑrnəgi
carniola → kˌɑrniˈolə
carnivore → kˈɑrnəvˌor
caroline → kˈærəlˌɑɪn
carolingian → kˌærəlˈɪnʤən
carousel → kˌærəsˈɛl
carport → kˈɑrport
cartwheel → kˈɑrθwil
caruso → kərˈuso
carvel → kˈɑrvəl
casanova → kˌæsənˈovə
casbah → kˈɑzbɑ
casein → kˈesin
cashmere → kˈæʒmɪr
caspar → kˈæspər
cassette → kəsˈɛt
cassino → kəsˈino
castiglione → kˌɑstɪljˈonɛ
castrato → kəstrˈɑto
castries → kˈɑstriz
catalan → kˈætələn
catalase → kˈætəlez
catalog → kˈætəlɑg
catalonia → kˌætlˈonjə
catania → kətˈɑnjə
catapult → kˈætəpˌəlt
catcher → kˈæʧər
catching → kˈæʧɪŋ
catchment → kˈæʧmənt
catchword → kˈæʧwərd
catecholamine → kˌætɪkˈoləmˌɑɪn
categorical → kˌætɪgˈorɪkəl
category → kˈætɪgˌori
caterpillar → kˈætərpˌɪlər
cattleman → kˈætlmən
caucasian → kokˈeʒən
caudillo → kaʊdˈijo
cauliflower → kˈɑlɪflˌaʊər
caveat → kˈæviˌɑt
caviar → kˈæviˌɑr
cayenne → kɑɪˈɛn
celeriac → səlˈɛriˌæk
celestine → sˈɛlɪstˌɑɪn
cellini → ʧɛlˈini
cellulite → sˈɛljəlˌɑɪt
cellulose → sˈɛljəlˌos
celsius → sˈɛlsiəs
celtic → kˈɛltɪk
censorious → sɛnsˈoriəs
centrifugal → sɛntrˈɪfəgəl
centurion → sɛntˈʊriən
cepheid → sˈɛfiɪd
cerebral → sˈərəbrəl
cerebrospinal → sˌərəbrospˈɑɪnəl
cerebrovascular → sˌərəbrovˈæskjələr
cerebrum → sərˈibrəm
cerecloth → sˈɪrklɑθ
cerise → sərˈiz
certiorari → sˌərʃiərˈɛri
certitude → sˈərtɪtˌud
ceuta → sjˈutə
ceylon → selˈɑn
chablis → ʃɑblˈi
chagall → ʃəgˈɑl
chalkboard → ʧˈɑkbord
chamaeleon → kəmˈiljən
chameleon → kəmˈiljən
chamomile → kˈæməmˌɑɪl
chamonix → ʃˌɑmonˈi
chancellery → ʧˈænslˈəri
chancellor → ʧˈænslər
chantey → ʧˈænti
chanty → ʧˈænti
chanukah → hˈɑnəkə
charcuterie → ʃɑrkˌutərˈi
chartreuse → ʃɑrtrˈuz
chassid → kˈɑsɪd
checkerboard → ʧˈɛkərbˌord
cheesecloth → ʧˈizklɑθ
chekhov → ʧˈɛkɑf
chelyabinsk → ʧɛljˈɑbɪnsk
chemoprophylaxis → kˌimoprˌofəlˈæksɪs
chemotaxis → kˌimotˈæksɪs
chemotherapy → kˌimoθˈɛrəpi
chernobyl → ʧərnˈobəl
cherubini → kˌɛrəbˈini
chessboard → ʧˈɛsbord
chestnut → ʧˈɛsnət
cheviot → ʃˈɛviət
cheyenne → ʃɑɪˈɛn
chianti → kiˈɑnti
chiaroscuro → kiˌɑroskˈuro
chicago → ʃɪkˈɑgo
chicane → ʃɪkˈen
chicanery → ʃɪkˈenəri
chicano → ʧɪkˈɑno
chihuahua → ʧɪwˈɑwɑ
chillicothe → ʧˌɪlɪkˈɑθi
chimaera → kɑɪmˈɪrə
chimera → kɑɪmˈɪrə
chimerical → kɑɪmˈɪrɪkəl
chimpanzee → ʧˌɪmpænzˈi
chinese → ʧɑɪnˈiz
chino → ʧˈino
chinook → ʃɪnˈʊk
chios → kˈɑɪɑs
chipboard → ʧˈɪpbord
chippewa → ʧˈɪpəwˌɑ
chirico → kˈɪrɪkˌo
chiropody → kɪrˈɑpədi
chirrup → ʧˈərəp
chittagong → ʧˈɪtəgˌɑŋ
chivalric → ʃɪvˈælrɪk
chloral → klˈorəl
chloramphenicol → klˌoræmfˈɛnɪkˌol
chlorate → klˈoret
chloride → klˈorɑɪd
chlorinate → klˈorənˌet
chlorine → klˈorin
chlorite → klˈorɑɪt
chlorofluorocarbon → klˌoroflˌorokˈɑrbən
chloroform → klˈorəfˌorm
chlorophyll → klˈorəfɪl
chloroquine → klˈorəkwˌɑɪn
chlorpromazine → klorprˈɑməzˌɑɪn
chocolate → ʧˈɑklɪt
cholesterol → kəlˈɛstərˌɑl
choral → kˈorəl
chorale → kərˈæl
chorea → korˈiə
choreograph → kˈoriəgrˌæf
choreography → kˌoriˈɑgrəfi
chorioid → kˈoriˌoid
chorion → kˈoriˌɑn
chorister → kˈorɪstər
choroid → kˈorˌoid
chorus → kˈorəs
christianity → krˌɪsʧiˈænɪti
chronological → krˌɑnəlˈɑʤɪkəl
chrysanthemum → krɪsˈænθəməm
chrysostom → krˈɪsəstəm
chutzpah → hˈʊtspə
chávez → ʃˈɑvɛz
cicada → sɪkˈedə
cicerone → ʧˌiʧɛrˈonɛ
cilantro → sɪlˈæntro
cimetidine → sɪmˈɛtɪdˌɑɪn
cinchona → sɪŋkˈonə
cincinnati → sˌɪnsənˈæti
circadian → sərkˈediən
circassian → sərkˈæʃən
circulatory → sˈərkjələtˌori
citadel → sˈɪtədəl
clambering → klˈæmərɪŋ
clapboard → klˈæbərd
classroom → klˈæsrum
clavier → kləvˈɪr
claymore → klˈemor
clearwater → klˈɪrwˌɑtər
clemenceau → klˌɛmɑŋsˈo
clementine → klˈɛməntˌɑɪn
cleopatra → klˌiəpˈætrə
clerestory → klˈɪrstˌori
clientele → klˌɑɪəntˈɛl
clipboard → klˈɪpbord
clitoridectomy → klˌɪtərɪdˈɛktəmi
cloakroom → klˈokrum
cloisonné → klˌoizənˈe
clonidine → klˈɑnɪdˌɑɪn
closeted → klˈɑzɪtɪd
clothesline → klˈoðzlɑɪn
clozapine → klˈozəpˌin
clubman → klˈəbmən
cluny → klˈuni
coarsen → kˈorsən
cochabamba → kˌoʧəbˈɑmbə
cochineal → kˌɑʧənˈil
cochise → koʧˈiz
coconut → kˈokənˌət
cocteau → kɑktˈo
codeine → kˈodin
codices → kˈɑdɪsˌiz
codify → kˈɑdɪfˌɑɪ
coercion → koˈərʒən
coevolution → kˌoɛvəlˈuʃən
coffeehouse → kˈɑfihˌaʊs
coffeepot → kˈɑfipˌɑt
cognac → kˈonjæk
cognoscente → kˌɑnjəʃˈɛnti
coherence → kohˈɪrəns
coherent → kohˈɪrənt
coimbra → koˈɪmbrə
coincidence → koˈɪnsɪdəns
coitus → kˈoɪtəs
colander → kˈɑləndər
colbert → kolbˈɛr
colchester → kˈolʧˌɛstər
colchicine → kˈɑlʧɪsˌin
colette → kɑlˈɛt
collage → kolˈɑʒ
collagenase → kəlˈæʤənˌez
collation → kolˈeʃən
collect → kəlˈɛkt
collectivity → kˌɑlɛktˈɪvɪti
collegial → kəlˈiʤiəl
collegiate → kəlˈiʤɪt
collusive → kəlˈusɪv
colonoscope → kolˈɑnəskˌop
colophon → kˈɑləfˌɑn
colorado → kˌɑlərˈædo
coloratura → kˌələrətˈʊrə
columnist → kˈɑləmɪst
colville → kˈolvɪl
comatose → kˈomətˌos
combinatorial → kˌɑmbənətˈoriəl
combinatory → kˌɑmbənətˈori
comfortable → kˈəmftəbəl
commandant → kˌɑməndˈɑnt
commemorative → kəmˈɛmərətɪv
commensurate → kəmˈɛnsərɪt
committeeman → kəmˈɪtimən
commodore → kˈɑmədˌor
communal → kəmjˈunəl
communalism → kəmjˈunəlˌɪzəm
communicative → kəmjˈunɪkˌetɪv
communiqué → kəmjˌunɪkˈe
compact → kˈɑmpækt
comparator → kˈɑmpərˌetər
compartmentalize → kˌɑmpɑrtmˈɛntlˌɑɪz
compass → kˈəmpəs
compatriot → kəmpˈetriət
complementary → kˌɑmpləmˈɛntri
complimentary → kˌɑmpləmˈɛntri
compline → kˈɑmplɪn
compound → kˈɑmpaʊnd
comptroller → kˈɑmptrˌolər
comrade → kˈɑmræd
comstock → kˈɑmstɑk
concatenate → kənkˈætnˌet
concepción → kənsˌɛpsiˈon
concert → kˈɑnsərt
conclave → kˈɑŋklev
concord → kˈɑŋkord
concorde → kˈɑŋkord
concourse → kˈɑŋkors
concrete → kɑŋkrˈit
concretize → kˈɑŋkrɪtˌɑɪz
concubine → kˈɑŋkjəbˌɑɪn
concurrence → kənkˈərəns
concurrency → kənkˈərənsi
concurrent → kənkˈərənt
condensate → kˈɑndɛnsˌet
condensation → kˌɑndɛnsˈeʃən
condonation → kˌɑndənˈeʃən
condor → kˈɑndor
conducive → kəndˈusɪv
conduit → kˈɑnduɪt
confederal → kənfˈɛdərəl
conference → kˈɑnfərəns
conferencing → kˈɑnfərənsɪŋ
confidant → kˈɑnfɪdˌɑnt
confidante → kˈɑnfɪdˌɑnt
confound → kənfˈaʊnd
confounded → kənfˈaʊndɪd
congolese → kˌɑŋgolˈiz
congratulate → kəŋgrˈæʧəlˌet
congratulation → kəŋgrˌæʧəlˈeʃən
congreve → kˈɑŋriv
congruence → kəngrˈuəns
congruent → kəngrˈuənt
congruity → kəngrˈuɪti
conifer → kˈɑnəfər
conjurer → kˈɑnʤərər
conjuror → kˈɑnʤərər
connacht → kˈɑnət
connoisseur → kˌɑnəsˈʊr
conodont → kˈonədˌɑnt
conquest → kˈɑŋkwɛst
conquistador → kɑŋkˈistədˌor
consanguinity → kˌɑnsæŋgwˈɪnɪti
consequence → kˈɑnsɪkwˌɛns
consequent → kˈɑnsɪkwˌɛnt
consequently → kˈɑnsɪkwˌɛntli
conservatory → kənsˈərvətˌori
consortium → kənsˈorʃəm
conspiratorial → kənspˌɪrətˈoriəl
constable → kˈɑnstəbəl
constitute → kˈɑnstɪtˌut
constitution → kˌɑnstɪtˈuʃən
constitutional → kˌɑnstɪtˈuʃənəl
constitutionalism → kˌɑnstɪtˈuʃənəlˌɪzəm
constitutionality → kˌɑnstɪtˌuʃənˈælɪti
constitutive → kˈɑnstɪtˌutɪv
contemplative → kəntˈɛmplətɪv
contextual → kəntˈɛksʧuəl
contractile → kəntrˈæktəl
contractor → kˈɑntrˌæktər
contrariwise → kˈɑntrˌɛriwˌɑɪz
contributory → kəntrˈɪbjətˌori
controversial → kˌɑntrəvˈərʃəl
contusion → kəntˈuʒən
convent → kˈɑnvənt
conversant → kənvˈərsənt
conversion → kənvˈərʒən
cooperative → koˈɑpərətɪv
coordinate → koˈordnˌet
copal → kˈopəl
copenhagen → kˈopənhˌegən
copernican → kopˈərnɪkən
copernicus → kopˈərnəkəs
coracle → kˈorəkəl
coral → kˈorəl
corbel → kˈorbəl
cordoba → kˈordəbə
corelli → kərˈɛli
coriander → kˈoriˌændər
corinth → kˈorɪnθ
cormorant → kˈormərənt
cornforth → kˈornfərθ
cornucopia → kˌornəkˈopiə
cornwallis → kornwˈɑlɪs
corolla → kərˈolə
corollary → kˈorəlˌɛri
coronado → kˌorənˈɑdo
coronal → kərˈonəl
coronary → kˈorənˌɛri
coronation → kˌorənˈeʃən
coroner → kˈorənər
coronet → kˌorənˈɛt
corot → korˈo
corporeal → korpˈoriəl
corpuscle → kˈorpəsəl
corregidor → kərˈɛgɪdˌor
correlate → kˈorəlˌet
correlation → kˌorəlˈeʃən
correspond → kˌorɪspˈɑnd
correspondence → kˌorɪspˈɑndəns
correspondent → kˌorɪspˈɑndənt
corresponding → kˌorɪspˈɑndɪŋ
corridor → kˈorɪdor
corrigan → kˈorɪgən
corrosive → kərˈosɪv
corrugate → kˈorəgˌet
corrugation → kˌorəgˈeʃən
corsage → korsˈɑʒ
corticosteroid → kˌortɪkostˈɪrˌoid
cortisol → kˈortɪsˌol
cortisone → kˈortɪzˌon
cortona → kortˈonə
cortés → kortˈɛz
cosby → kˈɑzbi
cosecant → kosˈikˌənt
cosenza → kozˈɛnsə
cosmos → kˈɑzmos
costa → kˈɑstə
costermonger → kˈɑstərmˌəŋgər
costume → kˈɑstum
costumer → kˈɑstˌumər
costumier → kˌostumjˈe
coty → kotˈi
coulomb → kˈulom
councillor → kˈaʊnslər
councilor → kˈaʊnslər
counselor → kˈaʊnslər
counterintuitive → kˌaʊntərɪntˈuɪtɪv
coupon → kˈupɑn
courage → kˈərɪʤ
courbet → kurbˈe
courier → kˈəriər
courseware → kˈorswɛr
coursing → kˈorsɪŋ
courtesan → kˈortɪzən
courthouse → kˈorthaʊs
courtier → kˈortiər
courtly → kˈortli
courtroom → kˈortrum
courtship → kˈorʧɪp
courtyard → kˈortjɑrd
couture → kutˈʊr
couturier → kutʊrjˈe
covenantee → kˌəvənəntˈi
covenantor → kˈəvənˌəntor
cowper → kˈupər
coxswɑɪn → kˈɑksən
cracow → krˈækaʊ
crampon → krˈæmpɑn
crayon → krˈeɑn
creatine → krˈiətˌin
creatinine → kriˈætnˌin
credo → krˈido
credulity → krɪdˈulɪti
crematorium → krˌimətˈoriəm
crimea → krɑɪmˈiə
crisscross → krˈɪskrɑs
croat → krˈoɑt
croatia → kroˈeʃə
crofter → krˈɑftər
cromwell → krˈɑmwɛl
crossbar → krˈɑsbɑr
crossbones → krˈɑsbonz
crossbow → krˈɑsbo
crossbred → krˈɑsbrɛd
crossbreed → krˈɑsbrid
crossfire → krˈɑsfɑɪr
crossover → krˈɑsˌovər
crossroad → krˈɑsrod
crosstalk → krˈɑstok
crossway → krˈɑswe
crossways → krˈɑswez
crosswind → krˈɑswɪnd
crosswise → krˈɑswɑɪz
crossword → krˈoswərd
croupier → krupiˈe
cruzeiro → kruzˈɛro
crystalline → krˈɪstəlɑɪn
cuckold → kˈəkəld
culinary → kˈələnˌɛri
culotte → kulˈɑt
cultivar → kˈəltəvˌɑr
cumin → kjˈumɪn
cumulative → kjˈumjələtɪv
cuneiform → kjˈuniəfˌorm
cupertino → kˌupərtˈino
curare → kjʊrˈɑri
curaçao → kˈʊrəsˌaʊ
curia → kjˈʊriə
curie → kjˈʊri
currant → kˈərənt
currency → kˈərənsi
current → kˈərənt
currier → kˈəriər
curvature → kˈərvəʧˌər
cutoff → kˈətɑf
cutwater → kˈətwˌɑtər
cuzco → kˈuzko
cyan → sˈɑɪæn
cyanobacterium → sˌɑɪənobæktˈɪriəm
cyanogenesis → sˌɑɪənoʤˈɛnɪsɪs
cycad → sˈɑɪkæd
cyclamen → sˈɑɪkləmən
cyclase → sˈɑɪklez
cycloheximide → sˌɑɪklohˈɛksəmˌɑɪd
cyclopean → sˌɑɪkləpˈiən
cyclosporine → sˌɑɪkləspˈorin
cynosure → sˈɑɪnəʃˌʊr
cypriot → sˈɪpriət
cyrenɑɪca → sˌɑɪrənˈeɪkə
cysteine → sˈɪstəˌin
cytosol → sˈɑɪtəsˌɑl
czarina → tsɑrˈinə
czarism → tsˈɑrˌɪzəm
czechoslovakia → ʧˌɛkəsləvˈɑkiə
cádiz → kˈedɪz
cárdenas → kˈɑrdnɑs
cézanne → sezˈɑn

#problems

#pioneer
#mennonites → mˈɛnənˌɑɪts → ṃẹṇn̩ọn̽ịṭe̽ṣ

#deletions

antonin
highest common factor
high german
greenwich mean time
bostian
deandrea
ioanus
wachtel
lustgarten
teh
pethtel
levine
in absentia
rocky mountɑɪns
bonoir
grospiron

#others

original → ərˈɪʤɪnəl
machine → məʃˈin
gauvin → govˈæŋ
going → gˈoɪnŋ
ingres → ˈæŋgrə
lapointe → lˈɑpwɑŋt
anno domini → ˈɑno domɪni
benincasa → bɛniŋkˈɑsə
soleprint → sˈolprɪnt
underwritten → ˈəndərrˌɪtən
gerashchenko → gˌɛrəʧʃˈeŋko
photographer → fətˈɑgrəfər
sincerely → sɪnsˈirli
hierogrammatic → hˌɑɪrəgrəmˈætɪk

prediction → prɪdˈɪkʃən
xenodocheion → zˌɛnədəkˈɑɪən
battered → bˈætərd
forerunner → fˈorrˌənər
imre
virement
centrefold → sˈɛntərfˌold
freyermuth
shirrell
unpɑɪred → ənpˈɛrd
wireless → wˈɑɪrlɛs
uninsured → ˌənɪnʃˈʊrəd
rebate → rˈibet
hendren → hˈɛndrən
delosreyes → dɛlˈɑsrɑɪz
wilfredo → wˌɪlfrˈedo

toward → twˈord
cheyenne → ʃɑɪˈɛn
film → fˈɪlm
tensions → tˈɛnʃənz
aerospatiale → ˌɛrospˌɑʃˈəl
thirty → θˈərti
physicians → fˈɪzˈɪʃənz
citizens → sˈɪtɪzənz

activities → æktˈɪvɪtiz
quantity → kwˈɑnɪti
boutin → butˈæŋ
twenties → twˈɛntiz
consortiums → kənsˈorʃəmz
consortium → kənsˈorʃəm
ferranti → fɛrˈɑnti
punctuating → pˈəŋkʧuˌetɪŋ
andreotti → ˌændriˈɑti
fatima → fˈætəmə
petiole → pˈɛtiˌol
kiribati → kˈɪrəbˌɑti

services → sˈərvɪsəz
jesuits → ʤˈɛʒuɪts
priests → prists
soles → sˈolz
crescendo → krɛʃˈɛndo
reschedule → riskˈɛʤul
bakes → bˈeks
want → wənt
væŋkˈuvər
canada → kˈænədə
freelance → frˈilæns
fiancee → fˌiɑnsˈe
phantom → fˈæntəm
iman → ɪmˈɑn

material → mətˈɪriəl
center → sˈɛntər
crocheted → krɑʧˈɛted
te → te
statehood → stˈethʊd

thereto → ðɛrtˈu
reporter → rˌɛportˈər
millimeter → mˈɪləmˌitər
seriously → sˈiriəsli
pierce → pirs
song → sɑŋ
samuelson → sæmjulsən
absentia → æbsˈɛnʃə
coloured → kˈələrd
plɑɪntiff → plˈentɪf
seventies → sˈɛvəntiz
depravation → dˌɛprəvˈeʃən
consortium's → kənsˈorʃəmz
fatimah
antimension
wants → wənts
sonorant → sˈɑnərənt
mangel → mˈɑŋgəl
deandrea's
companero → kˌompənjˈɛro
rwandese → ruˌɑndˈiz
takeshita → tˌɑkeʃˈitɑ
qureshi
gɛstalt → gəʃtˈɑl
mattea
changteh
schlouter
gassendi
benten
cervenka
unencumbered → ˌənɪnkˈəmbərd
llorens
solzhenitsyn → solʒənˈitsɪn
roentgen → rˈɛntgən
chiengmɑɪ
duena
internal-combustion engine
alfred → ˈælfred
mujahedeen → muʤɑhɛdˈin
liedtke
eichstaedt
disjasked
kedzierski
bedjaouni
sauter
unconquered → ənkˈɑŋkərd
zippered → zˈɪpərd
tierce → tˈirs

archaism → ˈɑrkeˌɪzəm
bath water → bˈæθwˌɑtər
bonsai → bɑnsˈɑɪ
bougainvillaea → bugənvˈɪljə
bougainvillea → bugenvˈɪljə
brainwash → brˈenwɑʃ
brainwashing → brˈenwɑʃɪŋ
caius → kˈɑɪəs
capercaillie → kˌæpərkˈeli
cold-water → kˈoldwˌɑtər
coxswain → kˈɑksən
cross-country → krˈɑskˌəntri
cross-link → krˈɑslɪŋk
cyrenaica → sˌɪrənˈeɪkə
dacia → dˈeʃə
dahlia → dˈæljə
dais → dˈeɪs
dalhousie → dælhˈuzi
dartmoor → dˈɑrtmor
data bank → dˈetəbˌæŋk
debacle → dɛbˈɑkəl
debauchee → dˌɛbɑʧˈi
debutante → dˈɛbjutˌɑnt
decaffeinated → dikˈæfənˌetɪd
decarboxylase → dˌikɑrbˈɑksəlˌes
decile → dˈɛsɑɪl
decorative →  dˈɛkərətɪv
deep-water → dˈipwˌɑtər
defendant → dɛfˈɛndənt
deformation → dˈɛfərmˈeʃən
degrease → digrˈis
dehydrogenase → dˌihɑɪdrˈɑʤənˌes
deification → dˌiɪfɪkˈeʃən
deify → dˈiɪfˌɑɪ
deism → dˈiˌɪzəm
deity → dˈiɪti
deliberative → dɛlˈɪbərˌetɪv
delinquency → dɛlˈɪŋkwənsi
delinquent → dɛlˈɪŋkwənt
delivery → dɛlˈɪvəri
deluge → dɛlˈuʤ
demagogic → dˌɛməgˈɑʤɪk
demagogy → dˈɛməgˌɑʤi
demesne → dɪmˈen
demographics → dˌɛməgrˈæfɪks
demolition → dˌɛməlˈɪʃən
denunciation → dɪnˌənsiˈeʃən
derisive → dərˈɑɪsɪv
derisory → dərˈɑɪsəri
derrida → dˈɛridˌɑ
desiderata → dɪsˌɪdərˈɑtə
desideratum → dɪsˌɪdərˈɑtəm
desolation → dˌɛsəlˈeʃən
desorb → dizˈorb
desperado → dˌɛspərˈɑdo
desultory → dˈɛsəltˌori
detainee → dˌitenˈi
devolution → dˌivəlˈuʃən
devotee → dˌɛvətˈi
dexamethasone → dˌɛksəmˈɛθəsˌon
dharma → dˈɑrmə
diaconate → dɑɪˈækənɪt
diadem → dˈɑɪədˌɛm
diagnose → dˈɑɪəgnˌos
diamine → dɑɪˈæmˌin
dias → dˈɑɪəz
diffidence → dˈɪfɪdəns
diffident → dˈɪfɪdənt
diffusive → dɪfjˈusɪv
diglossia → dɑɪglˈɑsiə
dilatation → dˌɪlətˈeʃən
dilation → dɑɪlˈeʃən
dilatometer → dˌɪlətˈɑmɪtər
dilettante → dˈɪlɪtˌɑnt
dimension → dˌɪmˈɛnʃən
dionysian → dˌɑɪənˈɪʃən
dionysius → dˌɑɪənˈɑɪʃəs
dionysus → dˌɑɪənˈɑɪsəs
diorama → dˌɑɪrˈæmə
diphtheria → dˌɪfθˈɪriə
diphthong → dˈɪfθɑŋ
diphthongize → dˈɪfθɑŋˌɑɪz
diplodocus →  dɪplˈɑdəkəs
disassociate → dˌɪsəsˈoʃiˌet
disaster → dˌɪzˈæstər
disastrous → dˌɪzˈæstrəs
discern → dɪsˈərn
discernible → dˌɪsˈərnəbəl
discerning → dˌɪsˈərnɪŋ
discernment → dˌɪsˈərnmənt
discriminative → dɪskrˈɪmɪnˌetɪv
disequilibrium →  dˌɪsˌikwəlˈɪbriəm
dishwasher →  dˈɪʃwˌɑʃər
dishwashing → dˈɪʃwˌɑʃɪŋ
disinterest → dˌɪsˈɪntrəst
dispensation → dˌɪspɛnsˈeʃən
dispersion → dˌɪspˈərʒən
dispersive → dˌɪspˈərsɪv
disputable → dɪspjˈutəbəl
dissociation → dˌɪsˌosiˈeʃən
disyllable → dˈɑɪsˌɪləbəl
dithyramb → dˈɪθɪrˌæm
diverge → dɪvˈərʤ
diversion → dɪvˈərʒən
divestiture → dɪvˈɛstɪʧər
divorcé → dɪvorsˈe
divorcée → dɪvorsˈe
dnieper → dənˈipər
dniester → dənˈistər
docile → dˈɑsəl
documentarian → dˌɑkjəmɛntˈɛriən
doha → dˌohɑ
doldrums → dˈoldrəmz
dolmen → dˈolmɛn
dolomite → dˈoləmˌɑɪt
dolphin → dˈɑlfɪn
domical → dˈɑmɪkəl
domicile → dˈɑmɪsˌɑɪl
domingo → domˈɪŋgo
donkey → dˈɑŋki
doorman → dˈormən
doppelgänger → dˈɑpəlgˌæŋər
dordogne → dordˈonjə
dortmund → dˈortmunt
dostoyevsky → dˌostoɪˈɛfski
douceur → dusˈər
dovecote → dˈəvkot
dragoon → drəgˈun
dramatization → drˌɑmətɪzˈeʃən
dramaturgy → drˈɑmətˌərʤi
dreiser → drˈɑɪzər
drina → drˈin
drogheda → drˈoɪdə
drosophila → drosˈɑfɪlə
dryad → drˈɑɪæd
dubček → dˈubʧɛk
ductile → dˈəktəl
dufy → dufˈi
duisburg → dˈusbərg
dumas → dumˈɑ
duration → dərˈeʃən
duress → dərˈɛs
durum → dˈərəm
duryea → durˈiə
dushanbe → duʃˈænbə
duvalier → dˌuvɑljˈe
dvořák → dvˈorʒɑk
dyad → dˈɑɪæd
dynast → dˈɑɪnæst
dyspepsia → dɪspˈɛpsiə
dysphagia → dɪsfˈeʤə
dysplasia → dˌɪsplˈeʒə
dysprosium → dɪsprˈoʒəm
détente → detˈɑnt
díaz → dˈiɑz
earthen → ˈərθən
earthenware → ˈərθənwˌɛr

ecclesia → ɛklˈiʒə
ecumenism → ˈɛkjumənˌɪzəm
eczema → ˈɛksəmə
edelweiss → ˈedəlvˌɑɪs
edinburgh → ˈɛdɪnbˌərə
edutainment → ɛʤutˈenmənt
edwardian → ɛdwˈɑrdiən
eglantine → ˈɛgləntˌɑɪn
egocentric → igosˈɛntrɪk
egoism → ˈigˌoɪzəm
egoist → ˈigoɪst
egotism → ˈigətˌɪzəm
egotist → ˈigətˌɪst
egregious → ɛgrˈiʤəs
eisteddfod → estˈɛðvɑd
elastase → ɪlˈæstez
electrician → ɪlɛktrˈɪʃən
electricity → ɪlˌɛktrˈɪsɪti
electrolysis → ɪlˌɛktrˈɑləsəs
electronic → ɪlɛktrˈɑnɪk
electronics → ɪlˌɛktrˈɑnɪks
elephantine → ˈɛləfəntˈɑɪn
elizabethan → ɪlˈɪzəbˌiθən
eluate → ˈɛljuɪt
elusive → ɪlˈusɪv
embodiment → ɛmbˈɑdimənt
embourgeoisement → ɛmbˈurʒwɑzmənt
emendation → ɪmˌɛndˈeʃən
emersion → ɪmˈərʒən
employee → ɛmplˈoɪi
encomiast → ɛnkˈɑmiˌəst
endecott → ˈɛndɪkɑt
endocrine → ˈɛndəkrɪn
endonuclease → ˌɛndonˈukliˌes
entail → ɛntˈel

abstraction → əbstrˈækʃən

enterocolitis → ˌɛntərokəlˈɑɪtɪs
entremets →  ˌɑntrəmˈe
envelope → ˈɛnvəlˌop
environ → ɛnvˈɑɪrən
environment → ɛnvˈɑɪrənmənt
environmental → ɛnvˌɑɪrənmˈɛntəl
environmentalism → ɛnvˌɑɪrənmˈɛntəlˌɪzəm
environs → ɛnvˈɑɪrənz
episcopate → ɪpˈɪskəpɪt
epochal → ɛpˈɑkəl
epsilon → ˈɛpsəlˌɑn
equable → ˈɛkwəbəl
equanimity → ˌɛkwənˈɪmɪti
equation → ɪkwˈeʒən
equatorial → ˌɛkwətˈoriəl
equidistant → ˌikwɪdˈɪstənt
equilateral → ˌikwəlˈætərəl
equilibrium → ˌikwəlˈɪbriəm
equimolar → ˌikwəmˈolər
equinoctial → ˌikwənˈɑkʃəl
equinox → ˈikwənˌɑks
equipotential → ˌikwəpətˈɛnʃəl
erbil → ˈɪrbɪl
erectile → ɪrˈɛktəl
ergo → ˈɛrgo
ergot → ˈərgət
erysipelas → ˌɛrɪsˈɪpələs
escallop → ɛskˈɑləp
escapee → ˌɛskepˈi
espalier → ɛspˈæljər
especially → ɛspˈɛʃəli
espionage → ˈɛspiənˌɑʒ
espousal → ɛspˈaʊzəl
estuarine → ˈɛsʧuərˌɑɪn
ethology → ɛθˈɑləʤi
eucaryote → jukˈɛriˌot
eukaryote → jukˈɛriot
euthanasia → jˌuθənˈeʒə
eutrophic → jutrˈɑfɪk
evangelical → ˌivænʤˈɛlɪkəl
evangelicalism → ˌivænʤˈɛlɪkəlˌɪzəm
evenki → ɪwˈɛŋki
everybody → ˈɛvribˌədi
evocation → ˌivokˈeʃən
evolutionism → ˌɛvəlˈuʃənˌɪzəm
exculpate → ˌɛkskˈəlpet
exedra → ˈɛksɪdrə
exeunt → ˈɛksiənt
exhalation → ɛksəlˈeʃən
exhibit → ɛgzˈɪbɪt
exhortation → ɛksortˈeʃən
exigency → ˈɛksɪʤənsi
exiguous → ɪgzˈɪgjuəs
existentialism → ˈɛksɪstˈɛnʃəlˌɪzəm
exmoor → ˈɛksmur
exocrine → ˈɛksəkrɪn
exonuclease → ˌɛksonˈukliˌez
exorcise → ˈɛksərsˌɑɪz
exorcism → ˈɛksərsˌɪzəm
extraordinaire → ˌɛkstrəˌordɪnˈɛr
extrinsic → ɛkstrˈɪnzɪk
extrusive → ɛkstrˈusɪv
facies → fˈeʃˌiz
faeroese → fˌɛrˈoiz
fahrenheit → fˈɛrənhˌɑɪt
faience → fɑɪˈɑns
fakir → fəkˈɪr
falangist → fəlˈænʤɪst
falcon → fˈælkən
falconer → fˈælkənər
falconet → fˌælkənˈɛt
falconry → fˈælkənri
famagusta → fˌɑməgˈustə
fantasia → fæntˈeʒə
fantasy → fˈæntəsi
farad → fˈɛrəd
farmland → fˈɑrmlænd
faroese → fˌɛrˈoiz

farrago → fərˈɑgo
fastidious → fæstˈɪdiəs
faubourg → fˈobur
favoritism →  fˈevərɪtˌɪzəm
fayetteville → fˈeˌɛtvɪl
fedayee → fɛdˌɑɪˈi
fellatio → fəlˈeʃˌo
fellini → fəlˈini
ferricyanide → fˌɛrɑɪsˈɑɪənˌɑɪd
ferruginous → fərˈuʤɪnəs
fetishism → fˈɛtɪʃˌɪzəm
fetoprotein → fˌitəprˈotin
fiasco → fiˈæsko
fiat → fˈiɑt
fiduciary → fɪdˈuʃˌɛri
fijian → fˈiʤiən
filene → fɪlˈin
filial → fˈɪliəl
filo → fˈilo
finale → fɪnˈæli
finality → fɪnˈælɪti
financier → fˌɪnənsˈɪr
finitude → fˈɪnɪtˌud
fissile →  fˈɪsəl
flageolet → flɑʒolˈɛ
flaherty → flˈɛrti
flatland → flˈætlænd

flautist → flˈɑtɪst
florentine → flˈorəntˌin
fluorescein → flˌuərˈɛsiɪn
fluorescence → flurˈɛsəns
fluoridate → flˈurɪdˌet
fluorine → flˈurin
fluoroscope → flˈurəskˌop
fluoroscopy → flərˈɑskəpi
fluorosis → flərˈosɪs
flycatcher → flˈɑɪkˌæʧər
focaccia → fokˈɑʧə
foci → fˈosɑɪ
footpath → fˈʊtpæθ
forbad → fərbˈæd
forbade → fərbˈed
forbid → fərbˈɪd
forbidding → fərbˈɪdɪŋ
forensic →  fˌorˈɛnzɪk
forensics → fˌorˈɛnzɪks
forgave → fərgˈev
forsake → fərsˈek
forsythia → fərsˈɪθiə
forte-pianofˌortepiˈɑno
fortepiano → fˌortepiˈɑno
fragile → frˈæʤəl
fragmentation → frˌægmɛntˈeʃən
fragonard → frˌɑgənˈɑr
francesca → frɑnʧˈɛskə
franco → frˈɑŋko
franconia → fræŋkˈonjə
frangipani → frˌɑnʤəpˈɑni
frankenthaler → frˈæŋkənθˌɑlər
freesia → frˈiʒə
friesland → frˈizlənd
frobisher → frˈobɪʃər
frogman → frˈɑgmæn
frontier → frəntˈɪr
frontiersman → frəntˈɪrzmən
fructose → frˈuktos
fräulein → frˈoɪlˌɑɪn
fugard → fjˈugɑrd
fuji → fˈuʤi
fujisawa → fuʤisˈɑwɑ
fukuoka → fukuˈokɑ
fukuyama → fukujˈɑmɑ
fulcrum → fˈʊlkrəm
fulmar → fˈʊlmɑr
fungicide → fˈənʤɪsˌɑɪd
funicular → fənˈɪkjələr
furor → fjˈurər


fuselage → fjˈusəlˌɑʤ
fusillade → fjˌusəlˈɑd
futurity → fjuʧˈurɪti
gaijin → gˈɑɪʤin
gainesville → gˈenzvɪl
gainsborough → gˈenzbˌəro
gaius → gˈɑɪəs
galileo → gˌæləlˈeo
galilei → gˌæləlˈe
gamow → gˈæmof
gandhi → gˈɑndi
gangland → gˈæŋlænd
garage → gərˈɑʒ
gastroduodenal → gˌæstrodˌuədˈinəl
gautama → gˈɑtəmə
gavarnie → gˌævərnˈi
gazebo → gəzˈibo
gdańsk → gədˈɑnsk
gdynia → gədˈɪnjə
geisha → gˈeʃə
genealogy → ʤˌiniˈɑləʤi
genitalia → ʤˌɛnɪtˈeliə
genotype → ʤˈɛnətˌɑɪp
geodesic → ʤˌiədˈɛsɪk
germania → ʤərmˈenjə
gerrymander → ʤˈɛrɪmˌændər
gestalt → gəʃtˈɑlt

gestapo → gəʃtˈɑpo
giacometti → ʤˌɑkəmˈɛti
giardia → ʤˈɑrdiə
gigacycle → gˈɪgəsˌɑɪkəl
gigawatt → gˈɪgəwˌɑt
gigolo → ʤˈɪgəlˌo
gimbal → gˈɪmbəl
giulini → ʤˌulˈini
glaciate → glˈeʃiˌet
glaciology → glˌeʃiˈɑləʤi
gladstone → glˈædston
glasgow → glˈæsko
glaswegian → glæswˈiʤən
glaucoma → glɑkˈomə
glazunov → glɑzʊnˈɑf
glockenspiel → glˈɑkənʃpˌil
glossolalia → glˌɑsəlˈeliə
glycine → glˈɑɪsin
glycoprotein → glˌɑɪkoprˈotˌin
glycosuria → glˌɑɪkoʃˈuriə
gnatcatcher → nˈætkˌæʧər
godunov → gˈodunɑv
gonadotropin → gonˌædətrˈopɪn
gondar → gˈɑndər
gooseberry → gˈusbˌɛri
goulash → gˈulɑʃ
gracile → grˈæsɪl
grandeur → grˈænʤər
grantor → grˈæntər
gratis → grˈɑtɪs

greaser → grˈisər
greasy → grˈisi
grenville → grˈɛnvɪl
grisaille → grɪzˈɑɪ
groningen → grˈonɪŋən
groomsman → grˈumzmən
ground water → grˈaʊndwˌɑtər
guanosine → gwˈɑnəsˌin
guiana → giˈɑnə
guillotine → gˈijətˌin
gupta → gˈuptə
gurdjieff → gˈərʤiɛf
gynecology → gˌɑɪnɪkˈɑləʤi
gyro → ʤˈɑɪro
gâteau → gætˈo
göring → gˈərɪŋ
hacienda → hˌɑsiˈɛndə
hafiz → hˈɑfɪz
haggadah → hˌɑgɑdˈɑ
hagiography → hˌeʤiˈɑgrəfi
hahnemann → hˈɑnəmən
haitian → hˈeʃən
halberd → hˈælbərd

half-wit → hˈæfwɪt
halfback → hˈæfbæk
halfhearted → hˈæfhˌɑrtɪd
halftime → hˈæftɑɪm
halftone → hˈæfton
halfway → hˈæfwe

halibut → hˈæləbət
halloween → hˌæləwˈin
haloperidol → hˌælopˈɛrɪdˌɑl
halter → hˈɑltər
hamburg → hˈɑmburg
hammurabi → hˌɑmurˈɑbi
handily → hˈændɪli
hanoi → hˈɑnoɪ
hanover → hˈɑnˌovər
harlequin → hˈɑrlɪkwɪn
hartlepool → hˈɑrtlipˌul
hashish → hæʃˈiʃ
hasid → hˈɑsɪd
hassid → hˈɑsɪd
hausa → hˈaʊsə
havelock → hˈævlɑk
hawaii → həwˈɑɪˌi
hayek → hˈɑɪək
hazlitt → hˈæzlɪt
headman → hˈɛdmən
hegelianism → hegˈeliənˌɪzəm
heidegger → hˈɑɪdˌɛgər
heidelberg → hˈɑɪdəlbˌɛrg
heinlein → hˈɑɪnlɑɪn
heisenberg → hˈɑɪzənbˌɛrg
helical → hˈɛlɪkəl
helices → hˈɛlɪsˌiz
helicon → hˈɛlɪkˌɑn
helsingør → hˌɛlsɪŋˈər
hemophilia → hˌiməfˈɪljə
hemophiliac → hˌiməfˈɪliˌæk
hempstead → hˈɛmpstɛd
hepatocyte → hˈɛpətəsˌɑɪt
hepatomegaly → hˌɛpətəmˈɛgəli
hepatotoxicity → hˌɛpətotɑksˈɪsɪti
herbage → ˈərbɪʤ
herbalism → ˈərbəlˌɪzəm
hereof → hɪrˈəv
herewith → hɪrwˈɪθ
hesiod → hˈisiəd
heterocyclic → hˌɛtərəsˈɑɪklɪk
hiawatha → hˌɑɪəwˈɑθə
hidalgo → hədˈælgˌo
hilarious → hɪlˈɛriəs
hilarity → hɪlˈɛrɪti
hillel → hilˈɛll
hindemith → hˈɪndəmɪθ
hindenburg → hˈɪndənbˌərg
hindustani → hˌɪndʊstˈɑni
hinshelwood →  hˈɪnʃəlwˌʊd
hirsute → hərsˈut
histamine → hˈɪstəmˌin
histidine → hˈɪstɪdˌin
histopathology → hˌɪstopæθˈɑləʤi
hohenzollern → hˈoəntsˌɑlərn
holocaust → hˈɑləkˌɑst
holocene → hˈɑləsˌin
holoenzyme → hˌɑloˈɛnzˌɑɪm
holograph → hˈɑləgrˌæf
holographic → hˌɑləgrˈæfɪk
holotype → hˈɑlətˌɑɪp
homicidal → hˌɑmɪsˈɑɪdəl
homicide → hˈɑmɪsˌɑɪd
homogenate → həmˈɑʤɪnˌet
homogeneity → hˌɑməʤənˈiəti
homogeneous → hˌoməʤˈiniəs
homogenous → həmˈɑʤənəs
homograph → hˈɑməgrˌæf
homolog → hˈɑməlˌɑg
homologous → həmˈɑləgəs
homologue → hˈɑməlˌɑg
homology → həmˈɑləʤi
homonym → hˈɑmənˌɪm
homophone → hˈɑməfˌon
homophonic → hˌɑməfˈɑnɪk
homozygote → hˌomozˈɑɪgˌot
homozygous → hˌoməzˈɑɪgəs
homunculus → həmˈəŋkjələs
honolulu → hˌɑnəlˈulu
hoofbeat → hˈʊfbit
hoopla → hˈuplɑ
hoopoe → hˈupo
hooray → hərˈe
hopewell → hˈopwɛl
horrendous → hˌərˈɛndəs
horrific → hərˈɪfɪk
horseshoe → hˈorʃu
hostler → hˈɑslər
hot dog → hˈɑtdɑg
hot-dog → hˈɑtdɑg
housewifery → hˈaʊswˌɑɪfəri
hovel → hˈəvəl
hover → hˈəvər
huerta → wˈɛrtə
hummus → hˈʊməs
humongous → hjumˈəŋgəs
humperdinck → hˈʊmpərdˌɪŋk
humphrey → hˈəmpfri
humus → hjˈuməs
hunyadi → hˈʊnjɑdi
hurrah → hərˈɑ
hussar → həsˈɑr
hussite → hˈəsɑɪt
hyderabad → hˈɑɪdərəbˌæd
hydrangea → hɑɪdrˈenʤə
hydrocortisone → hˌɑɪdrəkˈortɪsˌon
hygienic → hˌɑɪʤˈɛnɪk
hyperborean → hˌɑɪpərbˈoriən
hyperkinesia → hˌɑɪpərkɪnˈiʒə
hyperkinetic → hˌɑɪpərkɪnˈɛtɪk
hypnagogic → hˌɪpnəgˈɑʤɪk
hypoxia → hɑɪpˈɑksiə




ibsen →  ˈɪbsən
ickes →  ˈɪkiz
icosahedron → ɑɪkˌɑsəhˈidrən
ideological → ˌɑɪdiəlˈɑʤɪkəl
ideologue → ˈɑɪdiəlˌɑg
ideology → ˌɑɪdiˈɑləʤi
idiopathic → ˌɪdiəpˈæθɪk
ignominy → ˈɪgnɑmˌɪni
iliad → ˈɪliəd
illusory → ˌɪlˈuzəri
imaginal → ɪmˈæʤənəl
imaginative → ˌɪmˈæʤənətɪv
imago → ɪmˈɑgo
immature → ˌɪməʧˈur
immersion → ˌɪmˈərʒən
immunocompetent → ˌɪmjənokˈɑmpɪtənt
immunocompromised → ˌɪmjənokˈɑmprəmɑɪzd
immunofluorescence → ˌɪmjənoflurˈɛsəns
immunoglobulin → ˌɪmjənoglˈɑbjəlɪn
immunoreaction → ˌɪmjənoriˈækʃən
impasto → ɪmpˈɑsto
impatiens → ˌɪmpˈeʃənz
impious → ˈɪmpiəs
implacable → ˌɪmplˈækəbəl
impresario → ˌɪmprɛsˈɑriˌo
imprimatur → ˌɪmprəmˈɑtur
improvisation → ɪmprˌɑvɪzˈeʃən
inalienable → ˌɪnˈeliənəbəl
inapplicable → ˌɪnəplˈɪkəbəl
increment → ˈɪŋkrəmənt
incubate → ˈɪŋkjəbˌet
incubus → ˈɪŋkjəbəs
incunabulum → ˌɪŋkjənˈæbjələm
incursion → ˌɪnkˈərʒən
indigestible → ˌɪndɪʤˈɛstəbəl
indirect → ˌɪndɪrˈɛkt
indirection → ˌɪndɪrˈɛkʃən
indonesia → ˌɪndənˈiʒə
indonesian → ˌɪndənˈiʒən
infantile → ˈɪnfəntˌɑɪl
infantilism → ɪnfˈæntəlˌɪzəm
ingolstadt → ˈɪŋgɑlʃtɑt
inhomogeneity → ɪnhˌoməʤənˈiɪti
inlet → ˈɪnlɛt
innsbruck → ˈɪnsbrʊk
inoperable → ˌɪnˈɑpərəbəl
inoperative → ˌɪnˈɑpərətɪv
inositol → ɪnˈosɪtˌol
inquiry → ˈɪŋkwəri
inquisition → ˌɪŋkwɪzˈɪʃən
insatiable → ˌɪnsˈeʃəbəl
inseparable → ˌɪnsˈɛpərəbəl
insufferable → ˌɪnsˈəfərəbəl
intaglio → ˌɪntˈɑljo
intelligentsia → ɪntˌɛlɪʤˈɛntsiə
intemperance → ɪntˈɛmprəns
intemperate → ɪntˈɛmprɪt
intercollegiate → ˌɪntərkəlˈiʤɪt
interest → ˈɪntrɛst
interested → ˈɪntrɛstɪd
interesting → ˈɪntrɛstɪŋ
international → ˌɪntərnˈæʃənəl
internecine → ˌɪntərnˈɛsˌɑɪn
intestate → ɪntˈɛstˌet
intracerebral → ˌɪntrəsərˈibrəl
intransitive → ɪntrˈænsɪtɪv
intrauterine → ˌɪntrəjˈutərɑɪn
introversion → ˌɪntrəvˈərʒən
intrusive → ˌɪntrˈusɪv
inversion → ˌɪnvˈərʒən
iodine → ˈɑɪədˌɑɪn
irangate → ɪrˈɑngˌet
ironmonger → ˈɑɪrnmˌəŋgər
ironmongery → ˈɑɪrnmˌəŋgəri
irrefutable → ɪrˈɛfjətəbəl
isinglass → ˈɑɪzɪnglˌæs
islamism → ɪzlˈɑmˌɪzəm
isolde → ˌɪsˈoldə
italianate → ɪtˈæljənˌet
italicize → ɪtˈælɪsˌɑɪz
iterative → ˈɪtərətɪv
itinerant → ɑɪtˈɪnərənt
itinerary → ɑɪtˈɪnərˌɛri
jackal → ʤˈækəl
jacuzzi → ʤəkˈuzi
jansen → ʤˈænsən
japanese → ʤˌæpənˈiz
javanese → ʤˌɑvənˈiz
jerusalem → ʤɪrˈusələm
jesuit → ʤˈɛʒuɪt
jettison → ʤˈɛtɪsən
jezebel → ʤˈɛzəbˌɛl
jiménez → himˈɛnɛs
johannesburg → ʤohˈænɪsbˌərg
jonquil → ʤˈɑŋkwɪl
josiah → ʤozˈɑɪə
journalese → ʤˌərnəlˈiz
judaea → ʤudˈeə
judea → ʤudˈiə
judiciary → ʤudˈɪʃəri
junta → hˈuntə
juror → ʤˈurər
juvenilia → ʤˌuvənˈɪljə


kalashnikov → kəlˈæʃnɪkˌɑv
kaliningrad → kɑlˌinɪngrˈɑd
kamchatka → kˌɑmʧˈɑtkə
kamenev → kˈɑmənɛf
kandinsky → kændˈɪnski
kansas → kˈænzəs
kaput → kɑpˈut
karelia → kɑrˈiljə
karloff → kˈɑrlɑf
kasbah → kˈɑzbɑ
kashmiri → kæʃmˈɪri
kathmandu → kˌætmændˈu
katowice → kˌɑtəvˈitsə
kayseri → kˌɑɪzərˈi
kazakhstan → kˌɑzɑkstˈɑn
kazan → kəzˈæn
kerchief → kˈərʧɪf
kerensky → kərˈɛnski
kerman → kˈərmən
ketchup → kˈɛʧəp
khayyám → kɑɪjˈɑm
khrushchev → krˈuʃʧɛf
kibbutz → kɪbˈuts
kierkegaard → kˈɪrkɪgˌord
kimono → kəmˈono
kinase → kˈɑɪnez
kindergarten → kˈɪndərgˌɑrtən
kinetic → kɪnˈɛtɪk
kinetics → kɪnˈɛtɪks
kiowa → kˈɑɪəwˌɑ
kirghizia → kɪrgˈiʒə
kishinev → kˈɪʃənˌɛf
knoxville → nˈɑksvɪl
kohlrabi → kolrˈɑbi
korngold → kˈorngold
kraków → krˈɑkaʊ
krasnoyarsk → kræsnˈoɪɑrsk
kristallnacht → krˈɪstɑlnˌɑkt
krugerrand → krˈugərˌænd
kudo → kˈudo
kudos → kˈudoz
kurdish → kˈərdɪʃ
kurgan → kurgˈɑn
kyushu → kjˈuʃu



labile → lˈebɑɪl
laertes → -leˈɛrtiz
lafayette → lˌɑfeˈɛt
lagrange → lɑgrˈɑŋʒ
lamarck → ləmˈɑrk
lancashire → lˈæŋkəʃˌɪr
lancelot → lˈænsəlˌɑt
lapland → lˈæplænd
laryngeal → lˌɛrənʤˈiəl
latina → lɑtˈinə
latium → lˈeʃəm
laughable → lˈæfəbəl
laughter → lˈæftər
lausanne → lozˈɑn
lebanese → lˌɛbənˈiz
lebanon → lˈɛbənən
legatine → lˈɛgətɪn
legendre → ləʒˈɑŋdrə
leghorn → lˈɛghorn
lehmann → lˈemən
leibniz → lˈɑɪbnɪts
leipzig → lˈɑɪptsɪg
leisurely → lˈizərli
leisurewear → lˈiʒərwˌɛr
lemieux → lɛmjˈʊ
lena → lˈinə
lengthen → lˈɛŋθən
lengthways → lˈɛŋθwez
lengthwise → lˈɛŋθwɑɪz
lengthy → lˈɛŋθi
lenis → lˈinɪs
lenya → lˈenjə
leontief → liˈontjɛf
leprechaun → lˈɛprɪkˌɑn
lesbos → lˈɛzbos
levee → lˈɛvi
leyte → lˈeti
liana → liˈɑnə
libido → lɪbˈido
libran → lˈibrən
lilac → lˈɑɪlæk
limburg → lˈɪmbərg
linnaeus → lɪnˈeəs
lipoprotein → lˈɑɪpəprˈotin
liposome → lˈɑɪposˌom
liqueur → lɪkˈər
liquorice → lˈɪkrɪʃ
liveryman → lˈɪvrimən
login → lˈɑgɪn
logon → logˈɑn
lombard → lˈɑmbərd
lombardi → lɑmbˈɑrdi
lombardo → lɑmbˈɑrdo
lombardy → lˈɑmbərdi
longevity → lɑnʤˈɛvɪti
longitude → lˈɑnʤɪtˌud
longitudinal → lˌɑnʤɪtˈudnəl
lorca → lˈorkə
los angeles → lɑs ˈæŋgələs
louisiana → lˌuziˈænə
louisville → lˈuivˌɪl
lublin → lˈublən
lucretius → lukrˈiʃəs
lully → lulˈi
lumpen → lˈumpən
lumpenproletariat → lˌumpənprˌolɪtˈɛriət
luxor → lˈəksər
luxuriant → ləgʒˈəriənt
luxuriate → ləgʒˈəriˌet
luxurious → ləgʒˈəriəs
lydgate → lˈɪdget
lymphadenopathy → lɪmfˌædnˈɑpəθi
lysenko → lɪsˈɛŋko
lysine → lˈɑɪsin
lübeck → lˈʊbɛk
lüda → lˈʊdɑ
lüta → lˈʊdɑ


machiavelli → mˌɑkiɑvˈɛli
macquarie → məkwˈɑri
macroeconomics → mˌækroˌɛkənˈɑmɪks
madeira → mədˈɪrə
madman → mˈædmæn
madras → mˈædrəs
magistrate → mˈæʤɪstrˌet
magnate → mˈægnet
magnesia → mægnˈiʒə
magnesium → mægnˈiziəm
magyar → mˈɑjɑr
maharajah → mˌɑhərˈɑʤə
mahatma → məhˈɑtmə
mailman →  mˈelmæn
maisonette → mˌezənˈɛt
malabsorption → mˌæləbzˈorpʃən
malacca → məlˈækə
malaise → mælˈɛz
malay → mˈele
malaya → məlˈeə
malaysia → məlˈeʒə
malevich → məlˈevɪʧ
maltese → mɑltˈiz
mamey → mɑmˈe
manama → mənˈæmə
manchester → mˈænʧˌɛstər
mancunian → mænkjˈunjən
manhattan → mænhˈætən
mannheim → mˈɑnhɑɪm
mantra → mˈɑntrə
mantua → mˈænʧuə
manu → mˈɑnu
manzoni → mɑndzˈɑni
marbella → mˌɑrbˈɛlə
marburg → mˈɑrbərg
marlborough → mˈɑrlbˌəro
martinique → mˌɑrtɪnˈik
martinsonmˈɑrtɪnsən
masada → məsˈɑdə
masaryk → mˈæsərɪk
massachusett → mˌæsəʧˈusɪt
massage → məsˈɑʒ
matabeleland → mˌɑtəbˈɛlelˌænd
matrices → mˈetrɪsˌiz
matterhorn → mˈætərhˌorn
maturín → mˌɑturˈin
matzo → mˈɑtsə
mauritania → mˌorətˈenjə
mausoleum → mˌɑzəlˈiəm
mayoralty → mˈeərəlti
mazurka → məzˈərkə
mecklenburg → mˈɛklənbˌərg
mediaeval → mɛdˈivəl
mediaevalist → mɛdˈivəlɪst
medieval → mɛdˈivəl
medievalist → mɛdˈivəlɪst
mediterranean → mˌɛdɪtərˈenjən
meerschaum → mˈɪrʃəm
mefloquine → mˈɛfləkwˌɑɪn
megalomania → mˌɛgəlomˈenjə
melanesia → mˌɛlənˈiʒə
melanesian → mˌɛlənˈiʒən
melanocyte → mˈɛlənosˌɑɪt
melodrama → mˈɛlədrˌɑmə
memoir → mˈɛmwər
memorabilia → mˌɛmərəbˈiljə
menagerie → mənˈæʤəri
mende → -mˈɛnde
mendelian → mɛndˈɛljən
mendelssohn → mˈɛndəlsən
mendoza → mɛndˈozə
meningococcus → mənˌɪŋgəkˈɑkəs
mercantile → mˈərkəntˌɑɪl
mercia → mˈərʃə
mercian → mˈərʃən
merlot → mɛrlˈo
merovingian → mˌɛrəvˈɪnʤiən
mescaline → mˈɛskəlˌin
mesic → mˈɛzɪk
mesmer → mˈɛzmər
mesmerize → mˈɛzmərˌɑɪz
mesoamerica → mˌɛzoəmˈɛrɪkə
mesoderm → mˈɛzədˌərm
mesolithic → mˌɛzəlˈɪθɪk
meson → mˈizɑn
mesothelioma → mˌɛzəθˌiliˈomə
mesothorax → mˌɛzəθˈorˌæks
metamorphose → mˌɛtəmˈorfˌoz
metaphor → mˈɛtəfˌor
metaplasia → mˌɛtəplˈeʒə
metatheory → mˈɛtəθˌɪri
metempsychosis → mɛtəmsɑɪkˈosɪs
meteor → mˈitiər
mezzotint → mˈɛtsotˌɪnt
miami → mɑɪˈæmi
microeconomics → mˌɑɪkroˌɛkənˈɑmɪks
micronesia → mˌɑɪkrənˈiʒə
microprogramming → mˌɑɪkroprˈogræmɪŋ
microvasculature → mˌɑɪkrovˈæskjələʧˌər
micturate → mˈɪkʧərˌet
middling → mˈɪdlɪŋ
millet → mˈɪlɪt
milesian
millifarad → mˈɪləfˌɛrəd
milosz → mˈilɑʃ
mimesis → mɪmˈisɪs
mimetic → mɪmˈɛtɪk
mineralogy → mˌɪnərˈɑləʤi
minestrone → mˌɪnɪstrˈoni
miniature → mˈɪnɪʧˌur
miniaturize → mˈɪnɪʧərˌɑɪz
minos → mˈɑɪnəs
minotaur → mˈɪnətˌor
minutia → mɪnˈuʃə
misanthropic → mˌɪsənθrˈɑpɪk
misanthropy → mɪsˈænθrəpi
misdirection → mˌɪsdɪrˈɛkʃən
miserere → mˌɪzərˈɛri
misericord → mˌɪzərəkˈord
mishmash → mˈɪʃmæʃ
missile → mˈɪsəl
missis → mˈɪsɪz
missouri → mɪzˈərə
missus → mˈɪsɪz
mistral → mɪstrˈɑl
mistranslate → mɪstrˈænslˌet
mithraism → mˈɪθreˌɪzəm
mitterrand → mˌitərˈɑŋ
mobile → mˈobəl
modernity → mɑdˈərnɪti
modus → mˈodəs
operandi → ˌɑpərˈændɑɪ
mogadishu → mˌogədˈiʃˌu
mohammed → mohˈɑmɪd
mohican → mˌohˈikən
moiré → mwɑrˈe
mola → mˈolə
moldavia → mɑldˈevjə
molotov → mˈɑlətˌɑf
monarchism → mˈɑnɑrkˌɪzəm
monetary → mˈɑnɪtˌɛri
monger → mˈəŋgər
mongol → mˈɑŋgəl
mongolia → mɑŋgˈoljə
mongolian → mɑŋgˈoljən
mongoose → mˈɑŋgus
mongrel → mˈɑŋgrəl
monoamine → mˌɑnoˈæmin
monocoque → mˈɑnəkˌok
montage → mɑntˈɑʒ
monterrey → mˌɑntərˈe
monteverdi → mˌɑntəvˈɛrdi
monza → mˈontsɑ
moorhead → mˈurhɛd
morality → mərˈælɪti
morass → mərˈæs
moroni → mərˈoni
morose → mərˈos
morula → mˈorjələ
moses → mˈozəs
moslem → mˈɑzləm
motherese → mˌəðərˈiz
motocross → mˈotokrˌɑs
mouser → mˈaʊsər
mousey → mˈaʊsi
mousy → mˈaʊsi
mouthwash → mˈaʊθwɑʃ
mozzarella → mˌɑtsərˈɛlə
muezzin → muˈɛzɪn
mufti → mˈʊfti
muhammad → mʊhˈɑməd
mukden → mˈʊkdən
mulberry → mˈəlbˌɛri
mulhouse → mˈəlhaʊs
multicellular → mˌəltɪsˈɛljələr
multicultural → mˌəltɪkˈəlʧərəl
multidisciplinary → mˌəltidˈɪsəplənˌɛri
multiethnic → mˌəltiˈɛθnɪk
multifaceted → mˌəltifˈæsɪtɪd
multinational → mˌəltinˈæʃənəl
multiprocessing → mˌəltiprˈɑsˌɛsɪŋ
multipurpose → mˌəltipˈərpəs
multitasking → mˌəltitˈæskɪŋ
multiuser → mˌəltijˈuzər
multivariate → mˌəltivˈɛriɪt
munster → mˈənstər
murat → mʊrˈɑ
murcia → mˈərʃə
muslim → mˈəzlɪm
musset → mʊsˈe
mussorgsky → məzˈorgski
myalgia → mɑɪˈælʤə
métier → mɛtjˈe
métis → metˈis
mülheim → mˈʊlhɑɪm
müller → mˈʊlər
münster → mˈʊnstər

naphtha → nˈæfθə
naphthalene → nˈæfθəlˌin
napierian → nəpˈɪriən
napoleon i → nəpˈoljən
narbonne → nɑrbˈɑn
nasturtium → nəstˈərʃəm
nationalism → nˈæʃənəlˌɪzəm
nationality → nˌæʃənˈælɪti
nativity → nətˈɪvɪti
natron → nˈetrɑn
nausea → nˈɑziə
nauseate → nˈɑzɪˌet
nauseating → nˈɑziˌetɪŋ
nauseous → nˈɑzˈiəs
naxos → nˈɑksos
nazi → nˈɑtsi
nazism → nˈɑzˌɪzəm
neanderthal → niˈændərθˌɑl
neckerchief → nˈɛkərʧɪf
necropolis → nəkrˈɑpəlɪs
negro → nˈigro
nematocyst → nˈɛmətəsˌɪst
neoplasia → nˌioplˈeʒə
nepal → nəpˈɑl
nepalese → nˌɛpəlˈiz
nepali → nəpˈɑli
nestor → nˈɛstər
neuchâtel → nʊʃɑtˈɛl
neuritis → nərˈɑɪtɪs
neuroendocrine → nˌəroˈɛndokrˌɑɪn
neurology → nərˈɑləʤi
neuropathy → nˈəropˌæθi
neurosis → nərˈosɪs
neurotic → nərˈɑtɪk
neurotransmitter → nˌərotrˈænsmɪtər
newsroom → nˈuzrum
niagara → nɑɪˈægrə
nicotiana → nɪkˌoʃiˈænə
nicotinic → nˌɪkətˈinɪk
niebuhr
nihilism → nˈɑɪlˌɪzəm
nijinsky
nijmegen → nˈɑɪmˌegən
nitrate → nˈɑɪtret
nkrumah
nogales → nogˈælɪs
nomenclature → nˈomənklˌeʧər
nonjuror → nɑnʤˈurər
nonpartisan → nɑnpˈɑrtɪzən
nonsense → nˈɑnsɛns
norfolk → nˈorfək
northampton → nˌorθhˈæmptən
nostalgia → nɑstˈælʤə
nostradamus → nˌostrədˈɑməs
novitiate → novˈɪʃɪt
novosibirsk
nsaid
nubile → nˈubɑɪl
nuclease →  nˈukliˌes
nunciature → nˈənsiəʧˌur
nuncio → nˈənsiˌo
nymphomania → nˌɪmfəmˈeniə

obdurate → ˈɑbdurɪt
obeisance → obˈisəns
oberon → ˈobərˌɑn
obligatory → əblˈɪgətˌori
obliterate → əblˈɪtərˌet
obscurantism → əbskjˈurəntˌɪzəm
obsess → əbsˈɛs
obsession → əbsˈɛʃən
obsessive → əbsˈɛsɪv
obstruct → əbstrˈəkt
obstruction → əbstrˈəkʃən
obstructionist → əbstrˈəkʃənɪst
obtain → əbtˈen
obtrusive → əbtrˈusɪv
occlusive → əklˈuzɪv
occultism → əkˈəltˌɪzəm
oceania → ˌoʃiˈæniə
octavo → ɑktˈɑvo
odense → ˈoðənsə
oedipal → ˈɛdɪpəl
oedipus → ˈɛdɪpəs
off-piste → ˈɑfpist
offline → ˈɑflɑɪn
oftentimes → ˈɑfəntˌɑɪmz
oldenburg → ˈoldənbˌərg
olfactory → ɑlfˈæktəri
oligarchy → ˈɑlɪgˌɑrki
oligocene → ˈɑlɪgosˌin
oligodendrocyte → ˌɑlɪgodˈɛndrəsˌɑɪt
oligonucleotide → ˌɑlɪgonˈukliətɑɪd
oligopoly → ˌɑlɪgˈɑpəli
oligosaccharide → ˌɑlɪgosˈækərˌɑɪd
oligotrophic → ˌɑlɪgotrˈofɪk
olmec
olympia → əlˈɪmpiə
omicron → ˈɑmɪkrˌɑn
omnidirectional → ˌɑmnidɪrˈɛkʃənəl
on-site → ˈɑnsɑɪt
on-stream → ˈɑnstrim
onboard → ɑnbˈord
oncogenic → ɑŋkoʤˈɛnɪk
oncoming → ˈɑnkˌəmɪŋ
ongoing → ˈɑngˌoɪŋ
online → ˈɑnlɑɪn
onlooker → ˈɑnlˌʊkɛr
onomatopoeia → ˌɑnəmˌɑtəpˈiə
onrush → ˈɑnrəʃ
onscreen → ɑnskrˈin
onset → ˈɑnsɛt
onshore → ˈɑnʃor
onside → ˈɑnsɑɪd
onslaught → ˈɑnslɑt
onstage → ɑnstˈeʤ
onto → ˈɑntu
onward → ˈɑnwərd
oompah → ˈumpɑ
operable → ˈɑpərəbəl
operative → ˈɑpərˌətɪv
ophiolite
ophiuchus
ophiuroid → ˌɑfijˈəroɪd
ophthalmic → ɑfθˈælmɪk
orangutan → orˈæŋʊtˌæn
orchestra → ˈorkɛstrə
ordinate → ˈordɪnɪt
organochlorine → orgˌænəklˈorˌin
organogenesis → ˌorgənoʤˈɛnɪsɪs
organometallic → ˌorgənomətˈælɪk
orientate →  ˈoriɛntˌet
orienteering → ˌoriɛntˈɪrɪŋ
origen → ˈorɪʤˌɛn
orion → ərˈɑɪən
orlando → orlˈændo
orpheus → ˈorfiəs
ortega → ortˈegə
orwell → ˈorwɛl
osceola → ˌɑsiˈolə
osmometer → ɑzmˈɑmɪtər
osmosis → ˌɑzmˈosɪs
ostentation → ˌɑstɛntˈeʃən
ostrich → ˈɑstrɪʧ
otiose → ˈoʃiˌos
ottawa → ˈɑtəwˌɑ
ouija → wˈiʤə
outlet → ˈaʊtlɛt
ovulate → ˈɑvjʊlˌet
oxidase → ˈɑksɪdˌez


pace → pes
padre → pˈɑdre
paella → pɑˈejɑ
paganini → pˌɑgɑnˈini
palau → pɑlˈaʊ
palermo → pəlˈɛrmo
pandanus → pændˈenəs
panegyric → pˌænɪʤˈɪrɪk
pangolin → pˈæŋgəlɪn
panjabi → pənʤˈɑbi
panorama → pˌænərˈæmə
pantheon → pˈænθiˌɑn
papandreou → pˌɑpəndrˈeu
para-aminosalicylic → pˈɛrəəmˌinosˌælɪsˌɪlɪk
paradigm → pˈɛrədˌɑɪm
paradise → pˈɛrədˌɑɪs
paragon → pˈɛrəgˌɑn
paranoiac → pˌɛrənˈoɪˌɪk
paraná → pˌɑrɑnˈɑ
paraphiliapˌɛrəfˈɪljə
paraplegia → pˌɛrəplˈiʤə
parasitism → pˈɛrəsɪtˌɪzəm
parasitize → pˈɛrəsɪtˌɑɪz
parliamentary → pˌɑrləmˈɛntəri
parmesan → pˈɑrməzˌɑn
parmigianino → pˌɑrmɪʤɑnˈino
parthenon → pˈɑrθənˌɑn
particular → pərtˈɪkjələr
particularity → pərtˌɪkjəlˈɛrɪti
particularize → pərtˈɪkjələrˌɑɪz
particularly → pˌɑrtˈɪkjələrli
particulate → pərtˈɪkjəlɪt
parturition → pˌɑrʧurˈɪʃən
pasteurize → pˈɑstjərˌɑɪz
pastiche → pɑstˈiʃ
pastoral → pˈæstərəl
pastoralism → pˈæstərəlˌɪzəm
patagonia → pˌætəgˈonjə
paterfamilias → pˈætərfəmˌɪljəs
paternoster → pˈetərnˌɑstər
pathfinder → pˈæθfˌɑɪndər
pathname → pˈæθnem
pathos → pˈeθɑs
pathway → pˈæθwe
patriarchate → pˈetriˌɑrkɪt
patriot → pˈetriət
patronize → pˈetrənˌɑɪz
pavlov → pˈɑvləf
pavlova → pɑvlˈovə
pawtucket → pˌɑtˈəkət
peabody → pˈibˌɑdi
peculiarity → pɪkjˌuljˈɛrɪti
pedagogic → pˌɛdəgˈɑʤɪk
pedagogue → pˈɛdəgˌɑg
pedology → pɛdˈɑləʤi
pedophilia → pˌɛdəfˈɪljə

peignoir → penwˈɑr
pejorative → pɪʤˈorətɪv
peking → pˈikɪŋ
pekingese → pˌikɪŋˈiz
pelion → pˈiliən
pendulous → pˈɛnʤələs
pendulum → pˈɛnʤələm
penguin → pˈɛŋgwɪn
penile → pˈinɑɪl
penniless → pˈɛnilɪs
pentathlon → pɛntˈæθlɑn
pentecostal → pˌɛntɪkˈɑstəl
peplos → pˈɛpləs
peridotite → pərˈɪdətˌɑɪt
perihelion → pˌɛrɪhˈiliən
permian → pˈərmiən
peroxidase → pərˈɑksɪdˌes
perseus → pˈərsiəs
pershing → pˈərʃɪŋ
persia → pˈərʒə
persian → pˈərʒən
persist → pərsˈɪst
persistence → pərsˈɪstəns
persistent → pərsˈɪstənt
persuasive → pərswˈesɪv
perugia → pɛrˈuʤɑ
pervasive → pˈərvesɪv
perversion → pərvˈərʒən
perón → pɛrˈon
pesach → pˈesɑk
pesaro → pˈɛzɑro
petrolatum → pˌɛtrəlˈetəm
pettifog → pˈɛtifˌɑg
phalanges → fəlˈænʤiz
pharyngeal → fərˈɪnʤəl
phenomenon → fɪnˈɑmənˌən
phenylalanine → fˌɛnəlˈælənˌin
phenylketonuria → fˌɛnəlkˌitˈənuriə
phenylpropanolamine → fˌɛnəlprˌopənˈɑləmˌin
phenylthiocarbamide → fˌɛnəlθˌɑɪokˈɑrbəmˌɑɪd
philemon → fɪlˈimən
philharmonic → fˌɪlhˌɑrmˈɑnɪk
phimosis → fɑɪmˈosɪs
phonemicfənˈimɪk
phonology → fənˈɑləʤi
phosphatase → fˈɑsfətˌes
phospholipase → fˌɑsfolˈɪpˌes
phyllo → fˈilo
physiognomy → fˌɪziˈɑgnəmi
piaget → pˌiəʒˈe
piano → pjˈæno
piaster → piˈɑstər
piazza → piˈɑzɑ
picaresque → pˌɪkərˈɛsk
picasso → pɪkˈɑso
piezoelectricity → piˈeoɪlɛktrˈɪsɪti
pilau → pˈilɑf
pillsbury → pˈɪlzbˌəri
pimpernel → pˈɪmpərnˌɛl
piqué → pɪkˈe
piraeus → pɑɪrˈiəs
piranha → pɪrˈɑnə
pisa → pˈizɑ
pisistratus → pɑɪsˈɪstrətəs
pissarro → pɪsˈɑro
pistachio → pɪstˈæʃo
pizarro → pɪzˈɑro
plagioclase → plˈeʤiəklˌes
plainclothes → plˈenkloðz
planar → plˈenər
planimeter → plənˈɪmɪtər
platonic → plətˈɑnɪk
plebiscite → plˈɛbɪsˌɑɪt
pleiad → plˈiəd
pleiades → plˈiədˌiz
plekhanov → plɪkˈɑnˌof
plenipotentiary → plˌɛnɪpətˈɛnʃˌɛri
plesiosaur → plˈiziəsˌor
plimsoll → plˈɪmsəl
plosive → plˈosɪv
polarity → pəlˈɛrɪti
politburo → pˈɑlɪtbjˌʊro
politesse → pˌolitˈɛs
polonaise → pˌɑlənˈez
polycyclic → pˌɑlisˈɑɪklɪk
polymerase → pˈɑlɪmərˌes
polymerization → pɑlˌɪmərɪzˈeʃən
polynesia → pˌɑlənˈiʒə
polynesian → pˌɑlənˈiʒən
pomade → pəmˈɑd
pomegranate → pˈɑmɪgrˌænɪt
pomerania → pˌɑmərˈenjə
pomeranian → pˌɑmərˈenjən
pompeii → pɑmpˈe
pondicherry → pˌɑndɪʧˈɛri
portofino → pˌortofˈino
portrait → pˈortrɪt
portuguese → pˈorʧəgˌiz
posterior → pˌɑstˈɪriɛr
postgraduate → postgrˈæʤuɪt
postoperative → postˈɑpərətɪv
potemkin → potˈɛmkɪn
potherb → pˈɑtərb
potosí → potəsˈi
poughkeepsie → pəkˈɪpsi
poznań → pˈoznæn
praseodymium → prˌeziodˈɪmiəm
pre-socratic → prˌisokrˈætɪk
preceptory → prɪsˈɛptəri
predator → prˈɛdətər
predecessor → prˈɛdɪsˌɛsər
predilection → prˌɛdəlˈɛkʃən
prehensile → prihˈɛnsɑɪl
prelude → prˈilud
premiere → prɛmˈɪr
prenuptial → prinˈəpʃəl
preoperative → priˈɑpərətɪv
preparatory → prˈəpɛrətˌori
preprogram → priprˈogrˌæm
presbyter → prˈɛzbɪtər
presbytery → prˈɛzbɪtˌɛri
prescient → prˈɛʃənt
presentation → prˌɛzəntˈeʃən
presidency → prˈɛzɪdənsi
presley → prˈɛzli
pressmanprˈɛsmən
prestige → prɛstˈiʒ
preternatural → prˌitərnˈæʧərəl
prigogine → prɪgˈoʒən
primary → prˈɑɪmˌɛri
proclaim → prəklˈem
procure → prəkjˈur
producer → prədˈusər
productivity → prˌodəktˈɪvɪti
profess → prəfˈɛs
profundity → prəfˈəndɪti
profuse → prəfjˈus
profusion → prəfjˈuʒən
program → prˈogræm
programme → prˈogræm
programmed → prˈogræmd
programming → prˈogrˌæmɪŋ
progress → prˈɑgrɛs
project → prˈɑʤɛkt
prokofiev → prokˈofiəf
prolamine → prˈoləmɪn
prolongate → prəlˈɑŋgˌet
promenade → prˌɑmənˈɑd
prometheus → prəmˈiθiəs
promiscuity → prˌɑmɪskjˈuɪti
prophylaxis → prˌofəlˈæksɪs
propitiatory → prəpˈɪʃətˌori
propranolol → proprˈænəlˌol
protein → prˈotin
proteinase → prˈotinˌes
proteinuria → prˌotinˈuriə
protestation → prˌɑtɪstˈeʃən
proteus → prˈotiəs
protract → prətrˈækt
protuberant → prətˈubərənt
provenance → prˈɑvənəns
providence → prˈɑvɪdəns
provident → prˈɑvɪdənt
príncipe

psalmody → sˈɑmədi
psychedelia → sˌɑɪkɪdˈiljə
psychiatrist → sɑɪkˈɑɪətrɪst
psychodrama → sˈɑɪkodrˌɑmə
psychodynamics → sˌɑɪkodɑɪnˈæmɪks
psychokinesis → sˌɑɪkokɪnˈisɪs
psychopathology → sˌɑɪkopəθˈɑləʤi
puerile → pjˈurəl
pulaski
pulitzer → pˈʊlɪtsər
pulpit → pˈəlpɪt
pumpkin → pˈəmpkɪn
punjabi → pənʤˈɑbi
purulent → pjˈurələnt
putumayo → pˌutumˈɑjo
pygmalion → pˌɪgmˈeljən
pyjama → pəʤˈɑmə
pyloric → pɑɪlˈorɪk
pylorus → pɑɪlˈorəs
pyrimethamine → pˌɑɪrəmˈɛθəmˌin
pyromania → pˌɑɪrəmˈeniə
pyruvate → pɑɪrˈuvet
python → pˈɑɪθɑn
pátmos → pˈɑtmos

quadrat → kwˈɑdrət
quadrille → kwɑdrˈɪl
quadriplegia → kwˌɑdrəplˈiʤə
quadruple → kwɑdrˈupəl
quagmire → kwˈægmɑɪr
quandary → kwˈɑndəri
quasar → kwˈezɑr
quasi → kwˈɑzi
queensberry → kwˈinzbˌɛri
quinquennial → kwɪŋkwˈɛniəl
quinquennium → kwɪŋkwˈɛniəm
quran → kərˈɑn

rabelaisian → rˌæbəlˈeʒən
racemic → rəsˈimɪk
racine → rɑsˈin
radicchio → rədˈikio
radioimmunoassay → rˌediˌoɪmjənoˈæse
ragwort → rˈægwort
rain forest
rampart → rˈæmpɑrt
rangeland → rˈenʤlænd
raphael → rˌɑfɑɪˈɛl
rapport → rəpˈor
rapporteur → rˌæportˈur
rastafarian → rˌɑstəfˈɑriən
ratatouille → rˌɑtɑtˈui
ravel → rɑvˈɛl
real-time
realtor → rˈiltər
rebound → rˈibaʊnd
recitative → rɛsˈɑɪtətɪv
reclusive → riklˈusɪv
reconnaissance → rɪkˈɑnəsəns
recusant → rˈɛkjəzənt
redirect → rˌidɪrˈɛkt
redon → rədˈɑn
reductase → rɪdˈəktˌes
regenerative → rɪʤˈɛnərˌetɪv
regime → rəʒˈim
reify → rˈiəfˌɑɪ
renaissance → rˈɛnɪsˌɑns
rendezvous → rˈɑndevˌu
renege → rɪnˈɛg
repairman → rɪpˈɛrmˌæn
repartee → rˌɛpərtˈi
repercussion → rˌɛpərkˈəʃən
reposition → rˌipəzˈɪʃən
representation → rˌɛprɪzɛntˈeʃən
reptilian → rɛptˈɪljən
requiem → rˈɛkwɪˌɛm
reredos → rˈɛrɪdɑs
reservoir → rˈɛzərvwˌɑr
residence → rˈɛzɪdɛns
residency → rˈɛzɪdɛnsi
resident → rˈɛzɪdənt
resource → rˈisors
resourceful → rɪsˈorsfəl
respiratory → rˈɛspərətˌori
retinal → rˈɛtənəl
retinol → rˈɛtˌənɑl
retractile → rɪtrˈæktɑɪl
retrovirus → rˌɛtrovˈɑɪrəs
revere → rɪvˈɪr
revers → rɪvˈɪr
reykjavík → rˈekjəvˌik
reynard → rˈenərd
rhineland → rˈɑɪnlænd
rhumba → rˈumbə
rial → riˈɑl
rialto → riˈɑlto
ribera → ribˈɛrə
riboflavin → rˌɑɪboflˈevɪn
right-on
rimbaud → ræŋbˈo
rimini → rˈɪməni
risorgimento → risˌorʤimˈɛnto
rizzio → rˈɪtsiˌo
rnase → ˌɑrɛnˈez
robespierre → robɛspjˈɛr
rockingham → rˈɑkɪŋhˌæm
rockville → rˈɑkvɪl
rodin → rodˈæŋ
romagna → romˈɑnjɑ
romani → romˈɑni
romania → romˈenjə
romanian → romˈenjən
romanov → rˈomənˌɑf
roofless → rˈʊflɪs
roofline → rˈʊflɑɪn
rooftop → rˈʊftɑp
roosevelt → rˈozəvˌɛlt
roquelaure → rˌokəlˈor
rosalind → rˈɑzəlɪnd
rosario → rozˈɑriˌo
rosenberg → rˈozɪnbˌərg
rosicrucian → rˌozɪkrˈuʃən
rossellini → rˌɑsəlˈini
rostropovich → rˌɑstrəpˈovɪʧ
roswell → rˈɑzwɛl
rothschild → rˈɑθʧɑɪld
rottweiler → rˈɑtwˌɑɪlər
rowan → rˈoən
rucksack → rˈəksæk
rudimentary → rˌudəmˈɛntəri
ruisdael → rˈoɪsdɑl
rumania → rumˈenjə
rumba → rˈumbə
rutabaga → rˌutəbˈegə
ruthenian → ruθˈinjən


saale → zˈɑlə
saarland → zˈɑrlɑnt
sabadell → sˌɑbədˈɛl
saccade → səkˈɑd
saccharine → sˈækərɪn
sacrilegious → sˌækrəlˈɪʤəs
sadducee → sˈæʤəsˌi
sahara → səhˈɛrə
sahel → səhˈel
sahib → sɑhˈib
saipan → sˈɑɪpæn
sake → sˈɑke
sakharov → sˈɑkərˌof
saki → sˈɑki
salazar → sˌæləzˈɑr
salbutamol → sælbjˈutəmˌɑl
salerno → sɑlˈɛrno
salisbury → sˈælzbəri
saltation → sɑltˈeʃən
saltire → sˈɑltɑɪr
sambar → sˈɑmbər
sangria → sæŋgrˈiə
sanhedrin → sɑnhˈɛdrɪn
santero → sæntˈɛro
sapiens → sˈepiənz
sarawak → sˈɛrəwɑk
sardinia → sɑrdˈɪnjə
saskatchewan → sæskˈæʧəwˌɑn
saussure → sosˈur
saxatile → sˈæksətˌɑɪl
saxifrage → sˈæksəfreʤ
scabious → skˈæbiəs
scaffold → skˈæfəld
scaffolding → skˈæfəldɪŋ
scalar → skˈelər
scampi → skˈæmpi
scandinavia → skˌændənˈevjə
scandinavian → skˌændɪnˈevjən
scaramouch → skˈɛrəmˌuʃ
scarborough → skˈɑrbˌəro
scaremonger → skˈɛrmˌəŋgər
scatology → skætˈɑləʤi
scenario → sɪnˈɛriˌo
schedule → skˈɛʤʊl
schematic → skɛmˈætɪk
schiaparelli → skjˌɑpɑrˈɛli
schismatic → skɪzmˈætɪk
schizophrenia → skˌɪtsəfrˈiniə
schubert → ʃˈubərt
schuman → ʃˈumən
schwarzkopf → ʃwˈɑrtskɑpf
schweitzer → ʃwˈɑɪtsər
scimitar → sˈɪmɪtɑr
scipio → ʃˈipiˌo
scoliosis → skˌoliˈosɪs
secant → sˈikənt
secretagogue → sɪkrˈitəgˌɑg
sector → sˈɛktər
sedgemoor → sˈɛʤmur
sedimentary → sˌɛdəmˈɛntəri
sedimentation → sˌɛdəməntˈeʃən
sedimentology → sˌɛdəməntˈɑləʤi
segmentation → sˌɛgməntˈeʃən
selectivity → sˌɪlɛktˈɪvɪti
semiconductor → sˈɛmɪkəndˌəktər
semifinal → sˌɛmifˈɑɪnəl
semiology → sˌɛmiˈɑləʤi
semiotic → sˌɛmiˈɑtɪk
semiotics → sˌɛmiˈɑtɪks
semiprivate → sˌɛmiprˈɑɪvɪt
semiskilled → sˌɛmiskˈɪld
semisolid → sˌɛmisˈɑlɪd
semitone → sˈɛmitˌon
sensor → sˈɛnsər
sententia → sɛntˈɛnʃə
sentience → sˈɛnʃəns
sentient → sˈɛnʃənt
separable → sˈɛpərəbəl
separatist → sˈɛpərətɪst
sepulchral → səpˈəlkrəl
sequence → sˈikwɛns
sequencer → sˈikwənsər
sequestrate → sɪkwˈɛstrˌet
sequestration → sˌikwɪstrˈeʃən
seraglio → sɛrˈɑljo
seroconversion → sˌɪrokənvˈərʒən
serosa → sɪrˈosə
serotonin → sˌɛrətˈonɪn
serviceman → sˈərvɪsmˌæn
servile → sˈərvɑɪl
servitor → sˈərvɪtər
sesotho → səsˈoto
sessile → sˈɛsɑɪl
seurat → sʊrˈɑ
severable → sˈɛvərəbəl
seychelles → seʃˈɛl
shacko → ʃˈɑko
shaftesbury → ʃˈæftsbˌɛri
shako → ʃˈɑko
shakti → ʃˈɑkti
shamanism → ʃˈɑmənˌɪzəm
shanghai → ʃˈæŋhɑɪ
shankar → ʃˈɑŋkɑr
shaban
shieling → ʃˈilɪŋ
short-lived
shostakovich → ʃˌɑstəkˈovɪʧ
shropshire → ʃrˈɑpʃɪr
siamese → sˌɑɪəmˈiz
sibelius → sɪbˈeljəs
sicyon → sˈɪʃiˌɑn
siegfried → sˈigfrid
siemens → zˈimənz
signora → sinjˈorə
signore → sinjˈore
signorina → sˌinjərˈinə
silesia → sɪlˈiʒə
silicon → sˈɪlɪkən
silurian → sɪlˈuriən
simony → sˈɑɪməni
simpatico → sɪmpˈɑtɪkˌo
simulacrum → sˌɪmjəlˈekrəm
simultaneous → sˌɑɪməltˈeniəs
sinclair → sɪŋklˈɛr
sinecure → sˈɪnɪkjˌur
sinfonietta → sˌɪnfənjˈɛtə
singhalese → sˌɪŋgəlˈiz
sinhalese → sˌɪnhəlˈiz
slovakia → slˌovˈɑkjə
slovenia → slˌovˈiniə
smolensk → smɑlˈɛnsk
sobriety → səbrˈɑɪɪti
sociobiology → sˌosɪobɑɪˈɑləʤi
sociocultural → sˌosɪokˈəlʧərəl
socioeconomic → sˌosioˌɛkənˈɑmɪk
sociolinguistics → sˌosɪolɪŋgwˈɪstɪks
sociology → sˌosiˈɑləʤi
sociopath → sˈosiəpˌæθ
sociopolitical → sˌosiopəlˈɪtɪkəl
socratic → səkrˈætɪk
softcover → sˈɑftkˌəvər
solarium → səlˈɛriəm
solecism → sˈɑlɪsˌɪzəm
solipsism → sˈɑlɪpsˌɪzəm
solon → sˈolən
solstice → sˈolstɪs
solti → sˈolti
solvable → sˈɑlvəbəl
solvent → sˈɑlvənt
somatosensory → səmˌætəsˈɛnsəri
somatostatin → somˌætəstˈætən
sombrero → sɑmbrˈɛro
sonogram → sˈɑnəgrˌæm
soporific → sˌɑpərˈɪfɪk
sorrento → sərˈɛnto
sorrowful → sˈɑrofˌəl
soubriquet → sˈubrɪkˌe
souchong → sˈuʧɑŋ
sousa → sˈuzə
soutane → sutˈɑn
southampton → saʊθhˈæmptən
southwester → sˌaʊθwˈɛstər
soviet → sˈovjˌɛt
soweto → sowˈeto
speciation → spˌisiˈeʃən
specie → spˈisi
species → spˈisiz
speciesism → spˈisizˌɪzəm
spengler → spˈɛŋlər
spermatocyte → spərmˈætəsˌɑɪt
spermatogenesis → spərmˌætəʤˈɛnɪsɪs
spheroid → sfˈɪrˌoɪd
spheroplast → sfˈɪrəplˌæst
spirituel → spˌɪrɪʧuˈɛl
splenomegaly → splˌinəmˈɛgəli
spontaneity → spˌɑntənˈeɪti
spousal → spˈaʊzəl
spritzer → sprˈɪtsər
squamous → skwˈɑməs
stalactite → stəlˈæktˌɑɪt
stalagmite → stəlˈægmˌɑɪt
stanislavsky → stˌænɪslˈɑvski
steadfast → stˈɛdfæst
steiner → stˈɑɪnər
steinmetz → stˈɑɪnmɛts
stendhal → stɛndˈɑl
stepfamily → stˈɛpfˌæməli
stereo → stˈɛriˌo
stereochemistry → stˌɛriokˈɛmɪstri
stereography → stˌɛriˈɑgrəfi
stereophonic → stˌɛriəfˈɑnɪk
stereoscopic → stˌɛriəskˈɑpɪk
stereotaxis → stˌɛriətˈæksɪs
stereotype → stˈɛriotˌɑɪp
stereotyped → stˈɛriotˌɑɪpt
steric → stˈɛrɪk
stigmata → stɪgmˈɑtə
stilwell → stˈɪlwɛl
stirrup → stˈərəp


stokowski → stəkˈovski
storeroom → stˈorum
strengthen → strˈɛŋθən
stromboli → strˌɑmbˈoli
strongyle → strˈɑnʤɑɪl
strontium → strˈɑnʧiəm
strychnine → strˈɪknɑɪn
stuttgart → ʃtˈutgɑrt
subantarctic → sˌəbæntˈɑrktɪk
subaqueous → səbˈekwiəs
subarctic → səbˈɑrktɪk
subdirectory → sˌəbdɪrˈɛktəri
subspecies → sˈəbspˌiʃiz
substratum → sˈəbstrˌetəm
subversion → səbvˈərʒən
sudbury → sˈədbˌɛri
sudeten → sudˈetən
sudetenland → sudˈetnlˌænd
suggestible → səgʤˈɛstəbəl
suggestion → səgʤˈɛsʧən
suggestive → səgʤˈɛstɪv
suharto → suhˈɑrto
sully → sˈəli
sultana → səltˈænə
sumerian → sumˈɪriən
sunroof → -sˈənrʊf
superego → sˈupərigo
superintend → sˌupərɪntˈɛnd
superintendent → sˌupərɪntˈɛndɛnt
superovulate → sˌupərˈɑvjəlˌet
supposed → səpˈozd
supranational → sˌuprənˈæʃənəl
supremo → suprˈimˌo
suprême → suprˈim
susa → sˈusə
susah → sˈusə
suva → sˈuvə
suzerain → sˈuzərɪn
suzerainty → suzərˈenti
svengali → svɛngˈɑli
swampland → swˈɑmplænd
swashbuckle → swˈɑʃbˌəkəl
swashbuckler → swˈɑʃbˌəklər
sweelinck → swˈelɪŋk
sycophancy → sˈɪkəfənsi
sycophant → sˈɪkəfənt
sympatry → sˈɪmpˌətri
synagogue → sˈɪnəgˌɑg
synchro → sˈɪŋkro
synchronicity → sˌɪŋkrənˈɪsɪti
synchronism → sˈɪŋkrənˌɪzəm
synchronize → sˈɪŋkrənˌɑɪz
synchronous → sˈɪŋkrənəs
synchrony → sˈɪŋkrəni
synchrotron → sˈɪŋkrətrˌɑn
syncopate → sˈɪŋkəpˌet
syncopation → sˈɪŋkəpˌeʃən
syncope → sˈɪŋkəpi
syncretism → sˈɪŋkrɪtˌɪzəm
synthetase → sˈɪnθɪtˌes
syrupy → sˈərəpi
systemic → sˌɪstˈɛmɪk
séance → sˈeɑns

tabu → təbˈu
tacrine → tˈækrin
tadzhik → tˈɑʤɪk
tadzhikistan → təʤˈɪkɪstˌæn
taffrail → tˈæfrel
tagalog → tˈægəlˌɑg
tagliatelle → tˌɑljətˈɛle
tagore → təgˈor
taipei → tˈɑɪpe
taiwanese → tˌɑɪwɑnˈiz
tajik → tˈɑʤɪk
tajikistan → tˌɑʤˈikəstˌæn
talisman → tˈælɪzmən
talismanic → tˌælɪzmˈænɪk
tamar → tˈɑmər
tamarin → tˈæmərɪn
tambov →  tɑmbˈof
tamil → tˈɑməl
tampico → tɑmpˈiko
tarawa → tərˈɑwə
tarpaulin → tˈɑrpəlɪn
tarragon → tˈɛrəgˌɑn
tarsier → tˈɑrsiər
tasmania → tˌæzmˈeniə
tbilisi → təblˈisi
technetium → tɛknˈiʃəm
tejano → tehˈɑno
teleology → tˌɛliˈɑləʤi
telomere → tˈɛləmˌɪr
temblor → tˈɛmblər
temperamental → tˌɛmprəmˈɛntəl
tenerife → tˌɛnərˈɪf
tensile → tˈɛnsəl
tensor → tˈɛnsər
tenure → tˈɛnjər
tenured → tˈɛnjərd
teresa → tərˈisə
tetracycline → tˌɛtrəsˈɑɪklˌin
tewkesbury → tˈuksbˌɛri
textile → tˈɛkstɪl
thalberg → θˈɑlbərg
thenceforth → ðɛnsfˈorθ
thenceforward → ðˌɛnsfˈorwərd
theoretician → θˌiərɪtˈɪʃən
therefrom → ðɛrfrˈəm
thereof → ðɛrˈəv
thereon → -ðɛrˈɑn
theresa → tərˈisə
thereupon → -ðˈɛrəpˌɑn
theseus → θˈisiəs
theta → θˈetə
thiazide → θˈɑɪəzˌɑɪd
thither → θˈɪðər
thoroughfare → θˈərofˌɛr
thoroughgoing → θˈərogˌoɪŋ
threepence → θrˈɛpəns
threepenny → θrˈɛpəni
threshold → θrˈɛʃold
thuringia → θurˈɪnʤə
thuringian → θurˈɪnʤən
thyroxine → θɑɪrˈɑksˌin
tiepolo → tiˈɛpəlˌo
tigre → tˈigre
tilapia → təlˈɑpiə
tilburg → tˈɪlbərg
tilbury → tˈɪlbˌɛri
timbale → tˈɪmbəl
tinbergen → tˈɪnbərgən
tinnitus → tɪnˈɑɪtəs
tiranë → tərˈɑnə
tisane → tɪzˈæn
titania → tətˈɑnjə
titanic → tɑɪtˈænɪk
titanium → tɑɪtˈeniəm
tivoli → tˈɪvəli
tobin → tˈobɪn
tocqueville → tokvˈil
tokamak → tˈokəmˌæk
tolkien → tˈolkin
tolstoy → tˈolstoɪ
torrential → torˈɛnʧəl
torricelli → tˌorɪʧˈɛli
torsade → torsˈɑd
toruń → tˈorun
toscanini → tˌɑskənˈini
toucan → tˈukən
tournament → tˈərnəmənt
tousle → tˈaʊsəl
towpath → tˈopæθ
trampoline → trˌæmpəlˈin
tranquil → trˈæŋkwɪl
tranquilizer → trˈæŋkwəlˌɑɪzər
tranquillity → træŋkwˈɪlɪti
transactivate → trænsˈæktəvˌet
transaminase → trænsˈæmənˌes
transcaucasia → trˌænskɑkˈeʒə
transcriptase → trænskrˈɪptes
transducer → trænsdˈusər
transduction → trænsdˈəkʃən
transferase → trˈænsfərˌes
transformation → trˌænsfərmˈeʃən
transgene → trˈænsʤin
transgenics → trænsʤˈɛnɪks
transgressive → trænsgrˈɛsɪv
transhumance → trænshjˈuməns
transistor → trænzˈɪstər
transit → trˈænzɪt
transition → trænzˈɪʃən
transitive → trˈænsɪtɪv
transitory → trˈænsɪtˌori
transjordan → trænsʤˈordən
transkei → trˈɑnske
translocation → trˌænslokˈeʃən
translucent → trænslˈusənt
transmembrane → trænsmˈɛmbren
transmigrate → trænsmˈɑɪgrˌet
transmissible → trænsmˈɪsəbəl
transmittal → trænsmˈɪtəl
transmittance → trænsmˈɪtəns
transmitter → trænsmˈɪtər
transmutation → trˌænsmjutˈeʃən
transmute → trænsmjˈut
transnational → trænsnˈæʃənəl
transpersonal → trænspˈərsənəl
trasimeno → trˌɑzəmˈeno
traumatize → trˈɑmətˌɑɪz
trevelyan → trɪvˈɛljən
tribology → trɪbˈɑləʤi
tribunal → trɪbjˈunəl
tricyclic → trɑɪsˈɑɪklɪk
tridentine → trɑɪdˈɛntˌɑɪn
trieste → triˈɛst
tristan → trˈɪstən
tritium → trˈɪtiəm
trombone → trˈɑmbon
trondheim → trˈɑnhem
trotsky → trˈɑtski
troubadour → trˈubədˌor
tungus → təŋgˈuz
tunguska → tʊŋgˈuskə
tunisia → tˌunˈiʒə
tunisian → tˌunˈiʒən
tureen → turˈin
turenne → turˈɛn
turgor → -gor
turgot → turgˈo
turkestan → tˌərkɪstˈæn
turkistan → tˌərkɪstˈæn
turkmen → tˈərkmɛn
turkmenistan → tˌərkmˈɛnəstˌæn
turmeric → tˈərmərɪk
twentieth → twˈɛntiɪθ
twenty → twˈɛnti
tynemouth → tˈɑɪnməθ
tyrannical → tɪrˈænɪkəl
tyrannosaur → tɪrˈænəsˌor
tyrosinase → tˈɑɪrosɪnˌes
tübingen → tˈʊbɪŋən

ukelele → jˌukəlˈeli
ukulele → jˌukəlˈeli
ultimatum → əltəmˈetəm
unamuno → ˌunəmˈuno
unappreciative → ˌənəprˈiʃətɪv
uncial → ˈənʃəl
uncommunicative → ˌənkəmjˈunɪkətɪv
uncomplimentary → ˌənkɑmplɪmˈɛntəri
uncontroversial → ˌənkˌɑntrəvˈərʃəl
uncooperative → ˌənkoˈɑpərətɪv
underclothes → ˈəndərklˌoðz
undirected → ˌəndɪrˈɛktɪd
undulate → ˈənʤəlˌet
undulation → ˌənʤəlˈeʃən
unemployable → ˌənɛmplˈoɪəbəl
unemployed → ˌənɛmplˈoɪd
unerring → ənˈərɪŋ
unfavorable → ˌənfˈevərəbəl
uniat → jˈuniˌæt
unicode → jˈunɪkˌod
unidimensional → jˌunɪdɪmˈɛnʃənəl
unidirectional → jˌunɪdɪrˈɛkʃənəl
uninterest → ənˈɪntrɪst
uninterested → ənˈɪntrɪstɪd
uninteresting → ənˈɪntrɪstɪŋ
unison → jˈunɪsən
unitive → jˈunɪtɪv
unobstructed → ˌənəbstrˈəktɪd
unparliamentary → ˌənpɑrləmˈɛntəri
unsure → ənʃˈər
unwashed → ənwˈɑʃt
unwonted → ənwˈəntɪd
upholsterer → əphˈolstərər
upholstery → əphˈolstəri
upland → ˈəplənd
urease → jˈuriˌes
usage → jˈusɪʤ
usurp → jusˈərp
usurpation → jˌusərpˈeʃən
uterine → jˈutərɪn
uxorious → əksˈoriəs
uzbek → ˈuzbɛk
uzbekistan → uzbˈɛkəstˌæn

vacation → vekˈeʃən
vacuity → vəkjˈuɪti
valdo → vˈældo
valence → vˈeləns
valencia → vəlˈɛnʃə
valenciennes → vəlˌɛnsiˈɛn
valkyrie → vælkˈɪri
vallejo → vɑlˈeho
valuable → vˈæljubəl
vanquish → vˈæŋkwɪʃ
variate → vˈɛriɪt
variegated → vˈɛrɪgˌetɪd
vasari → vəzˈɑri
vasculature → vˈæskjələʧˌur
vasectomy → væsˈɛktəmi
vasodilation → vˌezodɑɪlˈeʃən
vasodilator → vˌezodɑɪlˈetər
vaudeville → vˈɑdvɪl
veda → vˈedə
vedic → vˈedɪk
vegetable → vˈɛʤtəbəl
vela → vˈɛlə
velodrome → vˈɛlədrˌom
venepuncture → vˈɛnəpˌəŋkʧər
venetia → vənˈiʃə
venezuela → vˌɛnɪzwˈelə
venipuncture → vˈɛnəpˌəŋkʧər
venison → vˈɛnɪsən
venusian → vɪnˈuʒən
verbiage → vˈərbɪʤ
verboten → fərbˈotən
verdigris → vˈərdɪgri
vermeer → vərmˈɪr
vermeil → vˈərmɪl
veronese → vˌɛrənˈez
version → vˈərʒən
vesicular → vɛsˈɪkjələr
vestigial → vɛstˈɪʤəl
vibrato → vɪbrˈɑto
vicariate → vɑɪkˈɛriɪt
vicarious → vɑɪkˈɛriəs
vice → vɑɪs
vice president
victoria → vɪktˈoriə
videlicet → vɪdˈɛlɪsˌɛt
vietcong → vˌiɛtkˈɑŋ
vietminh → vˌiɛtmˈɪn
vietnam → vˌiɛtnˈɑm
vietnamese → vˌiɛtnɑmˈiz
vietnamization → vˌiɛtnəmɪzˈeʃən
viewdata → vjˈudˌetə
vigo → vˈigo
villahermosa → vˌiəɛrmˈosə
vinegary → vˈɪnɪgəri
virile → vˈɪrəl
virion → vˈɑɪriˌɑn
virtu → vərtˈu
virtuoso → vˌərʧuˈozo
viticulture → vˈɪtɪkˌəlʧər
vituperation → vɪtˌupərˈeʃən
vituperative → vˌɪtˈupərətɪv
viva → vˈivə
vivacious → vɪvˈeʃəs
vivacity → vɪvˈæsɪti
volatile → vˈɑlətɪl
volcanic → vɑlkˈænɪk
volcanogenic → vˌɑlkənəʤˈɛnɪk
volcanology → vˌɑlkənˈɑləʤi
volga → vˈɑlgə
volta → vˈɑltə
volume → vˈɑljum
voracious → vorˈeʃəs
vulgate → vˈəlget
vyborg → vˈiborg
véronique → vˌɛrənˈik

w → dˈəbəlju
wainscot → wˈenskət
waldheim → vˈɑlthɑɪm
walhalla → vɑlhˈɑlə
walkyrie → vɑlkˈɪri
walsall → wˈɑlsəl
wampum → wˈɑmpəm
wannabe → wˈɑnəbˌi
wanting → wˈəntɪŋ
warpath → wˈorpæθ
wart hog
washable → wˈɑʃəbəl
washbasin → wˈɑʃbˌesən
washboard → wˈɑʃbord
washcloth → wˈɑʃklɑθ
washday → wˈɑʃde
washerwoman → wˈɑʃərwˌʊmən
washout → wˈɑʃaʊt
washroom → wˈɑʃrum
washstand → wˈɑʃstænd
water line → wˈɑtərlˌɑɪn
water ski
water wheel
water-ski
waterbus → wˈɑtərbˌəs
watersport → wˈɑtərspˌort
waterweed → wˈɑtərwˌid
watteau → wɑtˈo
wavelength → wˈevlɛŋθ
welshman → wˈɛlʃmən
werewolf → wˈɛrwʊlf
wesley → wˈɛsli
whatsit → wˈətsɪt
whereon → wɛrˈɑn
whereupon → wˌɛrəpˈɑn
wherewithal → wˈɛrwɪðˌɑl
whirlpool → wˈərlpul
whirlwind → wˈərlwɪnd
white-water → wˈɑɪtwˌɑtər
whitewash → wˈɑɪtwɑʃ
whitsunday → wˈɪtsˌənde
whooper → hˈupər
wildebeest → wˈɪldəbˌist
wilhelmina → wˌɪlhɛlmˈinə
wiltshire → wˈɪlʧɪr
winchester → wˈɪnʧˌɛstər
withal → wɪðˈɑl
withhold → wɪθhˈold
withholding → wˌɪθhˈoldɪŋ
withstand → wɪθstˈænd
wittgenstein → vˈɪtgənʃtˌɑɪn
wollstonecraft → wˈʊlstənkrˌæft
wonted → wˈəntɪd
worcestershire → wˈʊstərʃˌər
word processing
wrathful → rˈæθfəl

xanthine → zˈænθin
xavier → zˈeviər
xenobiotic → zˌɛnəbɑɪˈɑtɪk
xenograft → zˈɛnəgrˌæft
xenolith → zˈɛnəlˌɪθ
xenophobe → zˈɛnəfˌob
xenophon → zˈɛnəfən
xhosa → kˈozɑ
xosa → kˈozɑ
yahoo → jɑhˈu
yarborough → jˈɑrbˌərə
yggdrasil → ˈɪgdrəsɪl
yogyakarta → jˌɑgjəkˈɑrtə
yourselves → jərsˈɛlvz
yucatán → jˌukətˈɑn
zabaglione → zˌɑbɑljˈoni
zapotec → zˌɑpətˈɛk
zeta → zˈetə
ziegfeld → zˈɪgfɛld
ziegler → zˈiglər
zoology → zoˈɑləʤi
zwingli → tswˈɪŋli

antivivisectionist → ˌæntɪvˌɪvəsˈɛkshənəst
claudius → klˈɔdiəs
eery → ˈɪri
eifel → ˈɑɪfəl
idria → ˈɪdriə
lawrence → lˈorəns
mastoparietal → mˌæstopərˈɑɪətəl
rauschenbusch → rˈaʊʃənbʊʃ
respire → rɪspˈɑɪr
treble → trˈɛbəl
bell → bɛl
microcephalism → mˌɑɪkrosˈɛfəlˌɪzəm
objet → ˌɑbzhˈe
stuart → stˈuərt

engineer → ˈɛnʤənˌɪr
cipriano → sˈaɪpriˌɑno
manabozho
narcotic → nɑrkˈɑtɪc
pericardium
piracy → pˈaɪræsi
precancerous → prˈikˌænsrəs
recent → rˈisɛnt
recently → rˈicɛntli
recentness → rˈicɛntnɛs
space → spes
surcease → sˈərsiz
tzaristic → zɑrˈɪstɪk
vacancy → vˈekɛnsi
verdant → vərdɛnt
xinhua → ʃˈɪnwɑ
agassiz
caddy → kˈædi
cary → kˈæri
fitzgerald → fɪtsʤˈɛrəld
gnocchi → njˈoki
jackson → ʤˈæksən
layback → lˈebæck
marsh → mɑrʃ
scot → skɔt
subscribe → səbscrˈaɪb
tuchman → tˈəckmən
wilder → wˈaɪldər
wolfe → wʊlf

saw  → sɑ
a   → e
the   → ðə

of → əv
this → ðɪs

been → bɛn

said → sɛd


your → jur


because → bɪkəz




being → biɪŋ
going → goɪŋ
here → hɪri

want → wənt

thought → θɑt


power → pɑʊər

almost → ɑlmost


air → ɛr

saw	→	sɑ

alto → ɑlto
talk → tɑk
saying → seɪŋ
ɪnhərɛnt  → ɪnhɛrɛnt

the → thi

every  → ɛvri
secure  → sɛkjur
