# Baby names
అకుతీ	اكوتی
అక్సిథీ	اكسیتهی
అచలరాజ	اتشلراج
అచలా	اتشلا
అజగంధా	اججندها
అజాణీ	اجانی
అజియా	اجییا
అడ్యాత్రయీ	ادیاتریی
అదీక్యా	ادیكیا
అదృశ	ادرش
అదేన్య	ادینی
అద్రిక	ادریك
అద్రీపతి	ادریبتی
అధిక్శీఠా	ادهیكشیطها
అబిభవా	ابیبهوا
అబీశాఈ	ابیشاي
అబేల	ابیل
అబోఇల	ابويل
అబ్జా	ابجا
అబ్ధీ	ابدهی
అబ్బ్య్నాయ్హా	اببینایها
అభయ	ابهی
అభయాన	ابهیان
అభిథా	ابهیتها
అభిథి	ابهیتهی
అభినయ	ابهینی
అభినిత	ابهینیت
అభినీత	ابهینیت
అభిమంద	ابهیمند
అభిమానీ	ابهیمانی
అభిసోకా	ابهیسوكا
అభిహీతా	ابهیهیتا
అభీచంద్ర	ابهیتشندر
అభీనాతా	ابهیناتا
అభీశీక్తా	ابهیشیكتا
అభీసుమత	ابهیسومت
అభ్జిత	ابهجیت
అభ్యప్సీత	ابهیبسیت
అలకనందా	الكنندا
అశవ	اشو
అశునత	اشونت
అశ్నేఇల	اشنیيل
అహేలీ	اهیلی
ఆకర్షక	آكرشك
ఆచమన	آتشمن
ఆతమన	آتمن
ఆత్మజ	آتمج
ఆత్రయీ	آتریی
ఆదరవ	آدرو
ఆదర్శా	آدرشا
ఆదర్శీనీ	آدرشینی
ఆదీప్తా	آدیبتا
ఆధరిత	آدهریت
ఆధార	آدهار
ఆధిరా	آدهیرا
ఆధిరాఇ	آدهیراي
ఆధ్యా	آدهیا
ఆనందీ	آنندی
ఆనుష	آنوش
ఆబీర	آبیر
ఆభాస	آبهاس
ఆయనా	آینا
ఆరమాన	آرمان
ఆరాడ్యా	آرادیا
ఆరీవ	آریو
ఆర్కశ	آركش
ఆర్థీ	آرتهی
ఆలాప	آلاب
ఆల్యా	آلیا
ఆవీ	آوی
ఆశిమ	آشیم
ఆస్రీతా	آسریتا
ఆస్లుంనన	آسلوننن
ఇందుభూషణ	إندوبهوشن
ఇందుమతీ	إندومتی
ఇందుముఖీ	إندوموكهی
ఇందుశేఖర	إندوشیكهر
ఇతిశ్రీ	إتیشری
ఇధా	إدها
ఇధికా	إدهیكا
ఇన్గనామ	إنجنام
ఇన్దారేశ	إنداریش
ఇన్దుదార	إندودار
ఇన్దుబాలా	إندوبالا
ఇన్ద్రాణీ	إندرانی
ఇన్ద్రేశ	إندریش
ఇయురేశ	إیوریش
ఇలా	إلا
ఇలావేనిల	إلاوینیل
ఇలాశ్పస్తీ	إلاشبستی
ఇశానికా	إشانیكا
ఇశాన్వీ	إشانوی
ఇష్య	إشی
ఇస్లేత	إسلیت
ఈచ్ఛా	إتشتشها
ఈన్దుస	إندوس
ఈశాంత	إشانت
ఈశానపుత్ర	إشانبوتر
ఉగ్రేశ	وجریش
ఉజవణీ	وجونی
ఉజీత్ర	وجیتر
ఉజేశ	وجیش
ఉజ్జమ	وججم
ఉజ్జవాలా	وججوالا
ఉత్తల	وتتل
ఉత్పర	وتبر
ఉత్విక	وتویك
ఉత్సర్గ	وتسرج
ఉత్సుక	وتسوك
ఉదయన	ودین
ఉదయసూరియాఁ	ودیسورییان
ఉదేయ	ودیی
ఉద్వాహనీ	ودواهنی
ఉధ్గీతా	ودهجیتا
ఉపనయ	وبنی
ఉపాసనా	وباسنا
ఉమాంపుత్ర	ومانبوتر
ఉమికా	ومیكا
ఉలగన	ولجن
ఉల్ముక	ولموك
ఉషాకిరణ	وشاكیرن
ఋచా	رتشا
ఏకంశీ	یكنشی
ఏకలవ్య	یكلوی
ఏకాంత	یكانت
ఏకాంతా	یكانتا
ఏకాంతికా	یكانتیكا
ఏకాత్మా	یكاتما
ఏకావలీ	یكاولی
ఏత్తన	یتتن
ఏనక్షీ	ینكشی
ఏరీన	یرین
ఏలామరణ	یلامرن
ఏలావేన్ధన	یلاویندهن
ఏలుమలాఈ	یلوملاي
ఏవాంశీ	یوانشی
ఏశానికా	یشانیكا
ఓఇశని	اويشنی
ఓఈశీ	اويشی
ఓజస్వీ	اوجسوی
ఓజస్వీతా	اوجسویتا
ఓజ్జస్వీన	اوججسوین
ఓప్పిలమణి	اوببیلمنی
ఓమలా	اوملا
ఓమాజా	اوماجا
ఓమేసా	اومیسا
ఓమ్దుత్త	اومدوتت
ఓవీఏ	اوویي
ఓశమాం	اوشمان
ఓహస	اوهس
కంగనా	كنجنا
కంజ	كنج
కంధన	كندهن
కంశ	كنش
కజరీ	كجری
కతకీ	كتكی
కథీర	كتهیر
కథ్యనీ	كتهینی
కదంబన	كدنبن
కదంబీ	كدنبی
కనక	كنك
కనాహియా	كناهییا
కనిక	كنیك
కనిశ్టా	كنیشطا
కనీషా	كنیشا
కనుష	كنوش
కనైయా	كناییا
కన్కేయా	كنكییا
కన్తారవ	كنتارو
కన్నన	كننن
కన్హైయా	كنهيیا
కపిల	كبیل
కమసంతక	كمسنتك
కమాన	كمان
కమాలబంధూ	كمالبندهو
కయాల్వీఝ్హీ	كیالویجههی
కరబీ	كربی
కరమజీత	كرمجیت
కరూణా	كرونا
కర్ణన	كرنن
కర్తవయా	كرتویا
కలాఈ	كلاي
కలానీతీ	كلانیتی
కలోల	كلول
కల్యాణీ	كلیانی
కవి	كوی
కవీన్ద్ర	كویندر
కవీప్రనీతా	كویبرنیتا
కవీయాసరీ	كوییاسری
కవీరాసన	كویراسن
కవీషా	كویشا
కశీక	كشیك
కశ్నీ	كشنی
కశ్మాంలమ	كشمانلم
కస్లుంనీరా	كسلوننیرا
కహన	كهن
కహ్లీమాం	كهلیمان
కాంచీ	كانتشی
కాంతవ	كانتو
కాంతా	كانتا
కాంతామనీ	كانتامنی
కాంతి	كانتی
కాకలీ	كاكلی
కాక్షీ	كاكشی
కాన్జీరా	كانجیرا
కామేరీనా	كامیرینا
కారుం	كارون
కార్తికేయన	كارتیكیین
కార్నిక	كارنیك
కాలిందీ	كالیندی
కాలిత	كالیت
కాలిదాస	كالیداس
కాలీ	كالی
కాలీదాస	كالیداس
కావ్యరజ్సింహ	كاویرجسینه
కావ్యా	كاویا
కాసనీ	كاسنی
కిరాత	كیرات
కేంగా	كینجا
కేఈశా	كیيشا
కేతక	كیتك
కేతవ	كیتو
కేతాఘనీ	كیتاجهنی
కేనాలీ	كینالی
కేనీత	كینیت
కేనీల	كینیل
కేల్వీన	كیلوین
కేవ్లీనా	كیولینا
కేసరీనందన	كیسرینندن
కేసవ	كیسو
కేసవారాజ	كیسواراج
కైతవ	كایتو
కైశిక	كایشیك
కౌర్వాకీ	كاورواكی
ఖగేశ	كهجیش
ఖాజిత	كهاجیت
ఖానామ	كهانام
ఖామారీ	كهاماری
ఖాశ్వీ	كهاشوی
ఖుశీకా	كهوشیكا
ఖుశ్మీతా	كهوشمیتا
ఖైలాశ	كهایلاش
గంగవార	جنجوار
గంగోల	جنجول
గందిరా	جندیرا
గంధారా	جندهارا
గగనాసరీ	ججناسری
గగ్నేశ	ججنیش
గజగామినీ	جججامینی
గజరా	ججرا
గజలక్ష్మీ	ججلكشمی
గజానన	ججانن
గతితా	جتیتا
గత్రికా	جتریكا
గదీన	جدین
గధాధర	جدهادهر
గన్గసీరువన	جنجسیروون
గరిష్ట	جریشط
గరుల	جرول
గర్గ	جرج
గాథా	جاتها
గాయక	جایك
గిరీ	جیری
గీతా సుహానీ	جیتا سوهانی
గీరీచంద్ర	جیریتشندر
గీరీనాథ	جیریناته
గీర్వేన	جیروین
గీశుం	جیشون
గుదాకేశ	جوداكیش
గునవంత	جونونت
గునాలన	جونالن
గునితా	جونیتا
గురశరణ	جورشرن
గురురాజా	جوروراجا
గృహ్యా	جرهیا
గేహనా	جیهنا
గోఉరబ	جوورب
గోకుల	جوكول
గోదావరీ	جوداوری
గోపాల	جوبال
గోపీ	جوبی
గోబీకా	جوبیكا
గోమాంథీ	جومانتهی
గోరల	جورل
గోవీనేశ	جووینیش
గోవీన్దారాజ	جووینداراج
గోశీతా	جوشیتا
గౌరీ	جاوری
గ్నాపీకా	جنابیكا
గ్రంథిక	جرنتهیك
గ్రహిత	جرهیت
గ్రీతిక	جریتیك
ఘటా	جهطا
ఘనావీ	جهناوی
ఘోరరుపా	جهورروبا
ఘోశీనీ	جهوشینی
ఘోషా	جهوشا
ఘ్యాన	جهیان
చందక	تشندك
చందనా లక్ష్మీ	تشندنا لكشمی
చంద్రకలా	تشندركلا
చంద్రకాంత	تشندركانت
చంద్రకిశోర	تشندركیشور
చంద్రమాం	تشندرمان
చంద్రమౌలీ	تشندرماولی
చంద్రలేక్షా	تشندرلیكشا
చంద్రహాస	تشندرهاس
చంద్రాయణ	تشندراین
చక్రిక	تشكریك
చక్రికా	تشكریكا
చక్రియా	تشكرییا
చక్షస	تشكشس
చన్ద్రకేతు	تشندركیتو
చన్ద్రజ్యోతీ	تشندرجیوتی
చన్నాప్పా	تشنناببا
చరణ  రాజ	تشرن  راج
చరణరజ	تشرنرج
చరీథా	تشریتها
చరులా	تشرولا
చరుశీల	تشروشیل
చాతీమాం	تشاتیمان
చాతుర్య	تشاتوری
చామీనీ	تشامینی
చారుతా	تشاروتا
చారుహస	تشاروهس
చారుహాస	تشاروهاس
చాశ్ముమ	تشاشموم
చాహనా	تشاهنا
చింతక	تشینتك
చింతా	تشینتا
చిత్తప్రసాద	تشیتتبرساد
చిత్రంశీ	تشیترنشی
చిత్రఅక్షాం	تشیتراكشان
చిత్రకూట సమాంశ్రాయా	تشیتركوط سمانشرایا
చిత్రబానా	تشیتربانا
చిత్రలేఖా	تشیترلیكها
చిత్రాంగీ	تشیترانجی
చిత్రాదీప	تشیترادیب
చిత్రాదేవీ	تشیترادیوی
చిత్రీనీ	تشیترینی
చిన్మయానందా	تشینمیانندا
చిమాయీ	تشیمایی
చీథాన్యలాథా	تشیتهانیلاتها
చీనీత్య	تشینیتی
చీన్నీః	تشیننیها
చీరాన్తానా	تشیرانتانا
చేతన	تشیتن
చేతన్దీప	تشیتندیب
చేతన్సాఈ	تشیتنساي
చేథనా	تشیتهنا
చేననా	تشیننا
చేరన్రాజ	تشیرنراج
చేరాస్య	تشیراسی
చేష్టా	تشیشطا
చైతాలీ	تشایتالی
చైన	تشاین
చైసరణ	تشایسرن
జగజీత	جججیت
జగతపాల	ججتبال
జగనమోహన	ججنموهن
జగనమోహినీ	ججنموهینی
జగ్రవీ	ججروی
జతన	جتن
జతాస్యా	جتاسیا
జత్యా	جتیا
జనకనందినీ	جنكنندینی
జనావ	جناو
జన్మయా	جنمیا
జప్తేశ	جبتیش
జమునా	جمونا
జయకిరన	جیكیرن
జయప్రభా	جیبربها
జయలేన	جیلین
జయాద్రాతా	جیادراتا
జయాన్థ్య	جیانتهی
జరాసంధా	جراسندها
జలధర	جلدهر
జలస	جلس
జలార్క	جلارك
జలీతా	جلیتا
జవాస	جواس
జవాహరీ	جواهری
జశంక	جشنك
జసల	جسل
జసు	جسو
జసోదా	جسودا
జస్మీథా	جسمیتها
జస్మీథ్యా	جسمیتهیا
జస్వందీ	جسوندی
జహానవీ	جهانوی
జహితా	جهیتا
జహేన్కార	جهینكار
జాంసీ	جانسی
జాగృతి	جاجرتی
జాగేశ	جاجیش
జాగ్రతి	جاجرتی
జాఝీమ	جاجهیم
జానవీ	جانوی
జిఅనా	جیانا
జిగీషా	جیجیشا
జితేన్ద్రియ	جیتیندریی
జిల్పా	جیلبا
జీగాయాంశ	جیجایانش
జీజీద	جیجید
జీజేశ	جیجیش
జీతాకమ	جیتاكم
జీతేశ	جیتیش
జీనయ	جینی
జీరల	جیرل
జీల	جیل
జీవజ	جیوج
జీవానాన్ధామ	جیواناندهام
జీవిథా	جیویتها
జుఈ	جوي
జూహీ	جوهی
జేఈనన	جیينن
జేగన	جیجن
జేత్వీక	جیتویك
జేయాన్ద్రణ	جییاندرن
జేలక్ష్మీ	جیلكشمی
జేశన	جیشن
జేహాన్నాఝ	جیهانناجه
జైచంద	جایتشند
జైదిశ	جایدیش
జైదీశ	جایدیش
జైదేవ	جایدیو
జైలేణ	جایلین
జ్ఞానవ	جنانو
జ్ఞానా	جنانا
జ్య భగవాన	جی بهجوان
జ్యోతిబాలా	جیوتیبالا
జ్యోత్సనీ	جیوتسنی
జ్హోశీల	جهوشیل
ఝంకృత	جهنكرت
ఝరల	جهرل
ఝినూక	جهینوك
ఝియాన	جهییان
ఝేన్శీ	جهینشی
ఝ్యాననీ	جهیاننی
టీనా	طینا
ఠాకరశీ	طهاكرشی
ఠుమకీ	طهومكی
తంగసామీ	تنجسامی
తంగామనీ	تنجامنی
తక్షక	تكشك
తనిష	تنیش
తనీశా	تنیشا
తనుం ప్రియా	تنون برییا
తనుంజాశ్రీ	تنونجاشری
తనుపా	تنوبا
తనుశ్రీ	تنوشری
తన్మయ	تنمی
తమిరా	تمیرا
తమోఘ్నా	تموجهنا
తరాశా	تراشا
తరిత	تریت
తరుణ	ترون
తరునా	ترونا
తరులతా	ترولتا
తరుశ్రీ	تروشری
తర్పనా	تربنا
తర్లికా	ترلیكا
తస్మయ	تسمی
తహేలీ	تهیلی
తాక్ష్యా	تاكشیا
తానాయ్మీ	تانایمی
తానికా	تانیكا
తానీగాఈ	تانیجاي
తానీసకా	تانیسكا
తానులీప	تانولیب
తానుసియా	تانوسییا
తాన్శ్రాయ	تانشرای
తాప్తీ	تابتی
తామాస్వినీ	تاماسوینی
తారకేశ	تاركیش
తారాక్ష	تاراكش
తారానీసేన	تارانیسین
తారూశ	تاروش
తిమిన	تیمین
తిరు	تیرو
తిరుపథీ	تیروبتهی
తీననీ	تیننی
తీరుమరణ	تیرومرن
తుంష్యతీ	تونشیتی
తుక్సా	توكسا
తునావా	توناوا
తుపమ	توبم
తుర్వీ	توروی
తులసీలతా	تولسیلتا
తులికా	تولیكا
తులీ	تولی
తులీనదార	تولیندار
తుశారా	توشارا
తుసరికా	توسریكا
తేగవిర	تیجویر
తేజీ	تیجی
తేజేన్ద్ర	تیجیندر
తేనుం	تینون
తేవాన	تیوان
తోయేశ	توییش
తోరుం	تورون
తౌతిక	تاوتیك
తౌలీక	تاولیك
త్రిజగతి	تریججتی
త్రినాథ	تریناته
త్రిలోకేశ	تریلوكیش
త్రిలోచనా	تریلوتشنا
త్రిశల	تریشل
త్రిశులినీ	تریشولینی
త్రిషర	تریشر
త్రీజోయా	تریجویا
త్రీపుర్తి	تریبورتی
త్రీయోగ	ترییوج
త్రీవిదా	تریویدا
త్వరితా	توریتا
థంసీ	تهنسی
థయా	تهیا
థార్సీన	تهارسین
థీక్శీకా	تهیكشیكا
థీనీథా	تهینیتها
థేజల	تهیجل
థ్రీశంఠ	تهریشنطه
దందాపానీ	دندابانی
దక్శీన్య	دكشینی
దక్షిత	دكشیت
దక్షీణ	دكشین
దనీలా	دنیلا
దన్యతా	دنیتا
దయానిధి	دیانیدهی
దరరేన	دررین
దరిద్రా ధావ్సీనీ	دریدرا دهاوسینی
దరిద్రీయానాశీనీ	دریدرییاناشینی
దర్పిత	دربیت
దర్మీనీ	درمینی
దర్మేన్దర	درمیندر
దర్శనా	درشنا
దర్శ్వానా	درشوانا
దలపతి	دلبتی
దలాపథీ	دلابتهی
దల్శేర	دلشیر
దహా	دها
దానాస్వీ	داناسوی
దానీశ	دانیش
దామినీ	دامینی
దారుకా	داروكا
దిబసరీ	دیبسری
దిబ్యా	دیبیا
దివీథా	دیویتها
దిశీతా	دیشیتا
దీక్శీకా	دیكشیكا
దీక్షానా	دیكشانا
దీపక	دیبك
దీపథీ	دیبتهی
దీపా లక్ష్మీ	دیبا لكشمی
దీపాంశ	دیبانش
దీపేందు	دیبیندو
దీప్తిమాన	دیبتیمان
దేజ	دیج
దేబజ్యోతీ	دیبجیوتی
దేబన్శీ	دیبنشی
దేబ్ప్రతిమ	دیببرتیم
దేబ్ప్రసాద	دیببرساد
దేయాశీనీ	دییاشینی
దేవకలీ	دیوكلی
దేవదత్తా	دیودتتا
దేవదర్శన	دیودرشن
దేవనారాయణ	دیوناراین
దేవమతి	دیومتی
దేవాదార్స	دیوادارس
దేవాన్శీ	دیوانشی
దేవారహాల్లీ	دیوارهاللی
దేవారీశీ	دیواریشی
దేవార్యా	دیواریا
దేవాశ్రీ	دیواشری
దేవాస్మిథా	دیواسمیتها
దేవినా	دیوینا
దేవేశీ	دیویشی
దేవేసీ	دیویسی
దేవ్యశీ	دیویشی
దేశనీ	دیشنی
దేశిక	دیشیك
దైపాయన	دایباین
ధనాశ్రీ	دهناشری
ధనాస్వీ	دهناسوی
ధనుస	دهنوس
ధరనీ	دهرنی
ధరమనిష్ఠ	دهرمنیشطه
ధరానిశ	دهرانیش
ధర్మజా	دهرمجا
ధర్మదాస	دهرمداس
ధర్మదేవ	دهرمدیو
ధర్శానీ	دهرشانی
ధర్శీనీ	دهرشینی
ధర్శీనీకా	دهرشینیكا
ధవల	دهول
ధాన	دهان
ధానశ్రీ	دهانشری
ధానీశ్కా	دهانیشكا
ధామ	دهام
ధామన	دهامن
ధారణా	دهارنا
ధారనా	دهارنا
ధావక	دهاوك
ధీక్శీథా	دهیكشیتها
ధీయాన	دهییان
ధీవాశీనీ	دهیواشینی
ధుమావతీ	دهوماوتی
ధూన	دهون
ధృతి	دهرتی
ధేయాంశీ	دهییانشی
ధైర్యశీల	دهایریشیل
ధోశీనీ	دهوشینی
ధ్రాస్తీ	دهراستی
నంద	نند
నందలాల	نندلال
నందినీ	نندینی
నందీఘోష	نندیجهوش
నక్షాత్ర	نكشاتر
నగరజన	نجرجن
నగా మాంల్లేస్వారీ	نجا مانللیسواری
నచికేతాస	نتشیكیتاس
నటరాజన	نطراجن
నభా	نبها
నభాన్యు	نبهانیو
నభోజ	نبهوج
నమ్రతా	نمرتا
నరేన	نرین
నరేన్దేర	نریندیر
నర్తానా	نرتانا
నర్మద	نرمد
నర్మదా	نرمدا
నలినా	نلینا
నలేశ	نلیش
నవకార	نوكار
నవరాజ	نوراج
నవితా	نویتا
నాగదాతా	ناجداتا
నాగనాథ	ناجناته
నాగరాజు	ناجراجو
నాగేశ్వర	ناجیشور
నాతాభైరవీ	ناتابهایروی
నాతేసన	ناتیسن
నాధీనీ	نادهینی
నాన్నాన	ناننان
నామదేవ	نامدیو
నామాంనారాయనీ	نامانناراینی
నామాంశీ	نامانشی
నామీశా	نامیشا
నారన	نارن
నారాయన	ناراین
నారీనే	ناریني
నావేతా	ناویتا
నాహర	ناهر
నికేతా	نیكیتا
నిఖార	نیكهار
నిఖాల	نیكهال
నితల	نیتل
నిదాన	نیدان
నిధ్యానా	نیدهیانا
నినాద	نیناد
నిమల	نیمل
నిమేశ	نیمیش
నిరంజనీ	نیرنجنی
నిరాంత	نیرانت
నిరాధార	نیرادهار
నిర్మళా	نیرمرا
నిలారూనా	نیلارونا
నిలావోలీ	نیلاوولی
నిలీన	نیلین
నిశ్కా	نیشكا
నిష్ణాం	نیشنان
నీకశ	نیكش
నీకాన్దర్య	نیكاندری
నీకాశా	نیكاشا
నీకుంజా	نیكونجا
నీక్కుం	نیككون
నీఖేల	نیكهیل
నీగీ	نیجی
నీచికా	نیتشیكا
నీధాన	نیدهان
నీనీశా	نینیشا
నీపునా	نیبونا
నీబోధీతా	نیبودهیتا
నీభా	نیبها
నీమ్రిత	نیمریت
నీరాలీ	نیرالی
నీల కాంతా	نیل كانتا
నీలనీ	نیلنی
నీలమణి	نیلمنی
నీలాంజనా	نیلانجنا
నీలాబ్జా	نیلابجا
నీలామ్బరీ	نیلامبری
నీలేశ	نیلیش
నీవ	نیو
నీశ్రుతా	نیشروتا
నీసమాం	نیسمان
నీహన	نیهن
నేదుమాన	نیدومان
నేమీ	نیمی
నేమీశా	نیمیشا
నైంశీ	ناینشی
నైజా	نایجا
నైమాథ	نایماته
నైషా	نایشا
పంచావక్త్ర	بنتشاوكتر
పంధారీ	بندهاری
పద్మనాభ	بدمنابه
పద్మనాభా	بدمنابها
పద్మరేఖా	بدمریكها
పద్మల	بدمل
పద్మలోచన	بدملوتشن
పద్మాంనాభాన	بدماننابهان
పద్మాంనేత్ర	بدماننیتر
పద్మాకలీ	بدماكلی
పద్మాక్షీ	بدماكشی
పద్మామ	بدمام
పద్మారాజ	بدماراج
పనితా	بنیتا
పన్కీల	بنكیل
పన్కోజ	بنكوج
పన్యశ్రీ	بنیشری
పమ్బా	بمبا
పరణావీ	برناوی
పరబ్రహ్మనా	بربرهمنا
పరమ-హంస	برم-هنس
పరమేశ్వరీ	برمیشوری
పరసమే	برسمي
పరాగ	براج
పరాన్జయ	برانجی
పరామితా	برامیتا
పరిణీతా	برینیتا
పరీశుధ	بریشوده
పరు	برو
పరుశీ	بروشی
పర్తిక	برتیك
పర్వతీప్రిత	بروتیبریت
పలానీచామ్య	بلانیتشامی
పలాశకుసూమ	بلاشكوسوم
పల్లవిత	بللویت
పళవా	بروا
పవనసుత	بونسوت
పవీథా	بویتها
పవీన	بوین
పవీశ	بویش
పవీశీకా	بویشیكا
పాండురంగ	باندورنج
పాగలావన	باجلاون
పాటవ	باطو
పాణినీ	بانینی
పానీక	بانیك
పాయోధర	بایودهر
పారమితా	بارمیتا
పారవాథీ	بارواتهی
పారిజాత	باریجات
పార్థే	بارتهي
పావకీ	باوكی
పావలీన	باولین
పావానా	باوانا
పింగా	بینجا
పినాకిన	بیناكین
పీఅల్లీ	بیاللی
పీయుశా	بییوشا
పీరనీథా	بیرنیتها
పీహూ	بیهو
పూజా	بوجا
పూజిత	بوجیت
పూనిశ	بونیش
పూర్వికా	بورویكا
పూర్వీ	بوروی
పేమల	بیمل
పోంనన	بوننن
పోగులా	بوجولا
పోన్మాంలా	بونمانلا
పోరోమాం	بورومان
పౌలోమీ	باولومی
ప్రకారనా	بركارنا
ప్రగ్నీకా	برجنیكا
ప్రచీతా	برتشیتا
ప్రనాయా	برنایا
ప్రనావ్యా	برناویا
ప్రబంజన	بربنجن
ప్రబకరణ	بربكرن
ప్రభావ	بربهاو
ప్రమ్లాతా	برملاتا
ప్రహాసా	برهاسا
ప్రాగీ	براجی
ప్రాచికా	براتشیكا
ప్రాణ	بران
ప్రానక	برانك
ప్రానల	برانل
ప్రాశా	براشا
ఫనిన్ద్రనాథ	بهنیندرناته
ఫాల్గున	بهالجون
ఫాల్గునీ	بهالجونی
ఫాల్యా	بهالیا
ఫుతికా	بهوتیكا
ఫూలమాలా	بهولمالا
ఫూలేందు	بهولیندو
ఫేనిల	بهینیل
బటుక	بطوك
బద్రీ	بدری
బద్రీనాథ	بدریناته
బనవారీ	بنواری
బన్శిక	بنشیك
బన్హీ	بنهی
బబితా	ببیتا
బరన	برن
బరసాత	برسات
బరిద	برید
బరున	برون
బలదేవ	بلدیو
బలప్రదా	بلبردا
బలరామ	بلرام
బలవీర	بلویر
బల్మానీ	بلمانی
బవిశ్యా	بویشیا
బాంకేబిహారీ	بانكیبیهاری
బాంసురీ	بانسوری
బాల కృష్ణ	بال كرشن
బాలక్రిష్నా	بالكریشنا
బాలా	بالا
బాలారాజ	بالاراج
బాలారామ	بالارام
బాలాశంకర	بالاشنكر
బాళ గణపతి	بار جنبتی
బావరీ	باوری
బావీన	باوین
బిందియా	بیندیا
బినీతా	بینیتا
బిమల	بیمل
బిమలా	بیملا
బిల్వా	بیلوا
బీనాతా	بیناتا
బీన్కాల	بینكال
బీన్దేశ్వర	بیندیشور
బీన్నీకేర	بیننیكیر
బీప్రా	بیبرا
బీసలతా	بیسلتا
బుధీప్రియా	بودهیبرییا
బేకురీ	بیكوری
బేథినా	بیتهینا
బేలావార్ధానా	بیلاواردهانا
బ్రహ్మావతీ	برهماوتی
బ్రీన్ధా	بریندها
భక్తావాత్సలా	بهكتاواتسلا
భక్తి	بهكتی
భగదిత్య	بهجدیتی
భద్రీశా	بهدریشا
భవాద	بهواد
భవ్య శ్రీ	بهوی شری
భాగవాథ్య	بهاجواتهی
భాగేశ	بهاجیش
భాగ్యా	بهاجیا
భానీశ	بهانیش
భాన్ధవీ	بهاندهوی
భాలేంద్ర	بهالیندر
భావ	بهاو
భావిన	بهاوین
భావేశ్వారీ	بهاویشواری
భావ్నీశ	بهاونیش
భావ్యశ్రీ	بهاویشری
భాశ్వీనీ	بهاشوینی
భాస్వన	بهاسون
భాస్వాథ	بهاسواته
భిమేశ	بهیمیش
భీఖీ	بهیكهی
భీమా	بهیما
భీలానగనా	بهیلانجنا
భీష్మ	بهیشم
భువనేశ్వరీ	بهوونیشوری
భువన్పతీ	بهوونبتی
భువేశ	بهوویش
భూతేశ్వర	بهوتیشور
భూపేన్ద్ర	بهوبیندر
భూమత	بهومت
భూమిక	بهومیك
భూమీజా	بهومیجا
భోజరాజా	بهوجراجا
భ్రమర	بهرمر
భ్రిథీ	بهریتهی
మంగలమూర్తి	منجلمورتی
మంజుల	منجول
మంజులా	منجولا
మందాకినీ	منداكینی
మందాక్రాంతా	منداكرانتا
మణిశంకర	منیشنكر
మదిర	مدیر
మదేశ	مدیش
మద్వాన	مدوان
మధుప	مدهوب
మధుపాల	مدهوبال
మధురానీ	مدهورانی
మధులా	مدهولا
మధుశా	مدهوشا
మధుసూదన	مدهوسودن
మనన	منن
మనప	منب
మనమోహన	منموهن
మనస్విన	منسوین
మనాగోబీనదా	مناجوبیندا
మనీమ	منیم
మనోమయ	منومی
మనోహర	منوهر
మనోహరణ	منوهرن
మన్మాయీ	منمایی
మన్విత	منویت
మన్వీర	منویر
మల్లేశ	مللیش
మశీనీ	مشینی
మహాయోగీన	مهایوجین
మహారావణమర్దానా	مهاراونمردانا
మహాలీన్గమ	مهالینجم
మహింద్రా	مهیندرا
మహీథా	مهیتها
మహేర	مهیر
మహేశీ	مهیشی
మహేశ్వర	مهیشور
మాంగలీ	مانجلی
మాంగేశ్వారీ	مانجیشواری
మాందవ	ماندو
మాంన్గ్గౌర్దీ	ماننججاوردی
మాంన్జీరీ	ماننجیری
మాంన్దారికా	ماننداریكا
మాంన్వితా	ماننویتا
మాంరుతాత్మాజా	مانروتاتماجا
మాతంగీ	ماتنجی
మాతన	ماتن
మాధవిలతా	مادهویلتا
మాధుకేశ	مادهوكیش
మాధుర్య	مادهوری
మానధన	ماندهن
మానీక్యా	مانیكیا
మాన్యసరీ	مانیسری
మాయుఖీ	مایوكهی
మారూత	ماروت
మార్గీన	مارجین
మార్తండ	مارتند
మాలారవిలీ	مالارویلی
మాసమాం	ماسمان
మీనల	مینل
మైత్రా	مایترا
మైనాలీ	ماینالی
మైనావీ	مایناوی
మైరవా	مایروا
మౌలీశా	ماولیشا
యక్ష	یكش
యజత	یجت
యజుర్వ	یجورو
యతావన	یتاون
యత్నేశ	یتنیش
యదు	یدو
యదుక్రిష్నా	یدوكریشنا
యదునందన	یدونندن
యవనా	یونا
యశవర్ధన	یشوردهن
యశికా	یشیكا
యశ్వీ	یشوی
యశ్శ్రీ	یششری
యాజ్నా	یاجنا
యాతన	یاتن
యాతనా	یاتنا
యాత్నీక	یاتنیك
యాత్వికా	یاتویكا
యాదమమాం	یادممان
యాదీతా	یادیتا
యాద్నేశ	یادنیش
యామికా	یامیكا
యాశీకా	یاشیكا
యాసస్వీ	یاسسوی
యుంగేన్దర	یونجیندر
యుగన్తీకా	یوجنتیكا
యుగా	یوجا
యుగీన	یوجین
యుధావ	یودهاو
యుధీష్ఠీర	یودهیشطهیر
యుధ్ధ	یودهده
యుయుత్సు	یویوتسو
యువతీ	یووتی
యువాసరీ	یوواسری
యుసు	یوسو
యూరా	یورا
యేక్షిత	ییكشیت
యేఘరాజ	ییجهراج
యేశాస్వీనీ	ییشاسوینی
యేశ్మిత	ییشمیت
యేస్వంఠ	ییسونطه
యోగధీపా	یوجدهیبا
యోగలక్ష్మీ	یوجلكشمی
యోగా	یوجا
యోగాజా	یوجاجا
యోగానంద	یوجانند
యోగీ	یوجی
యోగేశ్వర	یوجیشور
యోగ్నవీ	یوجنوی
యోజనా	یوجنا
యోనితా	یونیتا
యోనేన్ద్ర	یونیندر
యోషిత	یوشیت
యోసనా	یوسنا
యోహ్శీనీ	یوهشینی
రంగప్రసాత	رنجبرسات
రంగరాజన	رنجراجن
రంగీత	رنجیت
రంజన	رنجن
రంజినీ	رنجینی
రంహ	رنه
రక్త	ركت
రక్తకమళ	ركتكمر
రక్తీమాం	ركتیمان
రక్షాద	ركشاد
రక్షావనరసంగథీనే	ركشاونرسنجتهیني
రగవార్శీనీ	رجوارشینی
రగిశ	رجیش
రగునాన్తన	رجونانتن
రజనీ	رجنی
రజిత	رجیت
రజినిపతి	رجینیبتی
రజీనీ	رجینی
రజీబ	رجیب
రజోఅబా	رجوابا
రణబీర	رنبیر
రతనమ	رتنم
రత్నాలీ	رتنالی
రత్నావలీ	رتناولی
రత్న్ప్రీయా	رتنبرییا
రథనా	رتهنا
రదీతే	ردیتي
రబేక	ربیك
రమాంలీన్గమ	رمانلینجم
రమాంవితా	رمانویتا
రమేశ్వరీ	رمیشوری
రర్నా	ررنا
రవి కాన్త	روی كانت
రవిజ	رویج
రవిన్శు	روینشو
రవిశంకర	رویشنكر
రవిశరణ	رویشرن
రవీకిరణ	رویكیرن
రవీచక్ర	رویتشكر
రవీతేజా	رویتیجا
రవీయంకీ	رویینكی
రవేన	روین
రశీల	رشیل
రశేష	رشیش
రశ్వంత	رشونت
రసికా	رسیكا
రాగ్వీనదార	راجویندار
రాజ  కిరణ	راج  كیرن
రాజతిలక	راجتیلك
రాజనాథ	راجناته
రాజన్య	راجنی
రాజమ	راجم
రాజవంత	راجونت
రాజసేకరణ	راجسیكرن
రాజహంసా	راجهنسا
రాజాథీ	راجاتهی
రాజూ	راجو
రాజేంద్రమోహన	راجیندرموهن
రాజేశ	راجیش
రాజ్వార్దన	راجواردن
రాధనా	رادهنا
రాధేయ	رادهیی
రాధ్యా	رادهیا
రాబేన	رابین
రామ  సేవక	رام  سیوك
రామచంద్ర	رامتشندر
రామదాస	رامداس
రామనాథ	رامناته
రామనారాయణ	رامناراین
రామమోహన	رامموهن
రావణ	راون
రావలీ	راولی
రాశిమ	راشیم
రాష్పల	راشبل
రాహనీ	راهنی
రాహుల	راهول
రినీ	رینی
రియా	رییا
రీఅనా	ریانا
రీతోమాం	ریتومان
రీథానా	ریتهانا
రీథీశా	ریتهیشا
రీథేకా	ریتهیكا
రీథ్వీ	ریتهوی
రీధుశనీ	ریدهوشنی
రీపాంశీ	ریبانشی
రీశీప్రియా	ریشیبرییا
రీశుం	ریشون
రేఖా	ریكها
రేచల	ریتشل
రేణు	رینو
రేశమ	ریشم
రేశ్వింద	ریشویند
రౌశన	راوشن
ర్హియా	رهییا
ల వేశ	ل ویش
లక్షన్య	لكشنی
లక్ష్మణ	لكشمن
లక్ష్మీదేవీ	لكشمیدیوی
లగాన	لجان
లజ్జా	لججا
లజ్జాన	لججان
లతికా	لتیكا
లశీతా	لشیتا
లాడలీ	لادلی
లాథీకా	لاتهیكا
లాభా	لابها
లామ్బోధార	لامبودهار
లాయక	لایك
లారా	لارا
లాలాతక్షా	لالاتكشا
లావణ్య	لاونی
లావానయ	لاوانی
లావీత్ర	لاویتر
లావీశ	لاویش
లాస్రీథా	لاسریتها
లిబ్నీ	لیبنی
లియన	لیین
లీకీలేశ	لیكیلیش
లీక్సీథా	لیكسیتها
లీగ	لیج
లీన్సీ	لینسی
లీపికా	لیبیكا
లీషణ	لیشن
లుకేశ	لوكیش
లేఈవీనా	لیيوینا
లేఖ	لیكه
లేఖిత	لیكهیت
లేథీకా	لیتهیكا
లేమార	لیمار
లోఉకిక	لووكیك
లోఉక్యీనీ	لووكیینی
లోకరంజన	لوكرنجن
లోకాపుజ్య	لوكابوجی
లోక్యా	لوكیا
లోమశ	لومش
లోలా	لولا
లోవ్యమ	لوویم
లోశానా	لوشانا
లోహీతాక్ష	لوهیتاكش
వంచిత	ونتشیت
వంచితా	ونتشیتا
వంశజా	ونشجا
వక్తి	وكتی
వచన	وتشن
వజ్రబాహూ	وجرباهو
వజ్రాకాయా	وجراكایا
వజ్రాజిత	وجراجیت
వనజా	ونجا
వనినీ	ونینی
వనియా	ونییا
వనీత	ونیت
వన్ధానా	وندهانا
వయుజత	ویوجت
వయ్శీనీ	ویشینی
వరదావీనాయకా	ورداوینایكا
వరహీ	ورهی
వరిన	ورین
వరియాస	ورییاس
వరునాగురుం	وروناجورون
వరునాప్రియా	ورونابرییا
వరునేశ	ورونیش
వరేణ్య	ورینی
వరేన్ద్ర	وریندر
వరేసీఖ	وریسیكه
వర్చస	ورتشس
వర్ణికా	ورنیكا
వర్ధమాన	وردهمان
వర్ధానీ	وردهانی
వర్నీశా	ورنیشا
వర్శనేయా	ورشنییا
వర్శాల	ورشال
వర్శీద	ورشید
వర్ష	ورش
వర్షీత	ورشیت
వర్షేనీ	ورشینی
వలాక	ولاك
వశీకరణ	وشیكرن
వశీతా	وشیتا
వసవీ	وسوی
వసుదేవన	وسودیون
వాకుల	واكول
వాచాస్య	واتشاسی
వాత్సల్య	واتسلی
వాత్సల్రాజ	واتسلراج
వాదిశ	وادیش
వానాజక్ష	واناجكش
వానిఏ	وانیي
వానుం	وانون
వాన్శుల	وانشول
వాన్సీకా	وانسیكا
వామిల	وامیل
వామీకా	وامیكا
వామ్నాయీ	وامنایی
వామ్శీథా	وامشیتها
వామ్సిధార	وامسیدهار
వాయున	وایون
వాయునా	وایونا
వారుణీ	وارونی
వారునీ	وارونی
వాల్లాకీ	واللاكی
వాసన్తీ	واسنتی
వాసుశ్రీ	واسوشری
వాహీలా	واهیلا
వికీశా	ویكیشا
విక్నేస్వారీ	ویكنیسواری
విజైతా	ویجایتا
విదీకా	ویدیكا
విదుషీ	ویدوشی
విద్యాలక్ష్మీ	ویدیالكشمی
వినతి	وینتی
వినాపానీ	وینابانی
వినావాదీనీ	ویناوادینی
విన్ధుజా	ویندهوجا
విభాంశు	ویبهانشو
విభాత్సుం	ویبهاتسون
విభావ	ویبهاو
విభావాసు	ویبهاواسو
విభిశానా ప్రతీశ్త్తాత్రే	ویبهیشانا برتیشتتاتري
విరాజు	ویراجو
విరాస్వామ్య	ویراسوامی
విలాసితా	ویلاسیتا
విహారికా	ویهاریكا
వీక్షా	ویكشا
వీణాధారీ	وینادهاری
వీహా	ویها
వేక్శనా	ویكشنا
వేద ఆర్యన	وید آرین
వేదవల్లీ	ویدوللی
వేదవ్రతా	ویدورتا
వేదీష	ویدیش
వేనీధర	وینیدهر
వేనుం గోపాల	وینون جوبال
వేనుమాధవ	وینومادهو
వేన్కాత్రమణ	وینكاترمن
వేన్కాత్శీవా	وینكاتشیوا
వేర్నీకా	ویرنیكا
వైకుంఠ నాథ	وایكونطه ناته
వైజయీ	وایجیی
వైదిక	وایدیك
వైద్యుంత	وایدیونت
వైధవీక	وایدهویك
వైధాఈ	وایدهاي
వైనావీ	وایناوی
శక్తిధార్య	شكتیدهاری
సంకీతా	سنكیتا
సంగత	سنجت
సంగ్రామ	سنجرام
సంచాయా	سنتشایا
సంచాలీ	سنتشالی
సంజన	سنجن
సంజయా	سنجیا
సంజితా	سنجیتا
సంజీతీ	سنجیتی
సంజీథా	سنجیتها
సంతయానీ	سنتیانی
సందతా	سندتا
సందీప	سندیب
సందీపన	سندیبن
సందీపేన	سندیبین
సంబిత	سنبیت
సంయోగితా	سنیوجیتا
సంవిధా	سنویدها
సంహిత	سنهیت
సంహితా	سنهیتا
సఈ దిపక	سي دیبك
సకలేశ్వర	سكلیشور
సకుంజ	سكونج
సకేశ	سكیش
సగుణ	سجون
సగునా	سجونا
సచంద్ర	ستشندر
సచ్చిత	ستشتشیت
సచ్చిదానందా	ستشتشیدانندا
సదా	سدا
సదా శివమ	سدا شیوم
సదానంద	سدانند
సదాశివ	سداشیو
సద్గుణ	سدجون
సనత	سنت
సనల	سنل
సనాతనా	سناتنا
సనావ్య	سناوی
సనీత	سنیت
సన్థీమాంథీ	سنتهیمانتهی
సన్నిధి	سننیدهی
సపనా దేవీ	سبنا دیوی
సప్తోమీ	سبتومی
సబ్రేశ	سبریش
సమరేందు	سمریندو
సమర్థ	سمرته
సమవర్త	سمورت
సమాంర్ధ	سمانرده
సమితా	سمیتا
సమీన	سمین
సమీరన	سمیرن
సమీసా	سمیسا
సముదాయ	سمودای
సమృద్ధి	سمرددهی
సమ్ప్రీతీ	سمبریتی
సమ్ప్రీయా	سمبرییا
సమ్ముద	سممود
సమ్రీధా	سمریدها
సమ్వీథ	سمویته
సరసతీ	سرستی
సరస్వతీ	سرسوتی
సరీగా	سریجا
సర్బానీ	سربانی
సహస్త్రజిత	سهسترجیت
సహ్తోష	سهتوش
సాఈ కార్తిక	ساي كارتیك
సాఈ కుమారీ	ساي كوماری
సాఈ జీవధరా	ساي جیودهرا
సాఈ వాణీ	ساي وانی
సాఈ శ్రీ	ساي شری
సాకేథా	ساكیتها
సాక్షీన	ساكشین
సాత్విక	ساتویك
సాధవ	سادهو
సానందనా	سانندنا
సాబరీఏశ	سابرییش
సామిల	سامیل
సాయన	ساین
సారణీ	سارنی
సాలేనా	سالینا
సాహస్రాంజలి	ساهسرانجلی
సైచారణ	سایتشارن
సైనా	ساینا
సైలేశ్వర	سایلیشور
సైశా	سایشا
హంశల	هنشل
హక్ష	هكش
హటీశ	هطیش
హనసీకా	هنسیكا
హనార్వీన	هناروین
హనిశ	هنیش
హన్శీతా	هنشیتا
హమసాదీపికా	همسادیبیكا
హమీర	همیر
హమ్సలేఖా	همسلیكها
హయాగ్రివ	هیاجریو
హయాతీ	هیاتی
హరమ్యా	هرمیا
హరిఅక్సా	هریاكسا
హరికా	هریكا
హరిగోపాల	هریجوبال
హరిత	هریت
హరిదాస	هریداس
హరిన	هرین
హరినా	هرینا
హరినాక్షీ	هریناكشی
హరియాన	هرییان
హరిశంకర	هریشنكر
హరిహర పుత్ర	هریهر بوتر
హరీ నారాయణ	هری ناراین
హర్యక్ష	هریكش
హర్యాక్షా	هریاكشا
హర్ష	هرش
హర్షవర్దన	هرشوردن
హర్షిత	هرشیت
హర్స్వీతా	هرسویتا
హవన	هون
హవీసా	هویسا
హసీనా	هسینا
హసుం	هسون
హార్శీనీ	هارشینی
హావీషా	هاویشا
హితాంశీ	هیتانشی
హితాంశు	هیتانشو
హిన్దవీ	هیندوی
హిన్ధావీ	هیندهاوی
హిమంత రాజ	هیمنت راج
హిమాంవార్శీకా	هیمانوارشیكا
హిమాంసేఖర	هیمانسیكهر
హిమాన	هیمان
హిమావత	هیماوت
హిమీశా	هیمیشا
హిరణ	هیرن
హిరుధాయా	هیرودهایا
హిశేతా	هیشیتا
హీతా	هیتا
హీమాంవాథీ	هیمانواتهی
హీరకనీ	هیركنی
హృషీకేశ	هرشیكیش
హేఇఅన	هیيان
హేనీల	هینیل
హేమ	هیم
హేమ లథా	هیم لتها
హేమకాంతా	هیمكانتا
హేమచంద్రా	هیمتشندرا
హేమన	هیمن
హేమా	هیما
హేమాంతి	هیمانتی
హేమీతా	هیمیتا
హేమ్నందన	هیمنندن
హైమాం	هيمان
హోనేయ్షా	هونییشا
హ్రదయ	هردی
హ్రిదయఆంశు	هریدیآنشو
హ్రీథీకా	هریتهیكا
హ్రీయాన	هرییان
హ్రీశా	هریشا
హ్రీషిత	هریشیت
